,generation,new_infections_1,new_infections_2,total_infections_1,total_infections_2,total_infections,simulation_id
0,0,1,0,1,0,1,0
1,1,1,0,2,0,2,0
2,2,1,0,3,0,3,0
3,3,1,0,4,0,4,0
4,4,2,0,6,0,6,0
5,5,3,0,9,0,9,0
6,6,1,0,10,0,10,0
7,7,2,0,12,0,12,0
8,8,2,0,14,0,14,0
9,9,0,1,14,1,15,0
10,10,1,3,15,4,19,0
11,11,1,1,16,5,21,0
12,12,0,1,16,6,22,0
13,13,0,1,16,7,23,0
14,14,0,0,16,7,23,0
0,0,1,0,1,0,1,1
1,1,0,1,1,1,2,1
2,2,0,1,1,2,3,1
3,3,0,0,1,2,3,1
0,0,1,0,1,0,1,2
1,1,1,0,2,0,2,2
2,2,0,0,2,0,2,2
0,0,1,0,1,0,1,3
1,1,0,1,1,1,2,3
2,2,0,2,1,3,4,3
3,3,0,1,1,4,5,3
4,4,0,0,1,4,5,3
0,0,1,0,1,0,1,4
1,1,2,0,3,0,3,4
2,2,0,1,3,1,4,4
3,3,0,0,3,1,4,4
0,0,1,0,1,0,1,5
1,1,1,0,2,0,2,5
2,2,1,1,3,1,4,5
3,3,1,2,4,3,7,5
4,4,0,1,4,4,8,5
5,5,0,0,4,4,8,5
0,0,1,0,1,0,1,6
1,1,0,0,1,0,1,6
0,0,1,0,1,0,1,7
1,1,0,0,1,0,1,7
0,0,1,0,1,0,1,8
1,1,1,0,2,0,2,8
2,2,1,1,3,1,4,8
3,3,2,1,5,2,7,8
4,4,2,2,7,4,11,8
5,5,2,2,9,6,15,8
6,6,2,3,11,9,20,8
7,7,2,1,13,10,23,8
8,8,3,1,16,11,27,8
9,9,1,1,17,12,29,8
10,10,1,1,18,13,31,8
11,11,1,0,19,13,32,8
12,12,1,0,20,13,33,8
13,13,1,0,21,13,34,8
14,14,0,0,21,13,34,8
0,0,1,0,1,0,1,9
1,1,1,1,2,1,3,9
2,2,2,1,4,2,6,9
3,3,1,1,5,3,8,9
4,4,0,1,5,4,9,9
5,5,1,0,6,4,10,9
6,6,1,0,7,4,11,9
7,7,0,0,7,4,11,9
0,0,1,0,1,0,1,10
1,1,1,0,2,0,2,10
2,2,1,0,3,0,3,10
3,3,1,0,4,0,4,10
4,4,2,0,6,0,6,10
5,5,3,0,9,0,9,10
6,6,3,1,12,1,13,10
7,7,0,1,12,2,14,10
8,8,1,0,13,2,15,10
9,9,2,0,15,2,17,10
10,10,1,1,16,3,19,10
11,11,1,1,17,4,21,10
12,12,0,0,17,4,21,10
0,0,1,0,1,0,1,11
1,1,0,1,1,1,2,11
2,2,0,0,1,1,2,11
0,0,1,0,1,0,1,12
1,1,0,1,1,1,2,12
2,2,0,0,1,1,2,12
0,0,1,0,1,0,1,13
1,1,0,0,1,0,1,13
0,0,1,0,1,0,1,14
1,1,0,0,1,0,1,14
0,0,1,0,1,0,1,15
1,1,1,0,2,0,2,15
2,2,1,0,3,0,3,15
3,3,1,0,4,0,4,15
4,4,2,0,6,0,6,15
5,5,1,0,7,0,7,15
6,6,0,0,7,0,7,15
0,0,1,0,1,0,1,16
1,1,0,2,1,2,3,16
2,2,1,0,2,2,4,16
3,3,1,0,3,2,5,16
4,4,0,1,3,3,6,16
5,5,0,0,3,3,6,16
0,0,1,0,1,0,1,17
1,1,2,0,3,0,3,17
2,2,2,0,5,0,5,17
3,3,1,1,6,1,7,17
4,4,0,0,6,1,7,17
0,0,1,0,1,0,1,18
1,1,1,0,2,0,2,18
2,2,1,1,3,1,4,18
3,3,0,1,3,2,5,18
4,4,0,0,3,2,5,18
0,0,1,0,1,0,1,19
1,1,0,0,1,0,1,19
0,0,1,0,1,0,1,20
1,1,1,0,2,0,2,20
2,2,0,2,2,2,4,20
3,3,1,1,3,3,6,20
4,4,1,0,4,3,7,20
5,5,0,0,4,3,7,20
0,0,1,0,1,0,1,21
1,1,0,1,1,1,2,21
2,2,0,1,1,2,3,21
3,3,1,0,2,2,4,21
4,4,1,0,3,2,5,21
5,5,1,0,4,2,6,21
6,6,2,1,6,3,9,21
7,7,1,0,7,3,10,21
8,8,0,0,7,3,10,21
0,0,1,0,1,0,1,22
1,1,0,0,1,0,1,22
0,0,1,0,1,0,1,23
1,1,0,0,1,0,1,23
0,0,1,0,1,0,1,24
1,1,2,0,3,0,3,24
2,2,2,0,5,0,5,24
3,3,0,0,5,0,5,24
0,0,1,0,1,0,1,25
1,1,3,0,4,0,4,25
2,2,2,1,6,1,7,25
3,3,1,1,7,2,9,25
4,4,1,0,8,2,10,25
5,5,0,0,8,2,10,25
0,0,1,0,1,0,1,26
1,1,1,0,2,0,2,26
2,2,1,0,3,0,3,26
3,3,1,0,4,0,4,26
4,4,0,0,4,0,4,26
0,0,1,0,1,0,1,27
1,1,0,1,1,1,2,27
2,2,0,0,1,1,2,27
0,0,1,0,1,0,1,28
1,1,0,1,1,1,2,28
2,2,0,0,1,1,2,28
0,0,1,0,1,0,1,29
1,1,1,0,2,0,2,29
2,2,0,0,2,0,2,29
0,0,1,0,1,0,1,30
1,1,1,0,2,0,2,30
2,2,1,0,3,0,3,30
3,3,2,0,5,0,5,30
4,4,0,1,5,1,6,30
5,5,0,1,5,2,7,30
6,6,0,0,5,2,7,30
0,0,1,0,1,0,1,31
1,1,0,0,1,0,1,31
0,0,1,0,1,0,1,32
1,1,1,1,2,1,3,32
2,2,1,1,3,2,5,32
3,3,2,2,5,4,9,32
4,4,2,3,7,7,14,32
5,5,0,0,7,7,14,32
0,0,1,0,1,0,1,33
1,1,1,0,2,0,2,33
2,2,0,0,2,0,2,33
0,0,1,0,1,0,1,34
1,1,0,1,1,1,2,34
2,2,0,2,1,3,4,34
3,3,1,4,2,7,9,34
4,4,1,1,3,8,11,34
5,5,1,0,4,8,12,34
6,6,0,0,4,8,12,34
0,0,1,0,1,0,1,35
1,1,0,0,1,0,1,35
0,0,1,0,1,0,1,36
1,1,0,0,1,0,1,36
0,0,1,0,1,0,1,37
1,1,2,0,3,0,3,37
2,2,1,0,4,0,4,37
3,3,1,0,5,0,5,37
4,4,1,0,6,0,6,37
5,5,1,0,7,0,7,37
6,6,0,1,7,1,8,37
7,7,0,0,7,1,8,37
0,0,1,0,1,0,1,38
1,1,1,0,2,0,2,38
2,2,0,0,2,0,2,38
0,0,1,0,1,0,1,39
1,1,0,0,1,0,1,39
0,0,1,0,1,0,1,40
1,1,0,2,1,2,3,40
2,2,0,1,1,3,4,40
3,3,0,0,1,3,4,40
0,0,1,0,1,0,1,41
1,1,1,0,2,0,2,41
2,2,2,0,4,0,4,41
3,3,0,0,4,0,4,41
0,0,1,0,1,0,1,42
1,1,0,1,1,1,2,42
2,2,0,1,1,2,3,42
3,3,1,0,2,2,4,42
4,4,0,0,2,2,4,42
0,0,1,0,1,0,1,43
1,1,1,0,2,0,2,43
2,2,3,0,5,0,5,43
3,3,0,1,5,1,6,43
4,4,0,1,5,2,7,43
5,5,0,1,5,3,8,43
6,6,0,0,5,3,8,43
0,0,1,0,1,0,1,44
1,1,1,0,2,0,2,44
2,2,1,0,3,0,3,44
3,3,0,0,3,0,3,44
0,0,1,0,1,0,1,45
1,1,1,0,2,0,2,45
2,2,3,0,5,0,5,45
3,3,2,2,7,2,9,45
4,4,5,4,12,6,18,45
5,5,0,5,12,11,23,45
6,6,0,4,12,15,27,45
7,7,0,0,12,15,27,45
0,0,1,0,1,0,1,46
1,1,2,0,3,0,3,46
2,2,2,1,5,1,6,46
3,3,1,2,6,3,9,46
4,4,1,1,7,4,11,46
5,5,1,2,8,6,14,46
6,6,0,3,8,9,17,46
7,7,1,1,9,10,19,46
8,8,1,0,10,10,20,46
9,9,0,0,10,10,20,46
0,0,1,0,1,0,1,47
1,1,1,0,2,0,2,47
2,2,1,0,3,0,3,47
3,3,0,0,3,0,3,47
0,0,1,0,1,0,1,48
1,1,0,0,1,0,1,48
0,0,1,0,1,0,1,49
1,1,2,0,3,0,3,49
2,2,1,1,4,1,5,49
3,3,1,1,5,2,7,49
4,4,3,4,8,6,14,49
5,5,2,5,10,11,21,49
6,6,1,6,11,17,28,49
7,7,2,4,13,21,34,49
8,8,3,2,16,23,39,49
9,9,2,1,18,24,42,49
10,10,1,3,19,27,46,49
11,11,2,5,21,32,53,49
12,12,3,3,24,35,59,49
13,13,1,3,25,38,63,49
14,14,2,3,27,41,68,49
15,15,0,1,27,42,69,49
16,16,1,0,28,42,70,49
17,17,1,0,29,42,71,49
18,18,0,0,29,42,71,49
0,0,1,0,1,0,1,50
1,1,0,0,1,0,1,50
0,0,1,0,1,0,1,51
1,1,0,0,1,0,1,51
0,0,1,0,1,0,1,52
1,1,1,0,2,0,2,52
2,2,0,0,2,0,2,52
0,0,1,0,1,0,1,53
1,1,2,0,3,0,3,53
2,2,1,0,4,0,4,53
3,3,0,0,4,0,4,53
0,0,1,0,1,0,1,54
1,1,1,0,2,0,2,54
2,2,0,0,2,0,2,54
0,0,1,0,1,0,1,55
1,1,0,0,1,0,1,55
0,0,1,0,1,0,1,56
1,1,0,0,1,0,1,56
0,0,1,0,1,0,1,57
1,1,0,0,1,0,1,57
0,0,1,0,1,0,1,58
1,1,0,0,1,0,1,58
0,0,1,0,1,0,1,59
1,1,0,0,1,0,1,59
0,0,1,0,1,0,1,60
1,1,0,0,1,0,1,60
0,0,1,0,1,0,1,61
1,1,3,0,4,0,4,61
2,2,5,0,9,0,9,61
3,3,2,2,11,2,13,61
4,4,3,0,14,2,16,61
5,5,0,0,14,2,16,61
0,0,1,0,1,0,1,62
1,1,1,0,2,0,2,62
2,2,1,0,3,0,3,62
3,3,0,0,3,0,3,62
0,0,1,0,1,0,1,63
1,1,1,0,2,0,2,63
2,2,1,0,3,0,3,63
3,3,2,0,5,0,5,63
4,4,2,0,7,0,7,63
5,5,1,0,8,0,8,63
6,6,0,1,8,1,9,63
7,7,0,2,8,3,11,63
8,8,0,1,8,4,12,63
9,9,0,0,8,4,12,63
0,0,1,0,1,0,1,64
1,1,2,0,3,0,3,64
2,2,1,1,4,1,5,64
3,3,0,0,4,1,5,64
0,0,1,0,1,0,1,65
1,1,0,1,1,1,2,65
2,2,0,1,1,2,3,65
3,3,0,0,1,2,3,65
0,0,1,0,1,0,1,66
1,1,1,0,2,0,2,66
2,2,1,0,3,0,3,66
3,3,0,0,3,0,3,66
0,0,1,0,1,0,1,67
1,1,1,0,2,0,2,67
2,2,0,0,2,0,2,67
0,0,1,0,1,0,1,68
1,1,1,1,2,1,3,68
2,2,1,2,3,3,6,68
3,3,2,3,5,6,11,68
4,4,0,3,5,9,14,68
5,5,0,1,5,10,15,68
6,6,0,0,5,10,15,68
0,0,1,0,1,0,1,69
1,1,1,0,2,0,2,69
2,2,0,1,2,1,3,69
3,3,0,1,2,2,4,69
4,4,0,1,2,3,5,69
5,5,0,1,2,4,6,69
6,6,0,0,2,4,6,69
0,0,1,0,1,0,1,70
1,1,0,2,1,2,3,70
2,2,0,1,1,3,4,70
3,3,1,1,2,4,6,70
4,4,1,3,3,7,10,70
5,5,0,4,3,11,14,70
6,6,0,5,3,16,19,70
7,7,0,3,3,19,22,70
8,8,1,1,4,20,24,70
9,9,1,1,5,21,26,70
10,10,1,1,6,22,28,70
11,11,1,1,7,23,30,70
12,12,0,0,7,23,30,70
0,0,1,0,1,0,1,71
1,1,1,0,2,0,2,71
2,2,1,0,3,0,3,71
3,3,0,0,3,0,3,71
0,0,1,0,1,0,1,72
1,1,0,0,1,0,1,72
0,0,1,0,1,0,1,73
1,1,1,1,2,1,3,73
2,2,0,0,2,1,3,73
0,0,1,0,1,0,1,74
1,1,1,0,2,0,2,74
2,2,1,0,3,0,3,74
3,3,1,0,4,0,4,74
4,4,4,0,8,0,8,74
5,5,1,1,9,1,10,74
6,6,0,1,9,2,11,74
7,7,0,0,9,2,11,74
0,0,1,0,1,0,1,75
1,1,1,0,2,0,2,75
2,2,2,1,4,1,5,75
3,3,4,2,8,3,11,75
4,4,4,4,12,7,19,75
5,5,7,3,19,10,29,75
6,6,2,4,21,14,35,75
7,7,0,2,21,16,37,75
8,8,0,3,21,19,40,75
9,9,1,0,22,19,41,75
10,10,0,0,22,19,41,75
0,0,1,0,1,0,1,76
1,1,0,0,1,0,1,76
0,0,1,0,1,0,1,77
1,1,2,0,3,0,3,77
2,2,3,0,6,0,6,77
3,3,1,2,7,2,9,77
4,4,0,5,7,7,14,77
5,5,0,3,7,10,17,77
6,6,1,2,8,12,20,77
7,7,1,0,9,12,21,77
8,8,0,0,9,12,21,77
0,0,1,0,1,0,1,78
1,1,3,0,4,0,4,78
2,2,3,0,7,0,7,78
3,3,3,0,10,0,10,78
4,4,0,1,10,1,11,78
5,5,0,1,10,2,12,78
6,6,0,0,10,2,12,78
0,0,1,0,1,0,1,79
1,1,0,0,1,0,1,79
0,0,1,0,1,0,1,80
1,1,1,0,2,0,2,80
2,2,0,1,2,1,3,80
3,3,0,1,2,2,4,80
4,4,0,0,2,2,4,80
0,0,1,0,1,0,1,81
1,1,0,0,1,0,1,81
0,0,1,0,1,0,1,82
1,1,0,0,1,0,1,82
0,0,1,0,1,0,1,83
1,1,0,1,1,1,2,83
2,2,0,0,1,1,2,83
0,0,1,0,1,0,1,84
1,1,0,0,1,0,1,84
0,0,1,0,1,0,1,85
1,1,2,0,3,0,3,85
2,2,3,1,6,1,7,85
3,3,1,1,7,2,9,85
4,4,0,1,7,3,10,85
5,5,0,2,7,5,12,85
6,6,0,2,7,7,14,85
7,7,1,1,8,8,16,85
8,8,1,0,9,8,17,85
9,9,1,0,10,8,18,85
10,10,0,1,10,9,19,85
11,11,1,1,11,10,21,85
12,12,1,1,12,11,23,85
13,13,2,0,14,11,25,85
14,14,0,0,14,11,25,85
0,0,1,0,1,0,1,86
1,1,0,0,1,0,1,86
0,0,1,0,1,0,1,87
1,1,0,0,1,0,1,87
0,0,1,0,1,0,1,88
1,1,0,0,1,0,1,88
0,0,1,0,1,0,1,89
1,1,1,0,2,0,2,89
2,2,1,0,3,0,3,89
3,3,0,0,3,0,3,89
0,0,1,0,1,0,1,90
1,1,0,0,1,0,1,90
0,0,1,0,1,0,1,91
1,1,1,1,2,1,3,91
2,2,2,1,4,2,6,91
3,3,1,1,5,3,8,91
4,4,2,1,7,4,11,91
5,5,4,1,11,5,16,91
6,6,4,0,15,5,20,91
7,7,5,0,20,5,25,91
8,8,3,1,23,6,29,91
9,9,2,5,25,11,36,91
10,10,1,4,26,15,41,91
11,11,0,2,26,17,43,91
12,12,1,4,27,21,48,91
13,13,1,3,28,24,52,91
14,14,2,3,30,27,57,91
15,15,4,2,34,29,63,91
16,16,5,3,39,32,71,91
17,17,5,6,44,38,82,91
18,18,4,9,48,47,95,91
19,19,5,6,53,53,106,91
20,20,2,1,55,54,109,91
21,21,3,1,58,55,113,91
22,22,1,1,59,56,115,91
23,23,0,0,59,56,115,91
0,0,1,0,1,0,1,92
1,1,0,0,1,0,1,92
0,0,1,0,1,0,1,93
1,1,0,0,1,0,1,93
0,0,1,0,1,0,1,94
1,1,0,0,1,0,1,94
0,0,1,0,1,0,1,95
1,1,2,1,3,1,4,95
2,2,1,1,4,2,6,95
3,3,0,2,4,4,8,95
4,4,1,1,5,5,10,95
5,5,2,1,7,6,13,95
6,6,5,3,12,9,21,95
7,7,5,3,17,12,29,95
8,8,6,2,23,14,37,95
9,9,5,1,28,15,43,95
10,10,5,3,33,18,51,95
11,11,6,5,39,23,62,95
12,12,2,7,41,30,71,95
13,13,7,2,48,32,80,95
14,14,1,2,49,34,83,95
15,15,1,2,50,36,86,95
16,16,4,2,54,38,92,95
17,17,3,2,57,40,97,95
18,18,2,0,59,40,99,95
19,19,1,0,60,40,100,95
20,20,0,0,60,40,100,95
0,0,1,0,1,0,1,96
1,1,1,1,2,1,3,96
2,2,1,1,3,2,5,96
3,3,0,0,3,2,5,96
0,0,1,0,1,0,1,97
1,1,1,1,2,1,3,97
2,2,0,1,2,2,4,97
3,3,0,0,2,2,4,97
0,0,1,0,1,0,1,98
1,1,2,0,3,0,3,98
2,2,1,2,4,2,6,98
3,3,2,0,6,2,8,98
4,4,1,2,7,4,11,98
5,5,1,0,8,4,12,98
6,6,2,0,10,4,14,98
7,7,3,0,13,4,17,98
8,8,3,1,16,5,21,98
9,9,1,2,17,7,24,98
10,10,1,3,18,10,28,98
11,11,2,2,20,12,32,98
12,12,2,3,22,15,37,98
13,13,1,3,23,18,41,98
14,14,1,2,24,20,44,98
15,15,1,1,25,21,46,98
16,16,0,1,25,22,47,98
17,17,0,1,25,23,48,98
18,18,0,0,25,23,48,98
0,0,1,0,1,0,1,99
1,1,1,0,2,0,2,99
2,2,1,0,3,0,3,99
3,3,0,0,3,0,3,99
0,0,1,0,1,0,1,100
1,1,3,0,4,0,4,100
2,2,4,0,8,0,8,100
3,3,5,1,13,1,14,100
4,4,3,2,16,3,19,100
5,5,2,1,18,4,22,100
6,6,1,0,19,4,23,100
7,7,0,0,19,4,23,100
0,0,1,0,1,0,1,101
1,1,0,0,1,0,1,101
0,0,1,0,1,0,1,102
1,1,0,0,1,0,1,102
0,0,1,0,1,0,1,103
1,1,0,0,1,0,1,103
0,0,1,0,1,0,1,104
1,1,0,0,1,0,1,104
0,0,1,0,1,0,1,105
1,1,1,0,2,0,2,105
2,2,1,0,3,0,3,105
3,3,0,0,3,0,3,105
0,0,1,0,1,0,1,106
1,1,2,0,3,0,3,106
2,2,3,0,6,0,6,106
3,3,0,0,6,0,6,106
0,0,1,0,1,0,1,107
1,1,2,0,3,0,3,107
2,2,1,0,4,0,4,107
3,3,1,0,5,0,5,107
4,4,1,0,6,0,6,107
5,5,0,0,6,0,6,107
0,0,1,0,1,0,1,108
1,1,0,0,1,0,1,108
0,0,1,0,1,0,1,109
1,1,0,0,1,0,1,109
0,0,1,0,1,0,1,110
1,1,2,0,3,0,3,110
2,2,0,0,3,0,3,110
0,0,1,0,1,0,1,111
1,1,0,0,1,0,1,111
0,0,1,0,1,0,1,112
1,1,1,0,2,0,2,112
2,2,0,0,2,0,2,112
0,0,1,0,1,0,1,113
1,1,1,0,2,0,2,113
2,2,0,0,2,0,2,113
0,0,1,0,1,0,1,114
1,1,0,0,1,0,1,114
0,0,1,0,1,0,1,115
1,1,0,0,1,0,1,115
0,0,1,0,1,0,1,116
1,1,0,0,1,0,1,116
0,0,1,0,1,0,1,117
1,1,1,0,2,0,2,117
2,2,1,0,3,0,3,117
3,3,2,1,5,1,6,117
4,4,0,0,5,1,6,117
0,0,1,0,1,0,1,118
1,1,1,0,2,0,2,118
2,2,1,0,3,0,3,118
3,3,0,0,3,0,3,118
0,0,1,0,1,0,1,119
1,1,1,0,2,0,2,119
2,2,0,0,2,0,2,119
0,0,1,0,1,0,1,120
1,1,1,0,2,0,2,120
2,2,1,1,3,1,4,120
3,3,1,0,4,1,5,120
4,4,1,0,5,1,6,120
5,5,0,0,5,1,6,120
0,0,1,0,1,0,1,121
1,1,0,0,1,0,1,121
0,0,1,0,1,0,1,122
1,1,0,0,1,0,1,122
0,0,1,0,1,0,1,123
1,1,0,0,1,0,1,123
0,0,1,0,1,0,1,124
1,1,1,0,2,0,2,124
2,2,1,0,3,0,3,124
3,3,2,0,5,0,5,124
4,4,2,2,7,2,9,124
5,5,0,1,7,3,10,124
6,6,0,0,7,3,10,124
0,0,1,0,1,0,1,125
1,1,2,0,3,0,3,125
2,2,2,1,5,1,6,125
3,3,2,0,7,1,8,125
4,4,1,0,8,1,9,125
5,5,0,0,8,1,9,125
0,0,1,0,1,0,1,126
1,1,0,1,1,1,2,126
2,2,0,1,1,2,3,126
3,3,0,0,1,2,3,126
0,0,1,0,1,0,1,127
1,1,0,0,1,0,1,127
0,0,1,0,1,0,1,128
1,1,1,0,2,0,2,128
2,2,2,0,4,0,4,128
3,3,4,1,8,1,9,128
4,4,7,3,15,4,19,128
5,5,5,6,20,10,30,128
6,6,8,5,28,15,43,128
7,7,4,7,32,22,54,128
8,8,7,6,39,28,67,128
9,9,8,6,47,34,81,128
10,10,5,2,52,36,88,128
11,11,5,3,57,39,96,128
12,12,7,0,64,39,103,128
13,13,11,2,75,41,116,128
14,14,8,7,83,48,131,128
15,15,6,8,89,56,145,128
16,16,6,6,95,62,157,128
17,17,6,5,101,67,168,128
18,18,5,5,106,72,178,128
19,19,2,6,108,78,186,128
20,20,4,2,112,80,192,128
21,21,5,0,117,80,197,128
22,22,2,0,119,80,199,128
23,23,3,1,122,81,203,128
24,24,7,2,129,83,212,128
25,25,7,1,136,84,220,128
26,26,2,1,138,85,223,128
27,27,1,1,139,86,225,128
28,28,2,0,141,86,227,128
29,29,1,0,142,86,228,128
30,30,1,0,143,86,229,128
31,31,1,0,144,86,230,128
32,32,0,0,144,86,230,128
0,0,1,0,1,0,1,129
1,1,0,0,1,0,1,129
0,0,1,0,1,0,1,130
1,1,0,0,1,0,1,130
0,0,1,0,1,0,1,131
1,1,0,0,1,0,1,131
0,0,1,0,1,0,1,132
1,1,2,1,3,1,4,132
2,2,1,2,4,3,7,132
3,3,0,1,4,4,8,132
4,4,0,2,4,6,10,132
5,5,0,3,4,9,13,132
6,6,0,2,4,11,15,132
7,7,0,2,4,13,17,132
8,8,1,3,5,16,21,132
9,9,1,4,6,20,26,132
10,10,1,1,7,21,28,132
11,11,1,0,8,21,29,132
12,12,0,0,8,21,29,132
0,0,1,0,1,0,1,133
1,1,0,0,1,0,1,133
0,0,1,0,1,0,1,134
1,1,3,0,4,0,4,134
2,2,2,0,6,0,6,134
3,3,1,0,7,0,7,134
4,4,0,0,7,0,7,134
0,0,1,0,1,0,1,135
1,1,0,0,1,0,1,135
0,0,1,0,1,0,1,136
1,1,0,1,1,1,2,136
2,2,0,0,1,1,2,136
0,0,1,0,1,0,1,137
1,1,0,0,1,0,1,137
0,0,1,0,1,0,1,138
1,1,1,0,2,0,2,138
2,2,1,1,3,1,4,138
3,3,2,1,5,2,7,138
4,4,0,2,5,4,9,138
5,5,0,1,5,5,10,138
6,6,1,0,6,5,11,138
7,7,1,0,7,5,12,138
8,8,1,0,8,5,13,138
9,9,0,1,8,6,14,138
10,10,1,1,9,7,16,138
11,11,1,1,10,8,18,138
12,12,4,1,14,9,23,138
13,13,5,0,19,9,28,138
14,14,2,4,21,13,34,138
15,15,0,1,21,14,35,138
16,16,0,2,21,16,37,138
17,17,1,0,22,16,38,138
18,18,0,0,22,16,38,138
0,0,1,0,1,0,1,139
1,1,1,0,2,0,2,139
2,2,1,0,3,0,3,139
3,3,1,0,4,0,4,139
4,4,1,0,5,0,5,139
5,5,0,0,5,0,5,139
0,0,1,0,1,0,1,140
1,1,1,1,2,1,3,140
2,2,2,1,4,2,6,140
3,3,2,1,6,3,9,140
4,4,2,0,8,3,11,140
5,5,2,0,10,3,13,140
6,6,0,0,10,3,13,140
0,0,1,0,1,0,1,141
1,1,0,0,1,0,1,141
0,0,1,0,1,0,1,142
1,1,2,0,3,0,3,142
2,2,2,0,5,0,5,142
3,3,2,0,7,0,7,142
4,4,4,0,11,0,11,142
5,5,4,1,15,1,16,142
6,6,1,2,16,3,19,142
7,7,2,1,18,4,22,142
8,8,6,1,24,5,29,142
9,9,3,0,27,5,32,142
10,10,5,0,32,5,37,142
11,11,4,0,36,5,41,142
12,12,3,0,39,5,44,142
13,13,1,0,40,5,45,142
14,14,0,0,40,5,45,142
0,0,1,0,1,0,1,143
1,1,1,0,2,0,2,143
2,2,1,1,3,1,4,143
3,3,1,0,4,1,5,143
4,4,1,0,5,1,6,143
5,5,3,0,8,1,9,143
6,6,3,1,11,2,13,143
7,7,2,1,13,3,16,143
8,8,2,1,15,4,19,143
9,9,1,0,16,4,20,143
10,10,1,0,17,4,21,143
11,11,0,0,17,4,21,143
0,0,1,0,1,0,1,144
1,1,1,0,2,0,2,144
2,2,0,0,2,0,2,144
0,0,1,0,1,0,1,145
1,1,1,0,2,0,2,145
2,2,2,0,4,0,4,145
3,3,1,0,5,0,5,145
4,4,2,0,7,0,7,145
5,5,0,1,7,1,8,145
6,6,0,0,7,1,8,145
0,0,1,0,1,0,1,146
1,1,0,0,1,0,1,146
0,0,1,0,1,0,1,147
1,1,0,0,1,0,1,147
0,0,1,0,1,0,1,148
1,1,0,1,1,1,2,148
2,2,0,1,1,2,3,148
3,3,0,0,1,2,3,148
0,0,1,0,1,0,1,149
1,1,0,1,1,1,2,149
2,2,0,0,1,1,2,149
0,0,1,0,1,0,1,150
1,1,1,0,2,0,2,150
2,2,0,0,2,0,2,150
0,0,1,0,1,0,1,151
1,1,0,0,1,0,1,151
0,0,1,0,1,0,1,152
1,1,0,0,1,0,1,152
0,0,1,0,1,0,1,153
1,1,1,1,2,1,3,153
2,2,2,1,4,2,6,153
3,3,3,0,7,2,9,153
4,4,0,0,7,2,9,153
0,0,1,0,1,0,1,154
1,1,2,0,3,0,3,154
2,2,1,0,4,0,4,154
3,3,1,0,5,0,5,154
4,4,1,1,6,1,7,154
5,5,2,2,8,3,11,154
6,6,2,0,10,3,13,154
7,7,3,0,13,3,16,154
8,8,3,0,16,3,19,154
9,9,1,0,17,3,20,154
10,10,1,0,18,3,21,154
11,11,1,0,19,3,22,154
12,12,1,0,20,3,23,154
13,13,0,0,20,3,23,154
0,0,1,0,1,0,1,155
1,1,2,1,3,1,4,155
2,2,2,1,5,2,7,155
3,3,4,0,9,2,11,155
4,4,3,3,12,5,17,155
5,5,2,1,14,6,20,155
6,6,0,1,14,7,21,155
7,7,0,1,14,8,22,155
8,8,0,0,14,8,22,155
0,0,1,0,1,0,1,156
1,1,0,0,1,0,1,156
0,0,1,0,1,0,1,157
1,1,0,0,1,0,1,157
0,0,1,0,1,0,1,158
1,1,0,0,1,0,1,158
0,0,1,0,1,0,1,159
1,1,0,0,1,0,1,159
0,0,1,0,1,0,1,160
1,1,2,0,3,0,3,160
2,2,1,0,4,0,4,160
3,3,0,0,4,0,4,160
0,0,1,0,1,0,1,161
1,1,2,0,3,0,3,161
2,2,1,0,4,0,4,161
3,3,1,0,5,0,5,161
4,4,1,0,6,0,6,161
5,5,1,2,7,2,9,161
6,6,0,3,7,5,12,161
7,7,1,0,8,5,13,161
8,8,0,0,8,5,13,161
0,0,1,0,1,0,1,162
1,1,2,0,3,0,3,162
2,2,1,2,4,2,6,162
3,3,1,3,5,5,10,162
4,4,0,1,5,6,11,162
5,5,0,0,5,6,11,162
0,0,1,0,1,0,1,163
1,1,0,0,1,0,1,163
0,0,1,0,1,0,1,164
1,1,0,0,1,0,1,164
0,0,1,0,1,0,1,165
1,1,0,0,1,0,1,165
0,0,1,0,1,0,1,166
1,1,0,1,1,1,2,166
2,2,0,2,1,3,4,166
3,3,1,2,2,5,7,166
4,4,1,4,3,9,12,166
5,5,5,3,8,12,20,166
6,6,4,3,12,15,27,166
7,7,3,5,15,20,35,166
8,8,4,6,19,26,45,166
9,9,10,5,29,31,60,166
10,10,13,5,42,36,78,166
11,11,13,4,55,40,95,166
12,12,9,4,64,44,108,166
13,13,6,6,70,50,120,166
14,14,7,7,77,57,134,166
15,15,9,8,86,65,151,166
16,16,12,5,98,70,168,166
17,17,8,10,106,80,186,166
18,18,8,10,114,90,204,166
19,19,6,8,120,98,218,166
20,20,5,3,125,101,226,166
21,21,5,2,130,103,233,166
22,22,3,3,133,106,239,166
23,23,7,1,140,107,247,166
24,24,5,1,145,108,253,166
25,25,1,0,146,108,254,166
26,26,0,0,146,108,254,166
0,0,1,0,1,0,1,167
1,1,0,1,1,1,2,167
2,2,0,2,1,3,4,167
3,3,0,1,1,4,5,167
4,4,1,0,2,4,6,167
5,5,0,0,2,4,6,167
0,0,1,0,1,0,1,168
1,1,0,0,1,0,1,168
0,0,1,0,1,0,1,169
1,1,1,0,2,0,2,169
2,2,0,0,2,0,2,169
0,0,1,0,1,0,1,170
1,1,0,0,1,0,1,170
0,0,1,0,1,0,1,171
1,1,0,0,1,0,1,171
0,0,1,0,1,0,1,172
1,1,0,0,1,0,1,172
0,0,1,0,1,0,1,173
1,1,0,0,1,0,1,173
0,0,1,0,1,0,1,174
1,1,0,0,1,0,1,174
0,0,1,0,1,0,1,175
1,1,1,0,2,0,2,175
2,2,0,0,2,0,2,175
0,0,1,0,1,0,1,176
1,1,1,0,2,0,2,176
2,2,0,0,2,0,2,176
0,0,1,0,1,0,1,177
1,1,1,0,2,0,2,177
2,2,2,0,4,0,4,177
3,3,2,0,6,0,6,177
4,4,4,0,10,0,10,177
5,5,4,0,14,0,14,177
6,6,1,3,15,3,18,177
7,7,0,4,15,7,22,177
8,8,0,1,15,8,23,177
9,9,0,0,15,8,23,177
0,0,1,0,1,0,1,178
1,1,0,0,1,0,1,178
0,0,1,0,1,0,1,179
1,1,0,0,1,0,1,179
0,0,1,0,1,0,1,180
1,1,0,0,1,0,1,180
0,0,1,0,1,0,1,181
1,1,0,0,1,0,1,181
0,0,1,0,1,0,1,182
1,1,0,0,1,0,1,182
0,0,1,0,1,0,1,183
1,1,1,0,2,0,2,183
2,2,0,0,2,0,2,183
0,0,1,0,1,0,1,184
1,1,0,1,1,1,2,184
2,2,0,0,1,1,2,184
0,0,1,0,1,0,1,185
1,1,1,0,2,0,2,185
2,2,0,0,2,0,2,185
0,0,1,0,1,0,1,186
1,1,0,0,1,0,1,186
0,0,1,0,1,0,1,187
1,1,1,0,2,0,2,187
2,2,3,0,5,0,5,187
3,3,4,1,9,1,10,187
4,4,4,1,13,2,15,187
5,5,2,1,15,3,18,187
6,6,1,1,16,4,20,187
7,7,4,0,20,4,24,187
8,8,1,0,21,4,25,187
9,9,0,0,21,4,25,187
0,0,1,0,1,0,1,188
1,1,0,0,1,0,1,188
0,0,1,0,1,0,1,189
1,1,1,0,2,0,2,189
2,2,1,0,3,0,3,189
3,3,0,0,3,0,3,189
0,0,1,0,1,0,1,190
1,1,0,1,1,1,2,190
2,2,1,0,2,1,3,190
3,3,0,0,2,1,3,190
0,0,1,0,1,0,1,191
1,1,1,0,2,0,2,191
2,2,0,0,2,0,2,191
0,0,1,0,1,0,1,192
1,1,0,0,1,0,1,192
0,0,1,0,1,0,1,193
1,1,0,1,1,1,2,193
2,2,0,3,1,4,5,193
3,3,0,4,1,8,9,193
4,4,1,7,2,15,17,193
5,5,2,4,4,19,23,193
6,6,2,1,6,20,26,193
7,7,1,2,7,22,29,193
8,8,1,3,8,25,33,193
9,9,1,6,9,31,40,193
10,10,2,7,11,38,49,193
11,11,5,7,16,45,61,193
12,12,4,4,20,49,69,193
13,13,5,3,25,52,77,193
14,14,3,6,28,58,86,193
15,15,3,5,31,63,94,193
16,16,2,4,33,67,100,193
17,17,2,2,35,69,104,193
18,18,1,0,36,69,105,193
19,19,0,0,36,69,105,193
0,0,1,0,1,0,1,194
1,1,3,0,4,0,4,194
2,2,2,0,6,0,6,194
3,3,1,1,7,1,8,194
4,4,0,0,7,1,8,194
0,0,1,0,1,0,1,195
1,1,0,0,1,0,1,195
0,0,1,0,1,0,1,196
1,1,0,0,1,0,1,196
0,0,1,0,1,0,1,197
1,1,1,0,2,0,2,197
2,2,0,0,2,0,2,197
0,0,1,0,1,0,1,198
1,1,0,0,1,0,1,198
0,0,1,0,1,0,1,199
1,1,0,0,1,0,1,199
0,0,1,0,1,0,1,200
1,1,0,0,1,0,1,200
0,0,1,0,1,0,1,201
1,1,0,0,1,0,1,201
0,0,1,0,1,0,1,202
1,1,2,0,3,0,3,202
2,2,2,0,5,0,5,202
3,3,0,1,5,1,6,202
4,4,0,1,5,2,7,202
5,5,0,1,5,3,8,202
6,6,1,1,6,4,10,202
7,7,1,0,7,4,11,202
8,8,0,0,7,4,11,202
0,0,1,0,1,0,1,203
1,1,2,1,3,1,4,203
2,2,0,1,3,2,5,203
3,3,0,1,3,3,6,203
4,4,1,1,4,4,8,203
5,5,0,1,4,5,9,203
6,6,1,0,5,5,10,203
7,7,0,0,5,5,10,203
0,0,1,0,1,0,1,204
1,1,0,0,1,0,1,204
0,0,1,0,1,0,1,205
1,1,0,0,1,0,1,205
0,0,1,0,1,0,1,206
1,1,0,0,1,0,1,206
0,0,1,0,1,0,1,207
1,1,1,0,2,0,2,207
2,2,0,0,2,0,2,207
0,0,1,0,1,0,1,208
1,1,0,0,1,0,1,208
0,0,1,0,1,0,1,209
1,1,0,0,1,0,1,209
0,0,1,0,1,0,1,210
1,1,1,0,2,0,2,210
2,2,0,0,2,0,2,210
0,0,1,0,1,0,1,211
1,1,0,0,1,0,1,211
0,0,1,0,1,0,1,212
1,1,1,0,2,0,2,212
2,2,1,0,3,0,3,212
3,3,1,0,4,0,4,212
4,4,1,0,5,0,5,212
5,5,0,0,5,0,5,212
0,0,1,0,1,0,1,213
1,1,0,0,1,0,1,213
0,0,1,0,1,0,1,214
1,1,0,1,1,1,2,214
2,2,0,0,1,1,2,214
0,0,1,0,1,0,1,215
1,1,0,0,1,0,1,215
0,0,1,0,1,0,1,216
1,1,0,0,1,0,1,216
0,0,1,0,1,0,1,217
1,1,1,0,2,0,2,217
2,2,0,0,2,0,2,217
0,0,1,0,1,0,1,218
1,1,0,0,1,0,1,218
0,0,1,0,1,0,1,219
1,1,0,1,1,1,2,219
2,2,1,0,2,1,3,219
3,3,4,1,6,2,8,219
4,4,4,5,10,7,17,219
5,5,3,5,13,12,25,219
6,6,1,8,14,20,34,219
7,7,0,7,14,27,41,219
8,8,2,4,16,31,47,219
9,9,0,2,16,33,49,219
10,10,0,0,16,33,49,219
0,0,1,0,1,0,1,220
1,1,1,0,2,0,2,220
2,2,2,0,4,0,4,220
3,3,0,0,4,0,4,220
0,0,1,0,1,0,1,221
1,1,2,0,3,0,3,221
2,2,0,0,3,0,3,221
0,0,1,0,1,0,1,222
1,1,1,0,2,0,2,222
2,2,1,0,3,0,3,222
3,3,0,0,3,0,3,222
0,0,1,0,1,0,1,223
1,1,1,0,2,0,2,223
2,2,0,1,2,1,3,223
3,3,0,3,2,4,6,223
4,4,0,2,2,6,8,223
5,5,0,1,2,7,9,223
6,6,1,0,3,7,10,223
7,7,1,0,4,7,11,223
8,8,0,0,4,7,11,223
0,0,1,0,1,0,1,224
1,1,1,0,2,0,2,224
2,2,0,0,2,0,2,224
0,0,1,0,1,0,1,225
1,1,1,0,2,0,2,225
2,2,2,0,4,0,4,225
3,3,2,1,6,1,7,225
4,4,1,0,7,1,8,225
5,5,1,0,8,1,9,225
6,6,1,0,9,1,10,225
7,7,1,0,10,1,11,225
8,8,0,0,10,1,11,225
0,0,1,0,1,0,1,226
1,1,3,0,4,0,4,226
2,2,2,0,6,0,6,226
3,3,1,1,7,1,8,226
4,4,1,0,8,1,9,226
5,5,2,0,10,1,11,226
6,6,1,1,11,2,13,226
7,7,1,1,12,3,15,226
8,8,0,1,12,4,16,226
9,9,0,2,12,6,18,226
10,10,0,2,12,8,20,226
11,11,1,1,13,9,22,226
12,12,2,2,15,11,26,226
13,13,2,1,17,12,29,226
14,14,3,1,20,13,33,226
15,15,5,1,25,14,39,226
16,16,1,1,26,15,41,226
17,17,1,0,27,15,42,226
18,18,0,1,27,16,43,226
19,19,0,1,27,17,44,226
20,20,0,1,27,18,45,226
21,21,0,1,27,19,46,226
22,22,0,1,27,20,47,226
23,23,0,1,27,21,48,226
24,24,0,0,27,21,48,226
0,0,1,0,1,0,1,227
1,1,0,1,1,1,2,227
2,2,0,1,1,2,3,227
3,3,0,1,1,3,4,227
4,4,0,0,1,3,4,227
0,0,1,0,1,0,1,228
1,1,2,1,3,1,4,228
2,2,1,2,4,3,7,228
3,3,3,1,7,4,11,228
4,4,3,0,10,4,14,228
5,5,0,0,10,4,14,228
0,0,1,0,1,0,1,229
1,1,0,0,1,0,1,229
0,0,1,0,1,0,1,230
1,1,1,0,2,0,2,230
2,2,1,0,3,0,3,230
3,3,0,0,3,0,3,230
0,0,1,0,1,0,1,231
1,1,1,0,2,0,2,231
2,2,0,0,2,0,2,231
0,0,1,0,1,0,1,232
1,1,1,0,2,0,2,232
2,2,0,0,2,0,2,232
0,0,1,0,1,0,1,233
1,1,0,0,1,0,1,233
0,0,1,0,1,0,1,234
1,1,1,0,2,0,2,234
2,2,0,0,2,0,2,234
0,0,1,0,1,0,1,235
1,1,1,0,2,0,2,235
2,2,1,1,3,1,4,235
3,3,2,1,5,2,7,235
4,4,2,0,7,2,9,235
5,5,0,0,7,2,9,235
0,0,1,0,1,0,1,236
1,1,1,1,2,1,3,236
2,2,1,2,3,3,6,236
3,3,0,0,3,3,6,236
0,0,1,0,1,0,1,237
1,1,0,0,1,0,1,237
0,0,1,0,1,0,1,238
1,1,0,0,1,0,1,238
0,0,1,0,1,0,1,239
1,1,1,0,2,0,2,239
2,2,0,0,2,0,2,239
0,0,1,0,1,0,1,240
1,1,0,0,1,0,1,240
0,0,1,0,1,0,1,241
1,1,0,0,1,0,1,241
0,0,1,0,1,0,1,242
1,1,1,1,2,1,3,242
2,2,1,1,3,2,5,242
3,3,1,0,4,2,6,242
4,4,0,1,4,3,7,242
5,5,0,3,4,6,10,242
6,6,0,3,4,9,13,242
7,7,1,1,5,10,15,242
8,8,0,2,5,12,17,242
9,9,0,2,5,14,19,242
10,10,2,1,7,15,22,242
11,11,0,1,7,16,23,242
12,12,0,0,7,16,23,242
0,0,1,0,1,0,1,243
1,1,0,1,1,1,2,243
2,2,1,0,2,1,3,243
3,3,3,0,5,1,6,243
4,4,0,0,5,1,6,243
0,0,1,0,1,0,1,244
1,1,0,0,1,0,1,244
0,0,1,0,1,0,1,245
1,1,1,0,2,0,2,245
2,2,2,0,4,0,4,245
3,3,1,0,5,0,5,245
4,4,1,0,6,0,6,245
5,5,0,0,6,0,6,245
0,0,1,0,1,0,1,246
1,1,1,0,2,0,2,246
2,2,0,0,2,0,2,246
0,0,1,0,1,0,1,247
1,1,0,0,1,0,1,247
0,0,1,0,1,0,1,248
1,1,0,0,1,0,1,248
0,0,1,0,1,0,1,249
1,1,2,0,3,0,3,249
2,2,2,2,5,2,7,249
3,3,2,3,7,5,12,249
4,4,2,2,9,7,16,249
5,5,3,0,12,7,19,249
6,6,0,1,12,8,20,249
7,7,0,0,12,8,20,249
0,0,1,0,1,0,1,250
1,1,0,0,1,0,1,250
0,0,1,0,1,0,1,251
1,1,8,0,9,0,9,251
2,2,10,1,19,1,20,251
3,3,4,5,23,6,29,251
4,4,6,4,29,10,39,251
5,5,4,5,33,15,48,251
6,6,3,2,36,17,53,251
7,7,2,2,38,19,57,251
8,8,1,7,39,26,65,251
9,9,2,4,41,30,71,251
10,10,0,3,41,33,74,251
11,11,1,2,42,35,77,251
12,12,3,3,45,38,83,251
13,13,1,2,46,40,86,251
14,14,1,1,47,41,88,251
15,15,2,1,49,42,91,251
16,16,2,2,51,44,95,251
17,17,2,1,53,45,98,251
18,18,4,1,57,46,103,251
19,19,4,3,61,49,110,251
20,20,5,8,66,57,123,251
21,21,4,4,70,61,131,251
22,22,4,4,74,65,139,251
23,23,5,1,79,66,145,251
24,24,4,2,83,68,151,251
25,25,4,1,87,69,156,251
26,26,0,4,87,73,160,251
27,27,1,2,88,75,163,251
28,28,2,3,90,78,168,251
29,29,2,4,92,82,174,251
30,30,1,3,93,85,178,251
31,31,2,3,95,88,183,251
32,32,2,4,97,92,189,251
33,33,8,3,105,95,200,251
34,34,7,2,112,97,209,251
35,35,12,3,124,100,224,251
36,36,10,3,134,103,237,251
37,37,10,6,144,109,253,251
38,38,11,8,155,117,272,251
39,39,7,6,162,123,285,251
40,40,7,9,169,132,301,251
41,41,10,2,179,134,313,251
42,42,10,3,189,137,326,251
43,43,3,3,192,140,332,251
44,44,1,0,193,140,333,251
45,45,1,1,194,141,335,251
46,46,2,3,196,144,340,251
47,47,2,3,198,147,345,251
48,48,2,2,200,149,349,251
49,49,1,2,201,151,352,251
50,50,1,3,202,154,356,251
51,51,2,4,204,158,362,251
52,52,2,6,206,164,370,251
53,53,2,2,208,166,374,251
54,54,4,2,212,168,380,251
55,55,3,0,215,168,383,251
56,56,2,2,217,170,387,251
57,57,5,8,222,178,400,251
58,58,2,4,224,182,406,251
59,59,1,3,225,185,410,251
60,60,0,3,225,188,413,251
61,61,0,4,225,192,417,251
62,62,1,5,226,197,423,251
63,63,3,3,229,200,429,251
64,64,5,3,234,203,437,251
65,65,4,4,238,207,445,251
66,66,1,5,239,212,451,251
67,67,2,2,241,214,455,251
68,68,0,2,241,216,457,251
69,69,1,0,242,216,458,251
70,70,3,0,245,216,461,251
71,71,1,1,246,217,463,251
72,72,1,0,247,217,464,251
73,73,0,1,247,218,465,251
74,74,0,0,247,218,465,251
0,0,1,0,1,0,1,252
1,1,0,0,1,0,1,252
0,0,1,0,1,0,1,253
1,1,0,1,1,1,2,253
2,2,0,1,1,2,3,253
3,3,1,2,2,4,6,253
4,4,1,0,3,4,7,253
5,5,1,0,4,4,8,253
6,6,1,0,5,4,9,253
7,7,2,0,7,4,11,253
8,8,1,0,8,4,12,253
9,9,2,0,10,4,14,253
10,10,2,0,12,4,16,253
11,11,1,1,13,5,18,253
12,12,1,1,14,6,20,253
13,13,0,0,14,6,20,253
0,0,1,0,1,0,1,254
1,1,2,0,3,0,3,254
2,2,3,0,6,0,6,254
3,3,2,1,8,1,9,254
4,4,3,1,11,2,13,254
5,5,2,1,13,3,16,254
6,6,2,0,15,3,18,254
7,7,0,0,15,3,18,254
0,0,1,0,1,0,1,255
1,1,1,0,2,0,2,255
2,2,1,0,3,0,3,255
3,3,0,0,3,0,3,255
0,0,1,0,1,0,1,256
1,1,0,0,1,0,1,256
0,0,1,0,1,0,1,257
1,1,0,1,1,1,2,257
2,2,0,1,1,2,3,257
3,3,0,2,1,4,5,257
4,4,1,1,2,5,7,257
5,5,1,3,3,8,11,257
6,6,4,2,7,10,17,257
7,7,3,0,10,10,20,257
8,8,1,1,11,11,22,257
9,9,2,0,13,11,24,257
10,10,1,1,14,12,26,257
11,11,1,2,15,14,29,257
12,12,2,0,17,14,31,257
13,13,3,1,20,15,35,257
14,14,2,0,22,15,37,257
15,15,2,1,24,16,40,257
16,16,0,1,24,17,41,257
17,17,0,0,24,17,41,257
0,0,1,0,1,0,1,258
1,1,0,0,1,0,1,258
0,0,1,0,1,0,1,259
1,1,1,0,2,0,2,259
2,2,0,0,2,0,2,259
0,0,1,0,1,0,1,260
1,1,0,0,1,0,1,260
0,0,1,0,1,0,1,261
1,1,0,0,1,0,1,261
0,0,1,0,1,0,1,262
1,1,1,0,2,0,2,262
2,2,1,0,3,0,3,262
3,3,0,0,3,0,3,262
0,0,1,0,1,0,1,263
1,1,2,0,3,0,3,263
2,2,4,0,7,0,7,263
3,3,2,0,9,0,9,263
4,4,1,0,10,0,10,263
5,5,1,0,11,0,11,263
6,6,1,1,12,1,13,263
7,7,0,0,12,1,13,263
0,0,1,0,1,0,1,264
1,1,1,1,2,1,3,264
2,2,1,1,3,2,5,264
3,3,0,2,3,4,7,264
4,4,1,1,4,5,9,264
5,5,0,2,4,7,11,264
6,6,0,0,4,7,11,264
0,0,1,0,1,0,1,265
1,1,0,0,1,0,1,265
0,0,1,0,1,0,1,266
1,1,0,0,1,0,1,266
0,0,1,0,1,0,1,267
1,1,2,0,3,0,3,267
2,2,2,1,5,1,6,267
3,3,2,1,7,2,9,267
4,4,3,0,10,2,12,267
5,5,2,3,12,5,17,267
6,6,1,1,13,6,19,267
7,7,0,3,13,9,22,267
8,8,1,3,14,12,26,267
9,9,1,0,15,12,27,267
10,10,1,0,16,12,28,267
11,11,1,2,17,14,31,267
12,12,0,0,17,14,31,267
0,0,1,0,1,0,1,268
1,1,2,1,3,1,4,268
2,2,4,1,7,2,9,268
3,3,6,2,13,4,17,268
4,4,3,1,16,5,21,268
5,5,1,4,17,9,26,268
6,6,1,3,18,12,30,268
7,7,1,1,19,13,32,268
8,8,0,0,19,13,32,268
0,0,1,0,1,0,1,269
1,1,1,0,2,0,2,269
2,2,2,1,4,1,5,269
3,3,2,0,6,1,7,269
4,4,2,0,8,1,9,269
5,5,2,0,10,1,11,269
6,6,1,0,11,1,12,269
7,7,0,0,11,1,12,269
0,0,1,0,1,0,1,270
1,1,0,0,1,0,1,270
0,0,1,0,1,0,1,271
1,1,0,1,1,1,2,271
2,2,0,0,1,1,2,271
0,0,1,0,1,0,1,272
1,1,2,0,3,0,3,272
2,2,0,0,3,0,3,272
0,0,1,0,1,0,1,273
1,1,0,0,1,0,1,273
0,0,1,0,1,0,1,274
1,1,1,0,2,0,2,274
2,2,0,0,2,0,2,274
0,0,1,0,1,0,1,275
1,1,0,0,1,0,1,275
0,0,1,0,1,0,1,276
1,1,0,0,1,0,1,276
0,0,1,0,1,0,1,277
1,1,2,0,3,0,3,277
2,2,1,1,4,1,5,277
3,3,1,2,5,3,8,277
4,4,1,1,6,4,10,277
5,5,2,0,8,4,12,277
6,6,1,1,9,5,14,277
7,7,0,2,9,7,16,277
8,8,0,1,9,8,17,277
9,9,0,0,9,8,17,277
0,0,1,0,1,0,1,278
1,1,1,0,2,0,2,278
2,2,0,0,2,0,2,278
0,0,1,0,1,0,1,279
1,1,0,1,1,1,2,279
2,2,0,0,1,1,2,279
0,0,1,0,1,0,1,280
1,1,1,0,2,0,2,280
2,2,0,0,2,0,2,280
0,0,1,0,1,0,1,281
1,1,1,0,2,0,2,281
2,2,0,0,2,0,2,281
0,0,1,0,1,0,1,282
1,1,1,0,2,0,2,282
2,2,0,0,2,0,2,282
0,0,1,0,1,0,1,283
1,1,0,0,1,0,1,283
0,0,1,0,1,0,1,284
1,1,1,0,2,0,2,284
2,2,0,1,2,1,3,284
3,3,0,0,2,1,3,284
0,0,1,0,1,0,1,285
1,1,2,1,3,1,4,285
2,2,0,2,3,3,6,285
3,3,0,1,3,4,7,285
4,4,0,1,3,5,8,285
5,5,0,1,3,6,9,285
6,6,0,0,3,6,9,285
0,0,1,0,1,0,1,286
1,1,1,0,2,0,2,286
2,2,2,0,4,0,4,286
3,3,0,0,4,0,4,286
0,0,1,0,1,0,1,287
1,1,2,1,3,1,4,287
2,2,3,1,6,2,8,287
3,3,1,0,7,2,9,287
4,4,0,0,7,2,9,287
0,0,1,0,1,0,1,288
1,1,0,0,1,0,1,288
0,0,1,0,1,0,1,289
1,1,0,0,1,0,1,289
0,0,1,0,1,0,1,290
1,1,0,1,1,1,2,290
2,2,0,0,1,1,2,290
0,0,1,0,1,0,1,291
1,1,0,0,1,0,1,291
0,0,1,0,1,0,1,292
1,1,0,0,1,0,1,292
0,0,1,0,1,0,1,293
1,1,1,0,2,0,2,293
2,2,0,0,2,0,2,293
0,0,1,0,1,0,1,294
1,1,0,0,1,0,1,294
0,0,1,0,1,0,1,295
1,1,0,0,1,0,1,295
0,0,1,0,1,0,1,296
1,1,0,0,1,0,1,296
0,0,1,0,1,0,1,297
1,1,1,0,2,0,2,297
2,2,0,0,2,0,2,297
0,0,1,0,1,0,1,298
1,1,2,0,3,0,3,298
2,2,1,0,4,0,4,298
3,3,1,0,5,0,5,298
4,4,0,1,5,1,6,298
5,5,0,1,5,2,7,298
6,6,1,2,6,4,10,298
7,7,4,4,10,8,18,298
8,8,3,4,13,12,25,298
9,9,6,5,19,17,36,298
10,10,4,2,23,19,42,298
11,11,1,3,24,22,46,298
12,12,1,2,25,24,49,298
13,13,1,0,26,24,50,298
14,14,0,0,26,24,50,298
0,0,1,0,1,0,1,299
1,1,0,1,1,1,2,299
2,2,0,1,1,2,3,299
3,3,0,2,1,4,5,299
4,4,0,2,1,6,7,299
5,5,0,1,1,7,8,299
6,6,0,0,1,7,8,299
0,0,1,0,1,0,1,300
1,1,0,1,1,1,2,300
2,2,2,1,3,2,5,300
3,3,3,1,6,3,9,300
4,4,3,0,9,3,12,300
5,5,2,1,11,4,15,300
6,6,0,0,11,4,15,300
0,0,1,0,1,0,1,301
1,1,0,0,1,0,1,301
0,0,1,0,1,0,1,302
1,1,1,0,2,0,2,302
2,2,2,0,4,0,4,302
3,3,2,0,6,0,6,302
4,4,1,0,7,0,7,302
5,5,2,0,9,0,9,302
6,6,1,0,10,0,10,302
7,7,2,0,12,0,12,302
8,8,4,1,16,1,17,302
9,9,6,3,22,4,26,302
10,10,10,3,32,7,39,302
11,11,8,7,40,14,54,302
12,12,4,6,44,20,64,302
13,13,7,6,51,26,77,302
14,14,8,4,59,30,89,302
15,15,5,1,64,31,95,302
16,16,3,3,67,34,101,302
17,17,1,1,68,35,103,302
18,18,0,1,68,36,104,302
19,19,0,0,68,36,104,302
0,0,1,0,1,0,1,303
1,1,1,0,2,0,2,303
2,2,0,2,2,2,4,303
3,3,0,2,2,4,6,303
4,4,0,1,2,5,7,303
5,5,0,1,2,6,8,303
6,6,0,0,2,6,8,303
0,0,1,0,1,0,1,304
1,1,3,0,4,0,4,304
2,2,2,0,6,0,6,304
3,3,1,0,7,0,7,304
4,4,0,2,7,2,9,304
5,5,0,0,7,2,9,304
0,0,1,0,1,0,1,305
1,1,0,0,1,0,1,305
0,0,1,0,1,0,1,306
1,1,0,0,1,0,1,306
0,0,1,0,1,0,1,307
1,1,0,0,1,0,1,307
0,0,1,0,1,0,1,308
1,1,1,0,2,0,2,308
2,2,0,0,2,0,2,308
0,0,1,0,1,0,1,309
1,1,1,0,2,0,2,309
2,2,1,1,3,1,4,309
3,3,2,0,5,1,6,309
4,4,3,0,8,1,9,309
5,5,1,0,9,1,10,309
6,6,3,0,12,1,13,309
7,7,1,4,13,5,18,309
8,8,1,1,14,6,20,309
9,9,1,2,15,8,23,309
10,10,1,7,16,15,31,309
11,11,2,7,18,22,40,309
12,12,2,9,20,31,51,309
13,13,4,8,24,39,63,309
14,14,6,6,30,45,75,309
15,15,12,4,42,49,91,309
16,16,6,5,48,54,102,309
17,17,4,11,52,65,117,309
18,18,3,7,55,72,127,309
19,19,6,8,61,80,141,309
20,20,6,8,67,88,155,309
21,21,7,4,74,92,166,309
22,22,5,2,79,94,173,309
23,23,6,3,85,97,182,309
24,24,7,1,92,98,190,309
25,25,1,4,93,102,195,309
26,26,1,3,94,105,199,309
27,27,1,3,95,108,203,309
28,28,2,3,97,111,208,309
29,29,0,3,97,114,211,309
30,30,0,1,97,115,212,309
31,31,0,1,97,116,213,309
32,32,1,1,98,117,215,309
33,33,4,0,102,117,219,309
34,34,4,0,106,117,223,309
35,35,2,2,108,119,227,309
36,36,3,0,111,119,230,309
37,37,3,0,114,119,233,309
38,38,1,1,115,120,235,309
39,39,0,1,115,121,236,309
40,40,1,1,116,122,238,309
41,41,0,0,116,122,238,309
0,0,1,0,1,0,1,310
1,1,1,0,2,0,2,310
2,2,0,1,2,1,3,310
3,3,0,0,2,1,3,310
0,0,1,0,1,0,1,311
1,1,0,0,1,0,1,311
0,0,1,0,1,0,1,312
1,1,2,0,3,0,3,312
2,2,4,0,7,0,7,312
3,3,1,0,8,0,8,312
4,4,1,0,9,0,9,312
5,5,0,0,9,0,9,312
0,0,1,0,1,0,1,313
1,1,1,0,2,0,2,313
2,2,1,0,3,0,3,313
3,3,0,0,3,0,3,313
0,0,1,0,1,0,1,314
1,1,0,0,1,0,1,314
0,0,1,0,1,0,1,315
1,1,1,0,2,0,2,315
2,2,0,0,2,0,2,315
0,0,1,0,1,0,1,316
1,1,2,0,3,0,3,316
2,2,1,0,4,0,4,316
3,3,1,2,5,2,7,316
4,4,1,0,6,2,8,316
5,5,0,0,6,2,8,316
0,0,1,0,1,0,1,317
1,1,0,0,1,0,1,317
0,0,1,0,1,0,1,318
1,1,0,0,1,0,1,318
0,0,1,0,1,0,1,319
1,1,0,0,1,0,1,319
0,0,1,0,1,0,1,320
1,1,1,0,2,0,2,320
2,2,3,0,5,0,5,320
3,3,0,0,5,0,5,320
0,0,1,0,1,0,1,321
1,1,0,0,1,0,1,321
0,0,1,0,1,0,1,322
1,1,0,0,1,0,1,322
0,0,1,0,1,0,1,323
1,1,1,0,2,0,2,323
2,2,1,0,3,0,3,323
3,3,2,0,5,0,5,323
4,4,0,0,5,0,5,323
0,0,1,0,1,0,1,324
1,1,1,0,2,0,2,324
2,2,0,0,2,0,2,324
0,0,1,0,1,0,1,325
1,1,0,1,1,1,2,325
2,2,0,2,1,3,4,325
3,3,0,1,1,4,5,325
4,4,0,1,1,5,6,325
5,5,0,0,1,5,6,325
0,0,1,0,1,0,1,326
1,1,1,0,2,0,2,326
2,2,1,0,3,0,3,326
3,3,0,2,3,2,5,326
4,4,1,2,4,4,8,326
5,5,1,2,5,6,11,326
6,6,2,1,7,7,14,326
7,7,1,2,8,9,17,326
8,8,4,2,12,11,23,326
9,9,6,2,18,13,31,326
10,10,9,1,27,14,41,326
11,11,6,1,33,15,48,326
12,12,4,9,37,24,61,326
13,13,5,14,42,38,80,326
14,14,6,14,48,52,100,326
15,15,4,8,52,60,112,326
16,16,5,7,57,67,124,326
17,17,3,2,60,69,129,326
18,18,0,0,60,69,129,326
0,0,1,0,1,0,1,327
1,1,2,1,3,1,4,327
2,2,1,1,4,2,6,327
3,3,0,0,4,2,6,327
0,0,1,0,1,0,1,328
1,1,0,0,1,0,1,328
0,0,1,0,1,0,1,329
1,1,0,0,1,0,1,329
0,0,1,0,1,0,1,330
1,1,1,0,2,0,2,330
2,2,0,0,2,0,2,330
0,0,1,0,1,0,1,331
1,1,0,0,1,0,1,331
0,0,1,0,1,0,1,332
1,1,2,0,3,0,3,332
2,2,2,0,5,0,5,332
3,3,0,0,5,0,5,332
0,0,1,0,1,0,1,333
1,1,1,0,2,0,2,333
2,2,0,1,2,1,3,333
3,3,0,0,2,1,3,333
0,0,1,0,1,0,1,334
1,1,0,0,1,0,1,334
0,0,1,0,1,0,1,335
1,1,1,0,2,0,2,335
2,2,0,0,2,0,2,335
0,0,1,0,1,0,1,336
1,1,1,0,2,0,2,336
2,2,2,0,4,0,4,336
3,3,3,0,7,0,7,336
4,4,3,0,10,0,10,336
5,5,3,0,13,0,13,336
6,6,1,3,14,3,17,336
7,7,2,3,16,6,22,336
8,8,0,1,16,7,23,336
9,9,0,3,16,10,26,336
10,10,0,2,16,12,28,336
11,11,1,3,17,15,32,336
12,12,1,1,18,16,34,336
13,13,1,0,19,16,35,336
14,14,1,0,20,16,36,336
15,15,1,1,21,17,38,336
16,16,1,1,22,18,40,336
17,17,4,2,26,20,46,336
18,18,4,1,30,21,51,336
19,19,3,1,33,22,55,336
20,20,4,2,37,24,61,336
21,21,3,3,40,27,67,336
22,22,3,3,43,30,73,336
23,23,9,3,52,33,85,336
24,24,5,6,57,39,96,336
25,25,3,4,60,43,103,336
26,26,2,3,62,46,108,336
27,27,3,0,65,46,111,336
28,28,2,1,67,47,114,336
29,29,2,1,69,48,117,336
30,30,1,4,70,52,122,336
31,31,2,2,72,54,126,336
32,32,4,1,76,55,131,336
33,33,3,0,79,55,134,336
34,34,2,0,81,55,136,336
35,35,1,0,82,55,137,336
36,36,1,0,83,55,138,336
37,37,0,0,83,55,138,336
0,0,1,0,1,0,1,337
1,1,0,0,1,0,1,337
0,0,1,0,1,0,1,338
1,1,0,0,1,0,1,338
0,0,1,0,1,0,1,339
1,1,2,0,3,0,3,339
2,2,3,0,6,0,6,339
3,3,2,0,8,0,8,339
4,4,3,0,11,0,11,339
5,5,2,0,13,0,13,339
6,6,0,1,13,1,14,339
7,7,0,1,13,2,15,339
8,8,0,1,13,3,16,339
9,9,1,1,14,4,18,339
10,10,1,2,15,6,21,339
11,11,0,1,15,7,22,339
12,12,0,0,15,7,22,339
0,0,1,0,1,0,1,340
1,1,0,0,1,0,1,340
0,0,1,0,1,0,1,341
1,1,1,0,2,0,2,341
2,2,0,0,2,0,2,341
0,0,1,0,1,0,1,342
1,1,1,0,2,0,2,342
2,2,4,0,6,0,6,342
3,3,2,1,8,1,9,342
4,4,0,0,8,1,9,342
0,0,1,0,1,0,1,343
1,1,0,0,1,0,1,343
0,0,1,0,1,0,1,344
1,1,1,0,2,0,2,344
2,2,1,0,3,0,3,344
3,3,0,0,3,0,3,344
0,0,1,0,1,0,1,345
1,1,0,0,1,0,1,345
0,0,1,0,1,0,1,346
1,1,1,0,2,0,2,346
2,2,1,1,3,1,4,346
3,3,0,0,3,1,4,346
0,0,1,0,1,0,1,347
1,1,1,1,2,1,3,347
2,2,0,2,2,3,5,347
3,3,0,1,2,4,6,347
4,4,1,0,3,4,7,347
5,5,1,0,4,4,8,347
6,6,0,0,4,4,8,347
0,0,1,0,1,0,1,348
1,1,1,0,2,0,2,348
2,2,0,0,2,0,2,348
0,0,1,0,1,0,1,349
1,1,0,0,1,0,1,349
0,0,1,0,1,0,1,350
1,1,0,0,1,0,1,350
0,0,1,0,1,0,1,351
1,1,1,0,2,0,2,351
2,2,1,0,3,0,3,351
3,3,1,0,4,0,4,351
4,4,1,1,5,1,6,351
5,5,1,0,6,1,7,351
6,6,0,0,6,1,7,351
0,0,1,0,1,0,1,352
1,1,0,0,1,0,1,352
0,0,1,0,1,0,1,353
1,1,0,1,1,1,2,353
2,2,0,0,1,1,2,353
0,0,1,0,1,0,1,354
1,1,0,0,1,0,1,354
0,0,1,0,1,0,1,355
1,1,0,0,1,0,1,355
0,0,1,0,1,0,1,356
1,1,2,0,3,0,3,356
2,2,2,0,5,0,5,356
3,3,0,0,5,0,5,356
0,0,1,0,1,0,1,357
1,1,0,0,1,0,1,357
0,0,1,0,1,0,1,358
1,1,1,0,2,0,2,358
2,2,2,0,4,0,4,358
3,3,1,0,5,0,5,358
4,4,0,0,5,0,5,358
0,0,1,0,1,0,1,359
1,1,0,0,1,0,1,359
0,0,1,0,1,0,1,360
1,1,1,0,2,0,2,360
2,2,0,0,2,0,2,360
0,0,1,0,1,0,1,361
1,1,0,0,1,0,1,361
0,0,1,0,1,0,1,362
1,1,0,0,1,0,1,362
0,0,1,0,1,0,1,363
1,1,0,1,1,1,2,363
2,2,1,3,2,4,6,363
3,3,0,4,2,8,10,363
4,4,0,4,2,12,14,363
5,5,0,5,2,17,19,363
6,6,0,2,2,19,21,363
7,7,0,2,2,21,23,363
8,8,0,0,2,21,23,363
0,0,1,0,1,0,1,364
1,1,1,0,2,0,2,364
2,2,1,0,3,0,3,364
3,3,1,0,4,0,4,364
4,4,0,1,4,1,5,364
5,5,0,1,4,2,6,364
6,6,0,1,4,3,7,364
7,7,0,0,4,3,7,364
0,0,1,0,1,0,1,365
1,1,1,0,2,0,2,365
2,2,1,0,3,0,3,365
3,3,1,0,4,0,4,365
4,4,2,2,6,2,8,365
5,5,2,1,8,3,11,365
6,6,0,1,8,4,12,365
7,7,0,1,8,5,13,365
8,8,0,0,8,5,13,365
0,0,1,0,1,0,1,366
1,1,1,0,2,0,2,366
2,2,1,1,3,1,4,366
3,3,0,0,3,1,4,366
0,0,1,0,1,0,1,367
1,1,0,1,1,1,2,367
2,2,0,1,1,2,3,367
3,3,0,0,1,2,3,367
0,0,1,0,1,0,1,368
1,1,2,0,3,0,3,368
2,2,2,0,5,0,5,368
3,3,0,0,5,0,5,368
0,0,1,0,1,0,1,369
1,1,1,0,2,0,2,369
2,2,0,0,2,0,2,369
0,0,1,0,1,0,1,370
1,1,0,1,1,1,2,370
2,2,0,0,1,1,2,370
0,0,1,0,1,0,1,371
1,1,0,0,1,0,1,371
0,0,1,0,1,0,1,372
1,1,0,0,1,0,1,372
0,0,1,0,1,0,1,373
1,1,0,0,1,0,1,373
0,0,1,0,1,0,1,374
1,1,0,0,1,0,1,374
0,0,1,0,1,0,1,375
1,1,3,0,4,0,4,375
2,2,2,1,6,1,7,375
3,3,3,2,9,3,12,375
4,4,1,4,10,7,17,375
5,5,1,2,11,9,20,375
6,6,0,0,11,9,20,375
0,0,1,0,1,0,1,376
1,1,0,0,1,0,1,376
0,0,1,0,1,0,1,377
1,1,0,0,1,0,1,377
0,0,1,0,1,0,1,378
1,1,3,0,4,0,4,378
2,2,2,0,6,0,6,378
3,3,0,1,6,1,7,378
4,4,0,0,6,1,7,378
0,0,1,0,1,0,1,379
1,1,1,0,2,0,2,379
2,2,1,0,3,0,3,379
3,3,0,0,3,0,3,379
0,0,1,0,1,0,1,380
1,1,0,1,1,1,2,380
2,2,0,0,1,1,2,380
0,0,1,0,1,0,1,381
1,1,1,0,2,0,2,381
2,2,0,1,2,1,3,381
3,3,0,0,2,1,3,381
0,0,1,0,1,0,1,382
1,1,0,0,1,0,1,382
0,0,1,0,1,0,1,383
1,1,0,0,1,0,1,383
0,0,1,0,1,0,1,384
1,1,1,1,2,1,3,384
2,2,4,1,6,2,8,384
3,3,2,0,8,2,10,384
4,4,1,1,9,3,12,384
5,5,0,0,9,3,12,384
0,0,1,0,1,0,1,385
1,1,1,0,2,0,2,385
2,2,0,0,2,0,2,385
0,0,1,0,1,0,1,386
1,1,1,2,2,2,4,386
2,2,0,0,2,2,4,386
0,0,1,0,1,0,1,387
1,1,0,0,1,0,1,387
0,0,1,0,1,0,1,388
1,1,1,0,2,0,2,388
2,2,0,0,2,0,2,388
0,0,1,0,1,0,1,389
1,1,1,0,2,0,2,389
2,2,0,0,2,0,2,389
0,0,1,0,1,0,1,390
1,1,2,0,3,0,3,390
2,2,4,0,7,0,7,390
3,3,1,1,8,1,9,390
4,4,1,0,9,1,10,390
5,5,1,0,10,1,11,390
6,6,1,0,11,1,12,390
7,7,0,1,11,2,13,390
8,8,0,3,11,5,16,390
9,9,0,3,11,8,19,390
10,10,0,3,11,11,22,390
11,11,0,0,11,11,22,390
0,0,1,0,1,0,1,391
1,1,1,0,2,0,2,391
2,2,1,0,3,0,3,391
3,3,1,0,4,0,4,391
4,4,2,0,6,0,6,391
5,5,0,2,6,2,8,391
6,6,1,2,7,4,11,391
7,7,5,1,12,5,17,391
8,8,2,0,14,5,19,391
9,9,3,0,17,5,22,391
10,10,1,1,18,6,24,391
11,11,1,0,19,6,25,391
12,12,0,0,19,6,25,391
0,0,1,0,1,0,1,392
1,1,0,0,1,0,1,392
0,0,1,0,1,0,1,393
1,1,1,0,2,0,2,393
2,2,0,0,2,0,2,393
0,0,1,0,1,0,1,394
1,1,0,0,1,0,1,394
0,0,1,0,1,0,1,395
1,1,0,1,1,1,2,395
2,2,0,0,1,1,2,395
0,0,1,0,1,0,1,396
1,1,1,1,2,1,3,396
2,2,0,0,2,1,3,396
0,0,1,0,1,0,1,397
1,1,1,0,2,0,2,397
2,2,0,0,2,0,2,397
0,0,1,0,1,0,1,398
1,1,1,0,2,0,2,398
2,2,0,0,2,0,2,398
0,0,1,0,1,0,1,399
1,1,2,0,3,0,3,399
2,2,1,0,4,0,4,399
3,3,1,0,5,0,5,399
4,4,0,0,5,0,5,399
0,0,1,0,1,0,1,400
1,1,1,0,2,0,2,400
2,2,1,0,3,0,3,400
3,3,1,0,4,0,4,400
4,4,1,0,5,0,5,400
5,5,1,1,6,1,7,400
6,6,0,1,6,2,8,400
7,7,0,1,6,3,9,400
8,8,0,1,6,4,10,400
9,9,1,1,7,5,12,400
10,10,0,0,7,5,12,400
0,0,1,0,1,0,1,401
1,1,1,0,2,0,2,401
2,2,0,1,2,1,3,401
3,3,0,0,2,1,3,401
0,0,1,0,1,0,1,402
1,1,1,1,2,1,3,402
2,2,3,1,5,2,7,402
3,3,2,4,7,6,13,402
4,4,4,3,11,9,20,402
5,5,7,4,18,13,31,402
6,6,12,2,30,15,45,402
7,7,14,5,44,20,64,402
8,8,13,6,57,26,83,402
9,9,11,10,68,36,104,402
10,10,2,10,70,46,116,402
11,11,2,10,72,56,128,402
12,12,5,1,77,57,134,402
13,13,4,0,81,57,138,402
14,14,1,0,82,57,139,402
15,15,0,2,82,59,141,402
16,16,0,1,82,60,142,402
17,17,1,1,83,61,144,402
18,18,0,2,83,63,146,402
19,19,1,0,84,63,147,402
20,20,0,0,84,63,147,402
0,0,1,0,1,0,1,403
1,1,1,0,2,0,2,403
2,2,1,0,3,0,3,403
3,3,1,0,4,0,4,403
4,4,0,0,4,0,4,403
0,0,1,0,1,0,1,404
1,1,1,0,2,0,2,404
2,2,0,0,2,0,2,404
0,0,1,0,1,0,1,405
1,1,1,0,2,0,2,405
2,2,1,0,3,0,3,405
3,3,0,0,3,0,3,405
0,0,1,0,1,0,1,406
1,1,0,0,1,0,1,406
0,0,1,0,1,0,1,407
1,1,0,0,1,0,1,407
0,0,1,0,1,0,1,408
1,1,0,0,1,0,1,408
0,0,1,0,1,0,1,409
1,1,0,0,1,0,1,409
0,0,1,0,1,0,1,410
1,1,1,0,2,0,2,410
2,2,0,1,2,1,3,410
3,3,0,0,2,1,3,410
0,0,1,0,1,0,1,411
1,1,0,1,1,1,2,411
2,2,0,2,1,3,4,411
3,3,1,3,2,6,8,411
4,4,2,2,4,8,12,411
5,5,0,4,4,12,16,411
6,6,3,3,7,15,22,411
7,7,3,4,10,19,29,411
8,8,2,7,12,26,38,411
9,9,2,4,14,30,44,411
10,10,4,0,18,30,48,411
11,11,1,0,19,30,49,411
12,12,1,0,20,30,50,411
13,13,0,0,20,30,50,411
0,0,1,0,1,0,1,412
1,1,1,0,2,0,2,412
2,2,1,0,3,0,3,412
3,3,1,0,4,0,4,412
4,4,0,0,4,0,4,412
0,0,1,0,1,0,1,413
1,1,0,0,1,0,1,413
0,0,1,0,1,0,1,414
1,1,2,0,3,0,3,414
2,2,2,0,5,0,5,414
3,3,0,1,5,1,6,414
4,4,0,0,5,1,6,414
0,0,1,0,1,0,1,415
1,1,2,0,3,0,3,415
2,2,1,1,4,1,5,415
3,3,1,0,5,1,6,415
4,4,0,0,5,1,6,415
0,0,1,0,1,0,1,416
1,1,1,0,2,0,2,416
2,2,0,0,2,0,2,416
0,0,1,0,1,0,1,417
1,1,1,0,2,0,2,417
2,2,1,0,3,0,3,417
3,3,2,0,5,0,5,417
4,4,1,1,6,1,7,417
5,5,2,1,8,2,10,417
6,6,1,0,9,2,11,417
7,7,0,0,9,2,11,417
0,0,1,0,1,0,1,418
1,1,0,1,1,1,2,418
2,2,0,0,1,1,2,418
0,0,1,0,1,0,1,419
1,1,0,1,1,1,2,419
2,2,0,1,1,2,3,419
3,3,0,0,1,2,3,419
0,0,1,0,1,0,1,420
1,1,0,0,1,0,1,420
0,0,1,0,1,0,1,421
1,1,1,0,2,0,2,421
2,2,1,0,3,0,3,421
3,3,2,1,5,1,6,421
4,4,2,2,7,3,10,421
5,5,2,0,9,3,12,421
6,6,3,0,12,3,15,421
7,7,2,1,14,4,18,421
8,8,2,0,16,4,20,421
9,9,0,0,16,4,20,421
0,0,1,0,1,0,1,422
1,1,0,0,1,0,1,422
0,0,1,0,1,0,1,423
1,1,1,0,2,0,2,423
2,2,1,0,3,0,3,423
3,3,1,0,4,0,4,423
4,4,1,0,5,0,5,423
5,5,0,0,5,0,5,423
0,0,1,0,1,0,1,424
1,1,0,1,1,1,2,424
2,2,1,2,2,3,5,424
3,3,3,0,5,3,8,424
4,4,1,0,6,3,9,424
5,5,0,0,6,3,9,424
0,0,1,0,1,0,1,425
1,1,0,0,1,0,1,425
0,0,1,0,1,0,1,426
1,1,0,0,1,0,1,426
0,0,1,0,1,0,1,427
1,1,1,0,2,0,2,427
2,2,2,0,4,0,4,427
3,3,2,0,6,0,6,427
4,4,1,0,7,0,7,427
5,5,1,1,8,1,9,427
6,6,1,3,9,4,13,427
7,7,1,0,10,4,14,427
8,8,2,0,12,4,16,427
9,9,5,1,17,5,22,427
10,10,8,1,25,6,31,427
11,11,2,0,27,6,33,427
12,12,1,0,28,6,34,427
13,13,0,0,28,6,34,427
0,0,1,0,1,0,1,428
1,1,2,0,3,0,3,428
2,2,1,1,4,1,5,428
3,3,2,0,6,1,7,428
4,4,0,0,6,1,7,428
0,0,1,0,1,0,1,429
1,1,0,0,1,0,1,429
0,0,1,0,1,0,1,430
1,1,1,0,2,0,2,430
2,2,1,0,3,0,3,430
3,3,1,0,4,0,4,430
4,4,1,0,5,0,5,430
5,5,2,0,7,0,7,430
6,6,1,1,8,1,9,430
7,7,1,1,9,2,11,430
8,8,0,0,9,2,11,430
0,0,1,0,1,0,1,431
1,1,0,1,1,1,2,431
2,2,0,0,1,1,2,431
0,0,1,0,1,0,1,432
1,1,0,0,1,0,1,432
0,0,1,0,1,0,1,433
1,1,1,0,2,0,2,433
2,2,1,0,3,0,3,433
3,3,0,0,3,0,3,433
0,0,1,0,1,0,1,434
1,1,0,0,1,0,1,434
0,0,1,0,1,0,1,435
1,1,0,0,1,0,1,435
0,0,1,0,1,0,1,436
1,1,1,0,2,0,2,436
2,2,1,1,3,1,4,436
3,3,0,1,3,2,5,436
4,4,1,0,4,2,6,436
5,5,1,0,5,2,7,436
6,6,0,0,5,2,7,436
0,0,1,0,1,0,1,437
1,1,1,0,2,0,2,437
2,2,1,0,3,0,3,437
3,3,2,0,5,0,5,437
4,4,3,0,8,0,8,437
5,5,0,0,8,0,8,437
0,0,1,0,1,0,1,438
1,1,1,0,2,0,2,438
2,2,0,1,2,1,3,438
3,3,0,1,2,2,4,438
4,4,0,0,2,2,4,438
0,0,1,0,1,0,1,439
1,1,0,0,1,0,1,439
0,0,1,0,1,0,1,440
1,1,2,0,3,0,3,440
2,2,1,0,4,0,4,440
3,3,0,0,4,0,4,440
0,0,1,0,1,0,1,441
1,1,1,0,2,0,2,441
2,2,1,0,3,0,3,441
3,3,1,0,4,0,4,441
4,4,1,0,5,0,5,441
5,5,2,0,7,0,7,441
6,6,2,1,9,1,10,441
7,7,1,0,10,1,11,441
8,8,1,0,11,1,12,441
9,9,2,1,13,2,15,441
10,10,3,0,16,2,18,441
11,11,2,1,18,3,21,441
12,12,2,2,20,5,25,441
13,13,1,3,21,8,29,441
14,14,2,3,23,11,34,441
15,15,2,1,25,12,37,441
16,16,1,0,26,12,38,441
17,17,0,0,26,12,38,441
0,0,1,0,1,0,1,442
1,1,1,1,2,1,3,442
2,2,1,2,3,3,6,442
3,3,0,2,3,5,8,442
4,4,1,2,4,7,11,442
5,5,2,2,6,9,15,442
6,6,0,2,6,11,17,442
7,7,1,1,7,12,19,442
8,8,0,1,7,13,20,442
9,9,1,1,8,14,22,442
10,10,1,0,9,14,23,442
11,11,1,0,10,14,24,442
12,12,0,0,10,14,24,442
0,0,1,0,1,0,1,443
1,1,1,0,2,0,2,443
2,2,0,0,2,0,2,443
0,0,1,0,1,0,1,444
1,1,0,0,1,0,1,444
0,0,1,0,1,0,1,445
1,1,1,0,2,0,2,445
2,2,1,0,3,0,3,445
3,3,0,0,3,0,3,445
0,0,1,0,1,0,1,446
1,1,0,0,1,0,1,446
0,0,1,0,1,0,1,447
1,1,1,0,2,0,2,447
2,2,2,0,4,0,4,447
3,3,2,1,6,1,7,447
4,4,2,0,8,1,9,447
5,5,2,0,10,1,11,447
6,6,1,0,11,1,12,447
7,7,0,0,11,1,12,447
0,0,1,0,1,0,1,448
1,1,1,0,2,0,2,448
2,2,0,0,2,0,2,448
0,0,1,0,1,0,1,449
1,1,0,1,1,1,2,449
2,2,0,2,1,3,4,449
3,3,0,3,1,6,7,449
4,4,2,1,3,7,10,449
5,5,1,1,4,8,12,449
6,6,1,1,5,9,14,449
7,7,1,0,6,9,15,449
8,8,1,0,7,9,16,449
9,9,0,0,7,9,16,449
0,0,1,0,1,0,1,450
1,1,0,1,1,1,2,450
2,2,0,1,1,2,3,450
3,3,0,1,1,3,4,450
4,4,0,0,1,3,4,450
0,0,1,0,1,0,1,451
1,1,1,0,2,0,2,451
2,2,0,0,2,0,2,451
0,0,1,0,1,0,1,452
1,1,1,0,2,0,2,452
2,2,1,0,3,0,3,452
3,3,3,0,6,0,6,452
4,4,1,1,7,1,8,452
5,5,1,0,8,1,9,452
6,6,0,0,8,1,9,452
0,0,1,0,1,0,1,453
1,1,0,2,1,2,3,453
2,2,1,3,2,5,7,453
3,3,3,1,5,6,11,453
4,4,5,2,10,8,18,453
5,5,7,4,17,12,29,453
6,6,6,3,23,15,38,453
7,7,3,3,26,18,44,453
8,8,5,2,31,20,51,453
9,9,3,0,34,20,54,453
10,10,2,0,36,20,56,453
11,11,3,0,39,20,59,453
12,12,1,0,40,20,60,453
13,13,1,0,41,20,61,453
14,14,1,0,42,20,62,453
15,15,2,0,44,20,64,453
16,16,0,0,44,20,64,453
0,0,1,0,1,0,1,454
1,1,0,0,1,0,1,454
0,0,1,0,1,0,1,455
1,1,0,0,1,0,1,455
0,0,1,0,1,0,1,456
1,1,1,0,2,0,2,456
2,2,3,0,5,0,5,456
3,3,1,2,6,2,8,456
4,4,1,1,7,3,10,456
5,5,1,0,8,3,11,456
6,6,1,0,9,3,12,456
7,7,0,0,9,3,12,456
0,0,1,0,1,0,1,457
1,1,0,0,1,0,1,457
0,0,1,0,1,0,1,458
1,1,1,0,2,0,2,458
2,2,4,0,6,0,6,458
3,3,0,0,6,0,6,458
0,0,1,0,1,0,1,459
1,1,0,0,1,0,1,459
0,0,1,0,1,0,1,460
1,1,0,0,1,0,1,460
0,0,1,0,1,0,1,461
1,1,0,0,1,0,1,461
0,0,1,0,1,0,1,462
1,1,2,0,3,0,3,462
2,2,5,0,8,0,8,462
3,3,2,1,10,1,11,462
4,4,1,0,11,1,12,462
5,5,1,0,12,1,13,462
6,6,0,1,12,2,14,462
7,7,0,1,12,3,15,462
8,8,0,0,12,3,15,462
0,0,1,0,1,0,1,463
1,1,3,0,4,0,4,463
2,2,1,1,5,1,6,463
3,3,1,1,6,2,8,463
4,4,1,1,7,3,10,463
5,5,1,1,8,4,12,463
6,6,0,0,8,4,12,463
0,0,1,0,1,0,1,464
1,1,3,0,4,0,4,464
2,2,2,0,6,0,6,464
3,3,2,1,8,1,9,464
4,4,4,0,12,1,13,464
5,5,4,2,16,3,19,464
6,6,4,0,20,3,23,464
7,7,1,0,21,3,24,464
8,8,0,0,21,3,24,464
0,0,1,0,1,0,1,465
1,1,0,0,1,0,1,465
0,0,1,0,1,0,1,466
1,1,3,0,4,0,4,466
2,2,2,0,6,0,6,466
3,3,0,0,6,0,6,466
0,0,1,0,1,0,1,467
1,1,1,0,2,0,2,467
2,2,2,0,4,0,4,467
3,3,1,1,5,1,6,467
4,4,2,0,7,1,8,467
5,5,0,0,7,1,8,467
0,0,1,0,1,0,1,468
1,1,1,0,2,0,2,468
2,2,0,0,2,0,2,468
0,0,1,0,1,0,1,469
1,1,0,0,1,0,1,469
0,0,1,0,1,0,1,470
1,1,1,0,2,0,2,470
2,2,2,0,4,0,4,470
3,3,1,2,5,2,7,470
4,4,1,3,6,5,11,470
5,5,1,3,7,8,15,470
6,6,1,4,8,12,20,470
7,7,2,1,10,13,23,470
8,8,1,2,11,15,26,470
9,9,2,2,13,17,30,470
10,10,0,3,13,20,33,470
11,11,1,1,14,21,35,470
12,12,0,3,14,24,38,470
13,13,0,0,14,24,38,470
0,0,1,0,1,0,1,471
1,1,0,0,1,0,1,471
0,0,1,0,1,0,1,472
1,1,0,0,1,0,1,472
0,0,1,0,1,0,1,473
1,1,1,1,2,1,3,473
2,2,4,2,6,3,9,473
3,3,2,2,8,5,13,473
4,4,1,2,9,7,16,473
5,5,2,1,11,8,19,473
6,6,4,0,15,8,23,473
7,7,0,2,15,10,25,473
8,8,0,3,15,13,28,473
9,9,0,2,15,15,30,473
10,10,0,2,15,17,32,473
11,11,0,0,15,17,32,473
0,0,1,0,1,0,1,474
1,1,0,1,1,1,2,474
2,2,0,0,1,1,2,474
0,0,1,0,1,0,1,475
1,1,2,0,3,0,3,475
2,2,3,0,6,0,6,475
3,3,2,1,8,1,9,475
4,4,0,1,8,2,10,475
5,5,0,1,8,3,11,475
6,6,1,1,9,4,13,475
7,7,1,2,10,6,16,475
8,8,3,5,13,11,24,475
9,9,3,5,16,16,32,475
10,10,3,2,19,18,37,475
11,11,1,1,20,19,39,475
12,12,2,1,22,20,42,475
13,13,0,1,22,21,43,475
14,14,0,1,22,22,44,475
15,15,0,0,22,22,44,475
0,0,1,0,1,0,1,476
1,1,0,1,1,1,2,476
2,2,0,0,1,1,2,476
0,0,1,0,1,0,1,477
1,1,1,0,2,0,2,477
2,2,0,0,2,0,2,477
0,0,1,0,1,0,1,478
1,1,0,0,1,0,1,478
0,0,1,0,1,0,1,479
1,1,0,0,1,0,1,479
0,0,1,0,1,0,1,480
1,1,2,0,3,0,3,480
2,2,1,0,4,0,4,480
3,3,1,0,5,0,5,480
4,4,0,0,5,0,5,480
0,0,1,0,1,0,1,481
1,1,1,0,2,0,2,481
2,2,1,0,3,0,3,481
3,3,2,1,5,1,6,481
4,4,4,0,9,1,10,481
5,5,4,1,13,2,15,481
6,6,2,2,15,4,19,481
7,7,4,1,19,5,24,481
8,8,5,2,24,7,31,481
9,9,4,4,28,11,39,481
10,10,4,4,32,15,47,481
11,11,4,6,36,21,57,481
12,12,8,7,44,28,72,481
13,13,5,10,49,38,87,481
14,14,6,5,55,43,98,481
15,15,5,4,60,47,107,481
16,16,4,2,64,49,113,481
17,17,3,3,67,52,119,481
18,18,3,2,70,54,124,481
19,19,3,1,73,55,128,481
20,20,0,1,73,56,129,481
21,21,0,1,73,57,130,481
22,22,0,3,73,60,133,481
23,23,1,4,74,64,138,481
24,24,2,5,76,69,145,481
25,25,2,3,78,72,150,481
26,26,2,5,80,77,157,481
27,27,2,4,82,81,163,481
28,28,2,2,84,83,167,481
29,29,1,1,85,84,169,481
30,30,0,1,85,85,170,481
31,31,0,1,85,86,171,481
32,32,0,2,85,88,173,481
33,33,0,3,85,91,176,481
34,34,1,1,86,92,178,481
35,35,1,1,87,93,180,481
36,36,1,0,88,93,181,481
37,37,0,0,88,93,181,481
0,0,1,0,1,0,1,482
1,1,0,1,1,1,2,482
2,2,0,1,1,2,3,482
3,3,0,0,1,2,3,482
0,0,1,0,1,0,1,483
1,1,2,0,3,0,3,483
2,2,0,0,3,0,3,483
0,0,1,0,1,0,1,484
1,1,0,0,1,0,1,484
0,0,1,0,1,0,1,485
1,1,1,0,2,0,2,485
2,2,0,0,2,0,2,485
0,0,1,0,1,0,1,486
1,1,2,0,3,0,3,486
2,2,1,0,4,0,4,486
3,3,1,0,5,0,5,486
4,4,1,0,6,0,6,486
5,5,0,0,6,0,6,486
0,0,1,0,1,0,1,487
1,1,0,0,1,0,1,487
0,0,1,0,1,0,1,488
1,1,2,1,3,1,4,488
2,2,1,2,4,3,7,488
3,3,4,3,8,6,14,488
4,4,1,1,9,7,16,488
5,5,1,3,10,10,20,488
6,6,2,0,12,10,22,488
7,7,2,0,14,10,24,488
8,8,3,0,17,10,27,488
9,9,2,1,19,11,30,488
10,10,2,0,21,11,32,488
11,11,4,0,25,11,36,488
12,12,0,1,25,12,37,488
13,13,0,3,25,15,40,488
14,14,0,1,25,16,41,488
15,15,0,2,25,18,43,488
16,16,1,1,26,19,45,488
17,17,0,1,26,20,46,488
18,18,0,1,26,21,47,488
19,19,0,1,26,22,48,488
20,20,0,2,26,24,50,488
21,21,0,1,26,25,51,488
22,22,0,1,26,26,52,488
23,23,0,1,26,27,53,488
24,24,0,0,26,27,53,488
0,0,1,0,1,0,1,489
1,1,0,0,1,0,1,489
0,0,1,0,1,0,1,490
1,1,0,0,1,0,1,490
0,0,1,0,1,0,1,491
1,1,1,0,2,0,2,491
2,2,1,0,3,0,3,491
3,3,0,0,3,0,3,491
0,0,1,0,1,0,1,492
1,1,1,0,2,0,2,492
2,2,0,0,2,0,2,492
0,0,1,0,1,0,1,493
1,1,0,0,1,0,1,493
0,0,1,0,1,0,1,494
1,1,1,0,2,0,2,494
2,2,1,0,3,0,3,494
3,3,0,0,3,0,3,494
0,0,1,0,1,0,1,495
1,1,0,0,1,0,1,495
0,0,1,0,1,0,1,496
1,1,2,0,3,0,3,496
2,2,0,0,3,0,3,496
0,0,1,0,1,0,1,497
1,1,1,0,2,0,2,497
2,2,0,1,2,1,3,497
3,3,0,0,2,1,3,497
0,0,1,0,1,0,1,498
1,1,2,2,3,2,5,498
2,2,1,2,4,4,8,498
3,3,1,1,5,5,10,498
4,4,0,0,5,5,10,498
0,0,1,0,1,0,1,499
1,1,0,0,1,0,1,499
0,0,1,0,1,0,1,500
1,1,0,0,1,0,1,500
0,0,1,0,1,0,1,501
1,1,0,0,1,0,1,501
0,0,1,0,1,0,1,502
1,1,2,0,3,0,3,502
2,2,5,2,8,2,10,502
3,3,4,2,12,4,16,502
4,4,1,5,13,9,22,502
5,5,0,8,13,17,30,502
6,6,0,6,13,23,36,502
7,7,0,2,13,25,38,502
8,8,0,2,13,27,40,502
9,9,0,1,13,28,41,502
10,10,0,0,13,28,41,502
0,0,1,0,1,0,1,503
1,1,0,1,1,1,2,503
2,2,0,0,1,1,2,503
0,0,1,0,1,0,1,504
1,1,1,1,2,1,3,504
2,2,2,1,4,2,6,504
3,3,2,2,6,4,10,504
4,4,3,2,9,6,15,504
5,5,5,2,14,8,22,504
6,6,3,8,17,16,33,504
7,7,4,9,21,25,46,504
8,8,3,6,24,31,55,504
9,9,2,4,26,35,61,504
10,10,1,3,27,38,65,504
11,11,1,4,28,42,70,504
12,12,2,3,30,45,75,504
13,13,0,2,30,47,77,504
14,14,0,2,30,49,79,504
15,15,1,1,31,50,81,504
16,16,0,0,31,50,81,504
0,0,1,0,1,0,1,505
1,1,1,1,2,1,3,505
2,2,1,0,3,1,4,505
3,3,1,0,4,1,5,505
4,4,0,0,4,1,5,505
0,0,1,0,1,0,1,506
1,1,0,0,1,0,1,506
0,0,1,0,1,0,1,507
1,1,1,0,2,0,2,507
2,2,1,0,3,0,3,507
3,3,0,0,3,0,3,507
0,0,1,0,1,0,1,508
1,1,0,0,1,0,1,508
0,0,1,0,1,0,1,509
1,1,0,1,1,1,2,509
2,2,0,0,1,1,2,509
0,0,1,0,1,0,1,510
1,1,1,0,2,0,2,510
2,2,0,0,2,0,2,510
0,0,1,0,1,0,1,511
1,1,1,0,2,0,2,511
2,2,0,0,2,0,2,511
0,0,1,0,1,0,1,512
1,1,1,0,2,0,2,512
2,2,0,0,2,0,2,512
0,0,1,0,1,0,1,513
1,1,0,0,1,0,1,513
0,0,1,0,1,0,1,514
1,1,2,0,3,0,3,514
2,2,0,0,3,0,3,514
0,0,1,0,1,0,1,515
1,1,0,0,1,0,1,515
0,0,1,0,1,0,1,516
1,1,0,0,1,0,1,516
0,0,1,0,1,0,1,517
1,1,0,0,1,0,1,517
0,0,1,0,1,0,1,518
1,1,1,0,2,0,2,518
2,2,0,1,2,1,3,518
3,3,0,0,2,1,3,518
0,0,1,0,1,0,1,519
1,1,0,0,1,0,1,519
0,0,1,0,1,0,1,520
1,1,0,0,1,0,1,520
0,0,1,0,1,0,1,521
1,1,0,0,1,0,1,521
0,0,1,0,1,0,1,522
1,1,0,1,1,1,2,522
2,2,0,0,1,1,2,522
0,0,1,0,1,0,1,523
1,1,2,0,3,0,3,523
2,2,1,0,4,0,4,523
3,3,0,0,4,0,4,523
0,0,1,0,1,0,1,524
1,1,0,0,1,0,1,524
0,0,1,0,1,0,1,525
1,1,1,1,2,1,3,525
2,2,0,1,2,2,4,525
3,3,0,2,2,4,6,525
4,4,0,2,2,6,8,525
5,5,1,1,3,7,10,525
6,6,0,1,3,8,11,525
7,7,0,2,3,10,13,525
8,8,0,1,3,11,14,525
9,9,1,2,4,13,17,525
10,10,1,0,5,13,18,525
11,11,0,0,5,13,18,525
0,0,1,0,1,0,1,526
1,1,0,0,1,0,1,526
0,0,1,0,1,0,1,527
1,1,0,2,1,2,3,527
2,2,0,3,1,5,6,527
3,3,1,3,2,8,10,527
4,4,1,3,3,11,14,527
5,5,1,2,4,13,17,527
6,6,0,1,4,14,18,527
7,7,0,1,4,15,19,527
8,8,1,1,5,16,21,527
9,9,3,3,8,19,27,527
10,10,3,3,11,22,33,527
11,11,2,3,13,25,38,527
12,12,1,3,14,28,42,527
13,13,3,0,17,28,45,527
14,14,0,0,17,28,45,527
0,0,1,0,1,0,1,528
1,1,1,0,2,0,2,528
2,2,1,0,3,0,3,528
3,3,0,0,3,0,3,528
0,0,1,0,1,0,1,529
1,1,1,0,2,0,2,529
2,2,1,0,3,0,3,529
3,3,1,0,4,0,4,529
4,4,0,0,4,0,4,529
0,0,1,0,1,0,1,530
1,1,0,0,1,0,1,530
0,0,1,0,1,0,1,531
1,1,2,1,3,1,4,531
2,2,3,3,6,4,10,531
3,3,2,2,8,6,14,531
4,4,3,3,11,9,20,531
5,5,1,3,12,12,24,531
6,6,0,3,12,15,27,531
7,7,1,3,13,18,31,531
8,8,2,3,15,21,36,531
9,9,2,1,17,22,39,531
10,10,2,0,19,22,41,531
11,11,1,4,20,26,46,531
12,12,2,3,22,29,51,531
13,13,1,1,23,30,53,531
14,14,0,0,23,30,53,531
0,0,1,0,1,0,1,532
1,1,0,1,1,1,2,532
2,2,0,1,1,2,3,532
3,3,0,0,1,2,3,532
0,0,1,0,1,0,1,533
1,1,0,0,1,0,1,533
0,0,1,0,1,0,1,534
1,1,3,0,4,0,4,534
2,2,0,0,4,0,4,534
0,0,1,0,1,0,1,535
1,1,0,0,1,0,1,535
0,0,1,0,1,0,1,536
1,1,0,0,1,0,1,536
0,0,1,0,1,0,1,537
1,1,0,0,1,0,1,537
0,0,1,0,1,0,1,538
1,1,0,0,1,0,1,538
0,0,1,0,1,0,1,539
1,1,0,0,1,0,1,539
0,0,1,0,1,0,1,540
1,1,0,0,1,0,1,540
0,0,1,0,1,0,1,541
1,1,1,0,2,0,2,541
2,2,1,0,3,0,3,541
3,3,0,1,3,1,4,541
4,4,0,0,3,1,4,541
0,0,1,0,1,0,1,542
1,1,0,1,1,1,2,542
2,2,0,0,1,1,2,542
0,0,1,0,1,0,1,543
1,1,2,1,3,1,4,543
2,2,1,0,4,1,5,543
3,3,1,1,5,2,7,543
4,4,2,1,7,3,10,543
5,5,1,2,8,5,13,543
6,6,2,3,10,8,18,543
7,7,3,3,13,11,24,543
8,8,2,5,15,16,31,543
9,9,1,3,16,19,35,543
10,10,0,7,16,26,42,543
11,11,1,4,17,30,47,543
12,12,0,6,17,36,53,543
13,13,1,4,18,40,58,543
14,14,0,1,18,41,59,543
15,15,0,1,18,42,60,543
16,16,0,0,18,42,60,543
0,0,1,0,1,0,1,544
1,1,0,1,1,1,2,544
2,2,0,0,1,1,2,544
0,0,1,0,1,0,1,545
1,1,0,0,1,0,1,545
0,0,1,0,1,0,1,546
1,1,0,0,1,0,1,546
0,0,1,0,1,0,1,547
1,1,1,0,2,0,2,547
2,2,2,0,4,0,4,547
3,3,1,0,5,0,5,547
4,4,0,0,5,0,5,547
0,0,1,0,1,0,1,548
1,1,0,0,1,0,1,548
0,0,1,0,1,0,1,549
1,1,1,0,2,0,2,549
2,2,3,0,5,0,5,549
3,3,2,0,7,0,7,549
4,4,0,0,7,0,7,549
0,0,1,0,1,0,1,550
1,1,3,0,4,0,4,550
2,2,1,0,5,0,5,550
3,3,0,0,5,0,5,550
0,0,1,0,1,0,1,551
1,1,2,0,3,0,3,551
2,2,5,0,8,0,8,551
3,3,0,1,8,1,9,551
4,4,0,0,8,1,9,551
0,0,1,0,1,0,1,552
1,1,1,1,2,1,3,552
2,2,1,2,3,3,6,552
3,3,1,2,4,5,9,552
4,4,0,2,4,7,11,552
5,5,0,2,4,9,13,552
6,6,0,2,4,11,15,552
7,7,0,0,4,11,15,552
0,0,1,0,1,0,1,553
1,1,1,0,2,0,2,553
2,2,0,0,2,0,2,553
0,0,1,0,1,0,1,554
1,1,2,0,3,0,3,554
2,2,0,0,3,0,3,554
0,0,1,0,1,0,1,555
1,1,0,0,1,0,1,555
0,0,1,0,1,0,1,556
1,1,1,0,2,0,2,556
2,2,0,0,2,0,2,556
0,0,1,0,1,0,1,557
1,1,1,0,2,0,2,557
2,2,0,0,2,0,2,557
0,0,1,0,1,0,1,558
1,1,0,0,1,0,1,558
0,0,1,0,1,0,1,559
1,1,0,0,1,0,1,559
0,0,1,0,1,0,1,560
1,1,1,1,2,1,3,560
2,2,3,2,5,3,8,560
3,3,3,1,8,4,12,560
4,4,2,0,10,4,14,560
5,5,2,0,12,4,16,560
6,6,2,0,14,4,18,560
7,7,2,0,16,4,20,560
8,8,2,0,18,4,22,560
9,9,2,0,20,4,24,560
10,10,2,0,22,4,26,560
11,11,1,0,23,4,27,560
12,12,1,1,24,5,29,560
13,13,0,2,24,7,31,560
14,14,1,4,25,11,36,560
15,15,1,4,26,15,41,560
16,16,1,2,27,17,44,560
17,17,0,3,27,20,47,560
18,18,1,1,28,21,49,560
19,19,0,1,28,22,50,560
20,20,0,0,28,22,50,560
0,0,1,0,1,0,1,561
1,1,0,0,1,0,1,561
0,0,1,0,1,0,1,562
1,1,0,0,1,0,1,562
0,0,1,0,1,0,1,563
1,1,0,0,1,0,1,563
0,0,1,0,1,0,1,564
1,1,1,0,2,0,2,564
2,2,1,0,3,0,3,564
3,3,2,1,5,1,6,564
4,4,1,1,6,2,8,564
5,5,1,2,7,4,11,564
6,6,1,1,8,5,13,564
7,7,1,1,9,6,15,564
8,8,0,1,9,7,16,564
9,9,0,1,9,8,17,564
10,10,0,1,9,9,18,564
11,11,1,0,10,9,19,564
12,12,0,0,10,9,19,564
0,0,1,0,1,0,1,565
1,1,0,0,1,0,1,565
0,0,1,0,1,0,1,566
1,1,2,0,3,0,3,566
2,2,2,0,5,0,5,566
3,3,0,1,5,1,6,566
4,4,1,3,6,4,10,566
5,5,0,2,6,6,12,566
6,6,0,0,6,6,12,566
0,0,1,0,1,0,1,567
1,1,0,0,1,0,1,567
0,0,1,0,1,0,1,568
1,1,1,0,2,0,2,568
2,2,4,0,6,0,6,568
3,3,1,1,7,1,8,568
4,4,1,1,8,2,10,568
5,5,0,1,8,3,11,568
6,6,0,0,8,3,11,568
0,0,1,0,1,0,1,569
1,1,0,0,1,0,1,569
0,0,1,0,1,0,1,570
1,1,1,0,2,0,2,570
2,2,2,0,4,0,4,570
3,3,1,1,5,1,6,570
4,4,2,2,7,3,10,570
5,5,1,3,8,6,14,570
6,6,3,2,11,8,19,570
7,7,2,0,13,8,21,570
8,8,2,0,15,8,23,570
9,9,1,1,16,9,25,570
10,10,3,1,19,10,29,570
11,11,1,0,20,10,30,570
12,12,0,0,20,10,30,570
0,0,1,0,1,0,1,571
1,1,2,0,3,0,3,571
2,2,2,0,5,0,5,571
3,3,3,0,8,0,8,571
4,4,3,0,11,0,11,571
5,5,3,1,14,1,15,571
6,6,4,2,18,3,21,571
7,7,5,4,23,7,30,571
8,8,5,5,28,12,40,571
9,9,2,5,30,17,47,571
10,10,0,3,30,20,50,571
11,11,1,1,31,21,52,571
12,12,0,2,31,23,54,571
13,13,1,0,32,23,55,571
14,14,1,0,33,23,56,571
15,15,2,0,35,23,58,571
16,16,3,0,38,23,61,571
17,17,3,1,41,24,65,571
18,18,7,1,48,25,73,571
19,19,8,4,56,29,85,571
20,20,9,3,65,32,97,571
21,21,8,4,73,36,109,571
22,22,5,5,78,41,119,571
23,23,3,5,81,46,127,571
24,24,3,6,84,52,136,571
25,25,5,6,89,58,147,571
26,26,6,7,95,65,160,571
27,27,11,7,106,72,178,571
28,28,6,7,112,79,191,571
29,29,2,5,114,84,198,571
30,30,3,7,117,91,208,571
31,31,5,4,122,95,217,571
32,32,9,5,131,100,231,571
33,33,7,7,138,107,245,571
34,34,10,12,148,119,267,571
35,35,4,13,152,132,284,571
36,36,3,10,155,142,297,571
37,37,3,10,158,152,310,571
38,38,2,9,160,161,321,571
39,39,2,5,162,166,328,571
40,40,4,4,166,170,336,571
41,41,2,3,168,173,341,571
42,42,6,2,174,175,349,571
43,43,7,3,181,178,359,571
44,44,9,3,190,181,371,571
45,45,4,6,194,187,381,571
46,46,5,4,199,191,390,571
47,47,7,2,206,193,399,571
48,48,6,6,212,199,411,571
49,49,4,8,216,207,423,571
50,50,10,6,226,213,439,571
51,51,11,6,237,219,456,571
52,52,12,4,249,223,472,571
53,53,9,7,258,230,488,571
54,54,6,6,264,236,500,571
55,55,6,7,270,243,513,571
56,56,7,3,277,246,523,571
57,57,12,4,289,250,539,571
58,58,10,7,299,257,556,571
59,59,9,6,308,263,571,571
60,60,7,8,315,271,586,571
61,61,8,4,323,275,598,571
62,62,5,3,328,278,606,571
63,63,1,2,329,280,609,571
64,64,0,1,329,281,610,571
65,65,0,0,329,281,610,571
0,0,1,0,1,0,1,572
1,1,0,0,1,0,1,572
0,0,1,0,1,0,1,573
1,1,2,0,3,0,3,573
2,2,0,0,3,0,3,573
0,0,1,0,1,0,1,574
1,1,0,0,1,0,1,574
0,0,1,0,1,0,1,575
1,1,0,1,1,1,2,575
2,2,1,1,2,2,4,575
3,3,1,0,3,2,5,575
4,4,1,0,4,2,6,575
5,5,1,0,5,2,7,575
6,6,1,1,6,3,9,575
7,7,0,2,6,5,11,575
8,8,0,0,6,5,11,575
0,0,1,0,1,0,1,576
1,1,0,0,1,0,1,576
0,0,1,0,1,0,1,577
1,1,1,0,2,0,2,577
2,2,0,0,2,0,2,577
0,0,1,0,1,0,1,578
1,1,0,0,1,0,1,578
0,0,1,0,1,0,1,579
1,1,1,0,2,0,2,579
2,2,0,0,2,0,2,579
0,0,1,0,1,0,1,580
1,1,1,0,2,0,2,580
2,2,0,0,2,0,2,580
0,0,1,0,1,0,1,581
1,1,2,1,3,1,4,581
2,2,0,0,3,1,4,581
0,0,1,0,1,0,1,582
1,1,1,0,2,0,2,582
2,2,0,0,2,0,2,582
0,0,1,0,1,0,1,583
1,1,1,0,2,0,2,583
2,2,1,0,3,0,3,583
3,3,0,0,3,0,3,583
0,0,1,0,1,0,1,584
1,1,2,1,3,1,4,584
2,2,0,0,3,1,4,584
0,0,1,0,1,0,1,585
1,1,1,0,2,0,2,585
2,2,1,0,3,0,3,585
3,3,0,0,3,0,3,585
0,0,1,0,1,0,1,586
1,1,0,1,1,1,2,586
2,2,0,0,1,1,2,586
0,0,1,0,1,0,1,587
1,1,0,0,1,0,1,587
0,0,1,0,1,0,1,588
1,1,0,0,1,0,1,588
0,0,1,0,1,0,1,589
1,1,1,0,2,0,2,589
2,2,1,0,3,0,3,589
3,3,0,0,3,0,3,589
0,0,1,0,1,0,1,590
1,1,2,0,3,0,3,590
2,2,3,0,6,0,6,590
3,3,1,0,7,0,7,590
4,4,1,0,8,0,8,590
5,5,0,0,8,0,8,590
0,0,1,0,1,0,1,591
1,1,1,0,2,0,2,591
2,2,0,0,2,0,2,591
0,0,1,0,1,0,1,592
1,1,0,0,1,0,1,592
0,0,1,0,1,0,1,593
1,1,1,1,2,1,3,593
2,2,0,1,2,2,4,593
3,3,0,1,2,3,5,593
4,4,1,1,3,4,7,593
5,5,1,0,4,4,8,593
6,6,0,0,4,4,8,593
0,0,1,0,1,0,1,594
1,1,2,0,3,0,3,594
2,2,1,1,4,1,5,594
3,3,1,0,5,1,6,594
4,4,2,1,7,2,9,594
5,5,2,1,9,3,12,594
6,6,0,2,9,5,14,594
7,7,0,1,9,6,15,594
8,8,0,0,9,6,15,594
0,0,1,0,1,0,1,595
1,1,0,0,1,0,1,595
0,0,1,0,1,0,1,596
1,1,1,0,2,0,2,596
2,2,0,1,2,1,3,596
3,3,0,0,2,1,3,596
0,0,1,0,1,0,1,597
1,1,1,0,2,0,2,597
2,2,2,0,4,0,4,597
3,3,1,1,5,1,6,597
4,4,1,1,6,2,8,597
5,5,0,2,6,4,10,597
6,6,0,1,6,5,11,597
7,7,0,1,6,6,12,597
8,8,0,1,6,7,13,597
9,9,0,1,6,8,14,597
10,10,0,0,6,8,14,597
0,0,1,0,1,0,1,598
1,1,0,0,1,0,1,598
0,0,1,0,1,0,1,599
1,1,0,0,1,0,1,599
0,0,1,0,1,0,1,600
1,1,0,2,1,2,3,600
2,2,0,2,1,4,5,600
3,3,1,0,2,4,6,600
4,4,1,0,3,4,7,600
5,5,1,0,4,4,8,600
6,6,1,0,5,4,9,600
7,7,1,0,6,4,10,600
8,8,0,0,6,4,10,600
0,0,1,0,1,0,1,601
1,1,1,1,2,1,3,601
2,2,1,0,3,1,4,601
3,3,2,0,5,1,6,601
4,4,1,0,6,1,7,601
5,5,1,0,7,1,8,601
6,6,1,0,8,1,9,601
7,7,3,0,11,1,12,601
8,8,3,0,14,1,15,601
9,9,2,0,16,1,17,601
10,10,0,0,16,1,17,601
0,0,1,0,1,0,1,602
1,1,0,0,1,0,1,602
0,0,1,0,1,0,1,603
1,1,2,0,3,0,3,603
2,2,1,0,4,0,4,603
3,3,0,0,4,0,4,603
0,0,1,0,1,0,1,604
1,1,0,0,1,0,1,604
0,0,1,0,1,0,1,605
1,1,0,0,1,0,1,605
0,0,1,0,1,0,1,606
1,1,1,0,2,0,2,606
2,2,0,0,2,0,2,606
0,0,1,0,1,0,1,607
1,1,1,0,2,0,2,607
2,2,1,0,3,0,3,607
3,3,1,0,4,0,4,607
4,4,0,0,4,0,4,607
0,0,1,0,1,0,1,608
1,1,2,0,3,0,3,608
2,2,1,0,4,0,4,608
3,3,0,0,4,0,4,608
0,0,1,0,1,0,1,609
1,1,0,0,1,0,1,609
0,0,1,0,1,0,1,610
1,1,2,0,3,0,3,610
2,2,1,0,4,0,4,610
3,3,1,0,5,0,5,610
4,4,1,0,6,0,6,610
5,5,1,0,7,0,7,610
6,6,1,0,8,0,8,610
7,7,1,0,9,0,9,610
8,8,0,0,9,0,9,610
0,0,1,0,1,0,1,611
1,1,0,0,1,0,1,611
0,0,1,0,1,0,1,612
1,1,1,0,2,0,2,612
2,2,1,0,3,0,3,612
3,3,1,0,4,0,4,612
4,4,0,0,4,0,4,612
0,0,1,0,1,0,1,613
1,1,0,1,1,1,2,613
2,2,0,0,1,1,2,613
0,0,1,0,1,0,1,614
1,1,2,0,3,0,3,614
2,2,2,0,5,0,5,614
3,3,0,1,5,1,6,614
4,4,0,1,5,2,7,614
5,5,1,0,6,2,8,614
6,6,2,1,8,3,11,614
7,7,2,3,10,6,16,614
8,8,2,3,12,9,21,614
9,9,2,3,14,12,26,614
10,10,4,2,18,14,32,614
11,11,2,5,20,19,39,614
12,12,1,1,21,20,41,614
13,13,2,0,23,20,43,614
14,14,1,0,24,20,44,614
15,15,1,2,25,22,47,614
16,16,3,1,28,23,51,614
17,17,3,1,31,24,55,614
18,18,0,1,31,25,56,614
19,19,0,1,31,26,57,614
20,20,0,1,31,27,58,614
21,21,0,0,31,27,58,614
0,0,1,0,1,0,1,615
1,1,0,0,1,0,1,615
0,0,1,0,1,0,1,616
1,1,0,0,1,0,1,616
0,0,1,0,1,0,1,617
1,1,2,0,3,0,3,617
2,2,0,0,3,0,3,617
0,0,1,0,1,0,1,618
1,1,0,0,1,0,1,618
0,0,1,0,1,0,1,619
1,1,1,0,2,0,2,619
2,2,1,0,3,0,3,619
3,3,0,0,3,0,3,619
0,0,1,0,1,0,1,620
1,1,0,0,1,0,1,620
0,0,1,0,1,0,1,621
1,1,0,0,1,0,1,621
0,0,1,0,1,0,1,622
1,1,0,1,1,1,2,622
2,2,0,0,1,1,2,622
0,0,1,0,1,0,1,623
1,1,1,0,2,0,2,623
2,2,0,0,2,0,2,623
0,0,1,0,1,0,1,624
1,1,1,1,2,1,3,624
2,2,0,0,2,1,3,624
0,0,1,0,1,0,1,625
1,1,0,1,1,1,2,625
2,2,0,0,1,1,2,625
0,0,1,0,1,0,1,626
1,1,2,1,3,1,4,626
2,2,1,2,4,3,7,626
3,3,1,2,5,5,10,626
4,4,1,0,6,5,11,626
5,5,1,0,7,5,12,626
6,6,0,1,7,6,13,626
7,7,0,1,7,7,14,626
8,8,0,0,7,7,14,626
0,0,1,0,1,0,1,627
1,1,1,0,2,0,2,627
2,2,3,1,5,1,6,627
3,3,0,1,5,2,7,627
4,4,0,0,5,2,7,627
0,0,1,0,1,0,1,628
1,1,0,0,1,0,1,628
0,0,1,0,1,0,1,629
1,1,1,0,2,0,2,629
2,2,0,0,2,0,2,629
0,0,1,0,1,0,1,630
1,1,1,0,2,0,2,630
2,2,2,0,4,0,4,630
3,3,1,0,5,0,5,630
4,4,0,1,5,1,6,630
5,5,0,1,5,2,7,630
6,6,0,1,5,3,8,630
7,7,0,0,5,3,8,630
0,0,1,0,1,0,1,631
1,1,0,0,1,0,1,631
0,0,1,0,1,0,1,632
1,1,0,0,1,0,1,632
0,0,1,0,1,0,1,633
1,1,0,0,1,0,1,633
0,0,1,0,1,0,1,634
1,1,1,1,2,1,3,634
2,2,0,0,2,1,3,634
0,0,1,0,1,0,1,635
1,1,1,0,2,0,2,635
2,2,0,1,2,1,3,635
3,3,0,3,2,4,6,635
4,4,0,1,2,5,7,635
5,5,0,2,2,7,9,635
6,6,2,0,4,7,11,635
7,7,0,1,4,8,12,635
8,8,0,0,4,8,12,635
0,0,1,0,1,0,1,636
1,1,0,0,1,0,1,636
0,0,1,0,1,0,1,637
1,1,2,0,3,0,3,637
2,2,1,0,4,0,4,637
3,3,1,0,5,0,5,637
4,4,1,0,6,0,6,637
5,5,1,1,7,1,8,637
6,6,0,1,7,2,9,637
7,7,0,0,7,2,9,637
0,0,1,0,1,0,1,638
1,1,1,0,2,0,2,638
2,2,3,1,5,1,6,638
3,3,2,1,7,2,9,638
4,4,3,0,10,2,12,638
5,5,6,4,16,6,22,638
6,6,4,6,20,12,32,638
7,7,9,3,29,15,44,638
8,8,8,3,37,18,55,638
9,9,3,4,40,22,62,638
10,10,3,5,43,27,70,638
11,11,4,2,47,29,76,638
12,12,4,2,51,31,82,638
13,13,4,2,55,33,88,638
14,14,3,2,58,35,93,638
15,15,4,0,62,35,97,638
16,16,5,3,67,38,105,638
17,17,1,2,68,40,108,638
18,18,2,1,70,41,111,638
19,19,2,2,72,43,115,638
20,20,2,1,74,44,118,638
21,21,1,2,75,46,121,638
22,22,0,4,75,50,125,638
23,23,1,2,76,52,128,638
24,24,2,2,78,54,132,638
25,25,2,3,80,57,137,638
26,26,2,2,82,59,141,638
27,27,4,2,86,61,147,638
28,28,1,2,87,63,150,638
29,29,1,2,88,65,153,638
30,30,1,1,89,66,155,638
31,31,2,0,91,66,157,638
32,32,0,0,91,66,157,638
0,0,1,0,1,0,1,639
1,1,1,0,2,0,2,639
2,2,0,0,2,0,2,639
0,0,1,0,1,0,1,640
1,1,0,0,1,0,1,640
0,0,1,0,1,0,1,641
1,1,0,1,1,1,2,641
2,2,0,2,1,3,4,641
3,3,0,1,1,4,5,641
4,4,0,2,1,6,7,641
5,5,0,0,1,6,7,641
0,0,1,0,1,0,1,642
1,1,0,0,1,0,1,642
0,0,1,0,1,0,1,643
1,1,0,1,1,1,2,643
2,2,0,2,1,3,4,643
3,3,0,3,1,6,7,643
4,4,1,2,2,8,10,643
5,5,1,1,3,9,12,643
6,6,1,1,4,10,14,643
7,7,1,0,5,10,15,643
8,8,0,1,5,11,16,643
9,9,0,0,5,11,16,643
0,0,1,0,1,0,1,644
1,1,0,0,1,0,1,644
0,0,1,0,1,0,1,645
1,1,1,1,2,1,3,645
2,2,1,1,3,2,5,645
3,3,1,1,4,3,7,645
4,4,2,1,6,4,10,645
5,5,4,0,10,4,14,645
6,6,4,0,14,4,18,645
7,7,0,0,14,4,18,645
0,0,1,0,1,0,1,646
1,1,1,1,2,1,3,646
2,2,1,1,3,2,5,646
3,3,0,0,3,2,5,646
0,0,1,0,1,0,1,647
1,1,0,0,1,0,1,647
0,0,1,0,1,0,1,648
1,1,0,0,1,0,1,648
0,0,1,0,1,0,1,649
1,1,1,0,2,0,2,649
2,2,0,0,2,0,2,649
0,0,1,0,1,0,1,650
1,1,1,0,2,0,2,650
2,2,1,1,3,1,4,650
3,3,0,3,3,4,7,650
4,4,0,1,3,5,8,650
5,5,0,1,3,6,9,650
6,6,0,5,3,11,14,650
7,7,1,2,4,13,17,650
8,8,2,1,6,14,20,650
9,9,1,0,7,14,21,650
10,10,3,0,10,14,24,650
11,11,5,0,15,14,29,650
12,12,5,0,20,14,34,650
13,13,5,0,25,14,39,650
14,14,4,0,29,14,43,650
15,15,0,1,29,15,44,650
16,16,0,1,29,16,45,650
17,17,1,1,30,17,47,650
18,18,0,0,30,17,47,650
0,0,1,0,1,0,1,651
1,1,1,0,2,0,2,651
2,2,1,0,3,0,3,651
3,3,1,0,4,0,4,651
4,4,1,0,5,0,5,651
5,5,0,1,5,1,6,651
6,6,0,0,5,1,6,651
0,0,1,0,1,0,1,652
1,1,1,0,2,0,2,652
2,2,1,1,3,1,4,652
3,3,2,0,5,1,6,652
4,4,3,1,8,2,10,652
5,5,2,1,10,3,13,652
6,6,0,2,10,5,15,652
7,7,1,1,11,6,17,652
8,8,1,1,12,7,19,652
9,9,0,1,12,8,20,652
10,10,1,0,13,8,21,652
11,11,1,0,14,8,22,652
12,12,0,0,14,8,22,652
0,0,1,0,1,0,1,653
1,1,0,0,1,0,1,653
0,0,1,0,1,0,1,654
1,1,1,0,2,0,2,654
2,2,3,0,5,0,5,654
3,3,2,0,7,0,7,654
4,4,1,0,8,0,8,654
5,5,0,0,8,0,8,654
0,0,1,0,1,0,1,655
1,1,0,0,1,0,1,655
0,0,1,0,1,0,1,656
1,1,1,0,2,0,2,656
2,2,2,0,4,0,4,656
3,3,2,0,6,0,6,656
4,4,0,0,6,0,6,656
0,0,1,0,1,0,1,657
1,1,1,0,2,0,2,657
2,2,0,0,2,0,2,657
0,0,1,0,1,0,1,658
1,1,0,0,1,0,1,658
0,0,1,0,1,0,1,659
1,1,1,0,2,0,2,659
2,2,1,0,3,0,3,659
3,3,2,1,5,1,6,659
4,4,0,0,5,1,6,659
0,0,1,0,1,0,1,660
1,1,0,0,1,0,1,660
0,0,1,0,1,0,1,661
1,1,0,0,1,0,1,661
0,0,1,0,1,0,1,662
1,1,0,0,1,0,1,662
0,0,1,0,1,0,1,663
1,1,1,0,2,0,2,663
2,2,0,0,2,0,2,663
0,0,1,0,1,0,1,664
1,1,0,0,1,0,1,664
0,0,1,0,1,0,1,665
1,1,2,0,3,0,3,665
2,2,2,0,5,0,5,665
3,3,1,0,6,0,6,665
4,4,2,0,8,0,8,665
5,5,3,0,11,0,11,665
6,6,3,0,14,0,14,665
7,7,3,0,17,0,17,665
8,8,3,0,20,0,20,665
9,9,5,0,25,0,25,665
10,10,5,1,30,1,31,665
11,11,7,2,37,3,40,665
12,12,5,3,42,6,48,665
13,13,8,6,50,12,62,665
14,14,6,7,56,19,75,665
15,15,3,10,59,29,88,665
16,16,4,4,63,33,96,665
17,17,2,3,65,36,101,665
18,18,1,4,66,40,106,665
19,19,3,4,69,44,113,665
20,20,2,4,71,48,119,665
21,21,3,5,74,53,127,665
22,22,4,2,78,55,133,665
23,23,3,4,81,59,140,665
24,24,3,3,84,62,146,665
25,25,4,6,88,68,156,665
26,26,2,4,90,72,162,665
27,27,3,4,93,76,169,665
28,28,5,5,98,81,179,665
29,29,4,5,102,86,188,665
30,30,4,5,106,91,197,665
31,31,3,8,109,99,208,665
32,32,5,4,114,103,217,665
33,33,4,5,118,108,226,665
34,34,6,3,124,111,235,665
35,35,5,3,129,114,243,665
36,36,2,6,131,120,251,665
37,37,2,5,133,125,258,665
38,38,1,4,134,129,263,665
39,39,2,0,136,129,265,665
40,40,3,0,139,129,268,665
41,41,1,0,140,129,269,665
42,42,1,0,141,129,270,665
43,43,0,0,141,129,270,665
0,0,1,0,1,0,1,666
1,1,0,0,1,0,1,666
0,0,1,0,1,0,1,667
1,1,0,0,1,0,1,667
0,0,1,0,1,0,1,668
1,1,1,0,2,0,2,668
2,2,1,0,3,0,3,668
3,3,1,1,4,1,5,668
4,4,4,1,8,2,10,668
5,5,0,0,8,2,10,668
0,0,1,0,1,0,1,669
1,1,1,1,2,1,3,669
2,2,2,0,4,1,5,669
3,3,4,0,8,1,9,669
4,4,1,1,9,2,11,669
5,5,0,1,9,3,12,669
6,6,0,0,9,3,12,669
0,0,1,0,1,0,1,670
1,1,2,1,3,1,4,670
2,2,1,1,4,2,6,670
3,3,2,0,6,2,8,670
4,4,5,0,11,2,13,670
5,5,4,1,15,3,18,670
6,6,0,2,15,5,20,670
7,7,0,0,15,5,20,670
0,0,1,0,1,0,1,671
1,1,1,0,2,0,2,671
2,2,0,0,2,0,2,671
0,0,1,0,1,0,1,672
1,1,0,0,1,0,1,672
0,0,1,0,1,0,1,673
1,1,0,0,1,0,1,673
0,0,1,0,1,0,1,674
1,1,0,0,1,0,1,674
0,0,1,0,1,0,1,675
1,1,0,1,1,1,2,675
2,2,0,0,1,1,2,675
0,0,1,0,1,0,1,676
1,1,3,0,4,0,4,676
2,2,4,4,8,4,12,676
3,3,3,4,11,8,19,676
4,4,5,5,16,13,29,676
5,5,8,3,24,16,40,676
6,6,6,7,30,23,53,676
7,7,4,8,34,31,65,676
8,8,6,6,40,37,77,676
9,9,2,8,42,45,87,676
10,10,1,4,43,49,92,676
11,11,0,4,43,53,96,676
12,12,1,4,44,57,101,676
13,13,2,4,46,61,107,676
14,14,6,2,52,63,115,676
15,15,5,3,57,66,123,676
16,16,3,7,60,73,133,676
17,17,7,10,67,83,150,676
18,18,3,11,70,94,164,676
19,19,4,7,74,101,175,676
20,20,3,4,77,105,182,676
21,21,2,3,79,108,187,676
22,22,1,0,80,108,188,676
23,23,2,0,82,108,190,676
24,24,3,0,85,108,193,676
25,25,2,1,87,109,196,676
26,26,0,1,87,110,197,676
27,27,0,1,87,111,198,676
28,28,0,0,87,111,198,676
0,0,1,0,1,0,1,677
1,1,1,0,2,0,2,677
2,2,0,0,2,0,2,677
0,0,1,0,1,0,1,678
1,1,1,0,2,0,2,678
2,2,1,0,3,0,3,678
3,3,1,0,4,0,4,678
4,4,1,0,5,0,5,678
5,5,0,1,5,1,6,678
6,6,1,1,6,2,8,678
7,7,1,2,7,4,11,678
8,8,2,0,9,4,13,678
9,9,2,0,11,4,15,678
10,10,0,0,11,4,15,678
0,0,1,0,1,0,1,679
1,1,0,0,1,0,1,679
0,0,1,0,1,0,1,680
1,1,1,0,2,0,2,680
2,2,0,1,2,1,3,680
3,3,0,0,2,1,3,680
0,0,1,0,1,0,1,681
1,1,0,0,1,0,1,681
0,0,1,0,1,0,1,682
1,1,0,0,1,0,1,682
0,0,1,0,1,0,1,683
1,1,2,0,3,0,3,683
2,2,0,0,3,0,3,683
0,0,1,0,1,0,1,684
1,1,0,0,1,0,1,684
0,0,1,0,1,0,1,685
1,1,0,0,1,0,1,685
0,0,1,0,1,0,1,686
1,1,1,0,2,0,2,686
2,2,1,0,3,0,3,686
3,3,0,0,3,0,3,686
0,0,1,0,1,0,1,687
1,1,1,0,2,0,2,687
2,2,0,0,2,0,2,687
0,0,1,0,1,0,1,688
1,1,0,0,1,0,1,688
0,0,1,0,1,0,1,689
1,1,0,0,1,0,1,689
0,0,1,0,1,0,1,690
1,1,1,0,2,0,2,690
2,2,0,0,2,0,2,690
0,0,1,0,1,0,1,691
1,1,0,0,1,0,1,691
0,0,1,0,1,0,1,692
1,1,0,1,1,1,2,692
2,2,0,1,1,2,3,692
3,3,0,0,1,2,3,692
0,0,1,0,1,0,1,693
1,1,0,0,1,0,1,693
0,0,1,0,1,0,1,694
1,1,1,0,2,0,2,694
2,2,2,0,4,0,4,694
3,3,2,0,6,0,6,694
4,4,4,0,10,0,10,694
5,5,3,3,13,3,16,694
6,6,2,5,15,8,23,694
7,7,5,7,20,15,35,694
8,8,4,10,24,25,49,694
9,9,4,8,28,33,61,694
10,10,4,9,32,42,74,694
11,11,8,4,40,46,86,694
12,12,7,2,47,48,95,694
13,13,7,3,54,51,105,694
14,14,4,3,58,54,112,694
15,15,1,1,59,55,114,694
16,16,0,0,59,55,114,694
0,0,1,0,1,0,1,695
1,1,1,0,2,0,2,695
2,2,1,0,3,0,3,695
3,3,1,0,4,0,4,695
4,4,1,0,5,0,5,695
5,5,2,1,7,1,8,695
6,6,1,3,8,4,12,695
7,7,1,2,9,6,15,695
8,8,2,2,11,8,19,695
9,9,1,3,12,11,23,695
10,10,1,2,13,13,26,695
11,11,0,3,13,16,29,695
12,12,1,2,14,18,32,695
13,13,3,1,17,19,36,695
14,14,4,0,21,19,40,695
15,15,4,2,25,21,46,695
16,16,2,2,27,23,50,695
17,17,0,1,27,24,51,695
18,18,0,0,27,24,51,695
0,0,1,0,1,0,1,696
1,1,0,0,1,0,1,696
0,0,1,0,1,0,1,697
1,1,2,0,3,0,3,697
2,2,2,0,5,0,5,697
3,3,2,1,7,1,8,697
4,4,0,2,7,3,10,697
5,5,0,0,7,3,10,697
0,0,1,0,1,0,1,698
1,1,0,0,1,0,1,698
0,0,1,0,1,0,1,699
1,1,0,0,1,0,1,699
0,0,1,0,1,0,1,700
1,1,2,0,3,0,3,700
2,2,0,0,3,0,3,700
0,0,1,0,1,0,1,701
1,1,0,0,1,0,1,701
0,0,1,0,1,0,1,702
1,1,2,0,3,0,3,702
2,2,0,0,3,0,3,702
0,0,1,0,1,0,1,703
1,1,0,0,1,0,1,703
0,0,1,0,1,0,1,704
1,1,0,0,1,0,1,704
0,0,1,0,1,0,1,705
1,1,1,0,2,0,2,705
2,2,1,0,3,0,3,705
3,3,0,0,3,0,3,705
0,0,1,0,1,0,1,706
1,1,1,0,2,0,2,706
2,2,2,0,4,0,4,706
3,3,1,0,5,0,5,706
4,4,0,0,5,0,5,706
0,0,1,0,1,0,1,707
1,1,0,0,1,0,1,707
0,0,1,0,1,0,1,708
1,1,0,0,1,0,1,708
0,0,1,0,1,0,1,709
1,1,0,1,1,1,2,709
2,2,0,3,1,4,5,709
3,3,0,2,1,6,7,709
4,4,1,2,2,8,10,709
5,5,1,1,3,9,12,709
6,6,1,0,4,9,13,709
7,7,4,0,8,9,17,709
8,8,2,0,10,9,19,709
9,9,2,1,12,10,22,709
10,10,1,1,13,11,24,709
11,11,0,0,13,11,24,709
0,0,1,0,1,0,1,710
1,1,2,0,3,0,3,710
2,2,1,0,4,0,4,710
3,3,1,0,5,0,5,710
4,4,0,2,5,2,7,710
5,5,0,2,5,4,9,710
6,6,0,2,5,6,11,710
7,7,0,0,5,6,11,710
0,0,1,0,1,0,1,711
1,1,1,1,2,1,3,711
2,2,1,2,3,3,6,711
3,3,1,2,4,5,9,711
4,4,1,4,5,9,14,711
5,5,0,4,5,13,18,711
6,6,0,2,5,15,20,711
7,7,1,0,6,15,21,711
8,8,1,0,7,15,22,711
9,9,0,0,7,15,22,711
0,0,1,0,1,0,1,712
1,1,1,0,2,0,2,712
2,2,0,1,2,1,3,712
3,3,0,2,2,3,5,712
4,4,1,1,3,4,7,712
5,5,0,0,3,4,7,712
0,0,1,0,1,0,1,713
1,1,0,0,1,0,1,713
0,0,1,0,1,0,1,714
1,1,1,0,2,0,2,714
2,2,0,0,2,0,2,714
0,0,1,0,1,0,1,715
1,1,1,0,2,0,2,715
2,2,0,0,2,0,2,715
0,0,1,0,1,0,1,716
1,1,0,0,1,0,1,716
0,0,1,0,1,0,1,717
1,1,2,0,3,0,3,717
2,2,1,0,4,0,4,717
3,3,0,1,4,1,5,717
4,4,0,0,4,1,5,717
0,0,1,0,1,0,1,718
1,1,1,0,2,0,2,718
2,2,1,1,3,1,4,718
3,3,2,1,5,2,7,718
4,4,2,3,7,5,12,718
5,5,2,3,9,8,17,718
6,6,2,3,11,11,22,718
7,7,2,4,13,15,28,718
8,8,2,4,15,19,34,718
9,9,0,4,15,23,38,718
10,10,2,1,17,24,41,718
11,11,1,1,18,25,43,718
12,12,3,0,21,25,46,718
13,13,0,0,21,25,46,718
0,0,1,0,1,0,1,719
1,1,1,0,2,0,2,719
2,2,0,0,2,0,2,719
0,0,1,0,1,0,1,720
1,1,0,0,1,0,1,720
0,0,1,0,1,0,1,721
1,1,0,0,1,0,1,721
0,0,1,0,1,0,1,722
1,1,0,1,1,1,2,722
2,2,0,0,1,1,2,722
0,0,1,0,1,0,1,723
1,1,0,0,1,0,1,723
0,0,1,0,1,0,1,724
1,1,1,0,2,0,2,724
2,2,2,0,4,0,4,724
3,3,2,1,6,1,7,724
4,4,2,0,8,1,9,724
5,5,3,1,11,2,13,724
6,6,1,2,12,4,16,724
7,7,0,2,12,6,18,724
8,8,0,1,12,7,19,724
9,9,0,1,12,8,20,724
10,10,0,1,12,9,21,724
11,11,0,2,12,11,23,724
12,12,1,1,13,12,25,724
13,13,2,1,15,13,28,724
14,14,0,1,15,14,29,724
15,15,0,2,15,16,31,724
16,16,0,5,15,21,36,724
17,17,1,6,16,27,43,724
18,18,0,4,16,31,47,724
19,19,1,8,17,39,56,724
20,20,2,3,19,42,61,724
21,21,1,2,20,44,64,724
22,22,0,1,20,45,65,724
23,23,0,1,20,46,66,724
24,24,0,1,20,47,67,724
25,25,0,0,20,47,67,724
0,0,1,0,1,0,1,725
1,1,0,0,1,0,1,725
0,0,1,0,1,0,1,726
1,1,0,0,1,0,1,726
0,0,1,0,1,0,1,727
1,1,0,0,1,0,1,727
0,0,1,0,1,0,1,728
1,1,0,0,1,0,1,728
0,0,1,0,1,0,1,729
1,1,1,0,2,0,2,729
2,2,2,0,4,0,4,729
3,3,0,0,4,0,4,729
0,0,1,0,1,0,1,730
1,1,0,1,1,1,2,730
2,2,0,1,1,2,3,730
3,3,0,2,1,4,5,730
4,4,0,1,1,5,6,730
5,5,0,1,1,6,7,730
6,6,1,0,2,6,8,730
7,7,1,0,3,6,9,730
8,8,1,0,4,6,10,730
9,9,0,0,4,6,10,730
0,0,1,0,1,0,1,731
1,1,1,0,2,0,2,731
2,2,0,0,2,0,2,731
0,0,1,0,1,0,1,732
1,1,0,0,1,0,1,732
0,0,1,0,1,0,1,733
1,1,0,0,1,0,1,733
0,0,1,0,1,0,1,734
1,1,1,0,2,0,2,734
2,2,0,0,2,0,2,734
0,0,1,0,1,0,1,735
1,1,0,0,1,0,1,735
0,0,1,0,1,0,1,736
1,1,1,0,2,0,2,736
2,2,1,0,3,0,3,736
3,3,1,0,4,0,4,736
4,4,1,0,5,0,5,736
5,5,1,0,6,0,6,736
6,6,2,0,8,0,8,736
7,7,5,0,13,0,13,736
8,8,5,0,18,0,18,736
9,9,3,2,21,2,23,736
10,10,1,1,22,3,25,736
11,11,1,0,23,3,26,736
12,12,0,0,23,3,26,736
0,0,1,0,1,0,1,737
1,1,1,0,2,0,2,737
2,2,0,1,2,1,3,737
3,3,0,1,2,2,4,737
4,4,0,0,2,2,4,737
0,0,1,0,1,0,1,738
1,1,0,0,1,0,1,738
0,0,1,0,1,0,1,739
1,1,0,1,1,1,2,739
2,2,0,0,1,1,2,739
0,0,1,0,1,0,1,740
1,1,1,0,2,0,2,740
2,2,0,0,2,0,2,740
0,0,1,0,1,0,1,741
1,1,0,1,1,1,2,741
2,2,2,0,3,1,4,741
3,3,3,0,6,1,7,741
4,4,0,0,6,1,7,741
0,0,1,0,1,0,1,742
1,1,3,0,4,0,4,742
2,2,3,0,7,0,7,742
3,3,2,1,9,1,10,742
4,4,0,1,9,2,11,742
5,5,0,0,9,2,11,742
0,0,1,0,1,0,1,743
1,1,0,0,1,0,1,743
0,0,1,0,1,0,1,744
1,1,1,1,2,1,3,744
2,2,0,1,2,2,4,744
3,3,0,0,2,2,4,744
0,0,1,0,1,0,1,745
1,1,1,0,2,0,2,745
2,2,1,0,3,0,3,745
3,3,0,0,3,0,3,745
0,0,1,0,1,0,1,746
1,1,1,0,2,0,2,746
2,2,0,0,2,0,2,746
0,0,1,0,1,0,1,747
1,1,0,0,1,0,1,747
0,0,1,0,1,0,1,748
1,1,0,0,1,0,1,748
0,0,1,0,1,0,1,749
1,1,2,0,3,0,3,749
2,2,1,1,4,1,5,749
3,3,0,1,4,2,6,749
4,4,0,1,4,3,7,749
5,5,0,0,4,3,7,749
0,0,1,0,1,0,1,750
1,1,0,0,1,0,1,750
0,0,1,0,1,0,1,751
1,1,0,0,1,0,1,751
0,0,1,0,1,0,1,752
1,1,1,0,2,0,2,752
2,2,0,0,2,0,2,752
0,0,1,0,1,0,1,753
1,1,0,0,1,0,1,753
0,0,1,0,1,0,1,754
1,1,3,0,4,0,4,754
2,2,2,1,6,1,7,754
3,3,1,2,7,3,10,754
4,4,0,3,7,6,13,754
5,5,1,1,8,7,15,754
6,6,1,1,9,8,17,754
7,7,0,0,9,8,17,754
0,0,1,0,1,0,1,755
1,1,2,0,3,0,3,755
2,2,0,0,3,0,3,755
0,0,1,0,1,0,1,756
1,1,2,0,3,0,3,756
2,2,1,1,4,1,5,756
3,3,2,2,6,3,9,756
4,4,1,3,7,6,13,756
5,5,1,2,8,8,16,756
6,6,0,1,8,9,17,756
7,7,0,0,8,9,17,756
0,0,1,0,1,0,1,757
1,1,1,2,2,2,4,757
2,2,0,5,2,7,9,757
3,3,0,10,2,17,19,757
4,4,1,13,3,30,33,757
5,5,1,10,4,40,44,757
6,6,0,7,4,47,51,757
7,7,0,4,4,51,55,757
8,8,1,2,5,53,58,757
9,9,2,2,7,55,62,757
10,10,5,4,12,59,71,757
11,11,1,5,13,64,77,757
12,12,2,5,15,69,84,757
13,13,2,6,17,75,92,757
14,14,3,2,20,77,97,757
15,15,3,2,23,79,102,757
16,16,1,0,24,79,103,757
17,17,1,0,25,79,104,757
18,18,1,0,26,79,105,757
19,19,0,0,26,79,105,757
0,0,1,0,1,0,1,758
1,1,0,0,1,0,1,758
0,0,1,0,1,0,1,759
1,1,0,1,1,1,2,759
2,2,0,2,1,3,4,759
3,3,0,1,1,4,5,759
4,4,0,1,1,5,6,759
5,5,0,1,1,6,7,759
6,6,0,2,1,8,9,759
7,7,1,1,2,9,11,759
8,8,1,0,3,9,12,759
9,9,1,1,4,10,14,759
10,10,0,0,4,10,14,759
0,0,1,0,1,0,1,760
1,1,2,0,3,0,3,760
2,2,1,0,4,0,4,760
3,3,1,0,5,0,5,760
4,4,0,0,5,0,5,760
0,0,1,0,1,0,1,761
1,1,1,0,2,0,2,761
2,2,1,0,3,0,3,761
3,3,2,1,5,1,6,761
4,4,3,1,8,2,10,761
5,5,3,3,11,5,16,761
6,6,0,4,11,9,20,761
7,7,1,0,12,9,21,761
8,8,1,0,13,9,22,761
9,9,0,0,13,9,22,761
0,0,1,0,1,0,1,762
1,1,1,1,2,1,3,762
2,2,3,1,5,2,7,762
3,3,2,2,7,4,11,762
4,4,2,1,9,5,14,762
5,5,2,1,11,6,17,762
6,6,1,0,12,6,18,762
7,7,0,1,12,7,19,762
8,8,0,3,12,10,22,762
9,9,0,3,12,13,25,762
10,10,0,1,12,14,26,762
11,11,0,1,12,15,27,762
12,12,0,0,12,15,27,762
0,0,1,0,1,0,1,763
1,1,0,0,1,0,1,763
0,0,1,0,1,0,1,764
1,1,2,0,3,0,3,764
2,2,1,0,4,0,4,764
3,3,0,0,4,0,4,764
0,0,1,0,1,0,1,765
1,1,0,0,1,0,1,765
0,0,1,0,1,0,1,766
1,1,1,0,2,0,2,766
2,2,1,0,3,0,3,766
3,3,0,0,3,0,3,766
0,0,1,0,1,0,1,767
1,1,0,0,1,0,1,767
0,0,1,0,1,0,1,768
1,1,1,0,2,0,2,768
2,2,3,0,5,0,5,768
3,3,2,0,7,0,7,768
4,4,4,0,11,0,11,768
5,5,2,2,13,2,15,768
6,6,1,2,14,4,18,768
7,7,1,1,15,5,20,768
8,8,2,0,17,5,22,768
9,9,1,1,18,6,24,768
10,10,1,0,19,6,25,768
11,11,2,0,21,6,27,768
12,12,0,0,21,6,27,768
0,0,1,0,1,0,1,769
1,1,2,0,3,0,3,769
2,2,0,0,3,0,3,769
0,0,1,0,1,0,1,770
1,1,0,0,1,0,1,770
0,0,1,0,1,0,1,771
1,1,0,0,1,0,1,771
0,0,1,0,1,0,1,772
1,1,0,0,1,0,1,772
0,0,1,0,1,0,1,773
1,1,1,0,2,0,2,773
2,2,1,0,3,0,3,773
3,3,0,0,3,0,3,773
0,0,1,0,1,0,1,774
1,1,1,0,2,0,2,774
2,2,2,0,4,0,4,774
3,3,1,0,5,0,5,774
4,4,0,0,5,0,5,774
0,0,1,0,1,0,1,775
1,1,2,0,3,0,3,775
2,2,0,0,3,0,3,775
0,0,1,0,1,0,1,776
1,1,1,0,2,0,2,776
2,2,2,0,4,0,4,776
3,3,5,1,9,1,10,776
4,4,5,1,14,2,16,776
5,5,2,2,16,4,20,776
6,6,1,0,17,4,21,776
7,7,0,0,17,4,21,776
0,0,1,0,1,0,1,777
1,1,0,0,1,0,1,777
0,0,1,0,1,0,1,778
1,1,1,0,2,0,2,778
2,2,1,0,3,0,3,778
3,3,0,0,3,0,3,778
0,0,1,0,1,0,1,779
1,1,2,0,3,0,3,779
2,2,2,1,5,1,6,779
3,3,3,1,8,2,10,779
4,4,2,3,10,5,15,779
5,5,1,1,11,6,17,779
6,6,0,1,11,7,18,779
7,7,0,1,11,8,19,779
8,8,1,0,12,8,20,779
9,9,1,0,13,8,21,779
10,10,0,0,13,8,21,779
0,0,1,0,1,0,1,780
1,1,0,0,1,0,1,780
0,0,1,0,1,0,1,781
1,1,0,0,1,0,1,781
0,0,1,0,1,0,1,782
1,1,0,1,1,1,2,782
2,2,1,1,2,2,4,782
3,3,0,1,2,3,5,782
4,4,0,2,2,5,7,782
5,5,0,0,2,5,7,782
0,0,1,0,1,0,1,783
1,1,0,0,1,0,1,783
0,0,1,0,1,0,1,784
1,1,0,0,1,0,1,784
0,0,1,0,1,0,1,785
1,1,3,0,4,0,4,785
2,2,1,0,5,0,5,785
3,3,0,0,5,0,5,785
0,0,1,0,1,0,1,786
1,1,1,0,2,0,2,786
2,2,0,0,2,0,2,786
0,0,1,0,1,0,1,787
1,1,1,0,2,0,2,787
2,2,0,0,2,0,2,787
0,0,1,0,1,0,1,788
1,1,1,1,2,1,3,788
2,2,0,0,2,1,3,788
0,0,1,0,1,0,1,789
1,1,1,0,2,0,2,789
2,2,3,0,5,0,5,789
3,3,4,1,9,1,10,789
4,4,1,0,10,1,11,789
5,5,0,0,10,1,11,789
0,0,1,0,1,0,1,790
1,1,0,0,1,0,1,790
0,0,1,0,1,0,1,791
1,1,1,0,2,0,2,791
2,2,2,0,4,0,4,791
3,3,3,0,7,0,7,791
4,4,4,2,11,2,13,791
5,5,6,5,17,7,24,791
6,6,1,8,18,15,33,791
7,7,1,4,19,19,38,791
8,8,2,3,21,22,43,791
9,9,2,1,23,23,46,791
10,10,1,1,24,24,48,791
11,11,1,1,25,25,50,791
12,12,1,0,26,25,51,791
13,13,2,0,28,25,53,791
14,14,2,0,30,25,55,791
15,15,4,1,34,26,60,791
16,16,2,0,36,26,62,791
17,17,2,0,38,26,64,791
18,18,0,0,38,26,64,791
0,0,1,0,1,0,1,792
1,1,1,0,2,0,2,792
2,2,1,0,3,0,3,792
3,3,0,0,3,0,3,792
0,0,1,0,1,0,1,793
1,1,0,0,1,0,1,793
0,0,1,0,1,0,1,794
1,1,0,0,1,0,1,794
0,0,1,0,1,0,1,795
1,1,1,0,2,0,2,795
2,2,0,1,2,1,3,795
3,3,0,0,2,1,3,795
0,0,1,0,1,0,1,796
1,1,0,1,1,1,2,796
2,2,0,0,1,1,2,796
0,0,1,0,1,0,1,797
1,1,1,0,2,0,2,797
2,2,1,0,3,0,3,797
3,3,0,0,3,0,3,797
0,0,1,0,1,0,1,798
1,1,0,0,1,0,1,798
0,0,1,0,1,0,1,799
1,1,1,0,2,0,2,799
2,2,0,0,2,0,2,799
0,0,1,0,1,0,1,800
1,1,0,0,1,0,1,800
0,0,1,0,1,0,1,801
1,1,0,0,1,0,1,801
0,0,1,0,1,0,1,802
1,1,0,0,1,0,1,802
0,0,1,0,1,0,1,803
1,1,1,0,2,0,2,803
2,2,1,0,3,0,3,803
3,3,1,1,4,1,5,803
4,4,0,2,4,3,7,803
5,5,1,0,5,3,8,803
6,6,3,0,8,3,11,803
7,7,2,0,10,3,13,803
8,8,2,0,12,3,15,803
9,9,0,2,12,5,17,803
10,10,1,0,13,5,18,803
11,11,1,0,14,5,19,803
12,12,2,0,16,5,21,803
13,13,3,0,19,5,24,803
14,14,2,0,21,5,26,803
15,15,5,1,26,6,32,803
16,16,2,0,28,6,34,803
17,17,1,0,29,6,35,803
18,18,1,0,30,6,36,803
19,19,0,0,30,6,36,803
0,0,1,0,1,0,1,804
1,1,1,0,2,0,2,804
2,2,0,0,2,0,2,804
0,0,1,0,1,0,1,805
1,1,0,0,1,0,1,805
0,0,1,0,1,0,1,806
1,1,0,1,1,1,2,806
2,2,0,2,1,3,4,806
3,3,0,2,1,5,6,806
4,4,1,1,2,6,8,806
5,5,1,1,3,7,10,806
6,6,0,1,3,8,11,806
7,7,0,0,3,8,11,806
0,0,1,0,1,0,1,807
1,1,0,1,1,1,2,807
2,2,0,0,1,1,2,807
0,0,1,0,1,0,1,808
1,1,2,0,3,0,3,808
2,2,2,0,5,0,5,808
3,3,1,0,6,0,6,808
4,4,2,0,8,0,8,808
5,5,1,0,9,0,9,808
6,6,1,0,10,0,10,808
7,7,1,0,11,0,11,808
8,8,0,0,11,0,11,808
0,0,1,0,1,0,1,809
1,1,0,0,1,0,1,809
0,0,1,0,1,0,1,810
1,1,0,0,1,0,1,810
0,0,1,0,1,0,1,811
1,1,0,0,1,0,1,811
0,0,1,0,1,0,1,812
1,1,2,0,3,0,3,812
2,2,2,1,5,1,6,812
3,3,0,0,5,1,6,812
0,0,1,0,1,0,1,813
1,1,0,1,1,1,2,813
2,2,0,0,1,1,2,813
0,0,1,0,1,0,1,814
1,1,1,2,2,2,4,814
2,2,0,3,2,5,7,814
3,3,2,1,4,6,10,814
4,4,2,0,6,6,12,814
5,5,0,0,6,6,12,814
0,0,1,0,1,0,1,815
1,1,0,0,1,0,1,815
0,0,1,0,1,0,1,816
1,1,0,0,1,0,1,816
0,0,1,0,1,0,1,817
1,1,0,0,1,0,1,817
0,0,1,0,1,0,1,818
1,1,2,0,3,0,3,818
2,2,2,0,5,0,5,818
3,3,2,1,7,1,8,818
4,4,0,1,7,2,9,818
5,5,0,0,7,2,9,818
0,0,1,0,1,0,1,819
1,1,2,0,3,0,3,819
2,2,2,0,5,0,5,819
3,3,0,0,5,0,5,819
0,0,1,0,1,0,1,820
1,1,0,0,1,0,1,820
0,0,1,0,1,0,1,821
1,1,0,0,1,0,1,821
0,0,1,0,1,0,1,822
1,1,0,0,1,0,1,822
0,0,1,0,1,0,1,823
1,1,2,0,3,0,3,823
2,2,3,0,6,0,6,823
3,3,3,0,9,0,9,823
4,4,2,0,11,0,11,823
5,5,1,0,12,0,12,823
6,6,0,0,12,0,12,823
0,0,1,0,1,0,1,824
1,1,2,0,3,0,3,824
2,2,1,0,4,0,4,824
3,3,1,0,5,0,5,824
4,4,1,1,6,1,7,824
5,5,0,3,6,4,10,824
6,6,3,4,9,8,17,824
7,7,0,5,9,13,22,824
8,8,0,2,9,15,24,824
9,9,0,2,9,17,26,824
10,10,0,3,9,20,29,824
11,11,0,3,9,23,32,824
12,12,0,3,9,26,35,824
13,13,1,2,10,28,38,824
14,14,1,2,11,30,41,824
15,15,0,1,11,31,42,824
16,16,1,1,12,32,44,824
17,17,1,0,13,32,45,824
18,18,1,0,14,32,46,824
19,19,1,0,15,32,47,824
20,20,1,0,16,32,48,824
21,21,0,0,16,32,48,824
0,0,1,0,1,0,1,825
1,1,1,0,2,0,2,825
2,2,2,0,4,0,4,825
3,3,0,0,4,0,4,825
0,0,1,0,1,0,1,826
1,1,2,0,3,0,3,826
2,2,3,0,6,0,6,826
3,3,2,0,8,0,8,826
4,4,0,1,8,1,9,826
5,5,0,1,8,2,10,826
6,6,0,0,8,2,10,826
0,0,1,0,1,0,1,827
1,1,2,2,3,2,5,827
2,2,1,1,4,3,7,827
3,3,1,2,5,5,10,827
4,4,0,2,5,7,12,827
5,5,0,2,5,9,14,827
6,6,2,1,7,10,17,827
7,7,1,1,8,11,19,827
8,8,0,0,8,11,19,827
0,0,1,0,1,0,1,828
1,1,0,0,1,0,1,828
0,0,1,0,1,0,1,829
1,1,0,1,1,1,2,829
2,2,0,2,1,3,4,829
3,3,0,3,1,6,7,829
4,4,2,1,3,7,10,829
5,5,1,2,4,9,13,829
6,6,3,0,7,9,16,829
7,7,0,1,7,10,17,829
8,8,0,2,7,12,19,829
9,9,0,4,7,16,23,829
10,10,0,2,7,18,25,829
11,11,0,2,7,20,27,829
12,12,1,0,8,20,28,829
13,13,2,1,10,21,31,829
14,14,2,3,12,24,36,829
15,15,1,6,13,30,43,829
16,16,4,5,17,35,52,829
17,17,4,5,21,40,61,829
18,18,1,5,22,45,67,829
19,19,0,3,22,48,70,829
20,20,0,2,22,50,72,829
21,21,2,1,24,51,75,829
22,22,2,1,26,52,78,829
23,23,3,1,29,53,82,829
24,24,5,1,34,54,88,829
25,25,1,1,35,55,90,829
26,26,1,0,36,55,91,829
27,27,0,0,36,55,91,829
0,0,1,0,1,0,1,830
1,1,2,0,3,0,3,830
2,2,3,0,6,0,6,830
3,3,3,1,9,1,10,830
4,4,3,1,12,2,14,830
5,5,7,1,19,3,22,830
6,6,5,3,24,6,30,830
7,7,5,5,29,11,40,830
8,8,5,5,34,16,50,830
9,9,4,7,38,23,61,830
10,10,7,4,45,27,72,830
11,11,6,7,51,34,85,830
12,12,4,3,55,37,92,830
13,13,9,5,64,42,106,830
14,14,4,10,68,52,120,830
15,15,9,9,77,61,138,830
16,16,9,12,86,73,159,830
17,17,16,7,102,80,182,830
18,18,12,9,114,89,203,830
19,19,8,7,122,96,218,830
20,20,10,2,132,98,230,830
21,21,10,5,142,103,245,830
22,22,7,3,149,106,255,830
23,23,7,3,156,109,265,830
24,24,6,3,162,112,274,830
25,25,4,4,166,116,282,830
26,26,3,1,169,117,286,830
27,27,3,3,172,120,292,830
28,28,1,5,173,125,298,830
29,29,1,7,174,132,306,830
30,30,2,4,176,136,312,830
31,31,5,5,181,141,322,830
32,32,3,4,184,145,329,830
33,33,2,3,186,148,334,830
34,34,1,4,187,152,339,830
35,35,0,3,187,155,342,830
36,36,1,3,188,158,346,830
37,37,0,0,188,158,346,830
0,0,1,0,1,0,1,831
1,1,1,0,2,0,2,831
2,2,1,0,3,0,3,831
3,3,0,0,3,0,3,831
0,0,1,0,1,0,1,832
1,1,0,1,1,1,2,832
2,2,0,3,1,4,5,832
3,3,0,2,1,6,7,832
4,4,1,2,2,8,10,832
5,5,1,2,3,10,13,832
6,6,0,0,3,10,13,832
0,0,1,0,1,0,1,833
1,1,1,0,2,0,2,833
2,2,0,0,2,0,2,833
0,0,1,0,1,0,1,834
1,1,1,0,2,0,2,834
2,2,0,0,2,0,2,834
0,0,1,0,1,0,1,835
1,1,1,0,2,0,2,835
2,2,3,0,5,0,5,835
3,3,3,1,8,1,9,835
4,4,3,1,11,2,13,835
5,5,3,4,14,6,20,835
6,6,2,2,16,8,24,835
7,7,2,0,18,8,26,835
8,8,2,0,20,8,28,835
9,9,4,0,24,8,32,835
10,10,3,0,27,8,35,835
11,11,1,0,28,8,36,835
12,12,2,0,30,8,38,835
13,13,1,0,31,8,39,835
14,14,0,0,31,8,39,835
0,0,1,0,1,0,1,836
1,1,2,0,3,0,3,836
2,2,1,0,4,0,4,836
3,3,0,0,4,0,4,836
0,0,1,0,1,0,1,837
1,1,1,0,2,0,2,837
2,2,1,0,3,0,3,837
3,3,1,0,4,0,4,837
4,4,3,0,7,0,7,837
5,5,0,0,7,0,7,837
0,0,1,0,1,0,1,838
1,1,0,0,1,0,1,838
0,0,1,0,1,0,1,839
1,1,1,0,2,0,2,839
2,2,2,0,4,0,4,839
3,3,0,0,4,0,4,839
0,0,1,0,1,0,1,840
1,1,4,0,5,0,5,840
2,2,1,2,6,2,8,840
3,3,2,3,8,5,13,840
4,4,1,1,9,6,15,840
5,5,2,1,11,7,18,840
6,6,2,1,13,8,21,840
7,7,0,3,13,11,24,840
8,8,1,3,14,14,28,840
9,9,1,3,15,17,32,840
10,10,1,2,16,19,35,840
11,11,2,1,18,20,38,840
12,12,1,1,19,21,40,840
13,13,1,0,20,21,41,840
14,14,1,0,21,21,42,840
15,15,0,0,21,21,42,840
0,0,1,0,1,0,1,841
1,1,0,0,1,0,1,841
0,0,1,0,1,0,1,842
1,1,0,0,1,0,1,842
0,0,1,0,1,0,1,843
1,1,1,0,2,0,2,843
2,2,1,0,3,0,3,843
3,3,1,0,4,0,4,843
4,4,1,0,5,0,5,843
5,5,1,0,6,0,6,843
6,6,0,0,6,0,6,843
0,0,1,0,1,0,1,844
1,1,1,0,2,0,2,844
2,2,0,0,2,0,2,844
0,0,1,0,1,0,1,845
1,1,1,1,2,1,3,845
2,2,1,0,3,1,4,845
3,3,0,1,3,2,5,845
4,4,0,0,3,2,5,845
0,0,1,0,1,0,1,846
1,1,0,0,1,0,1,846
0,0,1,0,1,0,1,847
1,1,0,0,1,0,1,847
0,0,1,0,1,0,1,848
1,1,0,0,1,0,1,848
0,0,1,0,1,0,1,849
1,1,1,0,2,0,2,849
2,2,0,1,2,1,3,849
3,3,0,0,2,1,3,849
0,0,1,0,1,0,1,850
1,1,3,0,4,0,4,850
2,2,1,0,5,0,5,850
3,3,1,0,6,0,6,850
4,4,0,1,6,1,7,850
5,5,0,1,6,2,8,850
6,6,0,1,6,3,9,850
7,7,0,0,6,3,9,850
0,0,1,0,1,0,1,851
1,1,3,0,4,0,4,851
2,2,2,1,6,1,7,851
3,3,2,2,8,3,11,851
4,4,2,1,10,4,14,851
5,5,0,1,10,5,15,851
6,6,0,0,10,5,15,851
0,0,1,0,1,0,1,852
1,1,1,0,2,0,2,852
2,2,0,0,2,0,2,852
0,0,1,0,1,0,1,853
1,1,1,0,2,0,2,853
2,2,1,2,3,2,5,853
3,3,2,1,5,3,8,853
4,4,1,1,6,4,10,853
5,5,1,0,7,4,11,853
6,6,0,0,7,4,11,853
0,0,1,0,1,0,1,854
1,1,1,0,2,0,2,854
2,2,0,1,2,1,3,854
3,3,0,1,2,2,4,854
4,4,0,1,2,3,5,854
5,5,1,3,3,6,9,854
6,6,2,2,5,8,13,854
7,7,0,2,5,10,15,854
8,8,0,0,5,10,15,854
0,0,1,0,1,0,1,855
1,1,0,0,1,0,1,855
0,0,1,0,1,0,1,856
1,1,0,0,1,0,1,856
0,0,1,0,1,0,1,857
1,1,2,0,3,0,3,857
2,2,0,0,3,0,3,857
0,0,1,0,1,0,1,858
1,1,0,0,1,0,1,858
0,0,1,0,1,0,1,859
1,1,1,1,2,1,3,859
2,2,0,1,2,2,4,859
3,3,0,2,2,4,6,859
4,4,0,3,2,7,9,859
5,5,0,3,2,10,12,859
6,6,0,1,2,11,13,859
7,7,1,1,3,12,15,859
8,8,1,1,4,13,17,859
9,9,0,2,4,15,19,859
10,10,0,1,4,16,20,859
11,11,0,0,4,16,20,859
0,0,1,0,1,0,1,860
1,1,2,1,3,1,4,860
2,2,3,3,6,4,10,860
3,3,2,1,8,5,13,860
4,4,3,2,11,7,18,860
5,5,5,1,16,8,24,860
6,6,3,3,19,11,30,860
7,7,5,1,24,12,36,860
8,8,4,3,28,15,43,860
9,9,2,4,30,19,49,860
10,10,1,3,31,22,53,860
11,11,1,3,32,25,57,860
12,12,0,4,32,29,61,860
13,13,0,3,32,32,64,860
14,14,2,3,34,35,69,860
15,15,0,0,34,35,69,860
0,0,1,0,1,0,1,861
1,1,0,0,1,0,1,861
0,0,1,0,1,0,1,862
1,1,0,0,1,0,1,862
0,0,1,0,1,0,1,863
1,1,2,0,3,0,3,863
2,2,1,1,4,1,5,863
3,3,1,4,5,5,10,863
4,4,1,3,6,8,14,863
5,5,5,1,11,9,20,863
6,6,4,3,15,12,27,863
7,7,10,0,25,12,37,863
8,8,6,1,31,13,44,863
9,9,4,3,35,16,51,863
10,10,8,8,43,24,67,863
11,11,15,3,58,27,85,863
12,12,7,3,65,30,95,863
13,13,5,3,70,33,103,863
14,14,13,5,83,38,121,863
15,15,12,8,95,46,141,863
16,16,13,12,108,58,166,863
17,17,6,5,114,63,177,863
18,18,4,7,118,70,188,863
19,19,4,6,122,76,198,863
20,20,4,3,126,79,205,863
21,21,7,0,133,79,212,863
22,22,6,0,139,79,218,863
23,23,2,1,141,80,221,863
24,24,2,1,143,81,224,863
25,25,0,1,143,82,225,863
26,26,0,1,143,83,226,863
27,27,0,1,143,84,227,863
28,28,0,1,143,85,228,863
29,29,1,2,144,87,231,863
30,30,2,2,146,89,235,863
31,31,1,0,147,89,236,863
32,32,1,0,148,89,237,863
33,33,1,0,149,89,238,863
34,34,0,1,149,90,239,863
35,35,0,0,149,90,239,863
0,0,1,0,1,0,1,864
1,1,0,0,1,0,1,864
0,0,1,0,1,0,1,865
1,1,2,0,3,0,3,865
2,2,2,1,5,1,6,865
3,3,3,2,8,3,11,865
4,4,2,1,10,4,14,865
5,5,0,0,10,4,14,865
0,0,1,0,1,0,1,866
1,1,0,0,1,0,1,866
0,0,1,0,1,0,1,867
1,1,1,0,2,0,2,867
2,2,1,0,3,0,3,867
3,3,0,1,3,1,4,867
4,4,0,2,3,3,6,867
5,5,2,2,5,5,10,867
6,6,2,1,7,6,13,867
7,7,2,2,9,8,17,867
8,8,1,2,10,10,20,867
9,9,1,2,11,12,23,867
10,10,1,1,12,13,25,867
11,11,1,1,13,14,27,867
12,12,0,2,13,16,29,867
13,13,0,3,13,19,32,867
14,14,0,4,13,23,36,867
15,15,0,2,13,25,38,867
16,16,0,0,13,25,38,867
0,0,1,0,1,0,1,868
1,1,0,0,1,0,1,868
0,0,1,0,1,0,1,869
1,1,2,1,3,1,4,869
2,2,1,3,4,4,8,869
3,3,0,1,4,5,9,869
4,4,0,0,4,5,9,869
0,0,1,0,1,0,1,870
1,1,0,0,1,0,1,870
0,0,1,0,1,0,1,871
1,1,0,0,1,0,1,871
0,0,1,0,1,0,1,872
1,1,2,0,3,0,3,872
2,2,2,0,5,0,5,872
3,3,0,1,5,1,6,872
4,4,0,2,5,3,8,872
5,5,0,0,5,3,8,872
0,0,1,0,1,0,1,873
1,1,0,0,1,0,1,873
0,0,1,0,1,0,1,874
1,1,0,0,1,0,1,874
0,0,1,0,1,0,1,875
1,1,1,0,2,0,2,875
2,2,0,0,2,0,2,875
0,0,1,0,1,0,1,876
1,1,0,0,1,0,1,876
0,0,1,0,1,0,1,877
1,1,2,0,3,0,3,877
2,2,0,0,3,0,3,877
0,0,1,0,1,0,1,878
1,1,1,0,2,0,2,878
2,2,1,0,3,0,3,878
3,3,2,0,5,0,5,878
4,4,1,1,6,1,7,878
5,5,0,4,6,5,11,878
6,6,1,5,7,10,17,878
7,7,4,3,11,13,24,878
8,8,3,2,14,15,29,878
9,9,3,4,17,19,36,878
10,10,4,2,21,21,42,878
11,11,4,3,25,24,49,878
12,12,5,3,30,27,57,878
13,13,3,4,33,31,64,878
14,14,1,5,34,36,70,878
15,15,1,5,35,41,76,878
16,16,3,6,38,47,85,878
17,17,3,7,41,54,95,878
18,18,4,4,45,58,103,878
19,19,2,4,47,62,109,878
20,20,1,1,48,63,111,878
21,21,0,3,48,66,114,878
22,22,1,3,49,69,118,878
23,23,2,3,51,72,123,878
24,24,2,3,53,75,128,878
25,25,4,1,57,76,133,878
26,26,3,1,60,77,137,878
27,27,2,2,62,79,141,878
28,28,2,3,64,82,146,878
29,29,4,1,68,83,151,878
30,30,3,3,71,86,157,878
31,31,5,1,76,87,163,878
32,32,2,1,78,88,166,878
33,33,2,1,80,89,169,878
34,34,2,1,82,90,172,878
35,35,0,1,82,91,173,878
36,36,0,0,82,91,173,878
0,0,1,0,1,0,1,879
1,1,0,0,1,0,1,879
0,0,1,0,1,0,1,880
1,1,0,0,1,0,1,880
0,0,1,0,1,0,1,881
1,1,3,1,4,1,5,881
2,2,1,3,5,4,9,881
3,3,1,2,6,6,12,881
4,4,1,4,7,10,17,881
5,5,2,1,9,11,20,881
6,6,0,4,9,15,24,881
7,7,1,1,10,16,26,881
8,8,1,2,11,18,29,881
9,9,1,3,12,21,33,881
10,10,1,1,13,22,35,881
11,11,1,3,14,25,39,881
12,12,0,1,14,26,40,881
13,13,1,1,15,27,42,881
14,14,1,0,16,27,43,881
15,15,0,0,16,27,43,881
0,0,1,0,1,0,1,882
1,1,1,0,2,0,2,882
2,2,1,0,3,0,3,882
3,3,1,0,4,0,4,882
4,4,0,0,4,0,4,882
0,0,1,0,1,0,1,883
1,1,1,0,2,0,2,883
2,2,0,0,2,0,2,883
0,0,1,0,1,0,1,884
1,1,2,0,3,0,3,884
2,2,1,0,4,0,4,884
3,3,1,0,5,0,5,884
4,4,0,0,5,0,5,884
0,0,1,0,1,0,1,885
1,1,2,0,3,0,3,885
2,2,4,0,7,0,7,885
3,3,0,1,7,1,8,885
4,4,0,2,7,3,10,885
5,5,1,1,8,4,12,885
6,6,0,0,8,4,12,885
0,0,1,0,1,0,1,886
1,1,2,0,3,0,3,886
2,2,2,0,5,0,5,886
3,3,4,0,9,0,9,886
4,4,4,0,13,0,13,886
5,5,4,1,17,1,18,886
6,6,7,0,24,1,25,886
7,7,5,5,29,6,35,886
8,8,4,7,33,13,46,886
9,9,6,8,39,21,60,886
10,10,10,6,49,27,76,886
11,11,13,3,62,30,92,886
12,12,12,5,74,35,109,886
13,13,15,7,89,42,131,886
14,14,11,6,100,48,148,886
15,15,12,9,112,57,169,886
16,16,12,7,124,64,188,886
17,17,7,7,131,71,202,886
18,18,7,2,138,73,211,886
19,19,6,2,144,75,219,886
20,20,4,3,148,78,226,886
21,21,6,2,154,80,234,886
22,22,4,5,158,85,243,886
23,23,6,6,164,91,255,886
24,24,7,4,171,95,266,886
25,25,4,1,175,96,271,886
26,26,0,0,175,96,271,886
0,0,1,0,1,0,1,887
1,1,0,1,1,1,2,887
2,2,0,1,1,2,3,887
3,3,0,2,1,4,5,887
4,4,0,2,1,6,7,887
5,5,1,2,2,8,10,887
6,6,0,1,2,9,11,887
7,7,0,1,2,10,12,887
8,8,0,2,2,12,14,887
9,9,0,2,2,14,16,887
10,10,0,1,2,15,17,887
11,11,1,2,3,17,20,887
12,12,2,5,5,22,27,887
13,13,1,6,6,28,34,887
14,14,1,6,7,34,41,887
15,15,0,8,7,42,49,887
16,16,2,7,9,49,58,887
17,17,4,6,13,55,68,887
18,18,3,6,16,61,77,887
19,19,2,6,18,67,85,887
20,20,2,6,20,73,93,887
21,21,4,6,24,79,103,887
22,22,4,4,28,83,111,887
23,23,4,5,32,88,120,887
24,24,2,5,34,93,127,887
25,25,1,2,35,95,130,887
26,26,4,3,39,98,137,887
27,27,8,1,47,99,146,887
28,28,8,2,55,101,156,887
29,29,3,3,58,104,162,887
30,30,8,2,66,106,172,887
31,31,9,4,75,110,185,887
32,32,5,5,80,115,195,887
33,33,2,5,82,120,202,887
34,34,0,3,82,123,205,887
35,35,0,5,82,128,210,887
36,36,0,6,82,134,216,887
37,37,1,4,83,138,221,887
38,38,2,2,85,140,225,887
39,39,1,0,86,140,226,887
40,40,0,0,86,140,226,887
0,0,1,0,1,0,1,888
1,1,3,0,4,0,4,888
2,2,6,0,10,0,10,888
3,3,4,0,14,0,14,888
4,4,2,1,16,1,17,888
5,5,3,1,19,2,21,888
6,6,4,1,23,3,26,888
7,7,2,1,25,4,29,888
8,8,1,1,26,5,31,888
9,9,1,0,27,5,32,888
10,10,1,0,28,5,33,888
11,11,1,0,29,5,34,888
12,12,1,1,30,6,36,888
13,13,0,0,30,6,36,888
0,0,1,0,1,0,1,889
1,1,3,0,4,0,4,889
2,2,2,0,6,0,6,889
3,3,2,0,8,0,8,889
4,4,4,0,12,0,12,889
5,5,1,2,13,2,15,889
6,6,1,1,14,3,17,889
7,7,0,0,14,3,17,889
0,0,1,0,1,0,1,890
1,1,0,0,1,0,1,890
0,0,1,0,1,0,1,891
1,1,2,0,3,0,3,891
2,2,0,1,3,1,4,891
3,3,0,0,3,1,4,891
0,0,1,0,1,0,1,892
1,1,0,0,1,0,1,892
0,0,1,0,1,0,1,893
1,1,2,0,3,0,3,893
2,2,0,0,3,0,3,893
0,0,1,0,1,0,1,894
1,1,0,0,1,0,1,894
0,0,1,0,1,0,1,895
1,1,0,0,1,0,1,895
0,0,1,0,1,0,1,896
1,1,0,0,1,0,1,896
0,0,1,0,1,0,1,897
1,1,0,0,1,0,1,897
0,0,1,0,1,0,1,898
1,1,1,0,2,0,2,898
2,2,1,0,3,0,3,898
3,3,0,1,3,1,4,898
4,4,0,0,3,1,4,898
0,0,1,0,1,0,1,899
1,1,0,1,1,1,2,899
2,2,0,0,1,1,2,899
0,0,1,0,1,0,1,900
1,1,1,0,2,0,2,900
2,2,0,1,2,1,3,900
3,3,0,0,2,1,3,900
0,0,1,0,1,0,1,901
1,1,0,0,1,0,1,901
0,0,1,0,1,0,1,902
1,1,1,1,2,1,3,902
2,2,1,4,3,5,8,902
3,3,1,5,4,10,14,902
4,4,0,4,4,14,18,902
5,5,0,3,4,17,21,902
6,6,0,2,4,19,23,902
7,7,0,1,4,20,24,902
8,8,0,0,4,20,24,902
0,0,1,0,1,0,1,903
1,1,0,0,1,0,1,903
0,0,1,0,1,0,1,904
1,1,0,0,1,0,1,904
0,0,1,0,1,0,1,905
1,1,2,0,3,0,3,905
2,2,1,0,4,0,4,905
3,3,1,0,5,0,5,905
4,4,0,0,5,0,5,905
0,0,1,0,1,0,1,906
1,1,0,0,1,0,1,906
0,0,1,0,1,0,1,907
1,1,1,0,2,0,2,907
2,2,0,0,2,0,2,907
0,0,1,0,1,0,1,908
1,1,1,0,2,0,2,908
2,2,0,0,2,0,2,908
0,0,1,0,1,0,1,909
1,1,0,2,1,2,3,909
2,2,0,2,1,4,5,909
3,3,1,0,2,4,6,909
4,4,3,0,5,4,9,909
5,5,3,0,8,4,12,909
6,6,0,2,8,6,14,909
7,7,1,1,9,7,16,909
8,8,0,0,9,7,16,909
0,0,1,0,1,0,1,910
1,1,1,0,2,0,2,910
2,2,1,0,3,0,3,910
3,3,1,0,4,0,4,910
4,4,3,1,7,1,8,910
5,5,0,2,7,3,10,910
6,6,0,1,7,4,11,910
7,7,0,0,7,4,11,910
0,0,1,0,1,0,1,911
1,1,0,2,1,2,3,911
2,2,1,2,2,4,6,911
3,3,1,1,3,5,8,911
4,4,0,2,3,7,10,911
5,5,0,1,3,8,11,911
6,6,0,0,3,8,11,911
0,0,1,0,1,0,1,912
1,1,0,0,1,0,1,912
0,0,1,0,1,0,1,913
1,1,0,0,1,0,1,913
0,0,1,0,1,0,1,914
1,1,1,0,2,0,2,914
2,2,2,0,4,0,4,914
3,3,2,1,6,1,7,914
4,4,0,4,6,5,11,914
5,5,1,0,7,5,12,914
6,6,1,0,8,5,13,914
7,7,0,0,8,5,13,914
0,0,1,0,1,0,1,915
1,1,0,1,1,1,2,915
2,2,0,1,1,2,3,915
3,3,0,1,1,3,4,915
4,4,0,3,1,6,7,915
5,5,1,2,2,8,10,915
6,6,4,1,6,9,15,915
7,7,8,0,14,9,23,915
8,8,6,3,20,12,32,915
9,9,3,4,23,16,39,915
10,10,4,4,27,20,47,915
11,11,6,4,33,24,57,915
12,12,4,5,37,29,66,915
13,13,3,3,40,32,72,915
14,14,4,2,44,34,78,915
15,15,5,4,49,38,87,915
16,16,7,2,56,40,96,915
17,17,10,4,66,44,110,915
18,18,3,7,69,51,120,915
19,19,8,4,77,55,132,915
20,20,8,5,85,60,145,915
21,21,5,6,90,66,156,915
22,22,7,6,97,72,169,915
23,23,10,3,107,75,182,915
24,24,8,2,115,77,192,915
25,25,4,3,119,80,199,915
26,26,1,3,120,83,203,915
27,27,3,4,123,87,210,915
28,28,4,1,127,88,215,915
29,29,4,4,131,92,223,915
30,30,2,2,133,94,227,915
31,31,2,2,135,96,231,915
32,32,2,4,137,100,237,915
33,33,0,3,137,103,240,915
34,34,0,2,137,105,242,915
35,35,0,1,137,106,243,915
36,36,1,1,138,107,245,915
37,37,0,1,138,108,246,915
38,38,0,0,138,108,246,915
0,0,1,0,1,0,1,916
1,1,3,0,4,0,4,916
2,2,2,0,6,0,6,916
3,3,3,0,9,0,9,916
4,4,0,1,9,1,10,916
5,5,0,1,9,2,11,916
6,6,0,0,9,2,11,916
0,0,1,0,1,0,1,917
1,1,2,1,3,1,4,917
2,2,1,2,4,3,7,917
3,3,1,2,5,5,10,917
4,4,0,2,5,7,12,917
5,5,1,1,6,8,14,917
6,6,0,0,6,8,14,917
0,0,1,0,1,0,1,918
1,1,1,0,2,0,2,918
2,2,0,0,2,0,2,918
0,0,1,0,1,0,1,919
1,1,0,0,1,0,1,919
0,0,1,0,1,0,1,920
1,1,0,0,1,0,1,920
0,0,1,0,1,0,1,921
1,1,1,0,2,0,2,921
2,2,1,0,3,0,3,921
3,3,2,0,5,0,5,921
4,4,1,1,6,1,7,921
5,5,2,0,8,1,9,921
6,6,2,0,10,1,11,921
7,7,2,0,12,1,13,921
8,8,1,1,13,2,15,921
9,9,1,1,14,3,17,921
10,10,0,1,14,4,18,921
11,11,0,1,14,5,19,921
12,12,0,0,14,5,19,921
0,0,1,0,1,0,1,922
1,1,0,1,1,1,2,922
2,2,0,1,1,2,3,922
3,3,0,2,1,4,5,922
4,4,0,1,1,5,6,922
5,5,0,1,1,6,7,922
6,6,0,2,1,8,9,922
7,7,0,1,1,9,10,922
8,8,1,0,2,9,11,922
9,9,0,0,2,9,11,922
0,0,1,0,1,0,1,923
1,1,1,0,2,0,2,923
2,2,0,0,2,0,2,923
0,0,1,0,1,0,1,924
1,1,1,0,2,0,2,924
2,2,0,0,2,0,2,924
0,0,1,0,1,0,1,925
1,1,0,0,1,0,1,925
0,0,1,0,1,0,1,926
1,1,2,1,3,1,4,926
2,2,1,2,4,3,7,926
3,3,2,5,6,8,14,926
4,4,1,0,7,8,15,926
5,5,1,0,8,8,16,926
6,6,0,0,8,8,16,926
0,0,1,0,1,0,1,927
1,1,1,0,2,0,2,927
2,2,0,0,2,0,2,927
0,0,1,0,1,0,1,928
1,1,1,0,2,0,2,928
2,2,0,0,2,0,2,928
0,0,1,0,1,0,1,929
1,1,0,0,1,0,1,929
0,0,1,0,1,0,1,930
1,1,0,0,1,0,1,930
0,0,1,0,1,0,1,931
1,1,2,0,3,0,3,931
2,2,0,2,3,2,5,931
3,3,0,1,3,3,6,931
4,4,0,0,3,3,6,931
0,0,1,0,1,0,1,932
1,1,1,0,2,0,2,932
2,2,2,0,4,0,4,932
3,3,3,0,7,0,7,932
4,4,1,0,8,0,8,932
5,5,1,0,9,0,9,932
6,6,1,1,10,1,11,932
7,7,1,2,11,3,14,932
8,8,1,3,12,6,18,932
9,9,1,3,13,9,22,932
10,10,1,2,14,11,25,932
11,11,2,2,16,13,29,932
12,12,3,0,19,13,32,932
13,13,2,3,21,16,37,932
14,14,4,2,25,18,43,932
15,15,2,2,27,20,47,932
16,16,1,1,28,21,49,932
17,17,1,1,29,22,51,932
18,18,0,1,29,23,52,932
19,19,0,0,29,23,52,932
0,0,1,0,1,0,1,933
1,1,1,0,2,0,2,933
2,2,1,0,3,0,3,933
3,3,1,0,4,0,4,933
4,4,0,1,4,1,5,933
5,5,1,1,5,2,7,933
6,6,1,0,6,2,8,933
7,7,0,0,6,2,8,933
0,0,1,0,1,0,1,934
1,1,0,0,1,0,1,934
0,0,1,0,1,0,1,935
1,1,1,0,2,0,2,935
2,2,0,0,2,0,2,935
0,0,1,0,1,0,1,936
1,1,0,0,1,0,1,936
0,0,1,0,1,0,1,937
1,1,0,0,1,0,1,937
0,0,1,0,1,0,1,938
1,1,1,0,2,0,2,938
2,2,0,1,2,1,3,938
3,3,0,1,2,2,4,938
4,4,1,1,3,3,6,938
5,5,3,0,6,3,9,938
6,6,0,1,6,4,10,938
7,7,0,1,6,5,11,938
8,8,0,1,6,6,12,938
9,9,0,0,6,6,12,938
0,0,1,0,1,0,1,939
1,1,1,0,2,0,2,939
2,2,0,0,2,0,2,939
0,0,1,0,1,0,1,940
1,1,0,0,1,0,1,940
0,0,1,0,1,0,1,941
1,1,1,0,2,0,2,941
2,2,1,1,3,1,4,941
3,3,0,2,3,3,6,941
4,4,0,0,3,3,6,941
0,0,1,0,1,0,1,942
1,1,2,0,3,0,3,942
2,2,0,0,3,0,3,942
0,0,1,0,1,0,1,943
1,1,0,0,1,0,1,943
0,0,1,0,1,0,1,944
1,1,0,0,1,0,1,944
0,0,1,0,1,0,1,945
1,1,1,0,2,0,2,945
2,2,0,2,2,2,4,945
3,3,0,1,2,3,5,945
4,4,0,1,2,4,6,945
5,5,1,3,3,7,10,945
6,6,0,4,3,11,14,945
7,7,2,4,5,15,20,945
8,8,1,2,6,17,23,945
9,9,1,0,7,17,24,945
10,10,1,0,8,17,25,945
11,11,2,1,10,18,28,945
12,12,0,0,10,18,28,945
0,0,1,0,1,0,1,946
1,1,2,1,3,1,4,946
2,2,2,2,5,3,8,946
3,3,1,1,6,4,10,946
4,4,0,0,6,4,10,946
0,0,1,0,1,0,1,947
1,1,2,0,3,0,3,947
2,2,2,2,5,2,7,947
3,3,1,4,6,6,12,947
4,4,3,5,9,11,20,947
5,5,3,6,12,17,29,947
6,6,1,5,13,22,35,947
7,7,1,2,14,24,38,947
8,8,1,4,15,28,43,947
9,9,1,4,16,32,48,947
10,10,1,5,17,37,54,947
11,11,2,6,19,43,62,947
12,12,2,2,21,45,66,947
13,13,2,0,23,45,68,947
14,14,2,0,25,45,70,947
15,15,1,2,26,47,73,947
16,16,1,2,27,49,76,947
17,17,2,1,29,50,79,947
18,18,1,1,30,51,81,947
19,19,0,0,30,51,81,947
0,0,1,0,1,0,1,948
1,1,2,0,3,0,3,948
2,2,1,2,4,2,6,948
3,3,0,2,4,4,8,948
4,4,0,0,4,4,8,948
0,0,1,0,1,0,1,949
1,1,1,0,2,0,2,949
2,2,0,0,2,0,2,949
0,0,1,0,1,0,1,950
1,1,1,0,2,0,2,950
2,2,1,0,3,0,3,950
3,3,0,0,3,0,3,950
0,0,1,0,1,0,1,951
1,1,3,0,4,0,4,951
2,2,2,3,6,3,9,951
3,3,2,3,8,6,14,951
4,4,4,3,12,9,21,951
5,5,2,3,14,12,26,951
6,6,3,3,17,15,32,951
7,7,5,2,22,17,39,951
8,8,5,2,27,19,46,951
9,9,4,0,31,19,50,951
10,10,3,2,34,21,55,951
11,11,2,1,36,22,58,951
12,12,4,0,40,22,62,951
13,13,3,0,43,22,65,951
14,14,2,0,45,22,67,951
15,15,2,1,47,23,70,951
16,16,2,1,49,24,73,951
17,17,0,2,49,26,75,951
18,18,0,0,49,26,75,951
0,0,1,0,1,0,1,952
1,1,3,0,4,0,4,952
2,2,0,0,4,0,4,952
0,0,1,0,1,0,1,953
1,1,0,0,1,0,1,953
0,0,1,0,1,0,1,954
1,1,0,0,1,0,1,954
0,0,1,0,1,0,1,955
1,1,1,0,2,0,2,955
2,2,0,0,2,0,2,955
0,0,1,0,1,0,1,956
1,1,0,0,1,0,1,956
0,0,1,0,1,0,1,957
1,1,0,0,1,0,1,957
0,0,1,0,1,0,1,958
1,1,0,0,1,0,1,958
0,0,1,0,1,0,1,959
1,1,0,0,1,0,1,959
0,0,1,0,1,0,1,960
1,1,1,0,2,0,2,960
2,2,1,0,3,0,3,960
3,3,0,0,3,0,3,960
0,0,1,0,1,0,1,961
1,1,0,0,1,0,1,961
0,0,1,0,1,0,1,962
1,1,0,0,1,0,1,962
0,0,1,0,1,0,1,963
1,1,1,0,2,0,2,963
2,2,0,0,2,0,2,963
0,0,1,0,1,0,1,964
1,1,1,0,2,0,2,964
2,2,0,0,2,0,2,964
0,0,1,0,1,0,1,965
1,1,1,0,2,0,2,965
2,2,0,0,2,0,2,965
0,0,1,0,1,0,1,966
1,1,0,0,1,0,1,966
0,0,1,0,1,0,1,967
1,1,0,1,1,1,2,967
2,2,1,0,2,1,3,967
3,3,0,0,2,1,3,967
0,0,1,0,1,0,1,968
1,1,1,1,2,1,3,968
2,2,1,3,3,4,7,968
3,3,2,3,5,7,12,968
4,4,1,5,6,12,18,968
5,5,1,7,7,19,26,968
6,6,1,9,8,28,36,968
7,7,2,6,10,34,44,968
8,8,4,3,14,37,51,968
9,9,5,3,19,40,59,968
10,10,4,2,23,42,65,968
11,11,1,2,24,44,68,968
12,12,2,3,26,47,73,968
13,13,3,1,29,48,77,968
14,14,2,2,31,50,81,968
15,15,1,1,32,51,83,968
16,16,1,2,33,53,86,968
17,17,1,4,34,57,91,968
18,18,3,2,37,59,96,968
19,19,3,4,40,63,103,968
20,20,0,3,40,66,106,968
21,21,1,3,41,69,110,968
22,22,1,1,42,70,112,968
23,23,0,0,42,70,112,968
0,0,1,0,1,0,1,969
1,1,1,0,2,0,2,969
2,2,0,0,2,0,2,969
0,0,1,0,1,0,1,970
1,1,0,0,1,0,1,970
0,0,1,0,1,0,1,971
1,1,2,0,3,0,3,971
2,2,3,0,6,0,6,971
3,3,2,0,8,0,8,971
4,4,0,0,8,0,8,971
0,0,1,0,1,0,1,972
1,1,0,0,1,0,1,972
0,0,1,0,1,0,1,973
1,1,2,0,3,0,3,973
2,2,1,0,4,0,4,973
3,3,1,0,5,0,5,973
4,4,0,0,5,0,5,973
0,0,1,0,1,0,1,974
1,1,0,0,1,0,1,974
0,0,1,0,1,0,1,975
1,1,2,0,3,0,3,975
2,2,2,0,5,0,5,975
3,3,1,0,6,0,6,975
4,4,1,0,7,0,7,975
5,5,0,0,7,0,7,975
0,0,1,0,1,0,1,976
1,1,2,1,3,1,4,976
2,2,0,2,3,3,6,976
3,3,0,2,3,5,8,976
4,4,1,2,4,7,11,976
5,5,1,1,5,8,13,976
6,6,1,0,6,8,14,976
7,7,2,0,8,8,16,976
8,8,1,2,9,10,19,976
9,9,1,0,10,10,20,976
10,10,0,0,10,10,20,976
0,0,1,0,1,0,1,977
1,1,0,0,1,0,1,977
0,0,1,0,1,0,1,978
1,1,2,0,3,0,3,978
2,2,2,0,5,0,5,978
3,3,0,1,5,1,6,978
4,4,0,1,5,2,7,978
5,5,0,0,5,2,7,978
0,0,1,0,1,0,1,979
1,1,2,0,3,0,3,979
2,2,0,0,3,0,3,979
0,0,1,0,1,0,1,980
1,1,0,0,1,0,1,980
0,0,1,0,1,0,1,981
1,1,1,0,2,0,2,981
2,2,1,0,3,0,3,981
3,3,2,1,5,1,6,981
4,4,0,0,5,1,6,981
0,0,1,0,1,0,1,982
1,1,1,0,2,0,2,982
2,2,1,0,3,0,3,982
3,3,1,0,4,0,4,982
4,4,1,0,5,0,5,982
5,5,2,0,7,0,7,982
6,6,1,0,8,0,8,982
7,7,1,0,9,0,9,982
8,8,0,0,9,0,9,982
0,0,1,0,1,0,1,983
1,1,4,1,5,1,6,983
2,2,3,2,8,3,11,983
3,3,1,2,9,5,14,983
4,4,1,1,10,6,16,983
5,5,1,1,11,7,18,983
6,6,1,1,12,8,20,983
7,7,1,1,13,9,22,983
8,8,0,2,13,11,24,983
9,9,1,0,14,11,25,983
10,10,0,0,14,11,25,983
0,0,1,0,1,0,1,984
1,1,0,0,1,0,1,984
0,0,1,0,1,0,1,985
1,1,0,0,1,0,1,985
0,0,1,0,1,0,1,986
1,1,1,0,2,0,2,986
2,2,2,0,4,0,4,986
3,3,0,0,4,0,4,986
0,0,1,0,1,0,1,987
1,1,1,0,2,0,2,987
2,2,0,1,2,1,3,987
3,3,0,0,2,1,3,987
0,0,1,0,1,0,1,988
1,1,1,0,2,0,2,988
2,2,0,0,2,0,2,988
0,0,1,0,1,0,1,989
1,1,0,0,1,0,1,989
0,0,1,0,1,0,1,990
1,1,0,1,1,1,2,990
2,2,0,2,1,3,4,990
3,3,0,2,1,5,6,990
4,4,0,2,1,7,8,990
5,5,1,0,2,7,9,990
6,6,1,0,3,7,10,990
7,7,0,0,3,7,10,990
0,0,1,0,1,0,1,991
1,1,0,0,1,0,1,991
0,0,1,0,1,0,1,992
1,1,0,0,1,0,1,992
0,0,1,0,1,0,1,993
1,1,0,0,1,0,1,993
0,0,1,0,1,0,1,994
1,1,0,0,1,0,1,994
0,0,1,0,1,0,1,995
1,1,0,0,1,0,1,995
0,0,1,0,1,0,1,996
1,1,2,2,3,2,5,996
2,2,3,1,6,3,9,996
3,3,0,2,6,5,11,996
4,4,1,0,7,5,12,996
5,5,0,0,7,5,12,996
0,0,1,0,1,0,1,997
1,1,0,0,1,0,1,997
0,0,1,0,1,0,1,998
1,1,1,0,2,0,2,998
2,2,1,0,3,0,3,998
3,3,0,0,3,0,3,998
0,0,1,0,1,0,1,999
1,1,3,0,4,0,4,999
2,2,2,0,6,0,6,999
3,3,1,1,7,1,8,999
4,4,1,0,8,1,9,999
5,5,1,0,9,1,10,999
6,6,0,0,9,1,10,999
0,0,1,0,1,0,1,1000
1,1,0,0,1,0,1,1000
0,0,1,0,1,0,1,1001
1,1,1,0,2,0,2,1001
2,2,0,0,2,0,2,1001
0,0,1,0,1,0,1,1002
1,1,0,0,1,0,1,1002
0,0,1,0,1,0,1,1003
1,1,1,0,2,0,2,1003
2,2,0,1,2,1,3,1003
3,3,1,2,3,3,6,1003
4,4,1,4,4,7,11,1003
5,5,2,2,6,9,15,1003
6,6,1,2,7,11,18,1003
7,7,1,3,8,14,22,1003
8,8,2,3,10,17,27,1003
9,9,3,2,13,19,32,1003
10,10,2,1,15,20,35,1003
11,11,2,2,17,22,39,1003
12,12,0,4,17,26,43,1003
13,13,1,2,18,28,46,1003
14,14,3,0,21,28,49,1003
15,15,2,1,23,29,52,1003
16,16,2,1,25,30,55,1003
17,17,1,4,26,34,60,1003
18,18,4,3,30,37,67,1003
19,19,6,7,36,44,80,1003
20,20,6,5,42,49,91,1003
21,21,8,3,50,52,102,1003
22,22,6,3,56,55,111,1003
23,23,4,4,60,59,119,1003
24,24,2,2,62,61,123,1003
25,25,0,1,62,62,124,1003
26,26,1,0,63,62,125,1003
27,27,2,0,65,62,127,1003
28,28,1,0,66,62,128,1003
29,29,0,0,66,62,128,1003
0,0,1,0,1,0,1,1004
1,1,0,0,1,0,1,1004
0,0,1,0,1,0,1,1005
1,1,1,0,2,0,2,1005
2,2,0,0,2,0,2,1005
0,0,1,0,1,0,1,1006
1,1,1,0,2,0,2,1006
2,2,2,0,4,0,4,1006
3,3,3,1,7,1,8,1006
4,4,5,3,12,4,16,1006
5,5,6,2,18,6,24,1006
6,6,2,3,20,9,29,1006
7,7,4,1,24,10,34,1006
8,8,2,1,26,11,37,1006
9,9,1,0,27,11,38,1006
10,10,1,0,28,11,39,1006
11,11,1,1,29,12,41,1006
12,12,0,1,29,13,42,1006
13,13,1,3,30,16,46,1006
14,14,1,5,31,21,52,1006
15,15,3,2,34,23,57,1006
16,16,7,5,41,28,69,1006
17,17,9,5,50,33,83,1006
18,18,6,9,56,42,98,1006
19,19,6,8,62,50,112,1006
20,20,2,7,64,57,121,1006
21,21,4,10,68,67,135,1006
22,22,6,9,74,76,150,1006
23,23,7,8,81,84,165,1006
24,24,5,3,86,87,173,1006
25,25,3,2,89,89,178,1006
26,26,6,0,95,89,184,1006
27,27,7,2,102,91,193,1006
28,28,5,4,107,95,202,1006
29,29,2,5,109,100,209,1006
30,30,3,4,112,104,216,1006
31,31,2,2,114,106,220,1006
32,32,2,0,116,106,222,1006
33,33,0,0,116,106,222,1006
0,0,1,0,1,0,1,1007
1,1,0,1,1,1,2,1007
2,2,0,0,1,1,2,1007
0,0,1,0,1,0,1,1008
1,1,0,0,1,0,1,1008
0,0,1,0,1,0,1,1009
1,1,1,0,2,0,2,1009
2,2,2,0,4,0,4,1009
3,3,2,1,6,1,7,1009
4,4,2,0,8,1,9,1009
5,5,1,0,9,1,10,1009
6,6,1,0,10,1,11,1009
7,7,0,0,10,1,11,1009
0,0,1,0,1,0,1,1010
1,1,1,0,2,0,2,1010
2,2,1,0,3,0,3,1010
3,3,1,0,4,0,4,1010
4,4,1,1,5,1,6,1010
5,5,0,0,5,1,6,1010
0,0,1,0,1,0,1,1011
1,1,1,0,2,0,2,1011
2,2,3,1,5,1,6,1011
3,3,2,1,7,2,9,1011
4,4,2,3,9,5,14,1011
5,5,1,3,10,8,18,1011
6,6,0,1,10,9,19,1011
7,7,1,2,11,11,22,1011
8,8,1,2,12,13,25,1011
9,9,1,3,13,16,29,1011
10,10,0,1,13,17,30,1011
11,11,1,0,14,17,31,1011
12,12,0,0,14,17,31,1011
0,0,1,0,1,0,1,1012
1,1,1,0,2,0,2,1012
2,2,0,0,2,0,2,1012
0,0,1,0,1,0,1,1013
1,1,0,0,1,0,1,1013
0,0,1,0,1,0,1,1014
1,1,1,0,2,0,2,1014
2,2,1,0,3,0,3,1014
3,3,0,0,3,0,3,1014
0,0,1,0,1,0,1,1015
1,1,1,0,2,0,2,1015
2,2,0,0,2,0,2,1015
0,0,1,0,1,0,1,1016
1,1,0,0,1,0,1,1016
0,0,1,0,1,0,1,1017
1,1,0,0,1,0,1,1017
0,0,1,0,1,0,1,1018
1,1,1,0,2,0,2,1018
2,2,2,0,4,0,4,1018
3,3,2,0,6,0,6,1018
4,4,0,1,6,1,7,1018
5,5,1,1,7,2,9,1018
6,6,1,1,8,3,11,1018
7,7,2,1,10,4,14,1018
8,8,2,0,12,4,16,1018
9,9,2,0,14,4,18,1018
10,10,2,0,16,4,20,1018
11,11,2,1,18,5,23,1018
12,12,4,1,22,6,28,1018
13,13,2,1,24,7,31,1018
14,14,1,0,25,7,32,1018
15,15,3,0,28,7,35,1018
16,16,0,1,28,8,36,1018
17,17,0,1,28,9,37,1018
18,18,0,0,28,9,37,1018
0,0,1,0,1,0,1,1019
1,1,2,1,3,1,4,1019
2,2,0,2,3,3,6,1019
3,3,1,1,4,4,8,1019
4,4,0,1,4,5,9,1019
5,5,0,1,4,6,10,1019
6,6,0,1,4,7,11,1019
7,7,1,1,5,8,13,1019
8,8,1,2,6,10,16,1019
9,9,2,2,8,12,20,1019
10,10,2,1,10,13,23,1019
11,11,2,2,12,15,27,1019
12,12,1,1,13,16,29,1019
13,13,0,2,13,18,31,1019
14,14,0,2,13,20,33,1019
15,15,2,1,15,21,36,1019
16,16,0,0,15,21,36,1019
0,0,1,0,1,0,1,1020
1,1,0,1,1,1,2,1020
2,2,0,1,1,2,3,1020
3,3,0,1,1,3,4,1020
4,4,0,0,1,3,4,1020
0,0,1,0,1,0,1,1021
1,1,1,0,2,0,2,1021
2,2,0,0,2,0,2,1021
0,0,1,0,1,0,1,1022
1,1,1,0,2,0,2,1022
2,2,0,1,2,1,3,1022
3,3,0,0,2,1,3,1022
0,0,1,0,1,0,1,1023
1,1,0,0,1,0,1,1023
0,0,1,0,1,0,1,1024
1,1,0,0,1,0,1,1024
0,0,1,0,1,0,1,1025
1,1,2,0,3,0,3,1025
2,2,0,0,3,0,3,1025
0,0,1,0,1,0,1,1026
1,1,2,0,3,0,3,1026
2,2,1,0,4,0,4,1026
3,3,1,0,5,0,5,1026
4,4,2,0,7,0,7,1026
5,5,0,1,7,1,8,1026
6,6,0,1,7,2,9,1026
7,7,0,0,7,2,9,1026
0,0,1,0,1,0,1,1027
1,1,1,1,2,1,3,1027
2,2,2,1,4,2,6,1027
3,3,0,2,4,4,8,1027
4,4,0,3,4,7,11,1027
5,5,0,3,4,10,14,1027
6,6,0,3,4,13,17,1027
7,7,0,2,4,15,19,1027
8,8,0,0,4,15,19,1027
0,0,1,0,1,0,1,1028
1,1,0,0,1,0,1,1028
0,0,1,0,1,0,1,1029
1,1,0,0,1,0,1,1029
0,0,1,0,1,0,1,1030
1,1,3,0,4,0,4,1030
2,2,1,0,5,0,5,1030
3,3,0,0,5,0,5,1030
0,0,1,0,1,0,1,1031
1,1,0,1,1,1,2,1031
2,2,0,0,1,1,2,1031
0,0,1,0,1,0,1,1032
1,1,1,1,2,1,3,1032
2,2,0,2,2,3,5,1032
3,3,0,0,2,3,5,1032
0,0,1,0,1,0,1,1033
1,1,0,0,1,0,1,1033
0,0,1,0,1,0,1,1034
1,1,1,0,2,0,2,1034
2,2,0,1,2,1,3,1034
3,3,0,1,2,2,4,1034
4,4,0,1,2,3,5,1034
5,5,0,2,2,5,7,1034
6,6,0,1,2,6,8,1034
7,7,0,1,2,7,9,1034
8,8,0,1,2,8,10,1034
9,9,0,2,2,10,12,1034
10,10,1,0,3,10,13,1034
11,11,1,1,4,11,15,1034
12,12,0,1,4,12,16,1034
13,13,0,0,4,12,16,1034
0,0,1,0,1,0,1,1035
1,1,1,0,2,0,2,1035
2,2,2,0,4,0,4,1035
3,3,1,0,5,0,5,1035
4,4,1,0,6,0,6,1035
5,5,1,0,7,0,7,1035
6,6,2,0,9,0,9,1035
7,7,2,0,11,0,11,1035
8,8,5,1,16,1,17,1035
9,9,2,2,18,3,21,1035
10,10,0,1,18,4,22,1035
11,11,1,0,19,4,23,1035
12,12,1,0,20,4,24,1035
13,13,3,0,23,4,27,1035
14,14,3,2,26,6,32,1035
15,15,2,3,28,9,37,1035
16,16,0,1,28,10,38,1035
17,17,0,0,28,10,38,1035
0,0,1,0,1,0,1,1036
1,1,0,0,1,0,1,1036
0,0,1,0,1,0,1,1037
1,1,0,1,1,1,2,1037
2,2,0,1,1,2,3,1037
3,3,0,1,1,3,4,1037
4,4,0,1,1,4,5,1037
5,5,0,1,1,5,6,1037
6,6,0,0,1,5,6,1037
0,0,1,0,1,0,1,1038
1,1,0,0,1,0,1,1038
0,0,1,0,1,0,1,1039
1,1,0,0,1,0,1,1039
0,0,1,0,1,0,1,1040
1,1,0,1,1,1,2,1040
2,2,1,1,2,2,4,1040
3,3,0,0,2,2,4,1040
0,0,1,0,1,0,1,1041
1,1,2,0,3,0,3,1041
2,2,1,0,4,0,4,1041
3,3,2,0,6,0,6,1041
4,4,1,0,7,0,7,1041
5,5,0,0,7,0,7,1041
0,0,1,0,1,0,1,1042
1,1,0,1,1,1,2,1042
2,2,0,1,1,2,3,1042
3,3,0,2,1,4,5,1042
4,4,1,2,2,6,8,1042
5,5,1,1,3,7,10,1042
6,6,0,0,3,7,10,1042
0,0,1,0,1,0,1,1043
1,1,1,0,2,0,2,1043
2,2,0,0,2,0,2,1043
0,0,1,0,1,0,1,1044
1,1,1,1,2,1,3,1044
2,2,1,2,3,3,6,1044
3,3,3,3,6,6,12,1044
4,4,1,1,7,7,14,1044
5,5,1,1,8,8,16,1044
6,6,1,0,9,8,17,1044
7,7,1,0,10,8,18,1044
8,8,0,1,10,9,19,1044
9,9,0,0,10,9,19,1044
0,0,1,0,1,0,1,1045
1,1,0,0,1,0,1,1045
0,0,1,0,1,0,1,1046
1,1,1,0,2,0,2,1046
2,2,3,1,5,1,6,1046
3,3,1,0,6,1,7,1046
4,4,3,0,9,1,10,1046
5,5,3,1,12,2,14,1046
6,6,3,1,15,3,18,1046
7,7,7,1,22,4,26,1046
8,8,0,7,22,11,33,1046
9,9,3,5,25,16,41,1046
10,10,5,3,30,19,49,1046
11,11,4,5,34,24,58,1046
12,12,1,3,35,27,62,1046
13,13,2,4,37,31,68,1046
14,14,2,2,39,33,72,1046
15,15,4,2,43,35,78,1046
16,16,3,1,46,36,82,1046
17,17,1,2,47,38,85,1046
18,18,1,2,48,40,88,1046
19,19,1,1,49,41,90,1046
20,20,0,1,49,42,91,1046
21,21,0,1,49,43,92,1046
22,22,1,0,50,43,93,1046
23,23,0,0,50,43,93,1046
0,0,1,0,1,0,1,1047
1,1,0,0,1,0,1,1047
0,0,1,0,1,0,1,1048
1,1,1,0,2,0,2,1048
2,2,0,0,2,0,2,1048
0,0,1,0,1,0,1,1049
1,1,0,0,1,0,1,1049
0,0,1,0,1,0,1,1050
1,1,0,0,1,0,1,1050
0,0,1,0,1,0,1,1051
1,1,0,0,1,0,1,1051
0,0,1,0,1,0,1,1052
1,1,1,0,2,0,2,1052
2,2,2,2,4,2,6,1052
3,3,4,5,8,7,15,1052
4,4,5,5,13,12,25,1052
5,5,3,1,16,13,29,1052
6,6,0,1,16,14,30,1052
7,7,0,1,16,15,31,1052
8,8,0,0,16,15,31,1052
0,0,1,0,1,0,1,1053
1,1,1,0,2,0,2,1053
2,2,0,0,2,0,2,1053
0,0,1,0,1,0,1,1054
1,1,0,0,1,0,1,1054
0,0,1,0,1,0,1,1055
1,1,2,0,3,0,3,1055
2,2,2,1,5,1,6,1055
3,3,0,0,5,1,6,1055
0,0,1,0,1,0,1,1056
1,1,1,0,2,0,2,1056
2,2,0,0,2,0,2,1056
0,0,1,0,1,0,1,1057
1,1,1,0,2,0,2,1057
2,2,2,0,4,0,4,1057
3,3,2,0,6,0,6,1057
4,4,0,0,6,0,6,1057
0,0,1,0,1,0,1,1058
1,1,0,1,1,1,2,1058
2,2,0,0,1,1,2,1058
0,0,1,0,1,0,1,1059
1,1,0,0,1,0,1,1059
0,0,1,0,1,0,1,1060
1,1,0,0,1,0,1,1060
0,0,1,0,1,0,1,1061
1,1,0,0,1,0,1,1061
0,0,1,0,1,0,1,1062
1,1,0,0,1,0,1,1062
0,0,1,0,1,0,1,1063
1,1,3,0,4,0,4,1063
2,2,2,0,6,0,6,1063
3,3,1,2,7,2,9,1063
4,4,2,0,9,2,11,1063
5,5,1,1,10,3,13,1063
6,6,0,1,10,4,14,1063
7,7,1,1,11,5,16,1063
8,8,1,2,12,7,19,1063
9,9,1,0,13,7,20,1063
10,10,1,0,14,7,21,1063
11,11,1,1,15,8,23,1063
12,12,1,1,16,9,25,1063
13,13,0,0,16,9,25,1063
0,0,1,0,1,0,1,1064
1,1,0,0,1,0,1,1064
0,0,1,0,1,0,1,1065
1,1,0,0,1,0,1,1065
0,0,1,0,1,0,1,1066
1,1,0,0,1,0,1,1066
0,0,1,0,1,0,1,1067
1,1,0,0,1,0,1,1067
0,0,1,0,1,0,1,1068
1,1,0,0,1,0,1,1068
0,0,1,0,1,0,1,1069
1,1,2,0,3,0,3,1069
2,2,1,0,4,0,4,1069
3,3,0,1,4,1,5,1069
4,4,0,0,4,1,5,1069
0,0,1,0,1,0,1,1070
1,1,1,1,2,1,3,1070
2,2,0,0,2,1,3,1070
0,0,1,0,1,0,1,1071
1,1,1,0,2,0,2,1071
2,2,1,0,3,0,3,1071
3,3,1,0,4,0,4,1071
4,4,1,0,5,0,5,1071
5,5,1,0,6,0,6,1071
6,6,1,0,7,0,7,1071
7,7,1,0,8,0,8,1071
8,8,3,0,11,0,11,1071
9,9,3,0,14,0,14,1071
10,10,2,2,16,2,18,1071
11,11,1,4,17,6,23,1071
12,12,0,1,17,7,24,1071
13,13,0,1,17,8,25,1071
14,14,0,0,17,8,25,1071
0,0,1,0,1,0,1,1072
1,1,1,0,2,0,2,1072
2,2,0,1,2,1,3,1072
3,3,0,1,2,2,4,1072
4,4,0,0,2,2,4,1072
0,0,1,0,1,0,1,1073
1,1,2,1,3,1,4,1073
2,2,1,1,4,2,6,1073
3,3,1,2,5,4,9,1073
4,4,0,0,5,4,9,1073
0,0,1,0,1,0,1,1074
1,1,0,1,1,1,2,1074
2,2,0,0,1,1,2,1074
0,0,1,0,1,0,1,1075
1,1,0,1,1,1,2,1075
2,2,0,0,1,1,2,1075
0,0,1,0,1,0,1,1076
1,1,0,1,1,1,2,1076
2,2,0,1,1,2,3,1076
3,3,0,1,1,3,4,1076
4,4,0,2,1,5,6,1076
5,5,0,3,1,8,9,1076
6,6,1,0,2,8,10,1076
7,7,0,1,2,9,11,1076
8,8,0,1,2,10,12,1076
9,9,0,0,2,10,12,1076
0,0,1,0,1,0,1,1077
1,1,0,0,1,0,1,1077
0,0,1,0,1,0,1,1078
1,1,2,0,3,0,3,1078
2,2,1,1,4,1,5,1078
3,3,0,1,4,2,6,1078
4,4,0,0,4,2,6,1078
0,0,1,0,1,0,1,1079
1,1,0,0,1,0,1,1079
0,0,1,0,1,0,1,1080
1,1,1,1,2,1,3,1080
2,2,2,2,4,3,7,1080
3,3,0,3,4,6,10,1080
4,4,0,4,4,10,14,1080
5,5,2,3,6,13,19,1080
6,6,1,2,7,15,22,1080
7,7,0,1,7,16,23,1080
8,8,0,0,7,16,23,1080
0,0,1,0,1,0,1,1081
1,1,0,0,1,0,1,1081
0,0,1,0,1,0,1,1082
1,1,0,0,1,0,1,1082
0,0,1,0,1,0,1,1083
1,1,0,0,1,0,1,1083
0,0,1,0,1,0,1,1084
1,1,1,1,2,1,3,1084
2,2,0,0,2,1,3,1084
0,0,1,0,1,0,1,1085
1,1,0,1,1,1,2,1085
2,2,0,0,1,1,2,1085
0,0,1,0,1,0,1,1086
1,1,1,1,2,1,3,1086
2,2,1,0,3,1,4,1086
3,3,2,0,5,1,6,1086
4,4,1,0,6,1,7,1086
5,5,1,0,7,1,8,1086
6,6,0,0,7,1,8,1086
0,0,1,0,1,0,1,1087
1,1,2,0,3,0,3,1087
2,2,0,1,3,1,4,1087
3,3,0,0,3,1,4,1087
0,0,1,0,1,0,1,1088
1,1,1,0,2,0,2,1088
2,2,0,0,2,0,2,1088
0,0,1,0,1,0,1,1089
1,1,1,0,2,0,2,1089
2,2,0,0,2,0,2,1089
0,0,1,0,1,0,1,1090
1,1,1,0,2,0,2,1090
2,2,2,0,4,0,4,1090
3,3,0,0,4,0,4,1090
0,0,1,0,1,0,1,1091
1,1,2,0,3,0,3,1091
2,2,1,0,4,0,4,1091
3,3,0,1,4,1,5,1091
4,4,0,0,4,1,5,1091
0,0,1,0,1,0,1,1092
1,1,0,0,1,0,1,1092
0,0,1,0,1,0,1,1093
1,1,2,0,3,0,3,1093
2,2,1,0,4,0,4,1093
3,3,0,1,4,1,5,1093
4,4,1,1,5,2,7,1093
5,5,0,0,5,2,7,1093
0,0,1,0,1,0,1,1094
1,1,0,0,1,0,1,1094
0,0,1,0,1,0,1,1095
1,1,0,0,1,0,1,1095
0,0,1,0,1,0,1,1096
1,1,0,0,1,0,1,1096
0,0,1,0,1,0,1,1097
1,1,0,1,1,1,2,1097
2,2,0,0,1,1,2,1097
0,0,1,0,1,0,1,1098
1,1,0,0,1,0,1,1098
0,0,1,0,1,0,1,1099
1,1,1,0,2,0,2,1099
2,2,1,1,3,1,4,1099
3,3,2,0,5,1,6,1099
4,4,1,0,6,1,7,1099
5,5,1,0,7,1,8,1099
6,6,1,0,8,1,9,1099
7,7,2,0,10,1,11,1099
8,8,0,0,10,1,11,1099
0,0,1,0,1,0,1,1100
1,1,1,0,2,0,2,1100
2,2,1,0,3,0,3,1100
3,3,1,0,4,0,4,1100
4,4,2,0,6,0,6,1100
5,5,0,1,6,1,7,1100
6,6,0,1,6,2,8,1100
7,7,0,2,6,4,10,1100
8,8,0,0,6,4,10,1100
0,0,1,0,1,0,1,1101
1,1,1,0,2,0,2,1101
2,2,0,0,2,0,2,1101
0,0,1,0,1,0,1,1102
1,1,1,0,2,0,2,1102
2,2,0,0,2,0,2,1102
0,0,1,0,1,0,1,1103
1,1,2,0,3,0,3,1103
2,2,1,0,4,0,4,1103
3,3,0,1,4,1,5,1103
4,4,0,0,4,1,5,1103
0,0,1,0,1,0,1,1104
1,1,1,0,2,0,2,1104
2,2,3,0,5,0,5,1104
3,3,1,1,6,1,7,1104
4,4,0,1,6,2,8,1104
5,5,0,0,6,2,8,1104
0,0,1,0,1,0,1,1105
1,1,2,0,3,0,3,1105
2,2,2,0,5,0,5,1105
3,3,0,0,5,0,5,1105
0,0,1,0,1,0,1,1106
1,1,1,0,2,0,2,1106
2,2,3,1,5,1,6,1106
3,3,1,0,6,1,7,1106
4,4,3,0,9,1,10,1106
5,5,5,1,14,2,16,1106
6,6,1,0,15,2,17,1106
7,7,1,0,16,2,18,1106
8,8,0,0,16,2,18,1106
0,0,1,0,1,0,1,1107
1,1,0,0,1,0,1,1107
0,0,1,0,1,0,1,1108
1,1,1,0,2,0,2,1108
2,2,1,1,3,1,4,1108
3,3,0,0,3,1,4,1108
0,0,1,0,1,0,1,1109
1,1,1,0,2,0,2,1109
2,2,0,0,2,0,2,1109
0,0,1,0,1,0,1,1110
1,1,1,0,2,0,2,1110
2,2,0,0,2,0,2,1110
0,0,1,0,1,0,1,1111
1,1,1,0,2,0,2,1111
2,2,1,0,3,0,3,1111
3,3,0,0,3,0,3,1111
0,0,1,0,1,0,1,1112
1,1,1,0,2,0,2,1112
2,2,1,0,3,0,3,1112
3,3,1,1,4,1,5,1112
4,4,1,1,5,2,7,1112
5,5,0,0,5,2,7,1112
0,0,1,0,1,0,1,1113
1,1,1,0,2,0,2,1113
2,2,0,0,2,0,2,1113
0,0,1,0,1,0,1,1114
1,1,1,0,2,0,2,1114
2,2,0,0,2,0,2,1114
0,0,1,0,1,0,1,1115
1,1,0,0,1,0,1,1115
0,0,1,0,1,0,1,1116
1,1,1,0,2,0,2,1116
2,2,0,0,2,0,2,1116
0,0,1,0,1,0,1,1117
1,1,4,0,5,0,5,1117
2,2,4,4,9,4,13,1117
3,3,1,5,10,9,19,1117
4,4,2,2,12,11,23,1117
5,5,2,1,14,12,26,1117
6,6,1,0,15,12,27,1117
7,7,0,0,15,12,27,1117
0,0,1,0,1,0,1,1118
1,1,0,0,1,0,1,1118
0,0,1,0,1,0,1,1119
1,1,1,0,2,0,2,1119
2,2,0,1,2,1,3,1119
3,3,0,1,2,2,4,1119
4,4,1,1,3,3,6,1119
5,5,2,0,5,3,8,1119
6,6,0,1,5,4,9,1119
7,7,0,1,5,5,10,1119
8,8,1,1,6,6,12,1119
9,9,1,0,7,6,13,1119
10,10,1,0,8,6,14,1119
11,11,0,0,8,6,14,1119
0,0,1,0,1,0,1,1120
1,1,0,0,1,0,1,1120
0,0,1,0,1,0,1,1121
1,1,0,0,1,0,1,1121
0,0,1,0,1,0,1,1122
1,1,0,1,1,1,2,1122
2,2,0,1,1,2,3,1122
3,3,0,2,1,4,5,1122
4,4,0,1,1,5,6,1122
5,5,0,2,1,7,8,1122
6,6,0,0,1,7,8,1122
0,0,1,0,1,0,1,1123
1,1,0,0,1,0,1,1123
0,0,1,0,1,0,1,1124
1,1,1,0,2,0,2,1124
2,2,1,0,3,0,3,1124
3,3,1,0,4,0,4,1124
4,4,1,0,5,0,5,1124
5,5,1,0,6,0,6,1124
6,6,1,1,7,1,8,1124
7,7,0,2,7,3,10,1124
8,8,0,1,7,4,11,1124
9,9,0,2,7,6,13,1124
10,10,1,0,8,6,14,1124
11,11,0,0,8,6,14,1124
0,0,1,0,1,0,1,1125
1,1,0,0,1,0,1,1125
0,0,1,0,1,0,1,1126
1,1,0,0,1,0,1,1126
0,0,1,0,1,0,1,1127
1,1,0,0,1,0,1,1127
0,0,1,0,1,0,1,1128
1,1,0,0,1,0,1,1128
0,0,1,0,1,0,1,1129
1,1,1,0,2,0,2,1129
2,2,0,0,2,0,2,1129
0,0,1,0,1,0,1,1130
1,1,3,0,4,0,4,1130
2,2,2,0,6,0,6,1130
3,3,1,0,7,0,7,1130
4,4,2,0,9,0,9,1130
5,5,0,2,9,2,11,1130
6,6,0,1,9,3,12,1130
7,7,1,1,10,4,14,1130
8,8,0,0,10,4,14,1130
0,0,1,0,1,0,1,1131
1,1,0,0,1,0,1,1131
0,0,1,0,1,0,1,1132
1,1,0,0,1,0,1,1132
0,0,1,0,1,0,1,1133
1,1,1,0,2,0,2,1133
2,2,0,0,2,0,2,1133
0,0,1,0,1,0,1,1134
1,1,0,0,1,0,1,1134
0,0,1,0,1,0,1,1135
1,1,0,0,1,0,1,1135
0,0,1,0,1,0,1,1136
1,1,0,0,1,0,1,1136
0,0,1,0,1,0,1,1137
1,1,1,0,2,0,2,1137
2,2,3,0,5,0,5,1137
3,3,0,1,5,1,6,1137
4,4,0,0,5,1,6,1137
0,0,1,0,1,0,1,1138
1,1,2,0,3,0,3,1138
2,2,3,0,6,0,6,1138
3,3,2,2,8,2,10,1138
4,4,0,0,8,2,10,1138
0,0,1,0,1,0,1,1139
1,1,1,1,2,1,3,1139
2,2,0,2,2,3,5,1139
3,3,0,0,2,3,5,1139
0,0,1,0,1,0,1,1140
1,1,1,1,2,1,3,1140
2,2,1,0,3,1,4,1140
3,3,0,1,3,2,5,1140
4,4,0,1,3,3,6,1140
5,5,0,0,3,3,6,1140
0,0,1,0,1,0,1,1141
1,1,1,0,2,0,2,1141
2,2,0,2,2,2,4,1141
3,3,0,0,2,2,4,1141
0,0,1,0,1,0,1,1142
1,1,0,0,1,0,1,1142
0,0,1,0,1,0,1,1143
1,1,0,1,1,1,2,1143
2,2,0,0,1,1,2,1143
0,0,1,0,1,0,1,1144
1,1,0,1,1,1,2,1144
2,2,1,0,2,1,3,1144
3,3,1,0,3,1,4,1144
4,4,0,0,3,1,4,1144
0,0,1,0,1,0,1,1145
1,1,0,0,1,0,1,1145
0,0,1,0,1,0,1,1146
1,1,1,0,2,0,2,1146
2,2,0,0,2,0,2,1146
0,0,1,0,1,0,1,1147
1,1,1,0,2,0,2,1147
2,2,1,1,3,1,4,1147
3,3,1,1,4,2,6,1147
4,4,1,2,5,4,9,1147
5,5,2,3,7,7,14,1147
6,6,1,4,8,11,19,1147
7,7,2,5,10,16,26,1147
8,8,5,10,15,26,41,1147
9,9,5,12,20,38,58,1147
10,10,6,9,26,47,73,1147
11,11,7,3,33,50,83,1147
12,12,5,2,38,52,90,1147
13,13,3,4,41,56,97,1147
14,14,4,6,45,62,107,1147
15,15,2,9,47,71,118,1147
16,16,1,0,48,71,119,1147
17,17,1,0,49,71,120,1147
18,18,0,0,49,71,120,1147
0,0,1,0,1,0,1,1148
1,1,3,0,4,0,4,1148
2,2,2,0,6,0,6,1148
3,3,1,1,7,1,8,1148
4,4,0,1,7,2,9,1148
5,5,2,0,9,2,11,1148
6,6,2,1,11,3,14,1148
7,7,3,1,14,4,18,1148
8,8,0,0,14,4,18,1148
0,0,1,0,1,0,1,1149
1,1,0,0,1,0,1,1149
0,0,1,0,1,0,1,1150
1,1,3,1,4,1,5,1150
2,2,0,3,4,4,8,1150
3,3,0,0,4,4,8,1150
0,0,1,0,1,0,1,1151
1,1,2,0,3,0,3,1151
2,2,3,0,6,0,6,1151
3,3,1,2,7,2,9,1151
4,4,1,1,8,3,11,1151
5,5,2,1,10,4,14,1151
6,6,3,0,13,4,17,1151
7,7,1,1,14,5,19,1151
8,8,1,2,15,7,22,1151
9,9,1,0,16,7,23,1151
10,10,0,1,16,8,24,1151
11,11,0,0,16,8,24,1151
0,0,1,0,1,0,1,1152
1,1,0,0,1,0,1,1152
0,0,1,0,1,0,1,1153
1,1,1,1,2,1,3,1153
2,2,1,1,3,2,5,1153
3,3,1,0,4,2,6,1153
4,4,0,0,4,2,6,1153
0,0,1,0,1,0,1,1154
1,1,2,0,3,0,3,1154
2,2,0,0,3,0,3,1154
0,0,1,0,1,0,1,1155
1,1,1,0,2,0,2,1155
2,2,3,0,5,0,5,1155
3,3,1,1,6,1,7,1155
4,4,1,1,7,2,9,1155
5,5,3,2,10,4,14,1155
6,6,2,4,12,8,20,1155
7,7,2,6,14,14,28,1155
8,8,2,4,16,18,34,1155
9,9,4,2,20,20,40,1155
10,10,5,0,25,20,45,1155
11,11,5,1,30,21,51,1155
12,12,2,2,32,23,55,1155
13,13,2,2,34,25,59,1155
14,14,3,1,37,26,63,1155
15,15,4,0,41,26,67,1155
16,16,4,0,45,26,71,1155
17,17,6,3,51,29,80,1155
18,18,4,4,55,33,88,1155
19,19,10,2,65,35,100,1155
20,20,8,5,73,40,113,1155
21,21,3,3,76,43,119,1155
22,22,4,2,80,45,125,1155
23,23,2,1,82,46,128,1155
24,24,1,0,83,46,129,1155
25,25,0,0,83,46,129,1155
0,0,1,0,1,0,1,1156
1,1,0,0,1,0,1,1156
0,0,1,0,1,0,1,1157
1,1,0,0,1,0,1,1157
0,0,1,0,1,0,1,1158
1,1,0,0,1,0,1,1158
0,0,1,0,1,0,1,1159
1,1,0,0,1,0,1,1159
0,0,1,0,1,0,1,1160
1,1,1,0,2,0,2,1160
2,2,2,0,4,0,4,1160
3,3,4,0,8,0,8,1160
4,4,1,0,9,0,9,1160
5,5,1,0,10,0,10,1160
6,6,0,0,10,0,10,1160
0,0,1,0,1,0,1,1161
1,1,1,0,2,0,2,1161
2,2,0,1,2,1,3,1161
3,3,1,1,3,2,5,1161
4,4,2,1,5,3,8,1161
5,5,0,0,5,3,8,1161
0,0,1,0,1,0,1,1162
1,1,0,0,1,0,1,1162
0,0,1,0,1,0,1,1163
1,1,0,0,1,0,1,1163
0,0,1,0,1,0,1,1164
1,1,1,0,2,0,2,1164
2,2,0,0,2,0,2,1164
0,0,1,0,1,0,1,1165
1,1,0,0,1,0,1,1165
0,0,1,0,1,0,1,1166
1,1,0,0,1,0,1,1166
0,0,1,0,1,0,1,1167
1,1,1,0,2,0,2,1167
2,2,1,0,3,0,3,1167
3,3,1,0,4,0,4,1167
4,4,1,1,5,1,6,1167
5,5,0,2,5,3,8,1167
6,6,0,0,5,3,8,1167
0,0,1,0,1,0,1,1168
1,1,0,0,1,0,1,1168
0,0,1,0,1,0,1,1169
1,1,2,0,3,0,3,1169
2,2,4,0,7,0,7,1169
3,3,1,0,8,0,8,1169
4,4,2,0,10,0,10,1169
5,5,2,1,12,1,13,1169
6,6,1,1,13,2,15,1169
7,7,2,0,15,2,17,1169
8,8,2,0,17,2,19,1169
9,9,1,0,18,2,20,1169
10,10,1,0,19,2,21,1169
11,11,0,0,19,2,21,1169
0,0,1,0,1,0,1,1170
1,1,0,0,1,0,1,1170
0,0,1,0,1,0,1,1171
1,1,0,0,1,0,1,1171
0,0,1,0,1,0,1,1172
1,1,2,0,3,0,3,1172
2,2,1,0,4,0,4,1172
3,3,1,0,5,0,5,1172
4,4,2,0,7,0,7,1172
5,5,2,0,9,0,9,1172
6,6,1,0,10,0,10,1172
7,7,0,0,10,0,10,1172
0,0,1,0,1,0,1,1173
1,1,0,1,1,1,2,1173
2,2,0,1,1,2,3,1173
3,3,0,0,1,2,3,1173
0,0,1,0,1,0,1,1174
1,1,0,0,1,0,1,1174
0,0,1,0,1,0,1,1175
1,1,3,0,4,0,4,1175
2,2,5,2,9,2,11,1175
3,3,4,1,13,3,16,1175
4,4,5,1,18,4,22,1175
5,5,5,2,23,6,29,1175
6,6,2,1,25,7,32,1175
7,7,3,0,28,7,35,1175
8,8,5,0,33,7,40,1175
9,9,2,1,35,8,43,1175
10,10,1,0,36,8,44,1175
11,11,1,0,37,8,45,1175
12,12,0,0,37,8,45,1175
0,0,1,0,1,0,1,1176
1,1,1,0,2,0,2,1176
2,2,0,1,2,1,3,1176
3,3,0,0,2,1,3,1176
0,0,1,0,1,0,1,1177
1,1,0,1,1,1,2,1177
2,2,0,0,1,1,2,1177
0,0,1,0,1,0,1,1178
1,1,1,0,2,0,2,1178
2,2,0,0,2,0,2,1178
0,0,1,0,1,0,1,1179
1,1,1,1,2,1,3,1179
2,2,1,2,3,3,6,1179
3,3,0,2,3,5,8,1179
4,4,1,1,4,6,10,1179
5,5,0,1,4,7,11,1179
6,6,0,0,4,7,11,1179
0,0,1,0,1,0,1,1180
1,1,2,0,3,0,3,1180
2,2,1,0,4,0,4,1180
3,3,1,1,5,1,6,1180
4,4,1,1,6,2,8,1180
5,5,0,2,6,4,10,1180
6,6,1,0,7,4,11,1180
7,7,1,0,8,4,12,1180
8,8,0,0,8,4,12,1180
0,0,1,0,1,0,1,1181
1,1,1,0,2,0,2,1181
2,2,1,0,3,0,3,1181
3,3,0,1,3,1,4,1181
4,4,0,1,3,2,5,1181
5,5,0,0,3,2,5,1181
0,0,1,0,1,0,1,1182
1,1,2,1,3,1,4,1182
2,2,1,2,4,3,7,1182
3,3,1,1,5,4,9,1182
4,4,3,0,8,4,12,1182
5,5,0,1,8,5,13,1182
6,6,0,0,8,5,13,1182
0,0,1,0,1,0,1,1183
1,1,0,0,1,0,1,1183
0,0,1,0,1,0,1,1184
1,1,0,0,1,0,1,1184
0,0,1,0,1,0,1,1185
1,1,0,0,1,0,1,1185
0,0,1,0,1,0,1,1186
1,1,0,0,1,0,1,1186
0,0,1,0,1,0,1,1187
1,1,1,1,2,1,3,1187
2,2,0,1,2,2,4,1187
3,3,0,0,2,2,4,1187
0,0,1,0,1,0,1,1188
1,1,0,0,1,0,1,1188
0,0,1,0,1,0,1,1189
1,1,1,0,2,0,2,1189
2,2,0,1,2,1,3,1189
3,3,0,0,2,1,3,1189
0,0,1,0,1,0,1,1190
1,1,0,1,1,1,2,1190
2,2,0,1,1,2,3,1190
3,3,1,0,2,2,4,1190
4,4,2,0,4,2,6,1190
5,5,3,0,7,2,9,1190
6,6,1,0,8,2,10,1190
7,7,0,0,8,2,10,1190
0,0,1,0,1,0,1,1191
1,1,1,0,2,0,2,1191
2,2,0,0,2,0,2,1191
0,0,1,0,1,0,1,1192
1,1,1,0,2,0,2,1192
2,2,1,0,3,0,3,1192
3,3,1,0,4,0,4,1192
4,4,1,0,5,0,5,1192
5,5,0,0,5,0,5,1192
0,0,1,0,1,0,1,1193
1,1,0,0,1,0,1,1193
0,0,1,0,1,0,1,1194
1,1,2,0,3,0,3,1194
2,2,0,0,3,0,3,1194
0,0,1,0,1,0,1,1195
1,1,0,0,1,0,1,1195
0,0,1,0,1,0,1,1196
1,1,1,0,2,0,2,1196
2,2,0,0,2,0,2,1196
0,0,1,0,1,0,1,1197
1,1,0,0,1,0,1,1197
0,0,1,0,1,0,1,1198
1,1,0,0,1,0,1,1198
0,0,1,0,1,0,1,1199
1,1,1,0,2,0,2,1199
2,2,1,0,3,0,3,1199
3,3,1,1,4,1,5,1199
4,4,0,0,4,1,5,1199
0,0,1,0,1,0,1,1200
1,1,1,0,2,0,2,1200
2,2,2,0,4,0,4,1200
3,3,1,0,5,0,5,1200
4,4,0,0,5,0,5,1200
0,0,1,0,1,0,1,1201
1,1,0,0,1,0,1,1201
0,0,1,0,1,0,1,1202
1,1,1,1,2,1,3,1202
2,2,2,2,4,3,7,1202
3,3,0,1,4,4,8,1202
4,4,0,0,4,4,8,1202
0,0,1,0,1,0,1,1203
1,1,0,1,1,1,2,1203
2,2,0,0,1,1,2,1203
0,0,1,0,1,0,1,1204
1,1,1,0,2,0,2,1204
2,2,0,1,2,1,3,1204
3,3,0,1,2,2,4,1204
4,4,0,1,2,3,5,1204
5,5,0,2,2,5,7,1204
6,6,0,1,2,6,8,1204
7,7,0,2,2,8,10,1204
8,8,0,4,2,12,14,1204
9,9,0,3,2,15,17,1204
10,10,2,5,4,20,24,1204
11,11,0,5,4,25,29,1204
12,12,0,2,4,27,31,1204
13,13,0,1,4,28,32,1204
14,14,0,0,4,28,32,1204
0,0,1,0,1,0,1,1205
1,1,3,0,4,0,4,1205
2,2,2,0,6,0,6,1205
3,3,3,0,9,0,9,1205
4,4,1,0,10,0,10,1205
5,5,2,0,12,0,12,1205
6,6,2,0,14,0,14,1205
7,7,2,1,16,1,17,1205
8,8,0,3,16,4,20,1205
9,9,1,1,17,5,22,1205
10,10,1,0,18,5,23,1205
11,11,0,0,18,5,23,1205
0,0,1,0,1,0,1,1206
1,1,0,0,1,0,1,1206
0,0,1,0,1,0,1,1207
1,1,2,0,3,0,3,1207
2,2,1,0,4,0,4,1207
3,3,1,0,5,0,5,1207
4,4,1,1,6,1,7,1207
5,5,0,2,6,3,9,1207
6,6,0,0,6,3,9,1207
0,0,1,0,1,0,1,1208
1,1,2,0,3,0,3,1208
2,2,1,0,4,0,4,1208
3,3,0,0,4,0,4,1208
0,0,1,0,1,0,1,1209
1,1,0,0,1,0,1,1209
0,0,1,0,1,0,1,1210
1,1,2,0,3,0,3,1210
2,2,2,0,5,0,5,1210
3,3,0,0,5,0,5,1210
0,0,1,0,1,0,1,1211
1,1,2,0,3,0,3,1211
2,2,2,1,5,1,6,1211
3,3,2,1,7,2,9,1211
4,4,3,0,10,2,12,1211
5,5,1,1,11,3,14,1211
6,6,1,1,12,4,16,1211
7,7,0,0,12,4,16,1211
0,0,1,0,1,0,1,1212
1,1,1,0,2,0,2,1212
2,2,0,0,2,0,2,1212
0,0,1,0,1,0,1,1213
1,1,1,0,2,0,2,1213
2,2,1,1,3,1,4,1213
3,3,0,0,3,1,4,1213
0,0,1,0,1,0,1,1214
1,1,1,0,2,0,2,1214
2,2,2,0,4,0,4,1214
3,3,2,0,6,0,6,1214
4,4,1,0,7,0,7,1214
5,5,0,0,7,0,7,1214
0,0,1,0,1,0,1,1215
1,1,0,0,1,0,1,1215
0,0,1,0,1,0,1,1216
1,1,2,0,3,0,3,1216
2,2,3,0,6,0,6,1216
3,3,5,0,11,0,11,1216
4,4,4,0,15,0,15,1216
5,5,1,0,16,0,16,1216
6,6,1,0,17,0,17,1216
7,7,2,0,19,0,19,1216
8,8,2,0,21,0,21,1216
9,9,2,0,23,0,23,1216
10,10,2,0,25,0,25,1216
11,11,7,0,32,0,32,1216
12,12,7,2,39,2,41,1216
13,13,3,2,42,4,46,1216
14,14,2,0,44,4,48,1216
15,15,0,0,44,4,48,1216
0,0,1,0,1,0,1,1217
1,1,3,0,4,0,4,1217
2,2,0,1,4,1,5,1217
3,3,0,0,4,1,5,1217
0,0,1,0,1,0,1,1218
1,1,0,0,1,0,1,1218
0,0,1,0,1,0,1,1219
1,1,2,0,3,0,3,1219
2,2,0,0,3,0,3,1219
0,0,1,0,1,0,1,1220
1,1,1,0,2,0,2,1220
2,2,1,0,3,0,3,1220
3,3,0,0,3,0,3,1220
0,0,1,0,1,0,1,1221
1,1,1,1,2,1,3,1221
2,2,0,0,2,1,3,1221
0,0,1,0,1,0,1,1222
1,1,2,0,3,0,3,1222
2,2,0,2,3,2,5,1222
3,3,0,2,3,4,7,1222
4,4,1,2,4,6,10,1222
5,5,2,1,6,7,13,1222
6,6,4,1,10,8,18,1222
7,7,4,2,14,10,24,1222
8,8,0,3,14,13,27,1222
9,9,0,4,14,17,31,1222
10,10,0,2,14,19,33,1222
11,11,0,1,14,20,34,1222
12,12,0,0,14,20,34,1222
0,0,1,0,1,0,1,1223
1,1,2,0,3,0,3,1223
2,2,1,1,4,1,5,1223
3,3,0,1,4,2,6,1223
4,4,0,0,4,2,6,1223
0,0,1,0,1,0,1,1224
1,1,0,0,1,0,1,1224
0,0,1,0,1,0,1,1225
1,1,0,0,1,0,1,1225
0,0,1,0,1,0,1,1226
1,1,1,0,2,0,2,1226
2,2,0,0,2,0,2,1226
0,0,1,0,1,0,1,1227
1,1,1,0,2,0,2,1227
2,2,1,1,3,1,4,1227
3,3,1,0,4,1,5,1227
4,4,2,0,6,1,7,1227
5,5,4,0,10,1,11,1227
6,6,1,0,11,1,12,1227
7,7,0,0,11,1,12,1227
0,0,1,0,1,0,1,1228
1,1,2,0,3,0,3,1228
2,2,0,0,3,0,3,1228
0,0,1,0,1,0,1,1229
1,1,2,0,3,0,3,1229
2,2,2,1,5,1,6,1229
3,3,2,1,7,2,9,1229
4,4,2,2,9,4,13,1229
5,5,3,0,12,4,16,1229
6,6,5,0,17,4,21,1229
7,7,2,2,19,6,25,1229
8,8,2,1,21,7,28,1229
9,9,3,1,24,8,32,1229
10,10,2,2,26,10,36,1229
11,11,1,3,27,13,40,1229
12,12,1,3,28,16,44,1229
13,13,1,3,29,19,48,1229
14,14,1,2,30,21,51,1229
15,15,0,0,30,21,51,1229
0,0,1,0,1,0,1,1230
1,1,0,0,1,0,1,1230
0,0,1,0,1,0,1,1231
1,1,1,0,2,0,2,1231
2,2,1,0,3,0,3,1231
3,3,0,0,3,0,3,1231
0,0,1,0,1,0,1,1232
1,1,0,2,1,2,3,1232
2,2,1,1,2,3,5,1232
3,3,1,0,3,3,6,1232
4,4,0,0,3,3,6,1232
0,0,1,0,1,0,1,1233
1,1,0,0,1,0,1,1233
0,0,1,0,1,0,1,1234
1,1,1,0,2,0,2,1234
2,2,0,1,2,1,3,1234
3,3,0,0,2,1,3,1234
0,0,1,0,1,0,1,1235
1,1,0,1,1,1,2,1235
2,2,1,2,2,3,5,1235
3,3,2,3,4,6,10,1235
4,4,3,1,7,7,14,1235
5,5,0,0,7,7,14,1235
0,0,1,0,1,0,1,1236
1,1,1,0,2,0,2,1236
2,2,0,0,2,0,2,1236
0,0,1,0,1,0,1,1237
1,1,1,1,2,1,3,1237
2,2,1,0,3,1,4,1237
3,3,0,1,3,2,5,1237
4,4,0,2,3,4,7,1237
5,5,0,1,3,5,8,1237
6,6,0,0,3,5,8,1237
0,0,1,0,1,0,1,1238
1,1,2,0,3,0,3,1238
2,2,3,0,6,0,6,1238
3,3,2,0,8,0,8,1238
4,4,2,1,10,1,11,1238
5,5,1,1,11,2,13,1238
6,6,2,0,13,2,15,1238
7,7,0,0,13,2,15,1238
0,0,1,0,1,0,1,1239
1,1,1,0,2,0,2,1239
2,2,2,0,4,0,4,1239
3,3,1,0,5,0,5,1239
4,4,1,0,6,0,6,1239
5,5,0,0,6,0,6,1239
0,0,1,0,1,0,1,1240
1,1,1,0,2,0,2,1240
2,2,0,0,2,0,2,1240
0,0,1,0,1,0,1,1241
1,1,2,2,3,2,5,1241
2,2,3,5,6,7,13,1241
3,3,2,8,8,15,23,1241
4,4,3,3,11,18,29,1241
5,5,4,3,15,21,36,1241
6,6,3,5,18,26,44,1241
7,7,3,5,21,31,52,1241
8,8,2,3,23,34,57,1241
9,9,2,1,25,35,60,1241
10,10,2,0,27,35,62,1241
11,11,0,2,27,37,64,1241
12,12,0,2,27,39,66,1241
13,13,0,1,27,40,67,1241
14,14,0,0,27,40,67,1241
0,0,1,0,1,0,1,1242
1,1,2,0,3,0,3,1242
2,2,4,1,7,1,8,1242
3,3,4,1,11,2,13,1242
4,4,0,1,11,3,14,1242
5,5,0,0,11,3,14,1242
0,0,1,0,1,0,1,1243
1,1,1,0,2,0,2,1243
2,2,0,0,2,0,2,1243
0,0,1,0,1,0,1,1244
1,1,1,0,2,0,2,1244
2,2,2,0,4,0,4,1244
3,3,2,1,6,1,7,1244
4,4,1,0,7,1,8,1244
5,5,2,0,9,1,10,1244
6,6,2,0,11,1,12,1244
7,7,3,0,14,1,15,1244
8,8,4,1,18,2,20,1244
9,9,2,1,20,3,23,1244
10,10,4,3,24,6,30,1244
11,11,1,5,25,11,36,1244
12,12,2,3,27,14,41,1244
13,13,2,3,29,17,46,1244
14,14,2,2,31,19,50,1244
15,15,3,1,34,20,54,1244
16,16,1,2,35,22,57,1244
17,17,0,2,35,24,59,1244
18,18,0,1,35,25,60,1244
19,19,0,0,35,25,60,1244
0,0,1,0,1,0,1,1245
1,1,0,0,1,0,1,1245
0,0,1,0,1,0,1,1246
1,1,0,0,1,0,1,1246
0,0,1,0,1,0,1,1247
1,1,1,0,2,0,2,1247
2,2,0,1,2,1,3,1247
3,3,0,0,2,1,3,1247
0,0,1,0,1,0,1,1248
1,1,1,0,2,0,2,1248
2,2,0,0,2,0,2,1248
0,0,1,0,1,0,1,1249
1,1,0,0,1,0,1,1249
0,0,1,0,1,0,1,1250
1,1,0,0,1,0,1,1250
0,0,1,0,1,0,1,1251
1,1,0,0,1,0,1,1251
0,0,1,0,1,0,1,1252
1,1,0,0,1,0,1,1252
0,0,1,0,1,0,1,1253
1,1,1,0,2,0,2,1253
2,2,1,0,3,0,3,1253
3,3,1,0,4,0,4,1253
4,4,1,0,5,0,5,1253
5,5,0,1,5,1,6,1253
6,6,0,4,5,5,10,1253
7,7,0,1,5,6,11,1253
8,8,0,2,5,8,13,1253
9,9,0,2,5,10,15,1253
10,10,0,0,5,10,15,1253
0,0,1,0,1,0,1,1254
1,1,0,0,1,0,1,1254
0,0,1,0,1,0,1,1255
1,1,3,0,4,0,4,1255
2,2,1,1,5,1,6,1255
3,3,2,1,7,2,9,1255
4,4,3,2,10,4,14,1255
5,5,3,4,13,8,21,1255
6,6,3,6,16,14,30,1255
7,7,1,3,17,17,34,1255
8,8,0,2,17,19,36,1255
9,9,0,0,17,19,36,1255
0,0,1,0,1,0,1,1256
1,1,0,0,1,0,1,1256
0,0,1,0,1,0,1,1257
1,1,1,0,2,0,2,1257
2,2,1,1,3,1,4,1257
3,3,1,1,4,2,6,1257
4,4,0,2,4,4,8,1257
5,5,1,3,5,7,12,1257
6,6,3,1,8,8,16,1257
7,7,2,2,10,10,20,1257
8,8,3,1,13,11,24,1257
9,9,4,2,17,13,30,1257
10,10,0,1,17,14,31,1257
11,11,0,1,17,15,32,1257
12,12,0,0,17,15,32,1257
0,0,1,0,1,0,1,1258
1,1,1,0,2,0,2,1258
2,2,0,0,2,0,2,1258
0,0,1,0,1,0,1,1259
1,1,0,1,1,1,2,1259
2,2,1,0,2,1,3,1259
3,3,0,0,2,1,3,1259
0,0,1,0,1,0,1,1260
1,1,0,0,1,0,1,1260
0,0,1,0,1,0,1,1261
1,1,0,0,1,0,1,1261
0,0,1,0,1,0,1,1262
1,1,1,0,2,0,2,1262
2,2,2,0,4,0,4,1262
3,3,1,0,5,0,5,1262
4,4,1,0,6,0,6,1262
5,5,0,0,6,0,6,1262
0,0,1,0,1,0,1,1263
1,1,0,0,1,0,1,1263
0,0,1,0,1,0,1,1264
1,1,1,0,2,0,2,1264
2,2,1,0,3,0,3,1264
3,3,0,0,3,0,3,1264
0,0,1,0,1,0,1,1265
1,1,0,0,1,0,1,1265
0,0,1,0,1,0,1,1266
1,1,0,0,1,0,1,1266
0,0,1,0,1,0,1,1267
1,1,1,0,2,0,2,1267
2,2,0,0,2,0,2,1267
0,0,1,0,1,0,1,1268
1,1,1,1,2,1,3,1268
2,2,1,2,3,3,6,1268
3,3,0,3,3,6,9,1268
4,4,2,3,5,9,14,1268
5,5,1,3,6,12,18,1268
6,6,3,1,9,13,22,1268
7,7,1,2,10,15,25,1268
8,8,1,2,11,17,28,1268
9,9,0,1,11,18,29,1268
10,10,1,2,12,20,32,1268
11,11,1,1,13,21,34,1268
12,12,0,2,13,23,36,1268
13,13,0,0,13,23,36,1268
0,0,1,0,1,0,1,1269
1,1,1,0,2,0,2,1269
2,2,1,0,3,0,3,1269
3,3,0,0,3,0,3,1269
0,0,1,0,1,0,1,1270
1,1,0,0,1,0,1,1270
0,0,1,0,1,0,1,1271
1,1,0,0,1,0,1,1271
0,0,1,0,1,0,1,1272
1,1,1,0,2,0,2,1272
2,2,1,0,3,0,3,1272
3,3,0,0,3,0,3,1272
0,0,1,0,1,0,1,1273
1,1,0,0,1,0,1,1273
0,0,1,0,1,0,1,1274
1,1,1,0,2,0,2,1274
2,2,1,0,3,0,3,1274
3,3,0,1,3,1,4,1274
4,4,0,2,3,3,6,1274
5,5,1,0,4,3,7,1274
6,6,2,0,6,3,9,1274
7,7,1,0,7,3,10,1274
8,8,1,1,8,4,12,1274
9,9,0,0,8,4,12,1274
0,0,1,0,1,0,1,1275
1,1,0,0,1,0,1,1275
0,0,1,0,1,0,1,1276
1,1,0,0,1,0,1,1276
0,0,1,0,1,0,1,1277
1,1,0,0,1,0,1,1277
0,0,1,0,1,0,1,1278
1,1,1,0,2,0,2,1278
2,2,1,0,3,0,3,1278
3,3,0,1,3,1,4,1278
4,4,0,1,3,2,5,1278
5,5,1,0,4,2,6,1278
6,6,1,0,5,2,7,1278
7,7,0,1,5,3,8,1278
8,8,0,0,5,3,8,1278
0,0,1,0,1,0,1,1279
1,1,1,0,2,0,2,1279
2,2,2,1,4,1,5,1279
3,3,1,0,5,1,6,1279
4,4,1,1,6,2,8,1279
5,5,2,1,8,3,11,1279
6,6,3,0,11,3,14,1279
7,7,2,0,13,3,16,1279
8,8,1,1,14,4,18,1279
9,9,1,2,15,6,21,1279
10,10,2,0,17,6,23,1279
11,11,1,1,18,7,25,1279
12,12,0,0,18,7,25,1279
0,0,1,0,1,0,1,1280
1,1,0,0,1,0,1,1280
0,0,1,0,1,0,1,1281
1,1,1,1,2,1,3,1281
2,2,1,0,3,1,4,1281
3,3,0,0,3,1,4,1281
0,0,1,0,1,0,1,1282
1,1,0,0,1,0,1,1282
0,0,1,0,1,0,1,1283
1,1,0,0,1,0,1,1283
0,0,1,0,1,0,1,1284
1,1,3,0,4,0,4,1284
2,2,2,0,6,0,6,1284
3,3,6,1,12,1,13,1284
4,4,4,2,16,3,19,1284
5,5,1,1,17,4,21,1284
6,6,0,2,17,6,23,1284
7,7,1,0,18,6,24,1284
8,8,0,0,18,6,24,1284
0,0,1,0,1,0,1,1285
1,1,0,0,1,0,1,1285
0,0,1,0,1,0,1,1286
1,1,0,0,1,0,1,1286
0,0,1,0,1,0,1,1287
1,1,0,0,1,0,1,1287
0,0,1,0,1,0,1,1288
1,1,0,0,1,0,1,1288
0,0,1,0,1,0,1,1289
1,1,2,0,3,0,3,1289
2,2,2,0,5,0,5,1289
3,3,1,0,6,0,6,1289
4,4,0,0,6,0,6,1289
0,0,1,0,1,0,1,1290
1,1,0,1,1,1,2,1290
2,2,1,0,2,1,3,1290
3,3,1,0,3,1,4,1290
4,4,1,1,4,2,6,1290
5,5,0,0,4,2,6,1290
0,0,1,0,1,0,1,1291
1,1,0,0,1,0,1,1291
0,0,1,0,1,0,1,1292
1,1,0,0,1,0,1,1292
0,0,1,0,1,0,1,1293
1,1,2,0,3,0,3,1293
2,2,1,0,4,0,4,1293
3,3,1,1,5,1,6,1293
4,4,0,1,5,2,7,1293
5,5,0,1,5,3,8,1293
6,6,0,2,5,5,10,1293
7,7,0,0,5,5,10,1293
0,0,1,0,1,0,1,1294
1,1,0,0,1,0,1,1294
0,0,1,0,1,0,1,1295
1,1,1,0,2,0,2,1295
2,2,0,0,2,0,2,1295
0,0,1,0,1,0,1,1296
1,1,2,0,3,0,3,1296
2,2,2,0,5,0,5,1296
3,3,2,1,7,1,8,1296
4,4,2,1,9,2,11,1296
5,5,3,2,12,4,16,1296
6,6,4,2,16,6,22,1296
7,7,6,3,22,9,31,1296
8,8,6,1,28,10,38,1296
9,9,1,1,29,11,40,1296
10,10,1,0,30,11,41,1296
11,11,0,0,30,11,41,1296
0,0,1,0,1,0,1,1297
1,1,2,0,3,0,3,1297
2,2,2,0,5,0,5,1297
3,3,3,0,8,0,8,1297
4,4,2,0,10,0,10,1297
5,5,1,1,11,1,12,1297
6,6,0,0,11,1,12,1297
0,0,1,0,1,0,1,1298
1,1,0,0,1,0,1,1298
0,0,1,0,1,0,1,1299
1,1,0,1,1,1,2,1299
2,2,0,2,1,3,4,1299
3,3,0,0,1,3,4,1299
0,0,1,0,1,0,1,1300
1,1,1,0,2,0,2,1300
2,2,2,0,4,0,4,1300
3,3,1,0,5,0,5,1300
4,4,0,0,5,0,5,1300
0,0,1,0,1,0,1,1301
1,1,0,1,1,1,2,1301
2,2,0,0,1,1,2,1301
0,0,1,0,1,0,1,1302
1,1,1,0,2,0,2,1302
2,2,0,0,2,0,2,1302
0,0,1,0,1,0,1,1303
1,1,0,2,1,2,3,1303
2,2,0,1,1,3,4,1303
3,3,1,0,2,3,5,1303
4,4,1,0,3,3,6,1303
5,5,0,0,3,3,6,1303
0,0,1,0,1,0,1,1304
1,1,1,1,2,1,3,1304
2,2,2,2,4,3,7,1304
3,3,2,0,6,3,9,1304
4,4,0,0,6,3,9,1304
0,0,1,0,1,0,1,1305
1,1,0,0,1,0,1,1305
0,0,1,0,1,0,1,1306
1,1,2,0,3,0,3,1306
2,2,0,0,3,0,3,1306
0,0,1,0,1,0,1,1307
1,1,2,0,3,0,3,1307
2,2,0,0,3,0,3,1307
0,0,1,0,1,0,1,1308
1,1,0,0,1,0,1,1308
0,0,1,0,1,0,1,1309
1,1,0,0,1,0,1,1309
0,0,1,0,1,0,1,1310
1,1,1,0,2,0,2,1310
2,2,1,1,3,1,4,1310
3,3,1,0,4,1,5,1310
4,4,0,0,4,1,5,1310
0,0,1,0,1,0,1,1311
1,1,0,0,1,0,1,1311
0,0,1,0,1,0,1,1312
1,1,1,0,2,0,2,1312
2,2,0,1,2,1,3,1312
3,3,0,1,2,2,4,1312
4,4,1,2,3,4,7,1312
5,5,1,2,4,6,10,1312
6,6,0,1,4,7,11,1312
7,7,0,2,4,9,13,1312
8,8,1,0,5,9,14,1312
9,9,0,0,5,9,14,1312
0,0,1,0,1,0,1,1313
1,1,1,0,2,0,2,1313
2,2,2,0,4,0,4,1313
3,3,2,0,6,0,6,1313
4,4,2,1,8,1,9,1313
5,5,3,1,11,2,13,1313
6,6,0,1,11,3,14,1313
7,7,0,0,11,3,14,1313
0,0,1,0,1,0,1,1314
1,1,0,0,1,0,1,1314
0,0,1,0,1,0,1,1315
1,1,1,0,2,0,2,1315
2,2,0,1,2,1,3,1315
3,3,0,0,2,1,3,1315
0,0,1,0,1,0,1,1316
1,1,1,0,2,0,2,1316
2,2,0,0,2,0,2,1316
0,0,1,0,1,0,1,1317
1,1,2,1,3,1,4,1317
2,2,3,0,6,1,7,1317
3,3,0,0,6,1,7,1317
0,0,1,0,1,0,1,1318
1,1,0,0,1,0,1,1318
0,0,1,0,1,0,1,1319
1,1,1,0,2,0,2,1319
2,2,2,0,4,0,4,1319
3,3,1,0,5,0,5,1319
4,4,1,0,6,0,6,1319
5,5,1,1,7,1,8,1319
6,6,0,1,7,2,9,1319
7,7,1,1,8,3,11,1319
8,8,0,0,8,3,11,1319
0,0,1,0,1,0,1,1320
1,1,0,0,1,0,1,1320
0,0,1,0,1,0,1,1321
1,1,0,1,1,1,2,1321
2,2,0,0,1,1,2,1321
0,0,1,0,1,0,1,1322
1,1,1,0,2,0,2,1322
2,2,1,0,3,0,3,1322
3,3,1,0,4,0,4,1322
4,4,0,0,4,0,4,1322
0,0,1,0,1,0,1,1323
1,1,0,0,1,0,1,1323
0,0,1,0,1,0,1,1324
1,1,3,0,4,0,4,1324
2,2,2,2,6,2,8,1324
3,3,4,2,10,4,14,1324
4,4,6,0,16,4,20,1324
5,5,4,1,20,5,25,1324
6,6,6,1,26,6,32,1324
7,7,2,2,28,8,36,1324
8,8,0,2,28,10,38,1324
9,9,0,1,28,11,39,1324
10,10,0,0,28,11,39,1324
0,0,1,0,1,0,1,1325
1,1,2,0,3,0,3,1325
2,2,3,0,6,0,6,1325
3,3,1,0,7,0,7,1325
4,4,0,0,7,0,7,1325
0,0,1,0,1,0,1,1326
1,1,1,0,2,0,2,1326
2,2,1,0,3,0,3,1326
3,3,2,0,5,0,5,1326
4,4,0,0,5,0,5,1326
0,0,1,0,1,0,1,1327
1,1,1,0,2,0,2,1327
2,2,0,0,2,0,2,1327
0,0,1,0,1,0,1,1328
1,1,0,0,1,0,1,1328
0,0,1,0,1,0,1,1329
1,1,2,0,3,0,3,1329
2,2,1,0,4,0,4,1329
3,3,1,0,5,0,5,1329
4,4,0,0,5,0,5,1329
0,0,1,0,1,0,1,1330
1,1,2,0,3,0,3,1330
2,2,2,0,5,0,5,1330
3,3,0,0,5,0,5,1330
0,0,1,0,1,0,1,1331
1,1,0,0,1,0,1,1331
0,0,1,0,1,0,1,1332
1,1,1,0,2,0,2,1332
2,2,0,0,2,0,2,1332
0,0,1,0,1,0,1,1333
1,1,1,1,2,1,3,1333
2,2,0,2,2,3,5,1333
3,3,1,2,3,5,8,1333
4,4,4,0,7,5,12,1333
5,5,4,0,11,5,16,1333
6,6,0,0,11,5,16,1333
0,0,1,0,1,0,1,1334
1,1,1,0,2,0,2,1334
2,2,1,0,3,0,3,1334
3,3,3,0,6,0,6,1334
4,4,3,2,9,2,11,1334
5,5,3,0,12,2,14,1334
6,6,2,3,14,5,19,1334
7,7,3,0,17,5,22,1334
8,8,2,0,19,5,24,1334
9,9,3,0,22,5,27,1334
10,10,3,1,25,6,31,1334
11,11,3,2,28,8,36,1334
12,12,4,4,32,12,44,1334
13,13,4,4,36,16,52,1334
14,14,4,4,40,20,60,1334
15,15,2,3,42,23,65,1334
16,16,2,2,44,25,69,1334
17,17,0,1,44,26,70,1334
18,18,0,1,44,27,71,1334
19,19,0,1,44,28,72,1334
20,20,0,0,44,28,72,1334
0,0,1,0,1,0,1,1335
1,1,0,0,1,0,1,1335
0,0,1,0,1,0,1,1336
1,1,2,1,3,1,4,1336
2,2,1,0,4,1,5,1336
3,3,1,0,5,1,6,1336
4,4,0,0,5,1,6,1336
0,0,1,0,1,0,1,1337
1,1,0,0,1,0,1,1337
0,0,1,0,1,0,1,1338
1,1,2,0,3,0,3,1338
2,2,1,0,4,0,4,1338
3,3,1,1,5,1,6,1338
4,4,0,0,5,1,6,1338
0,0,1,0,1,0,1,1339
1,1,0,0,1,0,1,1339
0,0,1,0,1,0,1,1340
1,1,0,0,1,0,1,1340
0,0,1,0,1,0,1,1341
1,1,0,0,1,0,1,1341
0,0,1,0,1,0,1,1342
1,1,2,1,3,1,4,1342
2,2,3,0,6,1,7,1342
3,3,3,0,9,1,10,1342
4,4,3,0,12,1,13,1342
5,5,1,2,13,3,16,1342
6,6,0,1,13,4,17,1342
7,7,0,1,13,5,18,1342
8,8,0,2,13,7,20,1342
9,9,1,0,14,7,21,1342
10,10,0,0,14,7,21,1342
0,0,1,0,1,0,1,1343
1,1,1,0,2,0,2,1343
2,2,0,1,2,1,3,1343
3,3,0,0,2,1,3,1343
0,0,1,0,1,0,1,1344
1,1,0,2,1,2,3,1344
2,2,0,4,1,6,7,1344
3,3,0,4,1,10,11,1344
4,4,1,5,2,15,17,1344
5,5,3,7,5,22,27,1344
6,6,2,4,7,26,33,1344
7,7,2,0,9,26,35,1344
8,8,2,0,11,26,37,1344
9,9,1,0,12,26,38,1344
10,10,1,0,13,26,39,1344
11,11,2,0,15,26,41,1344
12,12,0,0,15,26,41,1344
0,0,1,0,1,0,1,1345
1,1,1,0,2,0,2,1345
2,2,1,0,3,0,3,1345
3,3,1,0,4,0,4,1345
4,4,0,1,4,1,5,1345
5,5,0,0,4,1,5,1345
0,0,1,0,1,0,1,1346
1,1,0,0,1,0,1,1346
0,0,1,0,1,0,1,1347
1,1,1,1,2,1,3,1347
2,2,0,1,2,2,4,1347
3,3,0,1,2,3,5,1347
4,4,0,1,2,4,6,1347
5,5,0,0,2,4,6,1347
0,0,1,0,1,0,1,1348
1,1,2,0,3,0,3,1348
2,2,1,0,4,0,4,1348
3,3,0,0,4,0,4,1348
0,0,1,0,1,0,1,1349
1,1,0,0,1,0,1,1349
0,0,1,0,1,0,1,1350
1,1,2,0,3,0,3,1350
2,2,3,0,6,0,6,1350
3,3,3,0,9,0,9,1350
4,4,1,3,10,3,13,1350
5,5,1,1,11,4,15,1350
6,6,0,1,11,5,16,1350
7,7,1,0,12,5,17,1350
8,8,1,0,13,5,18,1350
9,9,1,0,14,5,19,1350
10,10,0,0,14,5,19,1350
0,0,1,0,1,0,1,1351
1,1,1,0,2,0,2,1351
2,2,1,0,3,0,3,1351
3,3,0,0,3,0,3,1351
0,0,1,0,1,0,1,1352
1,1,2,0,3,0,3,1352
2,2,1,0,4,0,4,1352
3,3,0,0,4,0,4,1352
0,0,1,0,1,0,1,1353
1,1,1,0,2,0,2,1353
2,2,0,0,2,0,2,1353
0,0,1,0,1,0,1,1354
1,1,0,0,1,0,1,1354
0,0,1,0,1,0,1,1355
1,1,1,0,2,0,2,1355
2,2,1,0,3,0,3,1355
3,3,3,0,6,0,6,1355
4,4,5,0,11,0,11,1355
5,5,5,0,16,0,16,1355
6,6,4,3,20,3,23,1355
7,7,2,7,22,10,32,1355
8,8,4,5,26,15,41,1355
9,9,2,4,28,19,47,1355
10,10,3,3,31,22,53,1355
11,11,3,2,34,24,58,1355
12,12,3,0,37,24,61,1355
13,13,4,2,41,26,67,1355
14,14,7,3,48,29,77,1355
15,15,3,3,51,32,83,1355
16,16,5,1,56,33,89,1355
17,17,2,1,58,34,92,1355
18,18,0,1,58,35,93,1355
19,19,0,0,58,35,93,1355
0,0,1,0,1,0,1,1356
1,1,1,0,2,0,2,1356
2,2,1,0,3,0,3,1356
3,3,2,0,5,0,5,1356
4,4,2,0,7,0,7,1356
5,5,0,0,7,0,7,1356
0,0,1,0,1,0,1,1357
1,1,0,0,1,0,1,1357
0,0,1,0,1,0,1,1358
1,1,0,0,1,0,1,1358
0,0,1,0,1,0,1,1359
1,1,0,0,1,0,1,1359
0,0,1,0,1,0,1,1360
1,1,0,1,1,1,2,1360
2,2,1,0,2,1,3,1360
3,3,1,0,3,1,4,1360
4,4,1,1,4,2,6,1360
5,5,1,0,5,2,7,1360
6,6,0,0,5,2,7,1360
0,0,1,0,1,0,1,1361
1,1,1,1,2,1,3,1361
2,2,0,2,2,3,5,1361
3,3,0,0,2,3,5,1361
0,0,1,0,1,0,1,1362
1,1,0,1,1,1,2,1362
2,2,0,0,1,1,2,1362
0,0,1,0,1,0,1,1363
1,1,1,0,2,0,2,1363
2,2,0,0,2,0,2,1363
0,0,1,0,1,0,1,1364
1,1,0,0,1,0,1,1364
0,0,1,0,1,0,1,1365
1,1,1,0,2,0,2,1365
2,2,1,1,3,1,4,1365
3,3,4,2,7,3,10,1365
4,4,3,1,10,4,14,1365
5,5,2,0,12,4,16,1365
6,6,1,0,13,4,17,1365
7,7,2,1,15,5,20,1365
8,8,2,0,17,5,22,1365
9,9,0,0,17,5,22,1365
0,0,1,0,1,0,1,1366
1,1,0,0,1,0,1,1366
0,0,1,0,1,0,1,1367
1,1,0,0,1,0,1,1367
0,0,1,0,1,0,1,1368
1,1,0,0,1,0,1,1368
0,0,1,0,1,0,1,1369
1,1,0,1,1,1,2,1369
2,2,0,1,1,2,3,1369
3,3,0,0,1,2,3,1369
0,0,1,0,1,0,1,1370
1,1,2,0,3,0,3,1370
2,2,0,0,3,0,3,1370
0,0,1,0,1,0,1,1371
1,1,0,0,1,0,1,1371
0,0,1,0,1,0,1,1372
1,1,1,0,2,0,2,1372
2,2,1,0,3,0,3,1372
3,3,0,0,3,0,3,1372
0,0,1,0,1,0,1,1373
1,1,0,0,1,0,1,1373
0,0,1,0,1,0,1,1374
1,1,0,1,1,1,2,1374
2,2,0,1,1,2,3,1374
3,3,0,0,1,2,3,1374
0,0,1,0,1,0,1,1375
1,1,1,0,2,0,2,1375
2,2,1,0,3,0,3,1375
3,3,0,0,3,0,3,1375
0,0,1,0,1,0,1,1376
1,1,3,0,4,0,4,1376
2,2,3,0,7,0,7,1376
3,3,3,0,10,0,10,1376
4,4,4,2,14,2,16,1376
5,5,4,4,18,6,24,1376
6,6,3,2,21,8,29,1376
7,7,3,3,24,11,35,1376
8,8,2,5,26,16,42,1376
9,9,3,8,29,24,53,1376
10,10,8,4,37,28,65,1376
11,11,5,3,42,31,73,1376
12,12,5,1,47,32,79,1376
13,13,5,1,52,33,85,1376
14,14,3,4,55,37,92,1376
15,15,1,2,56,39,95,1376
16,16,3,3,59,42,101,1376
17,17,3,2,62,44,106,1376
18,18,2,4,64,48,112,1376
19,19,3,2,67,50,117,1376
20,20,4,3,71,53,124,1376
21,21,6,1,77,54,131,1376
22,22,2,2,79,56,135,1376
23,23,5,2,84,58,142,1376
24,24,7,5,91,63,154,1376
25,25,5,5,96,68,164,1376
26,26,3,1,99,69,168,1376
27,27,3,0,102,69,171,1376
28,28,3,1,105,70,175,1376
29,29,4,1,109,71,180,1376
30,30,2,0,111,71,182,1376
31,31,1,1,112,72,184,1376
32,32,0,1,112,73,185,1376
33,33,0,0,112,73,185,1376
0,0,1,0,1,0,1,1377
1,1,0,0,1,0,1,1377
0,0,1,0,1,0,1,1378
1,1,0,0,1,0,1,1378
0,0,1,0,1,0,1,1379
1,1,0,0,1,0,1,1379
0,0,1,0,1,0,1,1380
1,1,0,0,1,0,1,1380
0,0,1,0,1,0,1,1381
1,1,3,0,4,0,4,1381
2,2,3,0,7,0,7,1381
3,3,2,2,9,2,11,1381
4,4,0,3,9,5,14,1381
5,5,2,2,11,7,18,1381
6,6,1,2,12,9,21,1381
7,7,1,1,13,10,23,1381
8,8,0,0,13,10,23,1381
0,0,1,0,1,0,1,1382
1,1,0,0,1,0,1,1382
0,0,1,0,1,0,1,1383
1,1,0,0,1,0,1,1383
0,0,1,0,1,0,1,1384
1,1,0,0,1,0,1,1384
0,0,1,0,1,0,1,1385
1,1,0,0,1,0,1,1385
0,0,1,0,1,0,1,1386
1,1,1,0,2,0,2,1386
2,2,0,1,2,1,3,1386
3,3,0,3,2,4,6,1386
4,4,0,1,2,5,7,1386
5,5,0,0,2,5,7,1386
0,0,1,0,1,0,1,1387
1,1,0,0,1,0,1,1387
0,0,1,0,1,0,1,1388
1,1,1,1,2,1,3,1388
2,2,1,1,3,2,5,1388
3,3,1,0,4,2,6,1388
4,4,0,0,4,2,6,1388
0,0,1,0,1,0,1,1389
1,1,1,0,2,0,2,1389
2,2,0,1,2,1,3,1389
3,3,0,1,2,2,4,1389
4,4,0,0,2,2,4,1389
0,0,1,0,1,0,1,1390
1,1,1,0,2,0,2,1390
2,2,1,0,3,0,3,1390
3,3,2,0,5,0,5,1390
4,4,3,0,8,0,8,1390
5,5,5,0,13,0,13,1390
6,6,3,1,16,1,17,1390
7,7,2,0,18,1,19,1390
8,8,1,0,19,1,20,1390
9,9,0,0,19,1,20,1390
0,0,1,0,1,0,1,1391
1,1,0,0,1,0,1,1391
0,0,1,0,1,0,1,1392
1,1,0,0,1,0,1,1392
0,0,1,0,1,0,1,1393
1,1,2,0,3,0,3,1393
2,2,1,0,4,0,4,1393
3,3,0,0,4,0,4,1393
0,0,1,0,1,0,1,1394
1,1,2,0,3,0,3,1394
2,2,1,0,4,0,4,1394
3,3,0,0,4,0,4,1394
0,0,1,0,1,0,1,1395
1,1,2,0,3,0,3,1395
2,2,2,0,5,0,5,1395
3,3,0,0,5,0,5,1395
0,0,1,0,1,0,1,1396
1,1,1,0,2,0,2,1396
2,2,0,0,2,0,2,1396
0,0,1,0,1,0,1,1397
1,1,0,0,1,0,1,1397
0,0,1,0,1,0,1,1398
1,1,0,0,1,0,1,1398
0,0,1,0,1,0,1,1399
1,1,0,0,1,0,1,1399
0,0,1,0,1,0,1,1400
1,1,0,0,1,0,1,1400
0,0,1,0,1,0,1,1401
1,1,3,1,4,1,5,1401
2,2,1,4,5,5,10,1401
3,3,2,3,7,8,15,1401
4,4,3,1,10,9,19,1401
5,5,4,2,14,11,25,1401
6,6,2,0,16,11,27,1401
7,7,3,1,19,12,31,1401
8,8,0,2,19,14,33,1401
9,9,1,1,20,15,35,1401
10,10,0,0,20,15,35,1401
0,0,1,0,1,0,1,1402
1,1,2,0,3,0,3,1402
2,2,0,0,3,0,3,1402
0,0,1,0,1,0,1,1403
1,1,1,0,2,0,2,1403
2,2,1,2,3,2,5,1403
3,3,0,0,3,2,5,1403
0,0,1,0,1,0,1,1404
1,1,1,0,2,0,2,1404
2,2,0,0,2,0,2,1404
0,0,1,0,1,0,1,1405
1,1,0,1,1,1,2,1405
2,2,0,0,1,1,2,1405
0,0,1,0,1,0,1,1406
1,1,1,0,2,0,2,1406
2,2,0,0,2,0,2,1406
0,0,1,0,1,0,1,1407
1,1,1,0,2,0,2,1407
2,2,1,0,3,0,3,1407
3,3,0,0,3,0,3,1407
0,0,1,0,1,0,1,1408
1,1,1,0,2,0,2,1408
2,2,1,0,3,0,3,1408
3,3,1,0,4,0,4,1408
4,4,0,0,4,0,4,1408
0,0,1,0,1,0,1,1409
1,1,1,0,2,0,2,1409
2,2,0,0,2,0,2,1409
0,0,1,0,1,0,1,1410
1,1,1,0,2,0,2,1410
2,2,1,0,3,0,3,1410
3,3,1,0,4,0,4,1410
4,4,2,1,6,1,7,1410
5,5,0,1,6,2,8,1410
6,6,0,0,6,2,8,1410
0,0,1,0,1,0,1,1411
1,1,0,1,1,1,2,1411
2,2,0,2,1,3,4,1411
3,3,0,1,1,4,5,1411
4,4,0,0,1,4,5,1411
0,0,1,0,1,0,1,1412
1,1,2,0,3,0,3,1412
2,2,3,0,6,0,6,1412
3,3,7,0,13,0,13,1412
4,4,4,1,17,1,18,1412
5,5,1,2,18,3,21,1412
6,6,1,0,19,3,22,1412
7,7,0,0,19,3,22,1412
0,0,1,0,1,0,1,1413
1,1,0,0,1,0,1,1413
0,0,1,0,1,0,1,1414
1,1,2,0,3,0,3,1414
2,2,1,0,4,0,4,1414
3,3,1,0,5,0,5,1414
4,4,2,0,7,0,7,1414
5,5,1,0,8,0,8,1414
6,6,1,0,9,0,9,1414
7,7,1,1,10,1,11,1414
8,8,3,0,13,1,14,1414
9,9,1,1,14,2,16,1414
10,10,0,2,14,4,18,1414
11,11,2,2,16,6,22,1414
12,12,1,4,17,10,27,1414
13,13,0,2,17,12,29,1414
14,14,2,2,19,14,33,1414
15,15,0,1,19,15,34,1414
16,16,1,1,20,16,36,1414
17,17,0,0,20,16,36,1414
0,0,1,0,1,0,1,1415
1,1,0,0,1,0,1,1415
0,0,1,0,1,0,1,1416
1,1,0,0,1,0,1,1416
0,0,1,0,1,0,1,1417
1,1,1,0,2,0,2,1417
2,2,1,0,3,0,3,1417
3,3,0,0,3,0,3,1417
0,0,1,0,1,0,1,1418
1,1,1,0,2,0,2,1418
2,2,0,0,2,0,2,1418
0,0,1,0,1,0,1,1419
1,1,1,0,2,0,2,1419
2,2,1,0,3,0,3,1419
3,3,0,0,3,0,3,1419
0,0,1,0,1,0,1,1420
1,1,2,0,3,0,3,1420
2,2,2,0,5,0,5,1420
3,3,3,0,8,0,8,1420
4,4,5,0,13,0,13,1420
5,5,2,0,15,0,15,1420
6,6,2,1,17,1,18,1420
7,7,2,1,19,2,21,1420
8,8,1,1,20,3,23,1420
9,9,0,3,20,6,26,1420
10,10,0,1,20,7,27,1420
11,11,1,0,21,7,28,1420
12,12,0,0,21,7,28,1420
0,0,1,0,1,0,1,1421
1,1,0,0,1,0,1,1421
0,0,1,0,1,0,1,1422
1,1,1,0,2,0,2,1422
2,2,1,0,3,0,3,1422
3,3,1,0,4,0,4,1422
4,4,0,0,4,0,4,1422
0,0,1,0,1,0,1,1423
1,1,0,0,1,0,1,1423
0,0,1,0,1,0,1,1424
1,1,0,2,1,2,3,1424
2,2,0,1,1,3,4,1424
3,3,0,0,1,3,4,1424
0,0,1,0,1,0,1,1425
1,1,1,0,2,0,2,1425
2,2,0,1,2,1,3,1425
3,3,0,0,2,1,3,1425
0,0,1,0,1,0,1,1426
1,1,0,0,1,0,1,1426
0,0,1,0,1,0,1,1427
1,1,0,0,1,0,1,1427
0,0,1,0,1,0,1,1428
1,1,0,0,1,0,1,1428
0,0,1,0,1,0,1,1429
1,1,1,0,2,0,2,1429
2,2,0,0,2,0,2,1429
0,0,1,0,1,0,1,1430
1,1,0,0,1,0,1,1430
0,0,1,0,1,0,1,1431
1,1,1,0,2,0,2,1431
2,2,1,1,3,1,4,1431
3,3,1,0,4,1,5,1431
4,4,1,0,5,1,6,1431
5,5,0,0,5,1,6,1431
0,0,1,0,1,0,1,1432
1,1,0,0,1,0,1,1432
0,0,1,0,1,0,1,1433
1,1,1,0,2,0,2,1433
2,2,1,0,3,0,3,1433
3,3,2,0,5,0,5,1433
4,4,0,0,5,0,5,1433
0,0,1,0,1,0,1,1434
1,1,0,0,1,0,1,1434
0,0,1,0,1,0,1,1435
1,1,1,1,2,1,3,1435
2,2,0,3,2,4,6,1435
3,3,1,0,3,4,7,1435
4,4,0,1,3,5,8,1435
5,5,0,0,3,5,8,1435
0,0,1,0,1,0,1,1436
1,1,1,0,2,0,2,1436
2,2,1,0,3,0,3,1436
3,3,1,0,4,0,4,1436
4,4,1,0,5,0,5,1436
5,5,0,0,5,0,5,1436
0,0,1,0,1,0,1,1437
1,1,0,0,1,0,1,1437
0,0,1,0,1,0,1,1438
1,1,0,0,1,0,1,1438
0,0,1,0,1,0,1,1439
1,1,1,0,2,0,2,1439
2,2,0,0,2,0,2,1439
0,0,1,0,1,0,1,1440
1,1,1,0,2,0,2,1440
2,2,2,0,4,0,4,1440
3,3,3,0,7,0,7,1440
4,4,3,2,10,2,12,1440
5,5,5,1,15,3,18,1440
6,6,3,3,18,6,24,1440
7,7,5,1,23,7,30,1440
8,8,3,3,26,10,36,1440
9,9,3,4,29,14,43,1440
10,10,6,2,35,16,51,1440
11,11,7,3,42,19,61,1440
12,12,5,3,47,22,69,1440
13,13,4,3,51,25,76,1440
14,14,5,1,56,26,82,1440
15,15,2,1,58,27,85,1440
16,16,1,1,59,28,87,1440
17,17,0,1,59,29,88,1440
18,18,0,1,59,30,89,1440
19,19,0,0,59,30,89,1440
0,0,1,0,1,0,1,1441
1,1,3,0,4,0,4,1441
2,2,6,0,10,0,10,1441
3,3,4,0,14,0,14,1441
4,4,4,2,18,2,20,1441
5,5,4,3,22,5,27,1441
6,6,3,5,25,10,35,1441
7,7,8,2,33,12,45,1441
8,8,9,2,42,14,56,1441
9,9,14,2,56,16,72,1441
10,10,4,2,60,18,78,1441
11,11,4,6,64,24,88,1441
12,12,3,4,67,28,95,1441
13,13,4,1,71,29,100,1441
14,14,4,2,75,31,106,1441
15,15,2,2,77,33,110,1441
16,16,4,1,81,34,115,1441
17,17,3,1,84,35,119,1441
18,18,0,1,84,36,120,1441
19,19,0,0,84,36,120,1441
0,0,1,0,1,0,1,1442
1,1,2,0,3,0,3,1442
2,2,2,0,5,0,5,1442
3,3,1,0,6,0,6,1442
4,4,1,0,7,0,7,1442
5,5,0,0,7,0,7,1442
0,0,1,0,1,0,1,1443
1,1,2,0,3,0,3,1443
2,2,1,0,4,0,4,1443
3,3,0,0,4,0,4,1443
0,0,1,0,1,0,1,1444
1,1,0,0,1,0,1,1444
0,0,1,0,1,0,1,1445
1,1,1,2,2,2,4,1445
2,2,0,2,2,4,6,1445
3,3,0,0,2,4,6,1445
0,0,1,0,1,0,1,1446
1,1,0,0,1,0,1,1446
0,0,1,0,1,0,1,1447
1,1,1,0,2,0,2,1447
2,2,0,1,2,1,3,1447
3,3,0,0,2,1,3,1447
0,0,1,0,1,0,1,1448
1,1,1,0,2,0,2,1448
2,2,2,0,4,0,4,1448
3,3,0,0,4,0,4,1448
0,0,1,0,1,0,1,1449
1,1,1,0,2,0,2,1449
2,2,0,0,2,0,2,1449
0,0,1,0,1,0,1,1450
1,1,1,0,2,0,2,1450
2,2,2,0,4,0,4,1450
3,3,0,1,4,1,5,1450
4,4,0,4,4,5,9,1450
5,5,0,4,4,9,13,1450
6,6,0,2,4,11,15,1450
7,7,0,2,4,13,17,1450
8,8,0,2,4,15,19,1450
9,9,0,2,4,17,21,1450
10,10,0,2,4,19,23,1450
11,11,0,0,4,19,23,1450
0,0,1,0,1,0,1,1451
1,1,1,0,2,0,2,1451
2,2,0,1,2,1,3,1451
3,3,0,2,2,3,5,1451
4,4,0,0,2,3,5,1451
0,0,1,0,1,0,1,1452
1,1,1,0,2,0,2,1452
2,2,1,0,3,0,3,1452
3,3,0,0,3,0,3,1452
0,0,1,0,1,0,1,1453
1,1,1,0,2,0,2,1453
2,2,1,0,3,0,3,1453
3,3,1,0,4,0,4,1453
4,4,0,0,4,0,4,1453
0,0,1,0,1,0,1,1454
1,1,1,0,2,0,2,1454
2,2,0,0,2,0,2,1454
0,0,1,0,1,0,1,1455
1,1,0,0,1,0,1,1455
0,0,1,0,1,0,1,1456
1,1,1,0,2,0,2,1456
2,2,1,0,3,0,3,1456
3,3,0,0,3,0,3,1456
0,0,1,0,1,0,1,1457
1,1,0,0,1,0,1,1457
0,0,1,0,1,0,1,1458
1,1,0,0,1,0,1,1458
0,0,1,0,1,0,1,1459
1,1,0,0,1,0,1,1459
0,0,1,0,1,0,1,1460
1,1,1,0,2,0,2,1460
2,2,2,0,4,0,4,1460
3,3,3,0,7,0,7,1460
4,4,0,0,7,0,7,1460
0,0,1,0,1,0,1,1461
1,1,0,1,1,1,2,1461
2,2,0,2,1,3,4,1461
3,3,0,2,1,5,6,1461
4,4,0,2,1,7,8,1461
5,5,0,0,1,7,8,1461
0,0,1,0,1,0,1,1462
1,1,1,0,2,0,2,1462
2,2,0,2,2,2,4,1462
3,3,0,2,2,4,6,1462
4,4,2,1,4,5,9,1462
5,5,3,2,7,7,14,1462
6,6,5,1,12,8,20,1462
7,7,6,2,18,10,28,1462
8,8,3,0,21,10,31,1462
9,9,2,1,23,11,34,1462
10,10,2,0,25,11,36,1462
11,11,0,2,25,13,38,1462
12,12,0,1,25,14,39,1462
13,13,0,1,25,15,40,1462
14,14,0,0,25,15,40,1462
0,0,1,0,1,0,1,1463
1,1,0,0,1,0,1,1463
0,0,1,0,1,0,1,1464
1,1,0,1,1,1,2,1464
2,2,0,0,1,1,2,1464
0,0,1,0,1,0,1,1465
1,1,1,1,2,1,3,1465
2,2,0,0,2,1,3,1465
0,0,1,0,1,0,1,1466
1,1,1,0,2,0,2,1466
2,2,1,0,3,0,3,1466
3,3,1,0,4,0,4,1466
4,4,2,0,6,0,6,1466
5,5,1,0,7,0,7,1466
6,6,0,0,7,0,7,1466
0,0,1,0,1,0,1,1467
1,1,0,0,1,0,1,1467
0,0,1,0,1,0,1,1468
1,1,0,0,1,0,1,1468
0,0,1,0,1,0,1,1469
1,1,1,0,2,0,2,1469
2,2,0,0,2,0,2,1469
0,0,1,0,1,0,1,1470
1,1,1,0,2,0,2,1470
2,2,0,1,2,1,3,1470
3,3,0,2,2,3,5,1470
4,4,1,1,3,4,7,1470
5,5,0,0,3,4,7,1470
0,0,1,0,1,0,1,1471
1,1,0,0,1,0,1,1471
0,0,1,0,1,0,1,1472
1,1,1,0,2,0,2,1472
2,2,1,0,3,0,3,1472
3,3,0,0,3,0,3,1472
0,0,1,0,1,0,1,1473
1,1,0,0,1,0,1,1473
0,0,1,0,1,0,1,1474
1,1,0,0,1,0,1,1474
0,0,1,0,1,0,1,1475
1,1,0,0,1,0,1,1475
0,0,1,0,1,0,1,1476
1,1,1,1,2,1,3,1476
2,2,0,3,2,4,6,1476
3,3,1,1,3,5,8,1476
4,4,1,0,4,5,9,1476
5,5,0,0,4,5,9,1476
0,0,1,0,1,0,1,1477
1,1,1,0,2,0,2,1477
2,2,1,0,3,0,3,1477
3,3,0,0,3,0,3,1477
0,0,1,0,1,0,1,1478
1,1,0,1,1,1,2,1478
2,2,0,0,1,1,2,1478
0,0,1,0,1,0,1,1479
1,1,3,0,4,0,4,1479
2,2,3,1,7,1,8,1479
3,3,2,1,9,2,11,1479
4,4,2,1,11,3,14,1479
5,5,0,2,11,5,16,1479
6,6,0,2,11,7,18,1479
7,7,0,2,11,9,20,1479
8,8,0,3,11,12,23,1479
9,9,0,1,11,13,24,1479
10,10,0,0,11,13,24,1479
0,0,1,0,1,0,1,1480
1,1,0,0,1,0,1,1480
0,0,1,0,1,0,1,1481
1,1,0,1,1,1,2,1481
2,2,0,1,1,2,3,1481
3,3,0,0,1,2,3,1481
0,0,1,0,1,0,1,1482
1,1,0,0,1,0,1,1482
0,0,1,0,1,0,1,1483
1,1,1,0,2,0,2,1483
2,2,0,0,2,0,2,1483
0,0,1,0,1,0,1,1484
1,1,0,0,1,0,1,1484
0,0,1,0,1,0,1,1485
1,1,0,0,1,0,1,1485
0,0,1,0,1,0,1,1486
1,1,0,0,1,0,1,1486
0,0,1,0,1,0,1,1487
1,1,0,1,1,1,2,1487
2,2,0,0,1,1,2,1487
0,0,1,0,1,0,1,1488
1,1,0,0,1,0,1,1488
0,0,1,0,1,0,1,1489
1,1,0,0,1,0,1,1489
0,0,1,0,1,0,1,1490
1,1,2,0,3,0,3,1490
2,2,1,0,4,0,4,1490
3,3,1,1,5,1,6,1490
4,4,0,1,5,2,7,1490
5,5,0,0,5,2,7,1490
0,0,1,0,1,0,1,1491
1,1,0,0,1,0,1,1491
0,0,1,0,1,0,1,1492
1,1,0,0,1,0,1,1492
0,0,1,0,1,0,1,1493
1,1,1,0,2,0,2,1493
2,2,0,0,2,0,2,1493
0,0,1,0,1,0,1,1494
1,1,2,0,3,0,3,1494
2,2,2,1,5,1,6,1494
3,3,2,0,7,1,8,1494
4,4,1,0,8,1,9,1494
5,5,0,0,8,1,9,1494
0,0,1,0,1,0,1,1495
1,1,2,1,3,1,4,1495
2,2,2,1,5,2,7,1495
3,3,2,1,7,3,10,1495
4,4,3,2,10,5,15,1495
5,5,1,7,11,12,23,1495
6,6,0,5,11,17,28,1495
7,7,0,0,11,17,28,1495
0,0,1,0,1,0,1,1496
1,1,0,0,1,0,1,1496
0,0,1,0,1,0,1,1497
1,1,0,1,1,1,2,1497
2,2,0,0,1,1,2,1497
0,0,1,0,1,0,1,1498
1,1,1,0,2,0,2,1498
2,2,0,0,2,0,2,1498
0,0,1,0,1,0,1,1499
1,1,1,0,2,0,2,1499
2,2,1,0,3,0,3,1499
3,3,0,1,3,1,4,1499
4,4,1,1,4,2,6,1499
5,5,1,1,5,3,8,1499
6,6,1,2,6,5,11,1499
7,7,0,1,6,6,12,1499
8,8,0,0,6,6,12,1499
0,0,1,0,1,0,1,1500
1,1,0,0,1,0,1,1500
0,0,1,0,1,0,1,1501
1,1,0,1,1,1,2,1501
2,2,0,2,1,3,4,1501
3,3,0,3,1,6,7,1501
4,4,0,2,1,8,9,1501
5,5,0,4,1,12,13,1501
6,6,3,2,4,14,18,1501
7,7,0,0,4,14,18,1501
0,0,1,0,1,0,1,1502
1,1,0,0,1,0,1,1502
0,0,1,0,1,0,1,1503
1,1,0,0,1,0,1,1503
0,0,1,0,1,0,1,1504
1,1,4,0,5,0,5,1504
2,2,4,1,9,1,10,1504
3,3,2,0,11,1,12,1504
4,4,2,0,13,1,14,1504
5,5,3,0,16,1,17,1504
6,6,0,1,16,2,18,1504
7,7,0,1,16,3,19,1504
8,8,0,1,16,4,20,1504
9,9,0,0,16,4,20,1504
0,0,1,0,1,0,1,1505
1,1,0,1,1,1,2,1505
2,2,0,0,1,1,2,1505
0,0,1,0,1,0,1,1506
1,1,2,0,3,0,3,1506
2,2,0,1,3,1,4,1506
3,3,0,0,3,1,4,1506
0,0,1,0,1,0,1,1507
1,1,0,1,1,1,2,1507
2,2,0,1,1,2,3,1507
3,3,1,0,2,2,4,1507
4,4,0,1,2,3,5,1507
5,5,0,0,2,3,5,1507
0,0,1,0,1,0,1,1508
1,1,1,0,2,0,2,1508
2,2,2,0,4,0,4,1508
3,3,0,0,4,0,4,1508
0,0,1,0,1,0,1,1509
1,1,1,0,2,0,2,1509
2,2,1,0,3,0,3,1509
3,3,2,0,5,0,5,1509
4,4,2,1,7,1,8,1509
5,5,2,0,9,1,10,1509
6,6,1,1,10,2,12,1509
7,7,2,0,12,2,14,1509
8,8,2,0,14,2,16,1509
9,9,0,1,14,3,17,1509
10,10,0,0,14,3,17,1509
0,0,1,0,1,0,1,1510
1,1,1,0,2,0,2,1510
2,2,1,0,3,0,3,1510
3,3,2,0,5,0,5,1510
4,4,2,0,7,0,7,1510
5,5,0,1,7,1,8,1510
6,6,2,1,9,2,11,1510
7,7,1,0,10,2,12,1510
8,8,0,0,10,2,12,1510
0,0,1,0,1,0,1,1511
1,1,1,0,2,0,2,1511
2,2,0,0,2,0,2,1511
0,0,1,0,1,0,1,1512
1,1,1,0,2,0,2,1512
2,2,0,0,2,0,2,1512
0,0,1,0,1,0,1,1513
1,1,5,0,6,0,6,1513
2,2,1,1,7,1,8,1513
3,3,0,0,7,1,8,1513
0,0,1,0,1,0,1,1514
1,1,2,0,3,0,3,1514
2,2,3,0,6,0,6,1514
3,3,1,1,7,1,8,1514
4,4,1,0,8,1,9,1514
5,5,1,0,9,1,10,1514
6,6,1,0,10,1,11,1514
7,7,1,1,11,2,13,1514
8,8,1,2,12,4,16,1514
9,9,0,2,12,6,18,1514
10,10,0,0,12,6,18,1514
0,0,1,0,1,0,1,1515
1,1,1,0,2,0,2,1515
2,2,0,0,2,0,2,1515
0,0,1,0,1,0,1,1516
1,1,0,0,1,0,1,1516
0,0,1,0,1,0,1,1517
1,1,1,0,2,0,2,1517
2,2,0,0,2,0,2,1517
0,0,1,0,1,0,1,1518
1,1,0,1,1,1,2,1518
2,2,0,1,1,2,3,1518
3,3,0,1,1,3,4,1518
4,4,1,1,2,4,6,1518
5,5,1,1,3,5,8,1518
6,6,0,0,3,5,8,1518
0,0,1,0,1,0,1,1519
1,1,1,0,2,0,2,1519
2,2,0,0,2,0,2,1519
0,0,1,0,1,0,1,1520
1,1,0,0,1,0,1,1520
0,0,1,0,1,0,1,1521
1,1,2,0,3,0,3,1521
2,2,0,1,3,1,4,1521
3,3,1,0,4,1,5,1521
4,4,0,0,4,1,5,1521
0,0,1,0,1,0,1,1522
1,1,0,0,1,0,1,1522
0,0,1,0,1,0,1,1523
1,1,0,0,1,0,1,1523
0,0,1,0,1,0,1,1524
1,1,1,1,2,1,3,1524
2,2,0,2,2,3,5,1524
3,3,1,2,3,5,8,1524
4,4,0,1,3,6,9,1524
5,5,1,0,4,6,10,1524
6,6,0,0,4,6,10,1524
0,0,1,0,1,0,1,1525
1,1,3,1,4,1,5,1525
2,2,1,1,5,2,7,1525
3,3,1,0,6,2,8,1525
4,4,1,0,7,2,9,1525
5,5,1,0,8,2,10,1525
6,6,3,0,11,2,13,1525
7,7,1,0,12,2,14,1525
8,8,0,0,12,2,14,1525
0,0,1,0,1,0,1,1526
1,1,2,0,3,0,3,1526
2,2,3,0,6,0,6,1526
3,3,1,0,7,0,7,1526
4,4,0,0,7,0,7,1526
0,0,1,0,1,0,1,1527
1,1,2,1,3,1,4,1527
2,2,5,0,8,1,9,1527
3,3,7,2,15,3,18,1527
4,4,7,2,22,5,27,1527
5,5,4,2,26,7,33,1527
6,6,2,4,28,11,39,1527
7,7,4,3,32,14,46,1527
8,8,5,3,37,17,54,1527
9,9,3,4,40,21,61,1527
10,10,3,5,43,26,69,1527
11,11,6,4,49,30,79,1527
12,12,1,5,50,35,85,1527
13,13,0,6,50,41,91,1527
14,14,1,4,51,45,96,1527
15,15,1,4,52,49,101,1527
16,16,4,1,56,50,106,1527
17,17,0,2,56,52,108,1527
18,18,1,4,57,56,113,1527
19,19,2,4,59,60,119,1527
20,20,3,6,62,66,128,1527
21,21,3,2,65,68,133,1527
22,22,2,4,67,72,139,1527
23,23,3,4,70,76,146,1527
24,24,2,4,72,80,152,1527
25,25,2,4,74,84,158,1527
26,26,0,3,74,87,161,1527
27,27,0,0,74,87,161,1527
0,0,1,0,1,0,1,1528
1,1,1,0,2,0,2,1528
2,2,1,0,3,0,3,1528
3,3,1,1,4,1,5,1528
4,4,0,0,4,1,5,1528
0,0,1,0,1,0,1,1529
1,1,0,1,1,1,2,1529
2,2,1,0,2,1,3,1529
3,3,0,2,2,3,5,1529
4,4,0,2,2,5,7,1529
5,5,1,0,3,5,8,1529
6,6,1,1,4,6,10,1529
7,7,0,2,4,8,12,1529
8,8,0,1,4,9,13,1529
9,9,0,0,4,9,13,1529
0,0,1,0,1,0,1,1530
1,1,1,1,2,1,3,1530
2,2,5,1,7,2,9,1530
3,3,3,1,10,3,13,1530
4,4,5,3,15,6,21,1530
5,5,5,1,20,7,27,1530
6,6,0,0,20,7,27,1530
0,0,1,0,1,0,1,1531
1,1,0,0,1,0,1,1531
0,0,1,0,1,0,1,1532
1,1,3,0,4,0,4,1532
2,2,3,1,7,1,8,1532
3,3,2,1,9,2,11,1532
4,4,0,4,9,6,15,1532
5,5,2,3,11,9,20,1532
6,6,4,4,15,13,28,1532
7,7,6,4,21,17,38,1532
8,8,2,6,23,23,46,1532
9,9,1,2,24,25,49,1532
10,10,0,0,24,25,49,1532
0,0,1,0,1,0,1,1533
1,1,1,2,2,2,4,1533
2,2,0,4,2,6,8,1533
3,3,0,5,2,11,13,1533
4,4,0,5,2,16,18,1533
5,5,0,1,2,17,19,1533
6,6,0,2,2,19,21,1533
7,7,0,1,2,20,22,1533
8,8,0,1,2,21,23,1533
9,9,0,1,2,22,24,1533
10,10,0,0,2,22,24,1533
0,0,1,0,1,0,1,1534
1,1,1,0,2,0,2,1534
2,2,0,0,2,0,2,1534
0,0,1,0,1,0,1,1535
1,1,0,0,1,0,1,1535
0,0,1,0,1,0,1,1536
1,1,0,0,1,0,1,1536
0,0,1,0,1,0,1,1537
1,1,0,0,1,0,1,1537
0,0,1,0,1,0,1,1538
1,1,0,0,1,0,1,1538
0,0,1,0,1,0,1,1539
1,1,0,0,1,0,1,1539
0,0,1,0,1,0,1,1540
1,1,1,0,2,0,2,1540
2,2,0,0,2,0,2,1540
0,0,1,0,1,0,1,1541
1,1,2,0,3,0,3,1541
2,2,5,1,8,1,9,1541
3,3,4,5,12,6,18,1541
4,4,5,4,17,10,27,1541
5,5,4,2,21,12,33,1541
6,6,4,5,25,17,42,1541
7,7,2,3,27,20,47,1541
8,8,3,4,30,24,54,1541
9,9,1,4,31,28,59,1541
10,10,2,1,33,29,62,1541
11,11,0,2,33,31,64,1541
12,12,2,1,35,32,67,1541
13,13,2,0,37,32,69,1541
14,14,0,0,37,32,69,1541
0,0,1,0,1,0,1,1542
1,1,0,0,1,0,1,1542
0,0,1,0,1,0,1,1543
1,1,0,0,1,0,1,1543
0,0,1,0,1,0,1,1544
1,1,0,1,1,1,2,1544
2,2,0,0,1,1,2,1544
0,0,1,0,1,0,1,1545
1,1,1,0,2,0,2,1545
2,2,0,0,2,0,2,1545
0,0,1,0,1,0,1,1546
1,1,0,1,1,1,2,1546
2,2,0,0,1,1,2,1546
0,0,1,0,1,0,1,1547
1,1,0,0,1,0,1,1547
0,0,1,0,1,0,1,1548
1,1,0,0,1,0,1,1548
0,0,1,0,1,0,1,1549
1,1,0,1,1,1,2,1549
2,2,0,0,1,1,2,1549
0,0,1,0,1,0,1,1550
1,1,1,0,2,0,2,1550
2,2,0,1,2,1,3,1550
3,3,1,1,3,2,5,1550
4,4,0,4,3,6,9,1550
5,5,0,2,3,8,11,1550
6,6,0,1,3,9,12,1550
7,7,0,1,3,10,13,1550
8,8,0,1,3,11,14,1550
9,9,0,0,3,11,14,1550
0,0,1,0,1,0,1,1551
1,1,0,0,1,0,1,1551
0,0,1,0,1,0,1,1552
1,1,1,0,2,0,2,1552
2,2,0,1,2,1,3,1552
3,3,0,0,2,1,3,1552
0,0,1,0,1,0,1,1553
1,1,0,0,1,0,1,1553
0,0,1,0,1,0,1,1554
1,1,1,0,2,0,2,1554
2,2,0,0,2,0,2,1554
0,0,1,0,1,0,1,1555
1,1,1,0,2,0,2,1555
2,2,0,0,2,0,2,1555
0,0,1,0,1,0,1,1556
1,1,0,2,1,2,3,1556
2,2,1,1,2,3,5,1556
3,3,2,2,4,5,9,1556
4,4,3,2,7,7,14,1556
5,5,3,1,10,8,18,1556
6,6,1,2,11,10,21,1556
7,7,1,2,12,12,24,1556
8,8,1,0,13,12,25,1556
9,9,1,0,14,12,26,1556
10,10,0,0,14,12,26,1556
0,0,1,0,1,0,1,1557
1,1,0,0,1,0,1,1557
0,0,1,0,1,0,1,1558
1,1,0,0,1,0,1,1558
0,0,1,0,1,0,1,1559
1,1,1,0,2,0,2,1559
2,2,0,0,2,0,2,1559
0,0,1,0,1,0,1,1560
1,1,0,0,1,0,1,1560
0,0,1,0,1,0,1,1561
1,1,1,1,2,1,3,1561
2,2,1,1,3,2,5,1561
3,3,2,2,5,4,9,1561
4,4,2,1,7,5,12,1561
5,5,0,2,7,7,14,1561
6,6,0,1,7,8,15,1561
7,7,0,1,7,9,16,1561
8,8,0,1,7,10,17,1561
9,9,0,1,7,11,18,1561
10,10,0,2,7,13,20,1561
11,11,0,0,7,13,20,1561
0,0,1,0,1,0,1,1562
1,1,1,0,2,0,2,1562
2,2,0,0,2,0,2,1562
0,0,1,0,1,0,1,1563
1,1,2,0,3,0,3,1563
2,2,0,0,3,0,3,1563
0,0,1,0,1,0,1,1564
1,1,0,2,1,2,3,1564
2,2,0,3,1,5,6,1564
3,3,1,2,2,7,9,1564
4,4,1,1,3,8,11,1564
5,5,0,1,3,9,12,1564
6,6,1,0,4,9,13,1564
7,7,1,0,5,9,14,1564
8,8,0,0,5,9,14,1564
0,0,1,0,1,0,1,1565
1,1,0,1,1,1,2,1565
2,2,0,1,1,2,3,1565
3,3,0,1,1,3,4,1565
4,4,0,0,1,3,4,1565
0,0,1,0,1,0,1,1566
1,1,1,0,2,0,2,1566
2,2,0,0,2,0,2,1566
0,0,1,0,1,0,1,1567
1,1,0,0,1,0,1,1567
0,0,1,0,1,0,1,1568
1,1,1,0,2,0,2,1568
2,2,1,0,3,0,3,1568
3,3,1,0,4,0,4,1568
4,4,0,0,4,0,4,1568
0,0,1,0,1,0,1,1569
1,1,0,0,1,0,1,1569
0,0,1,0,1,0,1,1570
1,1,1,0,2,0,2,1570
2,2,0,0,2,0,2,1570
0,0,1,0,1,0,1,1571
1,1,0,0,1,0,1,1571
0,0,1,0,1,0,1,1572
1,1,0,1,1,1,2,1572
2,2,0,1,1,2,3,1572
3,3,1,1,2,3,5,1572
4,4,1,0,3,3,6,1572
5,5,2,1,5,4,9,1572
6,6,2,1,7,5,12,1572
7,7,1,0,8,5,13,1572
8,8,2,0,10,5,15,1572
9,9,2,1,12,6,18,1572
10,10,0,0,12,6,18,1572
0,0,1,0,1,0,1,1573
1,1,0,0,1,0,1,1573
0,0,1,0,1,0,1,1574
1,1,1,0,2,0,2,1574
2,2,0,0,2,0,2,1574
0,0,1,0,1,0,1,1575
1,1,2,1,3,1,4,1575
2,2,3,1,6,2,8,1575
3,3,0,2,6,4,10,1575
4,4,0,0,6,4,10,1575
0,0,1,0,1,0,1,1576
1,1,2,0,3,0,3,1576
2,2,3,1,6,1,7,1576
3,3,1,0,7,1,8,1576
4,4,1,0,8,1,9,1576
5,5,4,1,12,2,14,1576
6,6,4,3,16,5,21,1576
7,7,3,1,19,6,25,1576
8,8,3,2,22,8,30,1576
9,9,4,2,26,10,36,1576
10,10,5,0,31,10,41,1576
11,11,3,0,34,10,44,1576
12,12,4,0,38,10,48,1576
13,13,5,0,43,10,53,1576
14,14,4,0,47,10,57,1576
15,15,2,2,49,12,61,1576
16,16,2,0,51,12,63,1576
17,17,0,1,51,13,64,1576
18,18,0,1,51,14,65,1576
19,19,0,1,51,15,66,1576
20,20,0,1,51,16,67,1576
21,21,0,1,51,17,68,1576
22,22,0,0,51,17,68,1576
0,0,1,0,1,0,1,1577
1,1,1,0,2,0,2,1577
2,2,0,0,2,0,2,1577
0,0,1,0,1,0,1,1578
1,1,1,0,2,0,2,1578
2,2,1,0,3,0,3,1578
3,3,0,0,3,0,3,1578
0,0,1,0,1,0,1,1579
1,1,1,0,2,0,2,1579
2,2,1,0,3,0,3,1579
3,3,1,1,4,1,5,1579
4,4,2,0,6,1,7,1579
5,5,2,0,8,1,9,1579
6,6,0,0,8,1,9,1579
0,0,1,0,1,0,1,1580
1,1,1,1,2,1,3,1580
2,2,2,0,4,1,5,1580
3,3,3,0,7,1,8,1580
4,4,1,0,8,1,9,1580
5,5,0,0,8,1,9,1580
0,0,1,0,1,0,1,1581
1,1,1,1,2,1,3,1581
2,2,4,1,6,2,8,1581
3,3,4,1,10,3,13,1581
4,4,6,1,16,4,20,1581
5,5,7,3,23,7,30,1581
6,6,2,2,25,9,34,1581
7,7,2,2,27,11,38,1581
8,8,2,0,29,11,40,1581
9,9,3,0,32,11,43,1581
10,10,0,0,32,11,43,1581
0,0,1,0,1,0,1,1582
1,1,0,0,1,0,1,1582
0,0,1,0,1,0,1,1583
1,1,1,0,2,0,2,1583
2,2,1,0,3,0,3,1583
3,3,1,0,4,0,4,1583
4,4,1,0,5,0,5,1583
5,5,0,0,5,0,5,1583
0,0,1,0,1,0,1,1584
1,1,2,0,3,0,3,1584
2,2,4,0,7,0,7,1584
3,3,3,2,10,2,12,1584
4,4,3,1,13,3,16,1584
5,5,0,1,13,4,17,1584
6,6,0,2,13,6,19,1584
7,7,0,0,13,6,19,1584
0,0,1,0,1,0,1,1585
1,1,0,0,1,0,1,1585
0,0,1,0,1,0,1,1586
1,1,2,0,3,0,3,1586
2,2,2,0,5,0,5,1586
3,3,1,2,6,2,8,1586
4,4,2,0,8,2,10,1586
5,5,2,0,10,2,12,1586
6,6,1,0,11,2,13,1586
7,7,0,0,11,2,13,1586
0,0,1,0,1,0,1,1587
1,1,0,0,1,0,1,1587
0,0,1,0,1,0,1,1588
1,1,0,0,1,0,1,1588
0,0,1,0,1,0,1,1589
1,1,0,0,1,0,1,1589
0,0,1,0,1,0,1,1590
1,1,0,0,1,0,1,1590
0,0,1,0,1,0,1,1591
1,1,0,0,1,0,1,1591
0,0,1,0,1,0,1,1592
1,1,1,0,2,0,2,1592
2,2,0,0,2,0,2,1592
0,0,1,0,1,0,1,1593
1,1,0,0,1,0,1,1593
0,0,1,0,1,0,1,1594
1,1,2,0,3,0,3,1594
2,2,1,0,4,0,4,1594
3,3,1,0,5,0,5,1594
4,4,1,0,6,0,6,1594
5,5,1,0,7,0,7,1594
6,6,0,0,7,0,7,1594
0,0,1,0,1,0,1,1595
1,1,2,1,3,1,4,1595
2,2,2,2,5,3,8,1595
3,3,3,2,8,5,13,1595
4,4,5,2,13,7,20,1595
5,5,5,2,18,9,27,1595
6,6,2,1,20,10,30,1595
7,7,1,0,21,10,31,1595
8,8,0,2,21,12,33,1595
9,9,1,0,22,12,34,1595
10,10,0,1,22,13,35,1595
11,11,0,0,22,13,35,1595
0,0,1,0,1,0,1,1596
1,1,2,1,3,1,4,1596
2,2,3,2,6,3,9,1596
3,3,2,0,8,3,11,1596
4,4,2,0,10,3,13,1596
5,5,1,0,11,3,14,1596
6,6,0,0,11,3,14,1596
0,0,1,0,1,0,1,1597
1,1,0,0,1,0,1,1597
0,0,1,0,1,0,1,1598
1,1,1,0,2,0,2,1598
2,2,2,0,4,0,4,1598
3,3,1,1,5,1,6,1598
4,4,0,0,5,1,6,1598
0,0,1,0,1,0,1,1599
1,1,2,0,3,0,3,1599
2,2,3,0,6,0,6,1599
3,3,1,0,7,0,7,1599
4,4,1,0,8,0,8,1599
5,5,2,0,10,0,10,1599
6,6,1,0,11,0,11,1599
7,7,1,0,12,0,12,1599
8,8,0,1,12,1,13,1599
9,9,1,0,13,1,14,1599
10,10,0,0,13,1,14,1599
0,0,1,0,1,0,1,1600
1,1,0,0,1,0,1,1600
0,0,1,0,1,0,1,1601
1,1,0,0,1,0,1,1601
0,0,1,0,1,0,1,1602
1,1,2,0,3,0,3,1602
2,2,2,0,5,0,5,1602
3,3,1,0,6,0,6,1602
4,4,0,0,6,0,6,1602
0,0,1,0,1,0,1,1603
1,1,1,0,2,0,2,1603
2,2,2,0,4,0,4,1603
3,3,2,0,6,0,6,1603
4,4,2,1,8,1,9,1603
5,5,4,1,12,2,14,1603
6,6,3,1,15,3,18,1603
7,7,4,3,19,6,25,1603
8,8,1,1,20,7,27,1603
9,9,1,0,21,7,28,1603
10,10,0,0,21,7,28,1603
0,0,1,0,1,0,1,1604
1,1,0,0,1,0,1,1604
0,0,1,0,1,0,1,1605
1,1,1,0,2,0,2,1605
2,2,0,0,2,0,2,1605
0,0,1,0,1,0,1,1606
1,1,1,0,2,0,2,1606
2,2,2,0,4,0,4,1606
3,3,4,0,8,0,8,1606
4,4,1,2,9,2,11,1606
5,5,0,0,9,2,11,1606
0,0,1,0,1,0,1,1607
1,1,0,0,1,0,1,1607
0,0,1,0,1,0,1,1608
1,1,0,0,1,0,1,1608
0,0,1,0,1,0,1,1609
1,1,0,1,1,1,2,1609
2,2,0,1,1,2,3,1609
3,3,0,1,1,3,4,1609
4,4,1,0,2,3,5,1609
5,5,0,0,2,3,5,1609
0,0,1,0,1,0,1,1610
1,1,0,0,1,0,1,1610
0,0,1,0,1,0,1,1611
1,1,1,0,2,0,2,1611
2,2,0,0,2,0,2,1611
0,0,1,0,1,0,1,1612
1,1,1,0,2,0,2,1612
2,2,0,0,2,0,2,1612
0,0,1,0,1,0,1,1613
1,1,0,1,1,1,2,1613
2,2,1,0,2,1,3,1613
3,3,0,0,2,1,3,1613
0,0,1,0,1,0,1,1614
1,1,3,0,4,0,4,1614
2,2,3,0,7,0,7,1614
3,3,2,0,9,0,9,1614
4,4,0,0,9,0,9,1614
0,0,1,0,1,0,1,1615
1,1,0,0,1,0,1,1615
0,0,1,0,1,0,1,1616
1,1,1,0,2,0,2,1616
2,2,1,0,3,0,3,1616
3,3,0,0,3,0,3,1616
0,0,1,0,1,0,1,1617
1,1,0,1,1,1,2,1617
2,2,0,1,1,2,3,1617
3,3,0,1,1,3,4,1617
4,4,0,1,1,4,5,1617
5,5,0,0,1,4,5,1617
0,0,1,0,1,0,1,1618
1,1,0,1,1,1,2,1618
2,2,0,0,1,1,2,1618
0,0,1,0,1,0,1,1619
1,1,0,0,1,0,1,1619
0,0,1,0,1,0,1,1620
1,1,1,0,2,0,2,1620
2,2,1,0,3,0,3,1620
3,3,0,1,3,1,4,1620
4,4,0,0,3,1,4,1620
0,0,1,0,1,0,1,1621
1,1,1,0,2,0,2,1621
2,2,3,0,5,0,5,1621
3,3,3,0,8,0,8,1621
4,4,4,1,12,1,13,1621
5,5,4,1,16,2,18,1621
6,6,2,0,18,2,20,1621
7,7,0,1,18,3,21,1621
8,8,2,1,20,4,24,1621
9,9,0,1,20,5,25,1621
10,10,0,0,20,5,25,1621
0,0,1,0,1,0,1,1622
1,1,1,0,2,0,2,1622
2,2,0,0,2,0,2,1622
0,0,1,0,1,0,1,1623
1,1,1,0,2,0,2,1623
2,2,1,0,3,0,3,1623
3,3,3,0,6,0,6,1623
4,4,2,1,8,1,9,1623
5,5,1,1,9,2,11,1623
6,6,0,2,9,4,13,1623
7,7,0,0,9,4,13,1623
0,0,1,0,1,0,1,1624
1,1,0,0,1,0,1,1624
0,0,1,0,1,0,1,1625
1,1,2,0,3,0,3,1625
2,2,2,0,5,0,5,1625
3,3,1,1,6,1,7,1625
4,4,0,1,6,2,8,1625
5,5,1,0,7,2,9,1625
6,6,0,0,7,2,9,1625
0,0,1,0,1,0,1,1626
1,1,1,0,2,0,2,1626
2,2,2,1,4,1,5,1626
3,3,2,6,6,7,13,1626
4,4,6,4,12,11,23,1626
5,5,7,6,19,17,36,1626
6,6,6,4,25,21,46,1626
7,7,8,5,33,26,59,1626
8,8,7,9,40,35,75,1626
9,9,5,6,45,41,86,1626
10,10,7,5,52,46,98,1626
11,11,7,7,59,53,112,1626
12,12,3,7,62,60,122,1626
13,13,4,6,66,66,132,1626
14,14,2,8,68,74,142,1626
15,15,2,9,70,83,153,1626
16,16,0,9,70,92,162,1626
17,17,2,7,72,99,171,1626
18,18,3,4,75,103,178,1626
19,19,3,4,78,107,185,1626
20,20,3,3,81,110,191,1626
21,21,1,1,82,111,193,1626
22,22,1,0,83,111,194,1626
23,23,2,0,85,111,196,1626
24,24,2,0,87,111,198,1626
25,25,1,2,88,113,201,1626
26,26,1,1,89,114,203,1626
27,27,1,1,90,115,205,1626
28,28,0,1,90,116,206,1626
29,29,0,1,90,117,207,1626
30,30,1,2,91,119,210,1626
31,31,1,1,92,120,212,1626
32,32,2,1,94,121,215,1626
33,33,0,1,94,122,216,1626
34,34,0,1,94,123,217,1626
35,35,0,0,94,123,217,1626
0,0,1,0,1,0,1,1627
1,1,0,0,1,0,1,1627
0,0,1,0,1,0,1,1628
1,1,0,0,1,0,1,1628
0,0,1,0,1,0,1,1629
1,1,1,0,2,0,2,1629
2,2,1,0,3,0,3,1629
3,3,1,0,4,0,4,1629
4,4,0,0,4,0,4,1629
0,0,1,0,1,0,1,1630
1,1,1,0,2,0,2,1630
2,2,0,1,2,1,3,1630
3,3,0,1,2,2,4,1630
4,4,0,0,2,2,4,1630
0,0,1,0,1,0,1,1631
1,1,0,0,1,0,1,1631
0,0,1,0,1,0,1,1632
1,1,0,0,1,0,1,1632
0,0,1,0,1,0,1,1633
1,1,0,0,1,0,1,1633
0,0,1,0,1,0,1,1634
1,1,0,0,1,0,1,1634
0,0,1,0,1,0,1,1635
1,1,1,0,2,0,2,1635
2,2,1,0,3,0,3,1635
3,3,0,0,3,0,3,1635
0,0,1,0,1,0,1,1636
1,1,0,0,1,0,1,1636
0,0,1,0,1,0,1,1637
1,1,0,0,1,0,1,1637
0,0,1,0,1,0,1,1638
1,1,0,0,1,0,1,1638
0,0,1,0,1,0,1,1639
1,1,0,0,1,0,1,1639
0,0,1,0,1,0,1,1640
1,1,0,0,1,0,1,1640
0,0,1,0,1,0,1,1641
1,1,0,0,1,0,1,1641
0,0,1,0,1,0,1,1642
1,1,0,1,1,1,2,1642
2,2,0,2,1,3,4,1642
3,3,0,1,1,4,5,1642
4,4,0,0,1,4,5,1642
0,0,1,0,1,0,1,1643
1,1,1,0,2,0,2,1643
2,2,1,0,3,0,3,1643
3,3,0,0,3,0,3,1643
0,0,1,0,1,0,1,1644
1,1,0,0,1,0,1,1644
0,0,1,0,1,0,1,1645
1,1,0,0,1,0,1,1645
0,0,1,0,1,0,1,1646
1,1,0,0,1,0,1,1646
0,0,1,0,1,0,1,1647
1,1,1,0,2,0,2,1647
2,2,0,0,2,0,2,1647
0,0,1,0,1,0,1,1648
1,1,3,0,4,0,4,1648
2,2,1,0,5,0,5,1648
3,3,0,0,5,0,5,1648
0,0,1,0,1,0,1,1649
1,1,1,0,2,0,2,1649
2,2,0,0,2,0,2,1649
0,0,1,0,1,0,1,1650
1,1,0,1,1,1,2,1650
2,2,0,0,1,1,2,1650
0,0,1,0,1,0,1,1651
1,1,0,0,1,0,1,1651
0,0,1,0,1,0,1,1652
1,1,0,0,1,0,1,1652
0,0,1,0,1,0,1,1653
1,1,1,0,2,0,2,1653
2,2,0,0,2,0,2,1653
0,0,1,0,1,0,1,1654
1,1,1,0,2,0,2,1654
2,2,1,2,3,2,5,1654
3,3,2,3,5,5,10,1654
4,4,3,3,8,8,16,1654
5,5,5,4,13,12,25,1654
6,6,3,5,16,17,33,1654
7,7,4,9,20,26,46,1654
8,8,7,5,27,31,58,1654
9,9,2,2,29,33,62,1654
10,10,2,2,31,35,66,1654
11,11,3,2,34,37,71,1654
12,12,4,2,38,39,77,1654
13,13,4,0,42,39,81,1654
14,14,0,1,42,40,82,1654
15,15,0,1,42,41,83,1654
16,16,0,0,42,41,83,1654
0,0,1,0,1,0,1,1655
1,1,1,0,2,0,2,1655
2,2,0,0,2,0,2,1655
0,0,1,0,1,0,1,1656
1,1,0,0,1,0,1,1656
0,0,1,0,1,0,1,1657
1,1,1,0,2,0,2,1657
2,2,1,0,3,0,3,1657
3,3,1,0,4,0,4,1657
4,4,1,0,5,0,5,1657
5,5,0,0,5,0,5,1657
0,0,1,0,1,0,1,1658
1,1,0,1,1,1,2,1658
2,2,0,0,1,1,2,1658
0,0,1,0,1,0,1,1659
1,1,1,0,2,0,2,1659
2,2,0,0,2,0,2,1659
0,0,1,0,1,0,1,1660
1,1,2,0,3,0,3,1660
2,2,1,1,4,1,5,1660
3,3,0,0,4,1,5,1660
0,0,1,0,1,0,1,1661
1,1,2,0,3,0,3,1661
2,2,7,2,10,2,12,1661
3,3,5,4,15,6,21,1661
4,4,2,2,17,8,25,1661
5,5,2,0,19,8,27,1661
6,6,1,0,20,8,28,1661
7,7,1,1,21,9,30,1661
8,8,1,1,22,10,32,1661
9,9,3,0,25,10,35,1661
10,10,5,0,30,10,40,1661
11,11,4,0,34,10,44,1661
12,12,2,0,36,10,46,1661
13,13,3,0,39,10,49,1661
14,14,1,2,40,12,52,1661
15,15,0,2,40,14,54,1661
16,16,0,1,40,15,55,1661
17,17,0,1,40,16,56,1661
18,18,0,0,40,16,56,1661
0,0,1,0,1,0,1,1662
1,1,0,1,1,1,2,1662
2,2,1,2,2,3,5,1662
3,3,1,1,3,4,7,1662
4,4,0,1,3,5,8,1662
5,5,0,1,3,6,9,1662
6,6,0,1,3,7,10,1662
7,7,0,0,3,7,10,1662
0,0,1,0,1,0,1,1663
1,1,0,0,1,0,1,1663
0,0,1,0,1,0,1,1664
1,1,1,0,2,0,2,1664
2,2,0,0,2,0,2,1664
0,0,1,0,1,0,1,1665
1,1,0,1,1,1,2,1665
2,2,0,0,1,1,2,1665
0,0,1,0,1,0,1,1666
1,1,1,0,2,0,2,1666
2,2,0,1,2,1,3,1666
3,3,0,4,2,5,7,1666
4,4,1,1,3,6,9,1666
5,5,0,0,3,6,9,1666
0,0,1,0,1,0,1,1667
1,1,0,0,1,0,1,1667
0,0,1,0,1,0,1,1668
1,1,1,0,2,0,2,1668
2,2,1,0,3,0,3,1668
3,3,1,0,4,0,4,1668
4,4,4,0,8,0,8,1668
5,5,2,0,10,0,10,1668
6,6,0,0,10,0,10,1668
0,0,1,0,1,0,1,1669
1,1,1,1,2,1,3,1669
2,2,2,1,4,2,6,1669
3,3,1,2,5,4,9,1669
4,4,2,2,7,6,13,1669
5,5,2,2,9,8,17,1669
6,6,3,0,12,8,20,1669
7,7,0,3,12,11,23,1669
8,8,1,3,13,14,27,1669
9,9,0,3,13,17,30,1669
10,10,0,2,13,19,32,1669
11,11,0,1,13,20,33,1669
12,12,0,0,13,20,33,1669
0,0,1,0,1,0,1,1670
1,1,0,0,1,0,1,1670
0,0,1,0,1,0,1,1671
1,1,1,0,2,0,2,1671
2,2,1,0,3,0,3,1671
3,3,1,0,4,0,4,1671
4,4,1,0,5,0,5,1671
5,5,3,0,8,0,8,1671
6,6,1,0,9,0,9,1671
7,7,2,0,11,0,11,1671
8,8,1,1,12,1,13,1671
9,9,0,2,12,3,15,1671
10,10,1,1,13,4,17,1671
11,11,0,0,13,4,17,1671
0,0,1,0,1,0,1,1672
1,1,2,0,3,0,3,1672
2,2,4,1,7,1,8,1672
3,3,6,1,13,2,15,1672
4,4,4,2,17,4,21,1672
5,5,2,1,19,5,24,1672
6,6,1,1,20,6,26,1672
7,7,1,1,21,7,28,1672
8,8,2,0,23,7,30,1672
9,9,1,0,24,7,31,1672
10,10,0,1,24,8,32,1672
11,11,0,3,24,11,35,1672
12,12,3,3,27,14,41,1672
13,13,6,6,33,20,53,1672
14,14,3,4,36,24,60,1672
15,15,5,5,41,29,70,1672
16,16,2,1,43,30,73,1672
17,17,0,1,43,31,74,1672
18,18,1,0,44,31,75,1672
19,19,0,1,44,32,76,1672
20,20,0,0,44,32,76,1672
0,0,1,0,1,0,1,1673
1,1,1,0,2,0,2,1673
2,2,0,0,2,0,2,1673
0,0,1,0,1,0,1,1674
1,1,1,0,2,0,2,1674
2,2,0,0,2,0,2,1674
0,0,1,0,1,0,1,1675
1,1,1,0,2,0,2,1675
2,2,0,0,2,0,2,1675
0,0,1,0,1,0,1,1676
1,1,1,0,2,0,2,1676
2,2,2,1,4,1,5,1676
3,3,0,4,4,5,9,1676
4,4,0,3,4,8,12,1676
5,5,1,1,5,9,14,1676
6,6,0,1,5,10,15,1676
7,7,0,2,5,12,17,1676
8,8,0,0,5,12,17,1676
0,0,1,0,1,0,1,1677
1,1,1,0,2,0,2,1677
2,2,1,0,3,0,3,1677
3,3,1,0,4,0,4,1677
4,4,1,1,5,1,6,1677
5,5,0,0,5,1,6,1677
0,0,1,0,1,0,1,1678
1,1,2,0,3,0,3,1678
2,2,5,0,8,0,8,1678
3,3,3,1,11,1,12,1678
4,4,2,3,13,4,17,1678
5,5,0,1,13,5,18,1678
6,6,0,0,13,5,18,1678
0,0,1,0,1,0,1,1679
1,1,1,0,2,0,2,1679
2,2,0,0,2,0,2,1679
0,0,1,0,1,0,1,1680
1,1,1,0,2,0,2,1680
2,2,0,0,2,0,2,1680
0,0,1,0,1,0,1,1681
1,1,0,0,1,0,1,1681
0,0,1,0,1,0,1,1682
1,1,0,0,1,0,1,1682
0,0,1,0,1,0,1,1683
1,1,2,1,3,1,4,1683
2,2,2,0,5,1,6,1683
3,3,4,0,9,1,10,1683
4,4,2,0,11,1,12,1683
5,5,4,1,15,2,17,1683
6,6,2,4,17,6,23,1683
7,7,0,4,17,10,27,1683
8,8,2,3,19,13,32,1683
9,9,4,0,23,13,36,1683
10,10,3,1,26,14,40,1683
11,11,3,1,29,15,44,1683
12,12,3,1,32,16,48,1683
13,13,2,0,34,16,50,1683
14,14,1,0,35,16,51,1683
15,15,1,0,36,16,52,1683
16,16,1,1,37,17,54,1683
17,17,1,1,38,18,56,1683
18,18,0,2,38,20,58,1683
19,19,0,5,38,25,63,1683
20,20,1,5,39,30,69,1683
21,21,3,4,42,34,76,1683
22,22,7,3,49,37,86,1683
23,23,4,3,53,40,93,1683
24,24,5,2,58,42,100,1683
25,25,7,2,65,44,109,1683
26,26,3,2,68,46,114,1683
27,27,3,0,71,46,117,1683
28,28,2,1,73,47,120,1683
29,29,1,0,74,47,121,1683
30,30,0,0,74,47,121,1683
0,0,1,0,1,0,1,1684
1,1,0,0,1,0,1,1684
0,0,1,0,1,0,1,1685
1,1,1,0,2,0,2,1685
2,2,0,0,2,0,2,1685
0,0,1,0,1,0,1,1686
1,1,0,0,1,0,1,1686
0,0,1,0,1,0,1,1687
1,1,1,0,2,0,2,1687
2,2,1,0,3,0,3,1687
3,3,1,0,4,0,4,1687
4,4,1,0,5,0,5,1687
5,5,0,0,5,0,5,1687
0,0,1,0,1,0,1,1688
1,1,1,0,2,0,2,1688
2,2,1,0,3,0,3,1688
3,3,2,0,5,0,5,1688
4,4,2,0,7,0,7,1688
5,5,0,0,7,0,7,1688
0,0,1,0,1,0,1,1689
1,1,0,0,1,0,1,1689
0,0,1,0,1,0,1,1690
1,1,2,0,3,0,3,1690
2,2,1,1,4,1,5,1690
3,3,0,0,4,1,5,1690
0,0,1,0,1,0,1,1691
1,1,2,1,3,1,4,1691
2,2,2,0,5,1,6,1691
3,3,2,1,7,2,9,1691
4,4,3,3,10,5,15,1691
5,5,1,2,11,7,18,1691
6,6,1,3,12,10,22,1691
7,7,1,3,13,13,26,1691
8,8,1,1,14,14,28,1691
9,9,1,0,15,14,29,1691
10,10,4,0,19,14,33,1691
11,11,2,0,21,14,35,1691
12,12,2,1,23,15,38,1691
13,13,0,1,23,16,39,1691
14,14,0,0,23,16,39,1691
0,0,1,0,1,0,1,1692
1,1,0,0,1,0,1,1692
0,0,1,0,1,0,1,1693
1,1,2,0,3,0,3,1693
2,2,0,0,3,0,3,1693
0,0,1,0,1,0,1,1694
1,1,0,0,1,0,1,1694
0,0,1,0,1,0,1,1695
1,1,1,0,2,0,2,1695
2,2,0,1,2,1,3,1695
3,3,0,1,2,2,4,1695
4,4,1,1,3,3,6,1695
5,5,1,0,4,3,7,1695
6,6,1,0,5,3,8,1695
7,7,1,0,6,3,9,1695
8,8,0,0,6,3,9,1695
0,0,1,0,1,0,1,1696
1,1,1,0,2,0,2,1696
2,2,3,0,5,0,5,1696
3,3,3,0,8,0,8,1696
4,4,1,0,9,0,9,1696
5,5,2,0,11,0,11,1696
6,6,0,1,11,1,12,1696
7,7,0,1,11,2,13,1696
8,8,0,0,11,2,13,1696
0,0,1,0,1,0,1,1697
1,1,0,0,1,0,1,1697
0,0,1,0,1,0,1,1698
1,1,0,0,1,0,1,1698
0,0,1,0,1,0,1,1699
1,1,1,0,2,0,2,1699
2,2,1,0,3,0,3,1699
3,3,0,1,3,1,4,1699
4,4,0,0,3,1,4,1699
0,0,1,0,1,0,1,1700
1,1,0,0,1,0,1,1700
0,0,1,0,1,0,1,1701
1,1,1,1,2,1,3,1701
2,2,0,2,2,3,5,1701
3,3,1,3,3,6,9,1701
4,4,1,2,4,8,12,1701
5,5,0,0,4,8,12,1701
0,0,1,0,1,0,1,1702
1,1,0,0,1,0,1,1702
0,0,1,0,1,0,1,1703
1,1,0,0,1,0,1,1703
0,0,1,0,1,0,1,1704
1,1,0,0,1,0,1,1704
0,0,1,0,1,0,1,1705
1,1,0,1,1,1,2,1705
2,2,0,1,1,2,3,1705
3,3,0,2,1,4,5,1705
4,4,0,1,1,5,6,1705
5,5,1,1,2,6,8,1705
6,6,0,0,2,6,8,1705
0,0,1,0,1,0,1,1706
1,1,0,0,1,0,1,1706
0,0,1,0,1,0,1,1707
1,1,0,0,1,0,1,1707
0,0,1,0,1,0,1,1708
1,1,0,0,1,0,1,1708
0,0,1,0,1,0,1,1709
1,1,2,0,3,0,3,1709
2,2,3,1,6,1,7,1709
3,3,3,1,9,2,11,1709
4,4,1,2,10,4,14,1709
5,5,3,2,13,6,19,1709
6,6,1,2,14,8,22,1709
7,7,0,1,14,9,23,1709
8,8,0,1,14,10,24,1709
9,9,0,2,14,12,26,1709
10,10,0,2,14,14,28,1709
11,11,0,1,14,15,29,1709
12,12,0,1,14,16,30,1709
13,13,0,0,14,16,30,1709
0,0,1,0,1,0,1,1710
1,1,0,0,1,0,1,1710
0,0,1,0,1,0,1,1711
1,1,0,1,1,1,2,1711
2,2,0,0,1,1,2,1711
0,0,1,0,1,0,1,1712
1,1,0,0,1,0,1,1712
0,0,1,0,1,0,1,1713
1,1,0,1,1,1,2,1713
2,2,0,1,1,2,3,1713
3,3,0,1,1,3,4,1713
4,4,0,0,1,3,4,1713
0,0,1,0,1,0,1,1714
1,1,1,0,2,0,2,1714
2,2,2,0,4,0,4,1714
3,3,1,0,5,0,5,1714
4,4,4,0,9,0,9,1714
5,5,4,0,13,0,13,1714
6,6,6,2,19,2,21,1714
7,7,4,4,23,6,29,1714
8,8,3,2,26,8,34,1714
9,9,2,0,28,8,36,1714
10,10,1,2,29,10,39,1714
11,11,1,4,30,14,44,1714
12,12,4,5,34,19,53,1714
13,13,6,1,40,20,60,1714
14,14,6,1,46,21,67,1714
15,15,3,1,49,22,71,1714
16,16,3,1,52,23,75,1714
17,17,2,1,54,24,78,1714
18,18,7,0,61,24,85,1714
19,19,4,1,65,25,90,1714
20,20,3,3,68,28,96,1714
21,21,3,3,71,31,102,1714
22,22,3,5,74,36,110,1714
23,23,9,4,83,40,123,1714
24,24,7,5,90,45,135,1714
25,25,7,2,97,47,144,1714
26,26,4,4,101,51,152,1714
27,27,4,1,105,52,157,1714
28,28,1,1,106,53,159,1714
29,29,0,1,106,54,160,1714
30,30,1,0,107,54,161,1714
31,31,1,0,108,54,162,1714
32,32,1,0,109,54,163,1714
33,33,0,0,109,54,163,1714
0,0,1,0,1,0,1,1715
1,1,0,0,1,0,1,1715
0,0,1,0,1,0,1,1716
1,1,0,0,1,0,1,1716
0,0,1,0,1,0,1,1717
1,1,0,0,1,0,1,1717
0,0,1,0,1,0,1,1718
1,1,0,0,1,0,1,1718
0,0,1,0,1,0,1,1719
1,1,0,0,1,0,1,1719
0,0,1,0,1,0,1,1720
1,1,0,0,1,0,1,1720
0,0,1,0,1,0,1,1721
1,1,0,0,1,0,1,1721
0,0,1,0,1,0,1,1722
1,1,0,0,1,0,1,1722
0,0,1,0,1,0,1,1723
1,1,1,1,2,1,3,1723
2,2,1,1,3,2,5,1723
3,3,1,0,4,2,6,1723
4,4,2,0,6,2,8,1723
5,5,2,0,8,2,10,1723
6,6,0,0,8,2,10,1723
0,0,1,0,1,0,1,1724
1,1,0,0,1,0,1,1724
0,0,1,0,1,0,1,1725
1,1,1,0,2,0,2,1725
2,2,0,0,2,0,2,1725
0,0,1,0,1,0,1,1726
1,1,0,0,1,0,1,1726
0,0,1,0,1,0,1,1727
1,1,1,0,2,0,2,1727
2,2,0,0,2,0,2,1727
0,0,1,0,1,0,1,1728
1,1,1,0,2,0,2,1728
2,2,0,0,2,0,2,1728
0,0,1,0,1,0,1,1729
1,1,1,0,2,0,2,1729
2,2,2,0,4,0,4,1729
3,3,0,0,4,0,4,1729
0,0,1,0,1,0,1,1730
1,1,0,2,1,2,3,1730
2,2,0,2,1,4,5,1730
3,3,1,1,2,5,7,1730
4,4,2,1,4,6,10,1730
5,5,1,0,5,6,11,1730
6,6,3,0,8,6,14,1730
7,7,4,0,12,6,18,1730
8,8,4,2,16,8,24,1730
9,9,3,1,19,9,28,1730
10,10,3,0,22,9,31,1730
11,11,2,1,24,10,34,1730
12,12,4,0,28,10,38,1730
13,13,4,0,32,10,42,1730
14,14,4,1,36,11,47,1730
15,15,5,0,41,11,52,1730
16,16,2,0,43,11,54,1730
17,17,1,0,44,11,55,1730
18,18,0,0,44,11,55,1730
0,0,1,0,1,0,1,1731
1,1,0,0,1,0,1,1731
0,0,1,0,1,0,1,1732
1,1,1,0,2,0,2,1732
2,2,1,0,3,0,3,1732
3,3,1,0,4,0,4,1732
4,4,1,0,5,0,5,1732
5,5,1,0,6,0,6,1732
6,6,1,0,7,0,7,1732
7,7,0,1,7,1,8,1732
8,8,0,0,7,1,8,1732
0,0,1,0,1,0,1,1733
1,1,1,0,2,0,2,1733
2,2,1,0,3,0,3,1733
3,3,1,0,4,0,4,1733
4,4,4,0,8,0,8,1733
5,5,5,1,13,1,14,1733
6,6,1,1,14,2,16,1733
7,7,0,3,14,5,19,1733
8,8,2,1,16,6,22,1733
9,9,3,1,19,7,26,1733
10,10,5,1,24,8,32,1733
11,11,3,0,27,8,35,1733
12,12,3,0,30,8,38,1733
13,13,2,0,32,8,40,1733
14,14,0,0,32,8,40,1733
0,0,1,0,1,0,1,1734
1,1,1,0,2,0,2,1734
2,2,0,1,2,1,3,1734
3,3,1,1,3,2,5,1734
4,4,2,2,5,4,9,1734
5,5,2,0,7,4,11,1734
6,6,6,0,13,4,17,1734
7,7,2,0,15,4,19,1734
8,8,2,0,17,4,21,1734
9,9,0,0,17,4,21,1734
0,0,1,0,1,0,1,1735
1,1,0,0,1,0,1,1735
0,0,1,0,1,0,1,1736
1,1,0,0,1,0,1,1736
0,0,1,0,1,0,1,1737
1,1,0,0,1,0,1,1737
0,0,1,0,1,0,1,1738
1,1,1,0,2,0,2,1738
2,2,1,1,3,1,4,1738
3,3,1,0,4,1,5,1738
4,4,1,0,5,1,6,1738
5,5,0,0,5,1,6,1738
0,0,1,0,1,0,1,1739
1,1,0,1,1,1,2,1739
2,2,0,3,1,4,5,1739
3,3,1,3,2,7,9,1739
4,4,1,1,3,8,11,1739
5,5,0,0,3,8,11,1739
0,0,1,0,1,0,1,1740
1,1,0,1,1,1,2,1740
2,2,0,2,1,3,4,1740
3,3,0,1,1,4,5,1740
4,4,0,0,1,4,5,1740
0,0,1,0,1,0,1,1741
1,1,3,1,4,1,5,1741
2,2,3,2,7,3,10,1741
3,3,3,0,10,3,13,1741
4,4,0,0,10,3,13,1741
0,0,1,0,1,0,1,1742
1,1,1,0,2,0,2,1742
2,2,0,0,2,0,2,1742
0,0,1,0,1,0,1,1743
1,1,2,1,3,1,4,1743
2,2,2,0,5,1,6,1743
3,3,2,0,7,1,8,1743
4,4,1,0,8,1,9,1743
5,5,1,0,9,1,10,1743
6,6,0,0,9,1,10,1743
0,0,1,0,1,0,1,1744
1,1,0,0,1,0,1,1744
0,0,1,0,1,0,1,1745
1,1,0,0,1,0,1,1745
0,0,1,0,1,0,1,1746
1,1,1,0,2,0,2,1746
2,2,1,0,3,0,3,1746
3,3,1,0,4,0,4,1746
4,4,1,1,5,1,6,1746
5,5,0,0,5,1,6,1746
0,0,1,0,1,0,1,1747
1,1,0,0,1,0,1,1747
0,0,1,0,1,0,1,1748
1,1,0,0,1,0,1,1748
0,0,1,0,1,0,1,1749
1,1,1,0,2,0,2,1749
2,2,0,0,2,0,2,1749
0,0,1,0,1,0,1,1750
1,1,1,0,2,0,2,1750
2,2,0,0,2,0,2,1750
0,0,1,0,1,0,1,1751
1,1,1,0,2,0,2,1751
2,2,2,0,4,0,4,1751
3,3,3,0,7,0,7,1751
4,4,1,1,8,1,9,1751
5,5,1,1,9,2,11,1751
6,6,0,0,9,2,11,1751
0,0,1,0,1,0,1,1752
1,1,1,0,2,0,2,1752
2,2,0,0,2,0,2,1752
0,0,1,0,1,0,1,1753
1,1,3,0,4,0,4,1753
2,2,0,1,4,1,5,1753
3,3,0,2,4,3,7,1753
4,4,1,1,5,4,9,1753
5,5,0,1,5,5,10,1753
6,6,0,1,5,6,11,1753
7,7,0,2,5,8,13,1753
8,8,1,2,6,10,16,1753
9,9,1,2,7,12,19,1753
10,10,0,2,7,14,21,1753
11,11,0,0,7,14,21,1753
0,0,1,0,1,0,1,1754
1,1,0,0,1,0,1,1754
0,0,1,0,1,0,1,1755
1,1,0,0,1,0,1,1755
0,0,1,0,1,0,1,1756
1,1,0,0,1,0,1,1756
0,0,1,0,1,0,1,1757
1,1,0,0,1,0,1,1757
0,0,1,0,1,0,1,1758
1,1,0,0,1,0,1,1758
0,0,1,0,1,0,1,1759
1,1,1,1,2,1,3,1759
2,2,2,1,4,2,6,1759
3,3,0,3,4,5,9,1759
4,4,0,3,4,8,12,1759
5,5,2,5,6,13,19,1759
6,6,2,4,8,17,25,1759
7,7,4,2,12,19,31,1759
8,8,2,3,14,22,36,1759
9,9,1,3,15,25,40,1759
10,10,1,3,16,28,44,1759
11,11,1,3,17,31,48,1759
12,12,3,1,20,32,52,1759
13,13,2,1,22,33,55,1759
14,14,0,1,22,34,56,1759
15,15,0,2,22,36,58,1759
16,16,0,2,22,38,60,1759
17,17,0,0,22,38,60,1759
0,0,1,0,1,0,1,1760
1,1,0,1,1,1,2,1760
2,2,0,0,1,1,2,1760
0,0,1,0,1,0,1,1761
1,1,0,0,1,0,1,1761
0,0,1,0,1,0,1,1762
1,1,0,0,1,0,1,1762
0,0,1,0,1,0,1,1763
1,1,3,0,4,0,4,1763
2,2,2,0,6,0,6,1763
3,3,0,0,6,0,6,1763
0,0,1,0,1,0,1,1764
1,1,0,1,1,1,2,1764
2,2,0,0,1,1,2,1764
0,0,1,0,1,0,1,1765
1,1,0,0,1,0,1,1765
0,0,1,0,1,0,1,1766
1,1,0,0,1,0,1,1766
0,0,1,0,1,0,1,1767
1,1,0,0,1,0,1,1767
0,0,1,0,1,0,1,1768
1,1,2,0,3,0,3,1768
2,2,5,0,8,0,8,1768
3,3,2,2,10,2,12,1768
4,4,0,1,10,3,13,1768
5,5,0,0,10,3,13,1768
0,0,1,0,1,0,1,1769
1,1,1,0,2,0,2,1769
2,2,0,0,2,0,2,1769
0,0,1,0,1,0,1,1770
1,1,0,0,1,0,1,1770
0,0,1,0,1,0,1,1771
1,1,1,0,2,0,2,1771
2,2,0,0,2,0,2,1771
0,0,1,0,1,0,1,1772
1,1,1,0,2,0,2,1772
2,2,0,0,2,0,2,1772
0,0,1,0,1,0,1,1773
1,1,0,0,1,0,1,1773
0,0,1,0,1,0,1,1774
1,1,1,0,2,0,2,1774
2,2,0,0,2,0,2,1774
0,0,1,0,1,0,1,1775
1,1,1,0,2,0,2,1775
2,2,1,0,3,0,3,1775
3,3,0,0,3,0,3,1775
0,0,1,0,1,0,1,1776
1,1,1,1,2,1,3,1776
2,2,1,0,3,1,4,1776
3,3,2,0,5,1,6,1776
4,4,0,0,5,1,6,1776
0,0,1,0,1,0,1,1777
1,1,0,1,1,1,2,1777
2,2,0,0,1,1,2,1777
0,0,1,0,1,0,1,1778
1,1,0,0,1,0,1,1778
0,0,1,0,1,0,1,1779
1,1,1,0,2,0,2,1779
2,2,4,0,6,0,6,1779
3,3,1,0,7,0,7,1779
4,4,1,0,8,0,8,1779
5,5,2,0,10,0,10,1779
6,6,1,0,11,0,11,1779
7,7,0,0,11,0,11,1779
0,0,1,0,1,0,1,1780
1,1,0,0,1,0,1,1780
0,0,1,0,1,0,1,1781
1,1,0,0,1,0,1,1781
0,0,1,0,1,0,1,1782
1,1,1,1,2,1,3,1782
2,2,0,1,2,2,4,1782
3,3,0,0,2,2,4,1782
0,0,1,0,1,0,1,1783
1,1,0,0,1,0,1,1783
0,0,1,0,1,0,1,1784
1,1,0,0,1,0,1,1784
0,0,1,0,1,0,1,1785
1,1,0,0,1,0,1,1785
0,0,1,0,1,0,1,1786
1,1,1,0,2,0,2,1786
2,2,4,0,6,0,6,1786
3,3,2,1,8,1,9,1786
4,4,1,0,9,1,10,1786
5,5,2,0,11,1,12,1786
6,6,3,1,14,2,16,1786
7,7,3,1,17,3,20,1786
8,8,3,0,20,3,23,1786
9,9,1,1,21,4,25,1786
10,10,0,2,21,6,27,1786
11,11,0,2,21,8,29,1786
12,12,1,2,22,10,32,1786
13,13,1,3,23,13,36,1786
14,14,1,3,24,16,40,1786
15,15,2,1,26,17,43,1786
16,16,0,2,26,19,45,1786
17,17,2,1,28,20,48,1786
18,18,2,2,30,22,52,1786
19,19,1,2,31,24,55,1786
20,20,1,1,32,25,57,1786
21,21,1,0,33,25,58,1786
22,22,4,1,37,26,63,1786
23,23,4,2,41,28,69,1786
24,24,4,1,45,29,74,1786
25,25,1,2,46,31,77,1786
26,26,0,0,46,31,77,1786
0,0,1,0,1,0,1,1787
1,1,0,0,1,0,1,1787
0,0,1,0,1,0,1,1788
1,1,0,1,1,1,2,1788
2,2,0,0,1,1,2,1788
0,0,1,0,1,0,1,1789
1,1,1,0,2,0,2,1789
2,2,2,1,4,1,5,1789
3,3,2,0,6,1,7,1789
4,4,2,0,8,1,9,1789
5,5,1,0,9,1,10,1789
6,6,0,0,9,1,10,1789
0,0,1,0,1,0,1,1790
1,1,0,1,1,1,2,1790
2,2,0,0,1,1,2,1790
0,0,1,0,1,0,1,1791
1,1,1,0,2,0,2,1791
2,2,1,1,3,1,4,1791
3,3,0,1,3,2,5,1791
4,4,0,1,3,3,6,1791
5,5,1,1,4,4,8,1791
6,6,2,1,6,5,11,1791
7,7,2,1,8,6,14,1791
8,8,0,1,8,7,15,1791
9,9,0,0,8,7,15,1791
0,0,1,0,1,0,1,1792
1,1,1,1,2,1,3,1792
2,2,0,0,2,1,3,1792
0,0,1,0,1,0,1,1793
1,1,2,0,3,0,3,1793
2,2,3,1,6,1,7,1793
3,3,1,0,7,1,8,1793
4,4,1,0,8,1,9,1793
5,5,0,0,8,1,9,1793
0,0,1,0,1,0,1,1794
1,1,0,0,1,0,1,1794
0,0,1,0,1,0,1,1795
1,1,0,0,1,0,1,1795
0,0,1,0,1,0,1,1796
1,1,1,0,2,0,2,1796
2,2,0,0,2,0,2,1796
0,0,1,0,1,0,1,1797
1,1,0,0,1,0,1,1797
0,0,1,0,1,0,1,1798
1,1,0,0,1,0,1,1798
0,0,1,0,1,0,1,1799
1,1,0,0,1,0,1,1799
0,0,1,0,1,0,1,1800
1,1,0,0,1,0,1,1800
0,0,1,0,1,0,1,1801
1,1,0,1,1,1,2,1801
2,2,0,0,1,1,2,1801
0,0,1,0,1,0,1,1802
1,1,1,0,2,0,2,1802
2,2,0,0,2,0,2,1802
0,0,1,0,1,0,1,1803
1,1,0,0,1,0,1,1803
0,0,1,0,1,0,1,1804
1,1,0,0,1,0,1,1804
0,0,1,0,1,0,1,1805
1,1,0,0,1,0,1,1805
0,0,1,0,1,0,1,1806
1,1,1,0,2,0,2,1806
2,2,0,1,2,1,3,1806
3,3,0,0,2,1,3,1806
0,0,1,0,1,0,1,1807
1,1,0,0,1,0,1,1807
0,0,1,0,1,0,1,1808
1,1,1,1,2,1,3,1808
2,2,1,1,3,2,5,1808
3,3,0,0,3,2,5,1808
0,0,1,0,1,0,1,1809
1,1,1,0,2,0,2,1809
2,2,1,0,3,0,3,1809
3,3,0,0,3,0,3,1809
0,0,1,0,1,0,1,1810
1,1,1,1,2,1,3,1810
2,2,2,0,4,1,5,1810
3,3,1,0,5,1,6,1810
4,4,1,0,6,1,7,1810
5,5,1,1,7,2,9,1810
6,6,1,1,8,3,11,1810
7,7,0,2,8,5,13,1810
8,8,0,5,8,10,18,1810
9,9,0,8,8,18,26,1810
10,10,0,8,8,26,34,1810
11,11,1,6,9,32,41,1810
12,12,1,4,10,36,46,1810
13,13,2,6,12,42,54,1810
14,14,3,5,15,47,62,1810
15,15,4,5,19,52,71,1810
16,16,5,5,24,57,81,1810
17,17,3,3,27,60,87,1810
18,18,3,2,30,62,92,1810
19,19,5,2,35,64,99,1810
20,20,6,3,41,67,108,1810
21,21,4,6,45,73,118,1810
22,22,5,2,50,75,125,1810
23,23,0,1,50,76,126,1810
24,24,0,1,50,77,127,1810
25,25,0,1,50,78,128,1810
26,26,0,1,50,79,129,1810
27,27,0,0,50,79,129,1810
0,0,1,0,1,0,1,1811
1,1,0,0,1,0,1,1811
0,0,1,0,1,0,1,1812
1,1,0,0,1,0,1,1812
0,0,1,0,1,0,1,1813
1,1,2,0,3,0,3,1813
2,2,1,1,4,1,5,1813
3,3,3,0,7,1,8,1813
4,4,1,0,8,1,9,1813
5,5,2,0,10,1,11,1813
6,6,0,0,10,1,11,1813
0,0,1,0,1,0,1,1814
1,1,0,0,1,0,1,1814
0,0,1,0,1,0,1,1815
1,1,0,0,1,0,1,1815
0,0,1,0,1,0,1,1816
1,1,1,0,2,0,2,1816
2,2,0,0,2,0,2,1816
0,0,1,0,1,0,1,1817
1,1,0,0,1,0,1,1817
0,0,1,0,1,0,1,1818
1,1,0,0,1,0,1,1818
0,0,1,0,1,0,1,1819
1,1,1,1,2,1,3,1819
2,2,1,0,3,1,4,1819
3,3,3,0,6,1,7,1819
4,4,3,1,9,2,11,1819
5,5,3,0,12,2,14,1819
6,6,0,0,12,2,14,1819
0,0,1,0,1,0,1,1820
1,1,0,0,1,0,1,1820
0,0,1,0,1,0,1,1821
1,1,1,0,2,0,2,1821
2,2,0,1,2,1,3,1821
3,3,0,0,2,1,3,1821
0,0,1,0,1,0,1,1822
1,1,0,0,1,0,1,1822
0,0,1,0,1,0,1,1823
1,1,3,0,4,0,4,1823
2,2,2,0,6,0,6,1823
3,3,1,0,7,0,7,1823
4,4,2,0,9,0,9,1823
5,5,1,1,10,1,11,1823
6,6,0,0,10,1,11,1823
0,0,1,0,1,0,1,1824
1,1,1,0,2,0,2,1824
2,2,0,0,2,0,2,1824
0,0,1,0,1,0,1,1825
1,1,0,1,1,1,2,1825
2,2,0,1,1,2,3,1825
3,3,0,2,1,4,5,1825
4,4,1,2,2,6,8,1825
5,5,0,1,2,7,9,1825
6,6,0,1,2,8,10,1825
7,7,0,0,2,8,10,1825
0,0,1,0,1,0,1,1826
1,1,0,0,1,0,1,1826
0,0,1,0,1,0,1,1827
1,1,0,0,1,0,1,1827
0,0,1,0,1,0,1,1828
1,1,0,0,1,0,1,1828
0,0,1,0,1,0,1,1829
1,1,1,0,2,0,2,1829
2,2,1,0,3,0,3,1829
3,3,0,0,3,0,3,1829
0,0,1,0,1,0,1,1830
1,1,2,0,3,0,3,1830
2,2,3,1,6,1,7,1830
3,3,2,2,8,3,11,1830
4,4,2,1,10,4,14,1830
5,5,1,1,11,5,16,1830
6,6,2,1,13,6,19,1830
7,7,1,3,14,9,23,1830
8,8,1,0,15,9,24,1830
9,9,0,0,15,9,24,1830
0,0,1,0,1,0,1,1831
1,1,1,1,2,1,3,1831
2,2,0,0,2,1,3,1831
0,0,1,0,1,0,1,1832
1,1,1,0,2,0,2,1832
2,2,1,0,3,0,3,1832
3,3,1,1,4,1,5,1832
4,4,1,1,5,2,7,1832
5,5,0,2,5,4,9,1832
6,6,0,0,5,4,9,1832
0,0,1,0,1,0,1,1833
1,1,0,0,1,0,1,1833
0,0,1,0,1,0,1,1834
1,1,0,0,1,0,1,1834
0,0,1,0,1,0,1,1835
1,1,3,1,4,1,5,1835
2,2,7,0,11,1,12,1835
3,3,4,3,15,4,19,1835
4,4,2,0,17,4,21,1835
5,5,2,0,19,4,23,1835
6,6,0,0,19,4,23,1835
0,0,1,0,1,0,1,1836
1,1,0,0,1,0,1,1836
0,0,1,0,1,0,1,1837
1,1,1,0,2,0,2,1837
2,2,0,0,2,0,2,1837
0,0,1,0,1,0,1,1838
1,1,0,0,1,0,1,1838
0,0,1,0,1,0,1,1839
1,1,1,0,2,0,2,1839
2,2,2,0,4,0,4,1839
3,3,0,0,4,0,4,1839
0,0,1,0,1,0,1,1840
1,1,2,0,3,0,3,1840
2,2,4,0,7,0,7,1840
3,3,10,1,17,1,18,1840
4,4,9,4,26,5,31,1840
5,5,6,6,32,11,43,1840
6,6,2,8,34,19,53,1840
7,7,5,9,39,28,67,1840
8,8,4,3,43,31,74,1840
9,9,3,2,46,33,79,1840
10,10,4,2,50,35,85,1840
11,11,4,4,54,39,93,1840
12,12,2,5,56,44,100,1840
13,13,0,3,56,47,103,1840
14,14,1,1,57,48,105,1840
15,15,0,2,57,50,107,1840
16,16,0,0,57,50,107,1840
0,0,1,0,1,0,1,1841
1,1,0,0,1,0,1,1841
0,0,1,0,1,0,1,1842
1,1,1,0,2,0,2,1842
2,2,1,0,3,0,3,1842
3,3,0,0,3,0,3,1842
0,0,1,0,1,0,1,1843
1,1,0,0,1,0,1,1843
0,0,1,0,1,0,1,1844
1,1,1,1,2,1,3,1844
2,2,0,2,2,3,5,1844
3,3,0,1,2,4,6,1844
4,4,0,0,2,4,6,1844
0,0,1,0,1,0,1,1845
1,1,1,0,2,0,2,1845
2,2,0,0,2,0,2,1845
0,0,1,0,1,0,1,1846
1,1,2,0,3,0,3,1846
2,2,2,0,5,0,5,1846
3,3,2,1,7,1,8,1846
4,4,1,0,8,1,9,1846
5,5,0,0,8,1,9,1846
0,0,1,0,1,0,1,1847
1,1,0,0,1,0,1,1847
0,0,1,0,1,0,1,1848
1,1,1,0,2,0,2,1848
2,2,3,1,5,1,6,1848
3,3,2,2,7,3,10,1848
4,4,3,0,10,3,13,1848
5,5,4,1,14,4,18,1848
6,6,2,1,16,5,21,1848
7,7,2,2,18,7,25,1848
8,8,0,2,18,9,27,1848
9,9,0,0,18,9,27,1848
0,0,1,0,1,0,1,1849
1,1,0,0,1,0,1,1849
0,0,1,0,1,0,1,1850
1,1,0,0,1,0,1,1850
0,0,1,0,1,0,1,1851
1,1,0,0,1,0,1,1851
0,0,1,0,1,0,1,1852
1,1,1,0,2,0,2,1852
2,2,1,0,3,0,3,1852
3,3,2,0,5,0,5,1852
4,4,0,0,5,0,5,1852
0,0,1,0,1,0,1,1853
1,1,2,0,3,0,3,1853
2,2,3,1,6,1,7,1853
3,3,1,1,7,2,9,1853
4,4,1,1,8,3,11,1853
5,5,1,2,9,5,14,1853
6,6,1,1,10,6,16,1853
7,7,1,2,11,8,19,1853
8,8,2,0,13,8,21,1853
9,9,0,1,13,9,22,1853
10,10,0,0,13,9,22,1853
0,0,1,0,1,0,1,1854
1,1,1,0,2,0,2,1854
2,2,2,0,4,0,4,1854
3,3,1,2,5,2,7,1854
4,4,1,0,6,2,8,1854
5,5,0,0,6,2,8,1854
0,0,1,0,1,0,1,1855
1,1,0,0,1,0,1,1855
0,0,1,0,1,0,1,1856
1,1,0,0,1,0,1,1856
0,0,1,0,1,0,1,1857
1,1,0,0,1,0,1,1857
0,0,1,0,1,0,1,1858
1,1,0,0,1,0,1,1858
0,0,1,0,1,0,1,1859
1,1,0,0,1,0,1,1859
0,0,1,0,1,0,1,1860
1,1,1,0,2,0,2,1860
2,2,1,0,3,0,3,1860
3,3,1,0,4,0,4,1860
4,4,1,1,5,1,6,1860
5,5,0,0,5,1,6,1860
0,0,1,0,1,0,1,1861
1,1,0,0,1,0,1,1861
0,0,1,0,1,0,1,1862
1,1,0,0,1,0,1,1862
0,0,1,0,1,0,1,1863
1,1,0,0,1,0,1,1863
0,0,1,0,1,0,1,1864
1,1,1,0,2,0,2,1864
2,2,2,1,4,1,5,1864
3,3,3,0,7,1,8,1864
4,4,4,0,11,1,12,1864
5,5,2,1,13,2,15,1864
6,6,0,1,13,3,16,1864
7,7,0,0,13,3,16,1864
0,0,1,0,1,0,1,1865
1,1,0,1,1,1,2,1865
2,2,0,1,1,2,3,1865
3,3,0,1,1,3,4,1865
4,4,0,0,1,3,4,1865
0,0,1,0,1,0,1,1866
1,1,1,0,2,0,2,1866
2,2,1,1,3,1,4,1866
3,3,2,1,5,2,7,1866
4,4,2,0,7,2,9,1866
5,5,2,0,9,2,11,1866
6,6,2,2,11,4,15,1866
7,7,3,2,14,6,20,1866
8,8,1,2,15,8,23,1866
9,9,0,4,15,12,27,1866
10,10,0,1,15,13,28,1866
11,11,0,0,15,13,28,1866
0,0,1,0,1,0,1,1867
1,1,0,2,1,2,3,1867
2,2,2,3,3,5,8,1867
3,3,0,0,3,5,8,1867
0,0,1,0,1,0,1,1868
1,1,1,0,2,0,2,1868
2,2,1,1,3,1,4,1868
3,3,1,0,4,1,5,1868
4,4,1,1,5,2,7,1868
5,5,1,0,6,2,8,1868
6,6,0,0,6,2,8,1868
0,0,1,0,1,0,1,1869
1,1,1,0,2,0,2,1869
2,2,0,0,2,0,2,1869
0,0,1,0,1,0,1,1870
1,1,3,1,4,1,5,1870
2,2,4,1,8,2,10,1870
3,3,2,1,10,3,13,1870
4,4,1,2,11,5,16,1870
5,5,2,0,13,5,18,1870
6,6,1,0,14,5,19,1870
7,7,0,0,14,5,19,1870
0,0,1,0,1,0,1,1871
1,1,0,0,1,0,1,1871
0,0,1,0,1,0,1,1872
1,1,0,0,1,0,1,1872
0,0,1,0,1,0,1,1873
1,1,1,0,2,0,2,1873
2,2,1,1,3,1,4,1873
3,3,0,1,3,2,5,1873
4,4,0,1,3,3,6,1873
5,5,0,0,3,3,6,1873
0,0,1,0,1,0,1,1874
1,1,1,0,2,0,2,1874
2,2,0,1,2,1,3,1874
3,3,0,2,2,3,5,1874
4,4,0,1,2,4,6,1874
5,5,0,3,2,7,9,1874
6,6,1,4,3,11,14,1874
7,7,1,6,4,17,21,1874
8,8,4,1,8,18,26,1874
9,9,4,0,12,18,30,1874
10,10,5,2,17,20,37,1874
11,11,3,1,20,21,41,1874
12,12,2,2,22,23,45,1874
13,13,1,2,23,25,48,1874
14,14,2,1,25,26,51,1874
15,15,2,0,27,26,53,1874
16,16,1,1,28,27,55,1874
17,17,1,1,29,28,57,1874
18,18,2,2,31,30,61,1874
19,19,2,1,33,31,64,1874
20,20,0,1,33,32,65,1874
21,21,0,0,33,32,65,1874
0,0,1,0,1,0,1,1875
1,1,0,0,1,0,1,1875
0,0,1,0,1,0,1,1876
1,1,1,0,2,0,2,1876
2,2,1,1,3,1,4,1876
3,3,1,0,4,1,5,1876
4,4,1,0,5,1,6,1876
5,5,0,0,5,1,6,1876
0,0,1,0,1,0,1,1877
1,1,1,1,2,1,3,1877
2,2,1,2,3,3,6,1877
3,3,0,0,3,3,6,1877
0,0,1,0,1,0,1,1878
1,1,1,0,2,0,2,1878
2,2,3,0,5,0,5,1878
3,3,2,1,7,1,8,1878
4,4,1,2,8,3,11,1878
5,5,0,2,8,5,13,1878
6,6,0,2,8,7,15,1878
7,7,0,1,8,8,16,1878
8,8,0,1,8,9,17,1878
9,9,0,1,8,10,18,1878
10,10,0,1,8,11,19,1878
11,11,0,0,8,11,19,1878
0,0,1,0,1,0,1,1879
1,1,0,0,1,0,1,1879
0,0,1,0,1,0,1,1880
1,1,0,0,1,0,1,1880
0,0,1,0,1,0,1,1881
1,1,0,0,1,0,1,1881
0,0,1,0,1,0,1,1882
1,1,0,0,1,0,1,1882
0,0,1,0,1,0,1,1883
1,1,0,0,1,0,1,1883
0,0,1,0,1,0,1,1884
1,1,0,0,1,0,1,1884
0,0,1,0,1,0,1,1885
1,1,1,0,2,0,2,1885
2,2,1,0,3,0,3,1885
3,3,1,0,4,0,4,1885
4,4,1,0,5,0,5,1885
5,5,0,0,5,0,5,1885
0,0,1,0,1,0,1,1886
1,1,0,0,1,0,1,1886
0,0,1,0,1,0,1,1887
1,1,1,0,2,0,2,1887
2,2,0,0,2,0,2,1887
0,0,1,0,1,0,1,1888
1,1,0,0,1,0,1,1888
0,0,1,0,1,0,1,1889
1,1,1,0,2,0,2,1889
2,2,1,0,3,0,3,1889
3,3,0,0,3,0,3,1889
0,0,1,0,1,0,1,1890
1,1,0,0,1,0,1,1890
0,0,1,0,1,0,1,1891
1,1,0,0,1,0,1,1891
0,0,1,0,1,0,1,1892
1,1,1,0,2,0,2,1892
2,2,0,0,2,0,2,1892
0,0,1,0,1,0,1,1893
1,1,0,0,1,0,1,1893
0,0,1,0,1,0,1,1894
1,1,0,0,1,0,1,1894
0,0,1,0,1,0,1,1895
1,1,1,0,2,0,2,1895
2,2,0,0,2,0,2,1895
0,0,1,0,1,0,1,1896
1,1,1,0,2,0,2,1896
2,2,2,0,4,0,4,1896
3,3,0,1,4,1,5,1896
4,4,1,1,5,2,7,1896
5,5,0,1,5,3,8,1896
6,6,0,0,5,3,8,1896
0,0,1,0,1,0,1,1897
1,1,1,0,2,0,2,1897
2,2,0,0,2,0,2,1897
0,0,1,0,1,0,1,1898
1,1,0,0,1,0,1,1898
0,0,1,0,1,0,1,1899
1,1,2,0,3,0,3,1899
2,2,2,0,5,0,5,1899
3,3,0,3,5,3,8,1899
4,4,0,2,5,5,10,1899
5,5,1,3,6,8,14,1899
6,6,1,2,7,10,17,1899
7,7,2,1,9,11,20,1899
8,8,3,2,12,13,25,1899
9,9,2,0,14,13,27,1899
10,10,4,1,18,14,32,1899
11,11,2,3,20,17,37,1899
12,12,5,4,25,21,46,1899
13,13,3,2,28,23,51,1899
14,14,2,2,30,25,55,1899
15,15,1,2,31,27,58,1899
16,16,3,1,34,28,62,1899
17,17,2,1,36,29,65,1899
18,18,0,1,36,30,66,1899
19,19,0,0,36,30,66,1899
0,0,1,0,1,0,1,1900
1,1,1,0,2,0,2,1900
2,2,0,0,2,0,2,1900
0,0,1,0,1,0,1,1901
1,1,3,0,4,0,4,1901
2,2,5,1,9,1,10,1901
3,3,8,1,17,2,19,1901
4,4,6,2,23,4,27,1901
5,5,5,0,28,4,32,1901
6,6,4,0,32,4,36,1901
7,7,3,0,35,4,39,1901
8,8,2,0,37,4,41,1901
9,9,1,1,38,5,43,1901
10,10,1,0,39,5,44,1901
11,11,1,0,40,5,45,1901
12,12,0,0,40,5,45,1901
0,0,1,0,1,0,1,1902
1,1,1,0,2,0,2,1902
2,2,1,0,3,0,3,1902
3,3,0,0,3,0,3,1902
0,0,1,0,1,0,1,1903
1,1,3,0,4,0,4,1903
2,2,1,2,5,2,7,1903
3,3,2,2,7,4,11,1903
4,4,4,4,11,8,19,1903
5,5,5,4,16,12,28,1903
6,6,4,7,20,19,39,1903
7,7,5,7,25,26,51,1903
8,8,5,8,30,34,64,1903
9,9,5,4,35,38,73,1903
10,10,2,3,37,41,78,1903
11,11,2,2,39,43,82,1903
12,12,1,2,40,45,85,1903
13,13,2,2,42,47,89,1903
14,14,3,1,45,48,93,1903
15,15,5,2,50,50,100,1903
16,16,3,2,53,52,105,1903
17,17,4,1,57,53,110,1903
18,18,2,0,59,53,112,1903
19,19,1,0,60,53,113,1903
20,20,1,0,61,53,114,1903
21,21,2,0,63,53,116,1903
22,22,0,1,63,54,117,1903
23,23,0,0,63,54,117,1903
0,0,1,0,1,0,1,1904
1,1,1,0,2,0,2,1904
2,2,1,0,3,0,3,1904
3,3,2,0,5,0,5,1904
4,4,2,0,7,0,7,1904
5,5,0,0,7,0,7,1904
0,0,1,0,1,0,1,1905
1,1,1,0,2,0,2,1905
2,2,1,0,3,0,3,1905
3,3,0,0,3,0,3,1905
0,0,1,0,1,0,1,1906
1,1,2,0,3,0,3,1906
2,2,3,0,6,0,6,1906
3,3,1,0,7,0,7,1906
4,4,2,0,9,0,9,1906
5,5,3,0,12,0,12,1906
6,6,6,2,18,2,20,1906
7,7,6,3,24,5,29,1906
8,8,6,4,30,9,39,1906
9,9,5,3,35,12,47,1906
10,10,3,0,38,12,50,1906
11,11,4,0,42,12,54,1906
12,12,2,0,44,12,56,1906
13,13,3,1,47,13,60,1906
14,14,2,0,49,13,62,1906
15,15,1,0,50,13,63,1906
16,16,3,0,53,13,66,1906
17,17,1,1,54,14,68,1906
18,18,2,0,56,14,70,1906
19,19,1,0,57,14,71,1906
20,20,1,0,58,14,72,1906
21,21,0,0,58,14,72,1906
0,0,1,0,1,0,1,1907
1,1,0,0,1,0,1,1907
0,0,1,0,1,0,1,1908
1,1,0,0,1,0,1,1908
0,0,1,0,1,0,1,1909
1,1,0,1,1,1,2,1909
2,2,0,0,1,1,2,1909
0,0,1,0,1,0,1,1910
1,1,3,0,4,0,4,1910
2,2,1,2,5,2,7,1910
3,3,2,4,7,6,13,1910
4,4,2,3,9,9,18,1910
5,5,2,3,11,12,23,1910
6,6,4,1,15,13,28,1910
7,7,6,0,21,13,34,1910
8,8,3,1,24,14,38,1910
9,9,0,1,24,15,39,1910
10,10,0,0,24,15,39,1910
0,0,1,0,1,0,1,1911
1,1,2,0,3,0,3,1911
2,2,1,0,4,0,4,1911
3,3,0,0,4,0,4,1911
0,0,1,0,1,0,1,1912
1,1,1,0,2,0,2,1912
2,2,0,1,2,1,3,1912
3,3,1,1,3,2,5,1912
4,4,1,0,4,2,6,1912
5,5,1,0,5,2,7,1912
6,6,0,0,5,2,7,1912
0,0,1,0,1,0,1,1913
1,1,0,0,1,0,1,1913
0,0,1,0,1,0,1,1914
1,1,0,0,1,0,1,1914
0,0,1,0,1,0,1,1915
1,1,0,0,1,0,1,1915
0,0,1,0,1,0,1,1916
1,1,0,0,1,0,1,1916
0,0,1,0,1,0,1,1917
1,1,0,0,1,0,1,1917
0,0,1,0,1,0,1,1918
1,1,0,0,1,0,1,1918
0,0,1,0,1,0,1,1919
1,1,0,0,1,0,1,1919
0,0,1,0,1,0,1,1920
1,1,1,0,2,0,2,1920
2,2,0,0,2,0,2,1920
0,0,1,0,1,0,1,1921
1,1,2,0,3,0,3,1921
2,2,2,0,5,0,5,1921
3,3,1,1,6,1,7,1921
4,4,0,0,6,1,7,1921
0,0,1,0,1,0,1,1922
1,1,2,0,3,0,3,1922
2,2,4,0,7,0,7,1922
3,3,3,0,10,0,10,1922
4,4,4,0,14,0,14,1922
5,5,5,0,19,0,19,1922
6,6,4,0,23,0,23,1922
7,7,2,0,25,0,25,1922
8,8,3,0,28,0,28,1922
9,9,1,1,29,1,30,1922
10,10,0,0,29,1,30,1922
0,0,1,0,1,0,1,1923
1,1,1,0,2,0,2,1923
2,2,0,0,2,0,2,1923
0,0,1,0,1,0,1,1924
1,1,0,0,1,0,1,1924
0,0,1,0,1,0,1,1925
1,1,1,0,2,0,2,1925
2,2,2,0,4,0,4,1925
3,3,0,0,4,0,4,1925
0,0,1,0,1,0,1,1926
1,1,0,0,1,0,1,1926
0,0,1,0,1,0,1,1927
1,1,0,1,1,1,2,1927
2,2,0,0,1,1,2,1927
0,0,1,0,1,0,1,1928
1,1,2,1,3,1,4,1928
2,2,2,1,5,2,7,1928
3,3,3,1,8,3,11,1928
4,4,1,2,9,5,14,1928
5,5,0,1,9,6,15,1928
6,6,0,0,9,6,15,1928
0,0,1,0,1,0,1,1929
1,1,2,1,3,1,4,1929
2,2,1,1,4,2,6,1929
3,3,0,2,4,4,8,1929
4,4,1,1,5,5,10,1929
5,5,0,0,5,5,10,1929
0,0,1,0,1,0,1,1930
1,1,1,0,2,0,2,1930
2,2,2,0,4,0,4,1930
3,3,0,3,4,3,7,1930
4,4,0,1,4,4,8,1930
5,5,0,2,4,6,10,1930
6,6,1,0,5,6,11,1930
7,7,0,1,5,7,12,1930
8,8,0,1,5,8,13,1930
9,9,0,1,5,9,14,1930
10,10,0,0,5,9,14,1930
0,0,1,0,1,0,1,1931
1,1,3,1,4,1,5,1931
2,2,2,0,6,1,7,1931
3,3,4,0,10,1,11,1931
4,4,2,2,12,3,15,1931
5,5,3,1,15,4,19,1931
6,6,2,2,17,6,23,1931
7,7,5,1,22,7,29,1931
8,8,2,2,24,9,33,1931
9,9,1,1,25,10,35,1931
10,10,0,0,25,10,35,1931
0,0,1,0,1,0,1,1932
1,1,2,0,3,0,3,1932
2,2,1,1,4,1,5,1932
3,3,1,1,5,2,7,1932
4,4,0,0,5,2,7,1932
0,0,1,0,1,0,1,1933
1,1,1,0,2,0,2,1933
2,2,1,0,3,0,3,1933
3,3,1,0,4,0,4,1933
4,4,1,0,5,0,5,1933
5,5,1,1,6,1,7,1933
6,6,0,1,6,2,8,1933
7,7,0,1,6,3,9,1933
8,8,0,1,6,4,10,1933
9,9,1,0,7,4,11,1933
10,10,0,0,7,4,11,1933
0,0,1,0,1,0,1,1934
1,1,1,0,2,0,2,1934
2,2,0,0,2,0,2,1934
0,0,1,0,1,0,1,1935
1,1,1,0,2,0,2,1935
2,2,0,0,2,0,2,1935
0,0,1,0,1,0,1,1936
1,1,0,0,1,0,1,1936
0,0,1,0,1,0,1,1937
1,1,1,1,2,1,3,1937
2,2,1,2,3,3,6,1937
3,3,1,3,4,6,10,1937
4,4,1,2,5,8,13,1937
5,5,3,0,8,8,16,1937
6,6,2,0,10,8,18,1937
7,7,1,0,11,8,19,1937
8,8,0,0,11,8,19,1937
0,0,1,0,1,0,1,1938
1,1,0,0,1,0,1,1938
0,0,1,0,1,0,1,1939
1,1,0,0,1,0,1,1939
0,0,1,0,1,0,1,1940
1,1,1,0,2,0,2,1940
2,2,0,0,2,0,2,1940
0,0,1,0,1,0,1,1941
1,1,0,0,1,0,1,1941
0,0,1,0,1,0,1,1942
1,1,0,2,1,2,3,1942
2,2,1,1,2,3,5,1942
3,3,0,2,2,5,7,1942
4,4,0,0,2,5,7,1942
0,0,1,0,1,0,1,1943
1,1,1,0,2,0,2,1943
2,2,3,0,5,0,5,1943
3,3,0,0,5,0,5,1943
0,0,1,0,1,0,1,1944
1,1,0,0,1,0,1,1944
0,0,1,0,1,0,1,1945
1,1,0,0,1,0,1,1945
0,0,1,0,1,0,1,1946
1,1,0,0,1,0,1,1946
0,0,1,0,1,0,1,1947
1,1,0,1,1,1,2,1947
2,2,0,0,1,1,2,1947
0,0,1,0,1,0,1,1948
1,1,0,0,1,0,1,1948
0,0,1,0,1,0,1,1949
1,1,0,0,1,0,1,1949
0,0,1,0,1,0,1,1950
1,1,0,0,1,0,1,1950
0,0,1,0,1,0,1,1951
1,1,2,2,3,2,5,1951
2,2,2,1,5,3,8,1951
3,3,1,3,6,6,12,1951
4,4,0,2,6,8,14,1951
5,5,0,1,6,9,15,1951
6,6,0,2,6,11,17,1951
7,7,0,1,6,12,18,1951
8,8,0,1,6,13,19,1951
9,9,0,1,6,14,20,1951
10,10,1,0,7,14,21,1951
11,11,2,0,9,14,23,1951
12,12,3,0,12,14,26,1951
13,13,6,1,18,15,33,1951
14,14,5,2,23,17,40,1951
15,15,4,1,27,18,45,1951
16,16,3,0,30,18,48,1951
17,17,0,0,30,18,48,1951
0,0,1,0,1,0,1,1952
1,1,1,0,2,0,2,1952
2,2,0,0,2,0,2,1952
0,0,1,0,1,0,1,1953
1,1,0,1,1,1,2,1953
2,2,0,0,1,1,2,1953
0,0,1,0,1,0,1,1954
1,1,1,0,2,0,2,1954
2,2,0,1,2,1,3,1954
3,3,0,3,2,4,6,1954
4,4,1,2,3,6,9,1954
5,5,1,0,4,6,10,1954
6,6,2,0,6,6,12,1954
7,7,1,0,7,6,13,1954
8,8,1,0,8,6,14,1954
9,9,1,0,9,6,15,1954
10,10,1,1,10,7,17,1954
11,11,0,1,10,8,18,1954
12,12,1,1,11,9,20,1954
13,13,1,1,12,10,22,1954
14,14,1,3,13,13,26,1954
15,15,1,2,14,15,29,1954
16,16,1,1,15,16,31,1954
17,17,2,1,17,17,34,1954
18,18,1,1,18,18,36,1954
19,19,1,1,19,19,38,1954
20,20,1,0,20,19,39,1954
21,21,0,0,20,19,39,1954
0,0,1,0,1,0,1,1955
1,1,0,0,1,0,1,1955
0,0,1,0,1,0,1,1956
1,1,2,0,3,0,3,1956
2,2,0,1,3,1,4,1956
3,3,0,0,3,1,4,1956
0,0,1,0,1,0,1,1957
1,1,1,0,2,0,2,1957
2,2,0,1,2,1,3,1957
3,3,0,0,2,1,3,1957
0,0,1,0,1,0,1,1958
1,1,1,0,2,0,2,1958
2,2,1,0,3,0,3,1958
3,3,2,0,5,0,5,1958
4,4,1,1,6,1,7,1958
5,5,0,2,6,3,9,1958
6,6,0,1,6,4,10,1958
7,7,1,4,7,8,15,1958
8,8,1,3,8,11,19,1958
9,9,3,0,11,11,22,1958
10,10,1,0,12,11,23,1958
11,11,1,0,13,11,24,1958
12,12,0,0,13,11,24,1958
0,0,1,0,1,0,1,1959
1,1,2,0,3,0,3,1959
2,2,2,1,5,1,6,1959
3,3,3,1,8,2,10,1959
4,4,3,0,11,2,13,1959
5,5,2,0,13,2,15,1959
6,6,2,0,15,2,17,1959
7,7,3,2,18,4,22,1959
8,8,3,2,21,6,27,1959
9,9,5,1,26,7,33,1959
10,10,5,3,31,10,41,1959
11,11,3,2,34,12,46,1959
12,12,2,2,36,14,50,1959
13,13,1,2,37,16,53,1959
14,14,1,2,38,18,56,1959
15,15,0,1,38,19,57,1959
16,16,1,0,39,19,58,1959
17,17,0,0,39,19,58,1959
0,0,1,0,1,0,1,1960
1,1,1,0,2,0,2,1960
2,2,1,0,3,0,3,1960
3,3,0,0,3,0,3,1960
0,0,1,0,1,0,1,1961
1,1,0,0,1,0,1,1961
0,0,1,0,1,0,1,1962
1,1,2,0,3,0,3,1962
2,2,0,0,3,0,3,1962
0,0,1,0,1,0,1,1963
1,1,0,0,1,0,1,1963
0,0,1,0,1,0,1,1964
1,1,2,0,3,0,3,1964
2,2,1,0,4,0,4,1964
3,3,1,0,5,0,5,1964
4,4,0,0,5,0,5,1964
0,0,1,0,1,0,1,1965
1,1,0,0,1,0,1,1965
0,0,1,0,1,0,1,1966
1,1,0,0,1,0,1,1966
0,0,1,0,1,0,1,1967
1,1,2,2,3,2,5,1967
2,2,4,2,7,4,11,1967
3,3,5,1,12,5,17,1967
4,4,3,0,15,5,20,1967
5,5,2,1,17,6,23,1967
6,6,2,1,19,7,26,1967
7,7,1,0,20,7,27,1967
8,8,0,0,20,7,27,1967
0,0,1,0,1,0,1,1968
1,1,1,1,2,1,3,1968
2,2,2,2,4,3,7,1968
3,3,0,2,4,5,9,1968
4,4,0,2,4,7,11,1968
5,5,1,3,5,10,15,1968
6,6,4,2,9,12,21,1968
7,7,4,0,13,12,25,1968
8,8,3,0,16,12,28,1968
9,9,4,0,20,12,32,1968
10,10,4,0,24,12,36,1968
11,11,7,0,31,12,43,1968
12,12,8,0,39,12,51,1968
13,13,4,5,43,17,60,1968
14,14,4,2,47,19,66,1968
15,15,0,2,47,21,68,1968
16,16,0,1,47,22,69,1968
17,17,0,0,47,22,69,1968
0,0,1,0,1,0,1,1969
1,1,0,0,1,0,1,1969
0,0,1,0,1,0,1,1970
1,1,0,1,1,1,2,1970
2,2,0,1,1,2,3,1970
3,3,0,3,1,5,6,1970
4,4,0,2,1,7,8,1970
5,5,0,1,1,8,9,1970
6,6,0,1,1,9,10,1970
7,7,0,2,1,11,12,1970
8,8,0,2,1,13,14,1970
9,9,0,2,1,15,16,1970
10,10,0,2,1,17,18,1970
11,11,2,2,3,19,22,1970
12,12,3,0,6,19,25,1970
13,13,1,3,7,22,29,1970
14,14,0,2,7,24,31,1970
15,15,0,1,7,25,32,1970
16,16,0,0,7,25,32,1970
0,0,1,0,1,0,1,1971
1,1,1,0,2,0,2,1971
2,2,0,1,2,1,3,1971
3,3,0,1,2,2,4,1971
4,4,0,2,2,4,6,1971
5,5,0,1,2,5,7,1971
6,6,0,0,2,5,7,1971
0,0,1,0,1,0,1,1972
1,1,0,0,1,0,1,1972
0,0,1,0,1,0,1,1973
1,1,0,0,1,0,1,1973
0,0,1,0,1,0,1,1974
1,1,2,0,3,0,3,1974
2,2,2,0,5,0,5,1974
3,3,1,1,6,1,7,1974
4,4,1,1,7,2,9,1974
5,5,1,1,8,3,11,1974
6,6,1,0,9,3,12,1974
7,7,0,1,9,4,13,1974
8,8,0,1,9,5,14,1974
9,9,0,1,9,6,15,1974
10,10,0,1,9,7,16,1974
11,11,0,1,9,8,17,1974
12,12,1,2,10,10,20,1974
13,13,1,3,11,13,24,1974
14,14,2,3,13,16,29,1974
15,15,0,4,13,20,33,1974
16,16,1,7,14,27,41,1974
17,17,1,8,15,35,50,1974
18,18,2,3,17,38,55,1974
19,19,0,4,17,42,59,1974
20,20,0,2,17,44,61,1974
21,21,1,1,18,45,63,1974
22,22,0,0,18,45,63,1974
0,0,1,0,1,0,1,1975
1,1,0,0,1,0,1,1975
0,0,1,0,1,0,1,1976
1,1,1,0,2,0,2,1976
2,2,1,0,3,0,3,1976
3,3,0,0,3,0,3,1976
0,0,1,0,1,0,1,1977
1,1,0,0,1,0,1,1977
0,0,1,0,1,0,1,1978
1,1,1,1,2,1,3,1978
2,2,0,0,2,1,3,1978
0,0,1,0,1,0,1,1979
1,1,2,0,3,0,3,1979
2,2,2,0,5,0,5,1979
3,3,3,0,8,0,8,1979
4,4,4,0,12,0,12,1979
5,5,1,0,13,0,13,1979
6,6,0,1,13,1,14,1979
7,7,0,0,13,1,14,1979
0,0,1,0,1,0,1,1980
1,1,1,0,2,0,2,1980
2,2,1,1,3,1,4,1980
3,3,1,0,4,1,5,1980
4,4,0,0,4,1,5,1980
0,0,1,0,1,0,1,1981
1,1,1,0,2,0,2,1981
2,2,0,0,2,0,2,1981
0,0,1,0,1,0,1,1982
1,1,0,0,1,0,1,1982
0,0,1,0,1,0,1,1983
1,1,0,0,1,0,1,1983
0,0,1,0,1,0,1,1984
1,1,0,1,1,1,2,1984
2,2,0,2,1,3,4,1984
3,3,0,1,1,4,5,1984
4,4,0,0,1,4,5,1984
0,0,1,0,1,0,1,1985
1,1,0,0,1,0,1,1985
0,0,1,0,1,0,1,1986
1,1,0,0,1,0,1,1986
0,0,1,0,1,0,1,1987
1,1,0,0,1,0,1,1987
0,0,1,0,1,0,1,1988
1,1,0,0,1,0,1,1988
0,0,1,0,1,0,1,1989
1,1,0,1,1,1,2,1989
2,2,0,1,1,2,3,1989
3,3,0,1,1,3,4,1989
4,4,0,2,1,5,6,1989
5,5,0,5,1,10,11,1989
6,6,0,3,1,13,14,1989
7,7,1,1,2,14,16,1989
8,8,0,1,2,15,17,1989
9,9,0,0,2,15,17,1989
0,0,1,0,1,0,1,1990
1,1,2,0,3,0,3,1990
2,2,0,0,3,0,3,1990
0,0,1,0,1,0,1,1991
1,1,0,0,1,0,1,1991
0,0,1,0,1,0,1,1992
1,1,1,0,2,0,2,1992
2,2,0,0,2,0,2,1992
0,0,1,0,1,0,1,1993
1,1,0,0,1,0,1,1993
0,0,1,0,1,0,1,1994
1,1,0,0,1,0,1,1994
0,0,1,0,1,0,1,1995
1,1,0,1,1,1,2,1995
2,2,0,2,1,3,4,1995
3,3,0,1,1,4,5,1995
4,4,0,0,1,4,5,1995
0,0,1,0,1,0,1,1996
1,1,0,2,1,2,3,1996
2,2,0,1,1,3,4,1996
3,3,0,1,1,4,5,1996
4,4,1,0,2,4,6,1996
5,5,0,0,2,4,6,1996
0,0,1,0,1,0,1,1997
1,1,0,0,1,0,1,1997
0,0,1,0,1,0,1,1998
1,1,1,0,2,0,2,1998
2,2,0,0,2,0,2,1998
0,0,1,0,1,0,1,1999
1,1,1,0,2,0,2,1999
2,2,0,0,2,0,2,1999
0,0,1,0,1,0,1,2000
1,1,0,0,1,0,1,2000
0,0,1,0,1,0,1,2001
1,1,1,0,2,0,2,2001
2,2,3,0,5,0,5,2001
3,3,4,0,9,0,9,2001
4,4,3,0,12,0,12,2001
5,5,4,3,16,3,19,2001
6,6,6,3,22,6,28,2001
7,7,3,4,25,10,35,2001
8,8,5,4,30,14,44,2001
9,9,7,1,37,15,52,2001
10,10,2,4,39,19,58,2001
11,11,4,2,43,21,64,2001
12,12,6,1,49,22,71,2001
13,13,4,1,53,23,76,2001
14,14,1,2,54,25,79,2001
15,15,0,1,54,26,80,2001
16,16,0,2,54,28,82,2001
17,17,2,2,56,30,86,2001
18,18,0,1,56,31,87,2001
19,19,0,1,56,32,88,2001
20,20,0,1,56,33,89,2001
21,21,1,2,57,35,92,2001
22,22,1,2,58,37,95,2001
23,23,2,0,60,37,97,2001
24,24,3,0,63,37,100,2001
25,25,0,0,63,37,100,2001
0,0,1,0,1,0,1,2002
1,1,0,0,1,0,1,2002
0,0,1,0,1,0,1,2003
1,1,2,0,3,0,3,2003
2,2,0,1,3,1,4,2003
3,3,0,1,3,2,5,2003
4,4,1,1,4,3,7,2003
5,5,0,1,4,4,8,2003
6,6,0,1,4,5,9,2003
7,7,0,0,4,5,9,2003
0,0,1,0,1,0,1,2004
1,1,0,1,1,1,2,2004
2,2,0,0,1,1,2,2004
0,0,1,0,1,0,1,2005
1,1,0,1,1,1,2,2005
2,2,0,0,1,1,2,2005
0,0,1,0,1,0,1,2006
1,1,0,0,1,0,1,2006
0,0,1,0,1,0,1,2007
1,1,0,1,1,1,2,2007
2,2,0,1,1,2,3,2007
3,3,0,0,1,2,3,2007
0,0,1,0,1,0,1,2008
1,1,0,0,1,0,1,2008
0,0,1,0,1,0,1,2009
1,1,3,0,4,0,4,2009
2,2,2,1,6,1,7,2009
3,3,0,0,6,1,7,2009
0,0,1,0,1,0,1,2010
1,1,0,0,1,0,1,2010
0,0,1,0,1,0,1,2011
1,1,0,0,1,0,1,2011
0,0,1,0,1,0,1,2012
1,1,1,0,2,0,2,2012
2,2,1,0,3,0,3,2012
3,3,3,1,6,1,7,2012
4,4,5,1,11,2,13,2012
5,5,3,2,14,4,18,2012
6,6,1,1,15,5,20,2012
7,7,2,1,17,6,23,2012
8,8,2,0,19,6,25,2012
9,9,0,2,19,8,27,2012
10,10,0,1,19,9,28,2012
11,11,0,0,19,9,28,2012
0,0,1,0,1,0,1,2013
1,1,1,0,2,0,2,2013
2,2,1,1,3,1,4,2013
3,3,3,2,6,3,9,2013
4,4,1,5,7,8,15,2013
5,5,0,1,7,9,16,2013
6,6,0,0,7,9,16,2013
0,0,1,0,1,0,1,2014
1,1,0,0,1,0,1,2014
0,0,1,0,1,0,1,2015
1,1,1,0,2,0,2,2015
2,2,0,0,2,0,2,2015
0,0,1,0,1,0,1,2016
1,1,0,0,1,0,1,2016
0,0,1,0,1,0,1,2017
1,1,0,0,1,0,1,2017
0,0,1,0,1,0,1,2018
1,1,0,0,1,0,1,2018
0,0,1,0,1,0,1,2019
1,1,1,0,2,0,2,2019
2,2,1,0,3,0,3,2019
3,3,3,0,6,0,6,2019
4,4,5,0,11,0,11,2019
5,5,3,0,14,0,14,2019
6,6,1,1,15,1,16,2019
7,7,1,2,16,3,19,2019
8,8,2,1,18,4,22,2019
9,9,1,1,19,5,24,2019
10,10,1,1,20,6,26,2019
11,11,1,1,21,7,28,2019
12,12,1,0,22,7,29,2019
13,13,0,0,22,7,29,2019
0,0,1,0,1,0,1,2020
1,1,1,0,2,0,2,2020
2,2,1,0,3,0,3,2020
3,3,0,0,3,0,3,2020
0,0,1,0,1,0,1,2021
1,1,0,0,1,0,1,2021
0,0,1,0,1,0,1,2022
1,1,0,0,1,0,1,2022
0,0,1,0,1,0,1,2023
1,1,1,0,2,0,2,2023
2,2,0,1,2,1,3,2023
3,3,1,0,3,1,4,2023
4,4,1,0,4,1,5,2023
5,5,0,0,4,1,5,2023
0,0,1,0,1,0,1,2024
1,1,0,0,1,0,1,2024
0,0,1,0,1,0,1,2025
1,1,0,0,1,0,1,2025
0,0,1,0,1,0,1,2026
1,1,0,0,1,0,1,2026
0,0,1,0,1,0,1,2027
1,1,0,1,1,1,2,2027
2,2,0,3,1,4,5,2027
3,3,1,4,2,8,10,2027
4,4,0,6,2,14,16,2027
5,5,2,4,4,18,22,2027
6,6,2,1,6,19,25,2027
7,7,1,1,7,20,27,2027
8,8,1,1,8,21,29,2027
9,9,2,0,10,21,31,2027
10,10,1,0,11,21,32,2027
11,11,0,0,11,21,32,2027
0,0,1,0,1,0,1,2028
1,1,0,2,1,2,3,2028
2,2,0,1,1,3,4,2028
3,3,0,1,1,4,5,2028
4,4,1,0,2,4,6,2028
5,5,1,0,3,4,7,2028
6,6,0,0,3,4,7,2028
0,0,1,0,1,0,1,2029
1,1,2,0,3,0,3,2029
2,2,0,2,3,2,5,2029
3,3,1,2,4,4,8,2029
4,4,4,2,8,6,14,2029
5,5,5,3,13,9,22,2029
6,6,0,7,13,16,29,2029
7,7,0,10,13,26,39,2029
8,8,1,8,14,34,48,2029
9,9,1,9,15,43,58,2029
10,10,4,4,19,47,66,2029
11,11,3,5,22,52,74,2029
12,12,4,2,26,54,80,2029
13,13,1,0,27,54,81,2029
14,14,1,0,28,54,82,2029
15,15,0,0,28,54,82,2029
0,0,1,0,1,0,1,2030
1,1,0,0,1,0,1,2030
0,0,1,0,1,0,1,2031
1,1,1,0,2,0,2,2031
2,2,0,0,2,0,2,2031
0,0,1,0,1,0,1,2032
1,1,0,0,1,0,1,2032
0,0,1,0,1,0,1,2033
1,1,0,0,1,0,1,2033
0,0,1,0,1,0,1,2034
1,1,2,0,3,0,3,2034
2,2,1,0,4,0,4,2034
3,3,1,0,5,0,5,2034
4,4,0,0,5,0,5,2034
0,0,1,0,1,0,1,2035
1,1,0,0,1,0,1,2035
0,0,1,0,1,0,1,2036
1,1,1,0,2,0,2,2036
2,2,2,0,4,0,4,2036
3,3,1,0,5,0,5,2036
4,4,1,0,6,0,6,2036
5,5,1,1,7,1,8,2036
6,6,0,1,7,2,9,2036
7,7,0,1,7,3,10,2036
8,8,0,0,7,3,10,2036
0,0,1,0,1,0,1,2037
1,1,1,0,2,0,2,2037
2,2,0,0,2,0,2,2037
0,0,1,0,1,0,1,2038
1,1,0,0,1,0,1,2038
0,0,1,0,1,0,1,2039
1,1,1,0,2,0,2,2039
2,2,2,0,4,0,4,2039
3,3,1,0,5,0,5,2039
4,4,0,1,5,1,6,2039
5,5,0,0,5,1,6,2039
0,0,1,0,1,0,1,2040
1,1,0,0,1,0,1,2040
0,0,1,0,1,0,1,2041
1,1,1,0,2,0,2,2041
2,2,1,0,3,0,3,2041
3,3,1,0,4,0,4,2041
4,4,1,1,5,1,6,2041
5,5,1,3,6,4,10,2041
6,6,2,3,8,7,15,2041
7,7,1,1,9,8,17,2041
8,8,1,0,10,8,18,2041
9,9,1,0,11,8,19,2041
10,10,0,0,11,8,19,2041
0,0,1,0,1,0,1,2042
1,1,0,0,1,0,1,2042
0,0,1,0,1,0,1,2043
1,1,0,0,1,0,1,2043
0,0,1,0,1,0,1,2044
1,1,0,0,1,0,1,2044
0,0,1,0,1,0,1,2045
1,1,1,0,2,0,2,2045
2,2,2,1,4,1,5,2045
3,3,2,2,6,3,9,2045
4,4,1,0,7,3,10,2045
5,5,0,0,7,3,10,2045
0,0,1,0,1,0,1,2046
1,1,0,0,1,0,1,2046
0,0,1,0,1,0,1,2047
1,1,0,1,1,1,2,2047
2,2,0,2,1,3,4,2047
3,3,0,2,1,5,6,2047
4,4,2,1,3,6,9,2047
5,5,1,0,4,6,10,2047
6,6,2,0,6,6,12,2047
7,7,2,0,8,6,14,2047
8,8,1,3,9,9,18,2047
9,9,0,5,9,14,23,2047
10,10,1,3,10,17,27,2047
11,11,1,3,11,20,31,2047
12,12,0,3,11,23,34,2047
13,13,0,0,11,23,34,2047
0,0,1,0,1,0,1,2048
1,1,1,0,2,0,2,2048
2,2,0,0,2,0,2,2048
0,0,1,0,1,0,1,2049
1,1,0,0,1,0,1,2049
0,0,1,0,1,0,1,2050
1,1,1,0,2,0,2,2050
2,2,2,0,4,0,4,2050
3,3,0,0,4,0,4,2050
0,0,1,0,1,0,1,2051
1,1,0,0,1,0,1,2051
0,0,1,0,1,0,1,2052
1,1,0,0,1,0,1,2052
0,0,1,0,1,0,1,2053
1,1,1,0,2,0,2,2053
2,2,0,0,2,0,2,2053
0,0,1,0,1,0,1,2054
1,1,3,0,4,0,4,2054
2,2,2,0,6,0,6,2054
3,3,0,0,6,0,6,2054
0,0,1,0,1,0,1,2055
1,1,1,0,2,0,2,2055
2,2,2,0,4,0,4,2055
3,3,1,0,5,0,5,2055
4,4,1,0,6,0,6,2055
5,5,1,0,7,0,7,2055
6,6,1,0,8,0,8,2055
7,7,2,0,10,0,10,2055
8,8,0,1,10,1,11,2055
9,9,1,0,11,1,12,2055
10,10,1,0,12,1,13,2055
11,11,0,0,12,1,13,2055
0,0,1,0,1,0,1,2056
1,1,1,0,2,0,2,2056
2,2,0,1,2,1,3,2056
3,3,1,0,3,1,4,2056
4,4,0,0,3,1,4,2056
0,0,1,0,1,0,1,2057
1,1,0,0,1,0,1,2057
0,0,1,0,1,0,1,2058
1,1,1,1,2,1,3,2058
2,2,1,2,3,3,6,2058
3,3,1,2,4,5,9,2058
4,4,1,2,5,7,12,2058
5,5,1,0,6,7,13,2058
6,6,1,0,7,7,14,2058
7,7,0,0,7,7,14,2058
0,0,1,0,1,0,1,2059
1,1,0,0,1,0,1,2059
0,0,1,0,1,0,1,2060
1,1,1,0,2,0,2,2060
2,2,0,0,2,0,2,2060
0,0,1,0,1,0,1,2061
1,1,0,0,1,0,1,2061
0,0,1,0,1,0,1,2062
1,1,0,0,1,0,1,2062
0,0,1,0,1,0,1,2063
1,1,0,1,1,1,2,2063
2,2,0,1,1,2,3,2063
3,3,0,3,1,5,6,2063
4,4,0,3,1,8,9,2063
5,5,0,0,1,8,9,2063
0,0,1,0,1,0,1,2064
1,1,0,0,1,0,1,2064
0,0,1,0,1,0,1,2065
1,1,1,1,2,1,3,2065
2,2,2,0,4,1,5,2065
3,3,1,1,5,2,7,2065
4,4,1,1,6,3,9,2065
5,5,1,1,7,4,11,2065
6,6,1,2,8,6,14,2065
7,7,3,2,11,8,19,2065
8,8,5,1,16,9,25,2065
9,9,5,3,21,12,33,2065
10,10,3,5,24,17,41,2065
11,11,6,6,30,23,53,2065
12,12,6,4,36,27,63,2065
13,13,7,2,43,29,72,2065
14,14,12,3,55,32,87,2065
15,15,9,4,64,36,100,2065
16,16,13,3,77,39,116,2065
17,17,5,6,82,45,127,2065
18,18,5,7,87,52,139,2065
19,19,7,9,94,61,155,2065
20,20,9,6,103,67,170,2065
21,21,8,9,111,76,187,2065
22,22,7,8,118,84,202,2065
23,23,12,8,130,92,222,2065
24,24,7,5,137,97,234,2065
25,25,3,7,140,104,244,2065
26,26,4,6,144,110,254,2065
27,27,4,6,148,116,264,2065
28,28,7,6,155,122,277,2065
29,29,5,4,160,126,286,2065
30,30,0,8,160,134,294,2065
31,31,1,11,161,145,306,2065
32,32,3,17,164,162,326,2065
33,33,2,12,166,174,340,2065
34,34,1,13,167,187,354,2065
35,35,3,6,170,193,363,2065
36,36,4,2,174,195,369,2065
37,37,6,2,180,197,377,2065
38,38,6,5,186,202,388,2065
39,39,4,5,190,207,397,2065
40,40,2,6,192,213,405,2065
41,41,2,3,194,216,410,2065
42,42,0,1,194,217,411,2065
43,43,0,0,194,217,411,2065
0,0,1,0,1,0,1,2066
1,1,0,0,1,0,1,2066
0,0,1,0,1,0,1,2067
1,1,1,1,2,1,3,2067
2,2,1,1,3,2,5,2067
3,3,0,2,3,4,7,2067
4,4,0,2,3,6,9,2067
5,5,0,0,3,6,9,2067
0,0,1,0,1,0,1,2068
1,1,2,0,3,0,3,2068
2,2,1,0,4,0,4,2068
3,3,0,0,4,0,4,2068
0,0,1,0,1,0,1,2069
1,1,1,0,2,0,2,2069
2,2,0,0,2,0,2,2069
0,0,1,0,1,0,1,2070
1,1,1,1,2,1,3,2070
2,2,1,2,3,3,6,2070
3,3,1,4,4,7,11,2070
4,4,2,3,6,10,16,2070
5,5,1,2,7,12,19,2070
6,6,0,1,7,13,20,2070
7,7,0,0,7,13,20,2070
0,0,1,0,1,0,1,2071
1,1,2,0,3,0,3,2071
2,2,4,0,7,0,7,2071
3,3,3,0,10,0,10,2071
4,4,1,0,11,0,11,2071
5,5,0,0,11,0,11,2071
0,0,1,0,1,0,1,2072
1,1,0,0,1,0,1,2072
0,0,1,0,1,0,1,2073
1,1,1,0,2,0,2,2073
2,2,0,0,2,0,2,2073
0,0,1,0,1,0,1,2074
1,1,1,0,2,0,2,2074
2,2,1,0,3,0,3,2074
3,3,0,0,3,0,3,2074
0,0,1,0,1,0,1,2075
1,1,0,0,1,0,1,2075
0,0,1,0,1,0,1,2076
1,1,2,0,3,0,3,2076
2,2,3,1,6,1,7,2076
3,3,3,2,9,3,12,2076
4,4,1,2,10,5,15,2076
5,5,2,4,12,9,21,2076
6,6,1,8,13,17,30,2076
7,7,2,4,15,21,36,2076
8,8,0,3,15,24,39,2076
9,9,0,5,15,29,44,2076
10,10,2,4,17,33,50,2076
11,11,2,0,19,33,52,2076
12,12,0,0,19,33,52,2076
0,0,1,0,1,0,1,2077
1,1,1,0,2,0,2,2077
2,2,0,0,2,0,2,2077
0,0,1,0,1,0,1,2078
1,1,3,0,4,0,4,2078
2,2,1,2,5,2,7,2078
3,3,0,2,5,4,9,2078
4,4,1,2,6,6,12,2078
5,5,1,2,7,8,15,2078
6,6,0,1,7,9,16,2078
7,7,1,0,8,9,17,2078
8,8,1,0,9,9,18,2078
9,9,0,0,9,9,18,2078
0,0,1,0,1,0,1,2079
1,1,0,0,1,0,1,2079
0,0,1,0,1,0,1,2080
1,1,0,1,1,1,2,2080
2,2,1,0,2,1,3,2080
3,3,1,0,3,1,4,2080
4,4,1,0,4,1,5,2080
5,5,1,0,5,1,6,2080
6,6,1,0,6,1,7,2080
7,7,2,0,8,1,9,2080
8,8,1,0,9,1,10,2080
9,9,1,0,10,1,11,2080
10,10,1,0,11,1,12,2080
11,11,1,0,12,1,13,2080
12,12,0,0,12,1,13,2080
0,0,1,0,1,0,1,2081
1,1,2,0,3,0,3,2081
2,2,3,0,6,0,6,2081
3,3,1,0,7,0,7,2081
4,4,1,0,8,0,8,2081
5,5,1,1,9,1,10,2081
6,6,2,1,11,2,13,2081
7,7,2,0,13,2,15,2081
8,8,2,0,15,2,17,2081
9,9,0,2,15,4,19,2081
10,10,0,2,15,6,21,2081
11,11,0,1,15,7,22,2081
12,12,0,1,15,8,23,2081
13,13,0,2,15,10,25,2081
14,14,1,2,16,12,28,2081
15,15,1,1,17,13,30,2081
16,16,0,2,17,15,32,2081
17,17,0,2,17,17,34,2081
18,18,0,0,17,17,34,2081
0,0,1,0,1,0,1,2082
1,1,0,0,1,0,1,2082
0,0,1,0,1,0,1,2083
1,1,0,0,1,0,1,2083
0,0,1,0,1,0,1,2084
1,1,1,0,2,0,2,2084
2,2,0,0,2,0,2,2084
0,0,1,0,1,0,1,2085
1,1,0,0,1,0,1,2085
0,0,1,0,1,0,1,2086
1,1,1,0,2,0,2,2086
2,2,0,0,2,0,2,2086
0,0,1,0,1,0,1,2087
1,1,0,0,1,0,1,2087
0,0,1,0,1,0,1,2088
1,1,1,0,2,0,2,2088
2,2,2,0,4,0,4,2088
3,3,2,0,6,0,6,2088
4,4,3,1,9,1,10,2088
5,5,1,0,10,1,11,2088
6,6,1,0,11,1,12,2088
7,7,1,0,12,1,13,2088
8,8,2,0,14,1,15,2088
9,9,0,0,14,1,15,2088
0,0,1,0,1,0,1,2089
1,1,1,0,2,0,2,2089
2,2,2,0,4,0,4,2089
3,3,0,0,4,0,4,2089
0,0,1,0,1,0,1,2090
1,1,0,0,1,0,1,2090
0,0,1,0,1,0,1,2091
1,1,1,0,2,0,2,2091
2,2,2,0,4,0,4,2091
3,3,0,0,4,0,4,2091
0,0,1,0,1,0,1,2092
1,1,0,0,1,0,1,2092
0,0,1,0,1,0,1,2093
1,1,2,1,3,1,4,2093
2,2,5,1,8,2,10,2093
3,3,4,0,12,2,14,2093
4,4,0,1,12,3,15,2093
5,5,0,2,12,5,17,2093
6,6,1,1,13,6,19,2093
7,7,2,3,15,9,24,2093
8,8,0,4,15,13,28,2093
9,9,1,1,16,14,30,2093
10,10,0,1,16,15,31,2093
11,11,0,1,16,16,32,2093
12,12,1,1,17,17,34,2093
13,13,1,3,18,20,38,2093
14,14,0,3,18,23,41,2093
15,15,0,3,18,26,44,2093
16,16,0,3,18,29,47,2093
17,17,1,3,19,32,51,2093
18,18,2,3,21,35,56,2093
19,19,2,2,23,37,60,2093
20,20,3,5,26,42,68,2093
21,21,6,7,32,49,81,2093
22,22,4,7,36,56,92,2093
23,23,6,8,42,64,106,2093
24,24,5,11,47,75,122,2093
25,25,10,7,57,82,139,2093
26,26,5,9,62,91,153,2093
27,27,5,5,67,96,163,2093
28,28,5,4,72,100,172,2093
29,29,4,5,76,105,181,2093
30,30,4,4,80,109,189,2093
31,31,3,6,83,115,198,2093
32,32,6,3,89,118,207,2093
33,33,7,1,96,119,215,2093
34,34,7,2,103,121,224,2093
35,35,5,2,108,123,231,2093
36,36,4,2,112,125,237,2093
37,37,2,3,114,128,242,2093
38,38,0,2,114,130,244,2093
39,39,0,0,114,130,244,2093
0,0,1,0,1,0,1,2094
1,1,0,0,1,0,1,2094
0,0,1,0,1,0,1,2095
1,1,1,0,2,0,2,2095
2,2,2,0,4,0,4,2095
3,3,1,0,5,0,5,2095
4,4,2,0,7,0,7,2095
5,5,0,2,7,2,9,2095
6,6,0,1,7,3,10,2095
7,7,0,2,7,5,12,2095
8,8,0,0,7,5,12,2095
0,0,1,0,1,0,1,2096
1,1,0,0,1,0,1,2096
0,0,1,0,1,0,1,2097
1,1,0,0,1,0,1,2097
0,0,1,0,1,0,1,2098
1,1,1,1,2,1,3,2098
2,2,3,0,5,1,6,2098
3,3,1,1,6,2,8,2098
4,4,4,0,10,2,12,2098
5,5,6,1,16,3,19,2098
6,6,5,1,21,4,25,2098
7,7,9,1,30,5,35,2098
8,8,8,3,38,8,46,2098
9,9,7,3,45,11,56,2098
10,10,8,2,53,13,66,2098
11,11,4,5,57,18,75,2098
12,12,1,4,58,22,80,2098
13,13,0,1,58,23,81,2098
14,14,2,1,60,24,84,2098
15,15,1,0,61,24,85,2098
16,16,0,1,61,25,86,2098
17,17,0,2,61,27,88,2098
18,18,0,4,61,31,92,2098
19,19,0,2,61,33,94,2098
20,20,0,0,61,33,94,2098
0,0,1,0,1,0,1,2099
1,1,0,0,1,0,1,2099
0,0,1,0,1,0,1,2100
1,1,2,0,3,0,3,2100
2,2,2,0,5,0,5,2100
3,3,2,1,7,1,8,2100
4,4,4,1,11,2,13,2100
5,5,3,1,14,3,17,2100
6,6,1,0,15,3,18,2100
7,7,1,0,16,3,19,2100
8,8,0,0,16,3,19,2100
0,0,1,0,1,0,1,2101
1,1,0,0,1,0,1,2101
0,0,1,0,1,0,1,2102
1,1,3,0,4,0,4,2102
2,2,1,0,5,0,5,2102
3,3,0,0,5,0,5,2102
0,0,1,0,1,0,1,2103
1,1,2,0,3,0,3,2103
2,2,1,1,4,1,5,2103
3,3,1,1,5,2,7,2103
4,4,1,1,6,3,9,2103
5,5,2,2,8,5,13,2103
6,6,2,2,10,7,17,2103
7,7,1,1,11,8,19,2103
8,8,1,0,12,8,20,2103
9,9,1,0,13,8,21,2103
10,10,0,0,13,8,21,2103
0,0,1,0,1,0,1,2104
1,1,1,1,2,1,3,2104
2,2,0,0,2,1,3,2104
0,0,1,0,1,0,1,2105
1,1,1,0,2,0,2,2105
2,2,1,0,3,0,3,2105
3,3,2,0,5,0,5,2105
4,4,2,0,7,0,7,2105
5,5,1,0,8,0,8,2105
6,6,2,1,10,1,11,2105
7,7,3,1,13,2,15,2105
8,8,0,1,13,3,16,2105
9,9,0,0,13,3,16,2105
0,0,1,0,1,0,1,2106
1,1,2,1,3,1,4,2106
2,2,0,0,3,1,4,2106
0,0,1,0,1,0,1,2107
1,1,0,0,1,0,1,2107
0,0,1,0,1,0,1,2108
1,1,1,0,2,0,2,2108
2,2,0,0,2,0,2,2108
0,0,1,0,1,0,1,2109
1,1,0,1,1,1,2,2109
2,2,0,1,1,2,3,2109
3,3,0,0,1,2,3,2109
0,0,1,0,1,0,1,2110
1,1,1,1,2,1,3,2110
2,2,2,2,4,3,7,2110
3,3,0,3,4,6,10,2110
4,4,0,1,4,7,11,2110
5,5,0,0,4,7,11,2110
0,0,1,0,1,0,1,2111
1,1,0,0,1,0,1,2111
0,0,1,0,1,0,1,2112
1,1,3,0,4,0,4,2112
2,2,2,1,6,1,7,2112
3,3,3,2,9,3,12,2112
4,4,3,2,12,5,17,2112
5,5,2,1,14,6,20,2112
6,6,4,0,18,6,24,2112
7,7,2,0,20,6,26,2112
8,8,1,1,21,7,28,2112
9,9,3,1,24,8,32,2112
10,10,6,2,30,10,40,2112
11,11,6,1,36,11,47,2112
12,12,5,3,41,14,55,2112
13,13,6,5,47,19,66,2112
14,14,5,7,52,26,78,2112
15,15,1,6,53,32,85,2112
16,16,5,3,58,35,93,2112
17,17,3,6,61,41,102,2112
18,18,7,2,68,43,111,2112
19,19,5,2,73,45,118,2112
20,20,3,3,76,48,124,2112
21,21,2,5,78,53,131,2112
22,22,2,7,80,60,140,2112
23,23,2,7,82,67,149,2112
24,24,0,4,82,71,153,2112
25,25,1,1,83,72,155,2112
26,26,2,0,85,72,157,2112
27,27,3,1,88,73,161,2112
28,28,2,2,90,75,165,2112
29,29,0,2,90,77,167,2112
30,30,1,0,91,77,168,2112
31,31,1,1,92,78,170,2112
32,32,1,0,93,78,171,2112
33,33,0,0,93,78,171,2112
0,0,1,0,1,0,1,2113
1,1,0,0,1,0,1,2113
0,0,1,0,1,0,1,2114
1,1,0,1,1,1,2,2114
2,2,0,0,1,1,2,2114
0,0,1,0,1,0,1,2115
1,1,2,0,3,0,3,2115
2,2,2,0,5,0,5,2115
3,3,3,0,8,0,8,2115
4,4,5,0,13,0,13,2115
5,5,3,0,16,0,16,2115
6,6,3,0,19,0,19,2115
7,7,2,2,21,2,23,2115
8,8,1,0,22,2,24,2115
9,9,1,0,23,2,25,2115
10,10,1,0,24,2,26,2115
11,11,0,0,24,2,26,2115
0,0,1,0,1,0,1,2116
1,1,2,0,3,0,3,2116
2,2,3,1,6,1,7,2116
3,3,3,1,9,2,11,2116
4,4,3,1,12,3,15,2116
5,5,1,0,13,3,16,2116
6,6,0,0,13,3,16,2116
0,0,1,0,1,0,1,2117
1,1,0,0,1,0,1,2117
0,0,1,0,1,0,1,2118
1,1,1,0,2,0,2,2118
2,2,1,0,3,0,3,2118
3,3,1,0,4,0,4,2118
4,4,0,0,4,0,4,2118
0,0,1,0,1,0,1,2119
1,1,1,0,2,0,2,2119
2,2,0,0,2,0,2,2119
0,0,1,0,1,0,1,2120
1,1,1,0,2,0,2,2120
2,2,1,0,3,0,3,2120
3,3,0,1,3,1,4,2120
4,4,1,0,4,1,5,2120
5,5,1,0,5,1,6,2120
6,6,0,0,5,1,6,2120
0,0,1,0,1,0,1,2121
1,1,0,0,1,0,1,2121
0,0,1,0,1,0,1,2122
1,1,1,1,2,1,3,2122
2,2,0,0,2,1,3,2122
0,0,1,0,1,0,1,2123
1,1,2,0,3,0,3,2123
2,2,1,0,4,0,4,2123
3,3,1,1,5,1,6,2123
4,4,0,2,5,3,8,2123
5,5,0,1,5,4,9,2123
6,6,1,1,6,5,11,2123
7,7,1,1,7,6,13,2123
8,8,3,1,10,7,17,2123
9,9,3,1,13,8,21,2123
10,10,3,2,16,10,26,2123
11,11,6,1,22,11,33,2123
12,12,3,2,25,13,38,2123
13,13,1,2,26,15,41,2123
14,14,0,2,26,17,43,2123
15,15,1,2,27,19,46,2123
16,16,2,2,29,21,50,2123
17,17,4,0,33,21,54,2123
18,18,2,1,35,22,57,2123
19,19,1,2,36,24,60,2123
20,20,1,4,37,28,65,2123
21,21,0,5,37,33,70,2123
22,22,4,2,41,35,76,2123
23,23,1,0,42,35,77,2123
24,24,2,0,44,35,79,2123
25,25,0,0,44,35,79,2123
0,0,1,0,1,0,1,2124
1,1,1,1,2,1,3,2124
2,2,2,1,4,2,6,2124
3,3,2,0,6,2,8,2124
4,4,1,0,7,2,9,2124
5,5,1,0,8,2,10,2124
6,6,0,1,8,3,11,2124
7,7,0,2,8,5,13,2124
8,8,0,0,8,5,13,2124
0,0,1,0,1,0,1,2125
1,1,1,0,2,0,2,2125
2,2,1,1,3,1,4,2125
3,3,1,1,4,2,6,2125
4,4,0,2,4,4,8,2125
5,5,0,0,4,4,8,2125
0,0,1,0,1,0,1,2126
1,1,0,0,1,0,1,2126
0,0,1,0,1,0,1,2127
1,1,1,0,2,0,2,2127
2,2,0,0,2,0,2,2127
0,0,1,0,1,0,1,2128
1,1,0,1,1,1,2,2128
2,2,1,0,2,1,3,2128
3,3,0,0,2,1,3,2128
0,0,1,0,1,0,1,2129
1,1,0,1,1,1,2,2129
2,2,0,0,1,1,2,2129
0,0,1,0,1,0,1,2130
1,1,1,1,2,1,3,2130
2,2,0,2,2,3,5,2130
3,3,0,0,2,3,5,2130
0,0,1,0,1,0,1,2131
1,1,1,0,2,0,2,2131
2,2,0,0,2,0,2,2131
0,0,1,0,1,0,1,2132
1,1,0,0,1,0,1,2132
0,0,1,0,1,0,1,2133
1,1,0,0,1,0,1,2133
0,0,1,0,1,0,1,2134
1,1,1,0,2,0,2,2134
2,2,2,0,4,0,4,2134
3,3,3,1,7,1,8,2134
4,4,2,2,9,3,12,2134
5,5,3,2,12,5,17,2134
6,6,1,2,13,7,20,2134
7,7,0,0,13,7,20,2134
0,0,1,0,1,0,1,2135
1,1,0,0,1,0,1,2135
0,0,1,0,1,0,1,2136
1,1,1,0,2,0,2,2136
2,2,0,1,2,1,3,2136
3,3,0,0,2,1,3,2136
0,0,1,0,1,0,1,2137
1,1,1,0,2,0,2,2137
2,2,1,2,3,2,5,2137
3,3,1,2,4,4,8,2137
4,4,0,3,4,7,11,2137
5,5,0,1,4,8,12,2137
6,6,0,0,4,8,12,2137
0,0,1,0,1,0,1,2138
1,1,1,0,2,0,2,2138
2,2,0,0,2,0,2,2138
0,0,1,0,1,0,1,2139
1,1,1,1,2,1,3,2139
2,2,2,1,4,2,6,2139
3,3,2,0,6,2,8,2139
4,4,4,0,10,2,12,2139
5,5,7,0,17,2,19,2139
6,6,4,5,21,7,28,2139
7,7,5,5,26,12,38,2139
8,8,5,4,31,16,47,2139
9,9,5,7,36,23,59,2139
10,10,3,10,39,33,72,2139
11,11,3,9,42,42,84,2139
12,12,3,4,45,46,91,2139
13,13,6,3,51,49,100,2139
14,14,2,1,53,50,103,2139
15,15,1,0,54,50,104,2139
16,16,0,0,54,50,104,2139
0,0,1,0,1,0,1,2140
1,1,1,1,2,1,3,2140
2,2,0,0,2,1,3,2140
0,0,1,0,1,0,1,2141
1,1,0,1,1,1,2,2141
2,2,0,1,1,2,3,2141
3,3,0,0,1,2,3,2141
0,0,1,0,1,0,1,2142
1,1,0,0,1,0,1,2142
0,0,1,0,1,0,1,2143
1,1,0,0,1,0,1,2143
0,0,1,0,1,0,1,2144
1,1,0,0,1,0,1,2144
0,0,1,0,1,0,1,2145
1,1,1,0,2,0,2,2145
2,2,1,0,3,0,3,2145
3,3,0,1,3,1,4,2145
4,4,0,1,3,2,5,2145
5,5,0,0,3,2,5,2145
0,0,1,0,1,0,1,2146
1,1,0,2,1,2,3,2146
2,2,2,1,3,3,6,2146
3,3,2,1,5,4,9,2146
4,4,0,0,5,4,9,2146
0,0,1,0,1,0,1,2147
1,1,0,0,1,0,1,2147
0,0,1,0,1,0,1,2148
1,1,0,0,1,0,1,2148
0,0,1,0,1,0,1,2149
1,1,0,1,1,1,2,2149
2,2,0,1,1,2,3,2149
3,3,0,1,1,3,4,2149
4,4,0,0,1,3,4,2149
0,0,1,0,1,0,1,2150
1,1,0,1,1,1,2,2150
2,2,0,2,1,3,4,2150
3,3,0,1,1,4,5,2150
4,4,0,0,1,4,5,2150
0,0,1,0,1,0,1,2151
1,1,1,0,2,0,2,2151
2,2,1,0,3,0,3,2151
3,3,0,0,3,0,3,2151
0,0,1,0,1,0,1,2152
1,1,0,0,1,0,1,2152
0,0,1,0,1,0,1,2153
1,1,1,0,2,0,2,2153
2,2,2,2,4,2,6,2153
3,3,3,3,7,5,12,2153
4,4,1,1,8,6,14,2153
5,5,1,2,9,8,17,2153
6,6,2,0,11,8,19,2153
7,7,1,0,12,8,20,2153
8,8,0,0,12,8,20,2153
0,0,1,0,1,0,1,2154
1,1,2,0,3,0,3,2154
2,2,1,1,4,1,5,2154
3,3,0,0,4,1,5,2154
0,0,1,0,1,0,1,2155
1,1,0,0,1,0,1,2155
0,0,1,0,1,0,1,2156
1,1,1,0,2,0,2,2156
2,2,0,0,2,0,2,2156
0,0,1,0,1,0,1,2157
1,1,1,1,2,1,3,2157
2,2,2,1,4,2,6,2157
3,3,2,0,6,2,8,2157
4,4,1,0,7,2,9,2157
5,5,0,0,7,2,9,2157
0,0,1,0,1,0,1,2158
1,1,1,0,2,0,2,2158
2,2,1,1,3,1,4,2158
3,3,0,1,3,2,5,2158
4,4,0,0,3,2,5,2158
0,0,1,0,1,0,1,2159
1,1,0,0,1,0,1,2159
0,0,1,0,1,0,1,2160
1,1,0,0,1,0,1,2160
0,0,1,0,1,0,1,2161
1,1,1,0,2,0,2,2161
2,2,0,0,2,0,2,2161
0,0,1,0,1,0,1,2162
1,1,0,1,1,1,2,2162
2,2,0,2,1,3,4,2162
3,3,0,3,1,6,7,2162
4,4,0,2,1,8,9,2162
5,5,0,1,1,9,10,2162
6,6,1,0,2,9,11,2162
7,7,0,0,2,9,11,2162
0,0,1,0,1,0,1,2163
1,1,0,0,1,0,1,2163
0,0,1,0,1,0,1,2164
1,1,0,0,1,0,1,2164
0,0,1,0,1,0,1,2165
1,1,1,0,2,0,2,2165
2,2,1,0,3,0,3,2165
3,3,0,0,3,0,3,2165
0,0,1,0,1,0,1,2166
1,1,1,0,2,0,2,2166
2,2,0,0,2,0,2,2166
0,0,1,0,1,0,1,2167
1,1,1,0,2,0,2,2167
2,2,0,0,2,0,2,2167
0,0,1,0,1,0,1,2168
1,1,0,0,1,0,1,2168
0,0,1,0,1,0,1,2169
1,1,2,0,3,0,3,2169
2,2,0,0,3,0,3,2169
0,0,1,0,1,0,1,2170
1,1,1,0,2,0,2,2170
2,2,0,0,2,0,2,2170
0,0,1,0,1,0,1,2171
1,1,1,0,2,0,2,2171
2,2,1,0,3,0,3,2171
3,3,1,1,4,1,5,2171
4,4,1,1,5,2,7,2171
5,5,1,0,6,2,8,2171
6,6,0,1,6,3,9,2171
7,7,0,2,6,5,11,2171
8,8,0,1,6,6,12,2171
9,9,0,1,6,7,13,2171
10,10,0,2,6,9,15,2171
11,11,0,1,6,10,16,2171
12,12,0,1,6,11,17,2171
13,13,0,0,6,11,17,2171
0,0,1,0,1,0,1,2172
1,1,1,0,2,0,2,2172
2,2,1,0,3,0,3,2172
3,3,2,0,5,0,5,2172
4,4,1,0,6,0,6,2172
5,5,2,0,8,0,8,2172
6,6,1,0,9,0,9,2172
7,7,1,0,10,0,10,2172
8,8,0,0,10,0,10,2172
0,0,1,0,1,0,1,2173
1,1,0,0,1,0,1,2173
0,0,1,0,1,0,1,2174
1,1,1,0,2,0,2,2174
2,2,0,1,2,1,3,2174
3,3,0,1,2,2,4,2174
4,4,0,0,2,2,4,2174
0,0,1,0,1,0,1,2175
1,1,1,0,2,0,2,2175
2,2,1,0,3,0,3,2175
3,3,0,0,3,0,3,2175
0,0,1,0,1,0,1,2176
1,1,0,0,1,0,1,2176
0,0,1,0,1,0,1,2177
1,1,1,0,2,0,2,2177
2,2,0,0,2,0,2,2177
0,0,1,0,1,0,1,2178
1,1,0,0,1,0,1,2178
0,0,1,0,1,0,1,2179
1,1,0,0,1,0,1,2179
0,0,1,0,1,0,1,2180
1,1,1,0,2,0,2,2180
2,2,2,0,4,0,4,2180
3,3,0,3,4,3,7,2180
4,4,0,1,4,4,8,2180
5,5,0,0,4,4,8,2180
0,0,1,0,1,0,1,2181
1,1,1,0,2,0,2,2181
2,2,2,1,4,1,5,2181
3,3,1,3,5,4,9,2181
4,4,3,4,8,8,16,2181
5,5,3,5,11,13,24,2181
6,6,2,5,13,18,31,2181
7,7,1,4,14,22,36,2181
8,8,2,2,16,24,40,2181
9,9,2,2,18,26,44,2181
10,10,4,2,22,28,50,2181
11,11,2,4,24,32,56,2181
12,12,0,3,24,35,59,2181
13,13,0,3,24,38,62,2181
14,14,0,1,24,39,63,2181
15,15,0,1,24,40,64,2181
16,16,2,1,26,41,67,2181
17,17,2,3,28,44,72,2181
18,18,3,2,31,46,77,2181
19,19,2,0,33,46,79,2181
20,20,1,0,34,46,80,2181
21,21,2,0,36,46,82,2181
22,22,3,0,39,46,85,2181
23,23,6,0,45,46,91,2181
24,24,5,0,50,46,96,2181
25,25,7,2,57,48,105,2181
26,26,8,6,65,54,119,2181
27,27,10,6,75,60,135,2181
28,28,11,7,86,67,153,2181
29,29,10,6,96,73,169,2181
30,30,12,7,108,80,188,2181
31,31,10,6,118,86,204,2181
32,32,4,4,122,90,212,2181
33,33,3,2,125,92,217,2181
34,34,2,2,127,94,221,2181
35,35,1,1,128,95,223,2181
36,36,0,1,128,96,224,2181
37,37,0,1,128,97,225,2181
38,38,0,1,128,98,226,2181
39,39,0,0,128,98,226,2181
0,0,1,0,1,0,1,2182
1,1,0,0,1,0,1,2182
0,0,1,0,1,0,1,2183
1,1,0,0,1,0,1,2183
0,0,1,0,1,0,1,2184
1,1,0,0,1,0,1,2184
0,0,1,0,1,0,1,2185
1,1,2,1,3,1,4,2185
2,2,1,2,4,3,7,2185
3,3,1,2,5,5,10,2185
4,4,0,2,5,7,12,2185
5,5,0,1,5,8,13,2185
6,6,0,2,5,10,15,2185
7,7,0,0,5,10,15,2185
0,0,1,0,1,0,1,2186
1,1,0,0,1,0,1,2186
0,0,1,0,1,0,1,2187
1,1,1,1,2,1,3,2187
2,2,1,0,3,1,4,2187
3,3,0,1,3,2,5,2187
4,4,0,2,3,4,7,2187
5,5,0,0,3,4,7,2187
0,0,1,0,1,0,1,2188
1,1,1,1,2,1,3,2188
2,2,1,2,3,3,6,2188
3,3,0,2,3,5,8,2188
4,4,0,0,3,5,8,2188
0,0,1,0,1,0,1,2189
1,1,1,0,2,0,2,2189
2,2,0,0,2,0,2,2189
0,0,1,0,1,0,1,2190
1,1,0,0,1,0,1,2190
0,0,1,0,1,0,1,2191
1,1,0,0,1,0,1,2191
0,0,1,0,1,0,1,2192
1,1,1,0,2,0,2,2192
2,2,0,0,2,0,2,2192
0,0,1,0,1,0,1,2193
1,1,0,0,1,0,1,2193
0,0,1,0,1,0,1,2194
1,1,1,0,2,0,2,2194
2,2,0,0,2,0,2,2194
0,0,1,0,1,0,1,2195
1,1,0,0,1,0,1,2195
0,0,1,0,1,0,1,2196
1,1,0,0,1,0,1,2196
0,0,1,0,1,0,1,2197
1,1,1,0,2,0,2,2197
2,2,0,0,2,0,2,2197
0,0,1,0,1,0,1,2198
1,1,1,0,2,0,2,2198
2,2,0,0,2,0,2,2198
0,0,1,0,1,0,1,2199
1,1,1,0,2,0,2,2199
2,2,0,1,2,1,3,2199
3,3,0,0,2,1,3,2199
0,0,1,0,1,0,1,2200
1,1,0,0,1,0,1,2200
0,0,1,0,1,0,1,2201
1,1,2,1,3,1,4,2201
2,2,0,0,3,1,4,2201
0,0,1,0,1,0,1,2202
1,1,1,0,2,0,2,2202
2,2,0,0,2,0,2,2202
0,0,1,0,1,0,1,2203
1,1,0,0,1,0,1,2203
0,0,1,0,1,0,1,2204
1,1,0,0,1,0,1,2204
0,0,1,0,1,0,1,2205
1,1,1,0,2,0,2,2205
2,2,1,0,3,0,3,2205
3,3,0,0,3,0,3,2205
0,0,1,0,1,0,1,2206
1,1,2,0,3,0,3,2206
2,2,1,0,4,0,4,2206
3,3,0,0,4,0,4,2206
0,0,1,0,1,0,1,2207
1,1,0,1,1,1,2,2207
2,2,0,2,1,3,4,2207
3,3,0,0,1,3,4,2207
0,0,1,0,1,0,1,2208
1,1,2,1,3,1,4,2208
2,2,1,1,4,2,6,2208
3,3,1,1,5,3,8,2208
4,4,0,0,5,3,8,2208
0,0,1,0,1,0,1,2209
1,1,0,1,1,1,2,2209
2,2,1,1,2,2,4,2209
3,3,0,0,2,2,4,2209
0,0,1,0,1,0,1,2210
1,1,1,0,2,0,2,2210
2,2,2,1,4,1,5,2210
3,3,1,0,5,1,6,2210
4,4,0,0,5,1,6,2210
0,0,1,0,1,0,1,2211
1,1,0,0,1,0,1,2211
0,0,1,0,1,0,1,2212
1,1,0,0,1,0,1,2212
0,0,1,0,1,0,1,2213
1,1,0,0,1,0,1,2213
0,0,1,0,1,0,1,2214
1,1,3,0,4,0,4,2214
2,2,0,0,4,0,4,2214
0,0,1,0,1,0,1,2215
1,1,2,0,3,0,3,2215
2,2,2,0,5,0,5,2215
3,3,2,1,7,1,8,2215
4,4,3,0,10,1,11,2215
5,5,1,0,11,1,12,2215
6,6,0,0,11,1,12,2215
0,0,1,0,1,0,1,2216
1,1,1,0,2,0,2,2216
2,2,1,0,3,0,3,2216
3,3,2,0,5,0,5,2216
4,4,2,1,7,1,8,2216
5,5,4,1,11,2,13,2216
6,6,4,0,15,2,17,2216
7,7,1,0,16,2,18,2216
8,8,1,0,17,2,19,2216
9,9,0,0,17,2,19,2216
0,0,1,0,1,0,1,2217
1,1,1,0,2,0,2,2217
2,2,0,0,2,0,2,2217
0,0,1,0,1,0,1,2218
1,1,0,0,1,0,1,2218
0,0,1,0,1,0,1,2219
1,1,1,0,2,0,2,2219
2,2,1,0,3,0,3,2219
3,3,0,0,3,0,3,2219
0,0,1,0,1,0,1,2220
1,1,0,1,1,1,2,2220
2,2,0,2,1,3,4,2220
3,3,1,0,2,3,5,2220
4,4,0,0,2,3,5,2220
0,0,1,0,1,0,1,2221
1,1,0,0,1,0,1,2221
0,0,1,0,1,0,1,2222
1,1,2,0,3,0,3,2222
2,2,4,0,7,0,7,2222
3,3,1,0,8,0,8,2222
4,4,0,0,8,0,8,2222
0,0,1,0,1,0,1,2223
1,1,0,0,1,0,1,2223
0,0,1,0,1,0,1,2224
1,1,1,0,2,0,2,2224
2,2,0,0,2,0,2,2224
0,0,1,0,1,0,1,2225
1,1,1,0,2,0,2,2225
2,2,0,0,2,0,2,2225
0,0,1,0,1,0,1,2226
1,1,3,0,4,0,4,2226
2,2,2,1,6,1,7,2226
3,3,3,1,9,2,11,2226
4,4,1,2,10,4,14,2226
5,5,1,0,11,4,15,2226
6,6,2,0,13,4,17,2226
7,7,1,1,14,5,19,2226
8,8,0,0,14,5,19,2226
0,0,1,0,1,0,1,2227
1,1,1,0,2,0,2,2227
2,2,1,0,3,0,3,2227
3,3,0,0,3,0,3,2227
0,0,1,0,1,0,1,2228
1,1,0,0,1,0,1,2228
0,0,1,0,1,0,1,2229
1,1,0,0,1,0,1,2229
0,0,1,0,1,0,1,2230
1,1,0,0,1,0,1,2230
0,0,1,0,1,0,1,2231
1,1,0,0,1,0,1,2231
0,0,1,0,1,0,1,2232
1,1,1,0,2,0,2,2232
2,2,0,0,2,0,2,2232
0,0,1,0,1,0,1,2233
1,1,1,0,2,0,2,2233
2,2,1,0,3,0,3,2233
3,3,0,0,3,0,3,2233
0,0,1,0,1,0,1,2234
1,1,1,0,2,0,2,2234
2,2,1,0,3,0,3,2234
3,3,0,0,3,0,3,2234
0,0,1,0,1,0,1,2235
1,1,0,1,1,1,2,2235
2,2,0,0,1,1,2,2235
0,0,1,0,1,0,1,2236
1,1,0,2,1,2,3,2236
2,2,1,1,2,3,5,2236
3,3,0,1,2,4,6,2236
4,4,0,2,2,6,8,2236
5,5,0,1,2,7,9,2236
6,6,0,1,2,8,10,2236
7,7,0,1,2,9,11,2236
8,8,0,1,2,10,12,2236
9,9,0,0,2,10,12,2236
0,0,1,0,1,0,1,2237
1,1,1,0,2,0,2,2237
2,2,2,0,4,0,4,2237
3,3,3,0,7,0,7,2237
4,4,1,1,8,1,9,2237
5,5,1,0,9,1,10,2237
6,6,0,1,9,2,11,2237
7,7,0,2,9,4,13,2237
8,8,0,3,9,7,16,2237
9,9,0,3,9,10,19,2237
10,10,1,2,10,12,22,2237
11,11,0,2,10,14,24,2237
12,12,0,3,10,17,27,2237
13,13,0,4,10,21,31,2237
14,14,0,3,10,24,34,2237
15,15,0,3,10,27,37,2237
16,16,0,4,10,31,41,2237
17,17,0,3,10,34,44,2237
18,18,0,0,10,34,44,2237
0,0,1,0,1,0,1,2238
1,1,0,0,1,0,1,2238
0,0,1,0,1,0,1,2239
1,1,0,2,1,2,3,2239
2,2,0,0,1,2,3,2239
0,0,1,0,1,0,1,2240
1,1,1,1,2,1,3,2240
2,2,0,2,2,3,5,2240
3,3,0,1,2,4,6,2240
4,4,0,2,2,6,8,2240
5,5,0,2,2,8,10,2240
6,6,0,3,2,11,13,2240
7,7,2,2,4,13,17,2240
8,8,0,1,4,14,18,2240
9,9,0,2,4,16,20,2240
10,10,0,2,4,18,22,2240
11,11,0,1,4,19,23,2240
12,12,0,2,4,21,25,2240
13,13,0,0,4,21,25,2240
0,0,1,0,1,0,1,2241
1,1,0,1,1,1,2,2241
2,2,0,2,1,3,4,2241
3,3,0,1,1,4,5,2241
4,4,0,2,1,6,7,2241
5,5,0,1,1,7,8,2241
6,6,0,0,1,7,8,2241
0,0,1,0,1,0,1,2242
1,1,0,0,1,0,1,2242
0,0,1,0,1,0,1,2243
1,1,1,1,2,1,3,2243
2,2,1,1,3,2,5,2243
3,3,1,1,4,3,7,2243
4,4,1,0,5,3,8,2243
5,5,0,0,5,3,8,2243
0,0,1,0,1,0,1,2244
1,1,1,0,2,0,2,2244
2,2,1,0,3,0,3,2244
3,3,1,1,4,1,5,2244
4,4,1,1,5,2,7,2244
5,5,1,0,6,2,8,2244
6,6,0,0,6,2,8,2244
0,0,1,0,1,0,1,2245
1,1,1,0,2,0,2,2245
2,2,4,1,6,1,7,2245
3,3,2,1,8,2,10,2245
4,4,0,0,8,2,10,2245
0,0,1,0,1,0,1,2246
1,1,1,0,2,0,2,2246
2,2,0,1,2,1,3,2246
3,3,0,1,2,2,4,2246
4,4,0,1,2,3,5,2246
5,5,0,0,2,3,5,2246
0,0,1,0,1,0,1,2247
1,1,0,0,1,0,1,2247
0,0,1,0,1,0,1,2248
1,1,1,0,2,0,2,2248
2,2,2,1,4,1,5,2248
3,3,6,1,10,2,12,2248
4,4,4,1,14,3,17,2248
5,5,6,0,20,3,23,2248
6,6,4,0,24,3,27,2248
7,7,5,1,29,4,33,2248
8,8,2,2,31,6,37,2248
9,9,4,1,35,7,42,2248
10,10,2,2,37,9,46,2248
11,11,2,2,39,11,50,2248
12,12,1,0,40,11,51,2248
13,13,0,0,40,11,51,2248
0,0,1,0,1,0,1,2249
1,1,0,0,1,0,1,2249
0,0,1,0,1,0,1,2250
1,1,0,0,1,0,1,2250
0,0,1,0,1,0,1,2251
1,1,1,0,2,0,2,2251
2,2,1,0,3,0,3,2251
3,3,1,0,4,0,4,2251
4,4,2,0,6,0,6,2251
5,5,4,0,10,0,10,2251
6,6,1,1,11,1,12,2251
7,7,0,0,11,1,12,2251
0,0,1,0,1,0,1,2252
1,1,0,0,1,0,1,2252
0,0,1,0,1,0,1,2253
1,1,0,1,1,1,2,2253
2,2,0,0,1,1,2,2253
0,0,1,0,1,0,1,2254
1,1,0,0,1,0,1,2254
0,0,1,0,1,0,1,2255
1,1,1,0,2,0,2,2255
2,2,1,0,3,0,3,2255
3,3,1,1,4,1,5,2255
4,4,0,1,4,2,6,2255
5,5,0,1,4,3,7,2255
6,6,0,1,4,4,8,2255
7,7,0,0,4,4,8,2255
0,0,1,0,1,0,1,2256
1,1,0,0,1,0,1,2256
0,0,1,0,1,0,1,2257
1,1,0,1,1,1,2,2257
2,2,0,1,1,2,3,2257
3,3,0,1,1,3,4,2257
4,4,1,3,2,6,8,2257
5,5,1,1,3,7,10,2257
6,6,1,1,4,8,12,2257
7,7,4,1,8,9,17,2257
8,8,4,2,12,11,23,2257
9,9,4,2,16,13,29,2257
10,10,2,1,18,14,32,2257
11,11,1,0,19,14,33,2257
12,12,0,1,19,15,34,2257
13,13,0,0,19,15,34,2257
0,0,1,0,1,0,1,2258
1,1,1,0,2,0,2,2258
2,2,1,0,3,0,3,2258
3,3,0,0,3,0,3,2258
0,0,1,0,1,0,1,2259
1,1,1,0,2,0,2,2259
2,2,2,1,4,1,5,2259
3,3,1,1,5,2,7,2259
4,4,2,2,7,4,11,2259
5,5,0,3,7,7,14,2259
6,6,0,2,7,9,16,2259
7,7,0,2,7,11,18,2259
8,8,0,1,7,12,19,2259
9,9,0,0,7,12,19,2259
0,0,1,0,1,0,1,2260
1,1,2,0,3,0,3,2260
2,2,1,0,4,0,4,2260
3,3,0,0,4,0,4,2260
0,0,1,0,1,0,1,2261
1,1,1,0,2,0,2,2261
2,2,1,1,3,1,4,2261
3,3,1,4,4,5,9,2261
4,4,3,2,7,7,14,2261
5,5,3,3,10,10,20,2261
6,6,3,4,13,14,27,2261
7,7,3,6,16,20,36,2261
8,8,6,2,22,22,44,2261
9,9,6,1,28,23,51,2261
10,10,5,2,33,25,58,2261
11,11,4,1,37,26,63,2261
12,12,3,2,40,28,68,2261
13,13,3,0,43,28,71,2261
14,14,2,0,45,28,73,2261
15,15,0,0,45,28,73,2261
0,0,1,0,1,0,1,2262
1,1,1,0,2,0,2,2262
2,2,0,1,2,1,3,2262
3,3,1,1,3,2,5,2262
4,4,1,2,4,4,8,2262
5,5,3,2,7,6,13,2262
6,6,3,2,10,8,18,2262
7,7,1,1,11,9,20,2262
8,8,2,0,13,9,22,2262
9,9,1,0,14,9,23,2262
10,10,0,0,14,9,23,2262
0,0,1,0,1,0,1,2263
1,1,3,0,4,0,4,2263
2,2,2,1,6,1,7,2263
3,3,3,1,9,2,11,2263
4,4,7,2,16,4,20,2263
5,5,11,5,27,9,36,2263
6,6,10,5,37,14,51,2263
7,7,12,5,49,19,68,2263
8,8,9,11,58,30,88,2263
9,9,9,8,67,38,105,2263
10,10,11,5,78,43,121,2263
11,11,9,9,87,52,139,2263
12,12,6,13,93,65,158,2263
13,13,6,16,99,81,180,2263
14,14,10,14,109,95,204,2263
15,15,9,12,118,107,225,2263
16,16,9,8,127,115,242,2263
17,17,7,7,134,122,256,2263
18,18,8,10,142,132,274,2263
19,19,13,9,155,141,296,2263
20,20,6,5,161,146,307,2263
21,21,6,1,167,147,314,2263
22,22,4,0,171,147,318,2263
23,23,1,2,172,149,321,2263
24,24,2,1,174,150,324,2263
25,25,0,0,174,150,324,2263
0,0,1,0,1,0,1,2264
1,1,0,1,1,1,2,2264
2,2,0,0,1,1,2,2264
0,0,1,0,1,0,1,2265
1,1,2,0,3,0,3,2265
2,2,5,1,8,1,9,2265
3,3,5,3,13,4,17,2265
4,4,4,1,17,5,22,2265
5,5,4,2,21,7,28,2265
6,6,4,1,25,8,33,2265
7,7,2,1,27,9,36,2265
8,8,5,1,32,10,42,2265
9,9,7,2,39,12,51,2265
10,10,5,3,44,15,59,2265
11,11,7,2,51,17,68,2265
12,12,11,3,62,20,82,2265
13,13,5,2,67,22,89,2265
14,14,4,0,71,22,93,2265
15,15,6,2,77,24,101,2265
16,16,4,3,81,27,108,2265
17,17,2,4,83,31,114,2265
18,18,3,6,86,37,123,2265
19,19,4,6,90,43,133,2265
20,20,7,2,97,45,142,2265
21,21,8,0,105,45,150,2265
22,22,3,3,108,48,156,2265
23,23,4,2,112,50,162,2265
24,24,2,2,114,52,166,2265
25,25,1,2,115,54,169,2265
26,26,2,2,117,56,173,2265
27,27,3,3,120,59,179,2265
28,28,4,4,124,63,187,2265
29,29,2,2,126,65,191,2265
30,30,1,0,127,65,192,2265
31,31,1,0,128,65,193,2265
32,32,0,0,128,65,193,2265
0,0,1,0,1,0,1,2266
1,1,0,0,1,0,1,2266
0,0,1,0,1,0,1,2267
1,1,1,0,2,0,2,2267
2,2,2,1,4,1,5,2267
3,3,3,0,7,1,8,2267
4,4,2,0,9,1,10,2267
5,5,1,0,10,1,11,2267
6,6,1,0,11,1,12,2267
7,7,0,1,11,2,13,2267
8,8,0,0,11,2,13,2267
0,0,1,0,1,0,1,2268
1,1,2,2,3,2,5,2268
2,2,2,3,5,5,10,2268
3,3,1,1,6,6,12,2268
4,4,0,0,6,6,12,2268
0,0,1,0,1,0,1,2269
1,1,2,0,3,0,3,2269
2,2,1,0,4,0,4,2269
3,3,1,0,5,0,5,2269
4,4,0,1,5,1,6,2269
5,5,1,0,6,1,7,2269
6,6,1,0,7,1,8,2269
7,7,3,0,10,1,11,2269
8,8,1,1,11,2,13,2269
9,9,1,0,12,2,14,2269
10,10,1,0,13,2,15,2269
11,11,1,0,14,2,16,2269
12,12,1,0,15,2,17,2269
13,13,0,0,15,2,17,2269
0,0,1,0,1,0,1,2270
1,1,1,1,2,1,3,2270
2,2,1,0,3,1,4,2270
3,3,1,0,4,1,5,2270
4,4,1,1,5,2,7,2270
5,5,3,1,8,3,11,2270
6,6,2,2,10,5,15,2270
7,7,3,2,13,7,20,2270
8,8,2,3,15,10,25,2270
9,9,1,4,16,14,30,2270
10,10,0,5,16,19,35,2270
11,11,0,3,16,22,38,2270
12,12,1,2,17,24,41,2270
13,13,0,2,17,26,43,2270
14,14,0,1,17,27,44,2270
15,15,0,4,17,31,48,2270
16,16,1,4,18,35,53,2270
17,17,1,2,19,37,56,2270
18,18,1,1,20,38,58,2270
19,19,1,3,21,41,62,2270
20,20,0,1,21,42,63,2270
21,21,0,0,21,42,63,2270
0,0,1,0,1,0,1,2271
1,1,2,0,3,0,3,2271
2,2,0,0,3,0,3,2271
0,0,1,0,1,0,1,2272
1,1,1,0,2,0,2,2272
2,2,1,0,3,0,3,2272
3,3,3,0,6,0,6,2272
4,4,1,1,7,1,8,2272
5,5,1,1,8,2,10,2272
6,6,1,1,9,3,12,2272
7,7,3,1,12,4,16,2272
8,8,1,0,13,4,17,2272
9,9,0,0,13,4,17,2272
0,0,1,0,1,0,1,2273
1,1,0,0,1,0,1,2273
0,0,1,0,1,0,1,2274
1,1,2,0,3,0,3,2274
2,2,0,0,3,0,3,2274
0,0,1,0,1,0,1,2275
1,1,1,0,2,0,2,2275
2,2,0,0,2,0,2,2275
0,0,1,0,1,0,1,2276
1,1,0,1,1,1,2,2276
2,2,0,1,1,2,3,2276
3,3,0,1,1,3,4,2276
4,4,0,0,1,3,4,2276
0,0,1,0,1,0,1,2277
1,1,0,0,1,0,1,2277
0,0,1,0,1,0,1,2278
1,1,0,0,1,0,1,2278
0,0,1,0,1,0,1,2279
1,1,2,0,3,0,3,2279
2,2,0,0,3,0,3,2279
0,0,1,0,1,0,1,2280
1,1,0,0,1,0,1,2280
0,0,1,0,1,0,1,2281
1,1,1,0,2,0,2,2281
2,2,3,0,5,0,5,2281
3,3,4,0,9,0,9,2281
4,4,5,0,14,0,14,2281
5,5,3,0,17,0,17,2281
6,6,3,0,20,0,20,2281
7,7,4,0,24,0,24,2281
8,8,4,1,28,1,29,2281
9,9,1,2,29,3,32,2281
10,10,2,4,31,7,38,2281
11,11,2,10,33,17,50,2281
12,12,2,6,35,23,58,2281
13,13,4,4,39,27,66,2281
14,14,4,1,43,28,71,2281
15,15,4,2,47,30,77,2281
16,16,1,4,48,34,82,2281
17,17,0,2,48,36,84,2281
18,18,0,0,48,36,84,2281
0,0,1,0,1,0,1,2282
1,1,0,0,1,0,1,2282
0,0,1,0,1,0,1,2283
1,1,0,0,1,0,1,2283
0,0,1,0,1,0,1,2284
1,1,0,0,1,0,1,2284
0,0,1,0,1,0,1,2285
1,1,1,1,2,1,3,2285
2,2,1,0,3,1,4,2285
3,3,2,0,5,1,6,2285
4,4,2,1,7,2,9,2285
5,5,0,1,7,3,10,2285
6,6,0,1,7,4,11,2285
7,7,0,1,7,5,12,2285
8,8,1,1,8,6,14,2285
9,9,0,0,8,6,14,2285
0,0,1,0,1,0,1,2286
1,1,0,0,1,0,1,2286
0,0,1,0,1,0,1,2287
1,1,0,0,1,0,1,2287
0,0,1,0,1,0,1,2288
1,1,1,0,2,0,2,2288
2,2,1,0,3,0,3,2288
3,3,2,0,5,0,5,2288
4,4,1,0,6,0,6,2288
5,5,1,0,7,0,7,2288
6,6,1,0,8,0,8,2288
7,7,0,0,8,0,8,2288
0,0,1,0,1,0,1,2289
1,1,0,0,1,0,1,2289
0,0,1,0,1,0,1,2290
1,1,1,0,2,0,2,2290
2,2,1,0,3,0,3,2290
3,3,1,0,4,0,4,2290
4,4,0,1,4,1,5,2290
5,5,1,1,5,2,7,2290
6,6,0,1,5,3,8,2290
7,7,1,1,6,4,10,2290
8,8,1,0,7,4,11,2290
9,9,1,0,8,4,12,2290
10,10,0,1,8,5,13,2290
11,11,1,0,9,5,14,2290
12,12,0,0,9,5,14,2290
0,0,1,0,1,0,1,2291
1,1,0,0,1,0,1,2291
0,0,1,0,1,0,1,2292
1,1,0,0,1,0,1,2292
0,0,1,0,1,0,1,2293
1,1,1,0,2,0,2,2293
2,2,1,0,3,0,3,2293
3,3,0,0,3,0,3,2293
0,0,1,0,1,0,1,2294
1,1,2,0,3,0,3,2294
2,2,2,0,5,0,5,2294
3,3,0,0,5,0,5,2294
0,0,1,0,1,0,1,2295
1,1,1,0,2,0,2,2295
2,2,1,0,3,0,3,2295
3,3,0,0,3,0,3,2295
0,0,1,0,1,0,1,2296
1,1,1,0,2,0,2,2296
2,2,0,0,2,0,2,2296
0,0,1,0,1,0,1,2297
1,1,0,0,1,0,1,2297
0,0,1,0,1,0,1,2298
1,1,0,0,1,0,1,2298
0,0,1,0,1,0,1,2299
1,1,0,0,1,0,1,2299
0,0,1,0,1,0,1,2300
1,1,0,0,1,0,1,2300
0,0,1,0,1,0,1,2301
1,1,1,0,2,0,2,2301
2,2,4,0,6,0,6,2301
3,3,5,1,11,1,12,2301
4,4,0,0,11,1,12,2301
0,0,1,0,1,0,1,2302
1,1,0,0,1,0,1,2302
0,0,1,0,1,0,1,2303
1,1,0,0,1,0,1,2303
0,0,1,0,1,0,1,2304
1,1,3,1,4,1,5,2304
2,2,1,2,5,3,8,2304
3,3,1,3,6,6,12,2304
4,4,2,4,8,10,18,2304
5,5,2,1,10,11,21,2304
6,6,1,0,11,11,22,2304
7,7,0,0,11,11,22,2304
0,0,1,0,1,0,1,2305
1,1,0,0,1,0,1,2305
0,0,1,0,1,0,1,2306
1,1,1,0,2,0,2,2306
2,2,1,0,3,0,3,2306
3,3,0,1,3,1,4,2306
4,4,1,0,4,1,5,2306
5,5,1,1,5,2,7,2306
6,6,1,2,6,4,10,2306
7,7,0,1,6,5,11,2306
8,8,0,0,6,5,11,2306
0,0,1,0,1,0,1,2307
1,1,0,0,1,0,1,2307
0,0,1,0,1,0,1,2308
1,1,3,0,4,0,4,2308
2,2,1,1,5,1,6,2308
3,3,2,2,7,3,10,2308
4,4,2,2,9,5,14,2308
5,5,4,5,13,10,23,2308
6,6,1,4,14,14,28,2308
7,7,0,3,14,17,31,2308
8,8,0,0,14,17,31,2308
0,0,1,0,1,0,1,2309
1,1,0,0,1,0,1,2309
0,0,1,0,1,0,1,2310
1,1,1,0,2,0,2,2310
2,2,0,0,2,0,2,2310
0,0,1,0,1,0,1,2311
1,1,1,0,2,0,2,2311
2,2,2,0,4,0,4,2311
3,3,2,1,6,1,7,2311
4,4,0,3,6,4,10,2311
5,5,1,1,7,5,12,2311
6,6,0,0,7,5,12,2311
0,0,1,0,1,0,1,2312
1,1,1,0,2,0,2,2312
2,2,0,0,2,0,2,2312
0,0,1,0,1,0,1,2313
1,1,1,0,2,0,2,2313
2,2,1,1,3,1,4,2313
3,3,0,2,3,3,6,2313
4,4,0,2,3,5,8,2313
5,5,0,0,3,5,8,2313
0,0,1,0,1,0,1,2314
1,1,0,0,1,0,1,2314
0,0,1,0,1,0,1,2315
1,1,1,0,2,0,2,2315
2,2,0,0,2,0,2,2315
0,0,1,0,1,0,1,2316
1,1,1,0,2,0,2,2316
2,2,1,1,3,1,4,2316
3,3,1,1,4,2,6,2316
4,4,1,3,5,5,10,2316
5,5,0,2,5,7,12,2316
6,6,0,2,5,9,14,2316
7,7,1,2,6,11,17,2316
8,8,1,0,7,11,18,2316
9,9,2,0,9,11,20,2316
10,10,3,0,12,11,23,2316
11,11,1,1,13,12,25,2316
12,12,0,0,13,12,25,2316
0,0,1,0,1,0,1,2317
1,1,0,0,1,0,1,2317
0,0,1,0,1,0,1,2318
1,1,0,0,1,0,1,2318
0,0,1,0,1,0,1,2319
1,1,1,0,2,0,2,2319
2,2,2,1,4,1,5,2319
3,3,2,0,6,1,7,2319
4,4,2,0,8,1,9,2319
5,5,4,1,12,2,14,2319
6,6,6,1,18,3,21,2319
7,7,4,2,22,5,27,2319
8,8,0,5,22,10,32,2319
9,9,0,1,22,11,33,2319
10,10,0,1,22,12,34,2319
11,11,1,1,23,13,36,2319
12,12,0,1,23,14,37,2319
13,13,1,2,24,16,40,2319
14,14,0,0,24,16,40,2319
0,0,1,0,1,0,1,2320
1,1,1,0,2,0,2,2320
2,2,1,0,3,0,3,2320
3,3,1,0,4,0,4,2320
4,4,0,0,4,0,4,2320
0,0,1,0,1,0,1,2321
1,1,0,0,1,0,1,2321
0,0,1,0,1,0,1,2322
1,1,4,1,5,1,6,2322
2,2,1,0,6,1,7,2322
3,3,0,0,6,1,7,2322
0,0,1,0,1,0,1,2323
1,1,0,0,1,0,1,2323
0,0,1,0,1,0,1,2324
1,1,0,0,1,0,1,2324
0,0,1,0,1,0,1,2325
1,1,0,0,1,0,1,2325
0,0,1,0,1,0,1,2326
1,1,0,0,1,0,1,2326
0,0,1,0,1,0,1,2327
1,1,0,1,1,1,2,2327
2,2,0,0,1,1,2,2327
0,0,1,0,1,0,1,2328
1,1,1,0,2,0,2,2328
2,2,2,1,4,1,5,2328
3,3,0,0,4,1,5,2328
0,0,1,0,1,0,1,2329
1,1,0,0,1,0,1,2329
0,0,1,0,1,0,1,2330
1,1,0,0,1,0,1,2330
0,0,1,0,1,0,1,2331
1,1,0,0,1,0,1,2331
0,0,1,0,1,0,1,2332
1,1,0,0,1,0,1,2332
0,0,1,0,1,0,1,2333
1,1,0,0,1,0,1,2333
0,0,1,0,1,0,1,2334
1,1,1,0,2,0,2,2334
2,2,0,0,2,0,2,2334
0,0,1,0,1,0,1,2335
1,1,0,0,1,0,1,2335
0,0,1,0,1,0,1,2336
1,1,1,0,2,0,2,2336
2,2,0,0,2,0,2,2336
0,0,1,0,1,0,1,2337
1,1,2,0,3,0,3,2337
2,2,0,0,3,0,3,2337
0,0,1,0,1,0,1,2338
1,1,1,0,2,0,2,2338
2,2,0,0,2,0,2,2338
0,0,1,0,1,0,1,2339
1,1,5,0,6,0,6,2339
2,2,4,2,10,2,12,2339
3,3,3,1,13,3,16,2339
4,4,5,0,18,3,21,2339
5,5,3,1,21,4,25,2339
6,6,1,0,22,4,26,2339
7,7,0,0,22,4,26,2339
0,0,1,0,1,0,1,2340
1,1,1,0,2,0,2,2340
2,2,1,0,3,0,3,2340
3,3,0,1,3,1,4,2340
4,4,0,1,3,2,5,2340
5,5,0,0,3,2,5,2340
0,0,1,0,1,0,1,2341
1,1,1,0,2,0,2,2341
2,2,1,1,3,1,4,2341
3,3,0,1,3,2,5,2341
4,4,0,1,3,3,6,2341
5,5,0,0,3,3,6,2341
0,0,1,0,1,0,1,2342
1,1,1,1,2,1,3,2342
2,2,0,2,2,3,5,2342
3,3,0,3,2,6,8,2342
4,4,1,2,3,8,11,2342
5,5,0,1,3,9,12,2342
6,6,1,1,4,10,14,2342
7,7,3,0,7,10,17,2342
8,8,0,0,7,10,17,2342
0,0,1,0,1,0,1,2343
1,1,1,0,2,0,2,2343
2,2,1,0,3,0,3,2343
3,3,0,0,3,0,3,2343
0,0,1,0,1,0,1,2344
1,1,1,0,2,0,2,2344
2,2,0,0,2,0,2,2344
0,0,1,0,1,0,1,2345
1,1,0,0,1,0,1,2345
0,0,1,0,1,0,1,2346
1,1,1,0,2,0,2,2346
2,2,0,0,2,0,2,2346
0,0,1,0,1,0,1,2347
1,1,0,0,1,0,1,2347
0,0,1,0,1,0,1,2348
1,1,0,0,1,0,1,2348
0,0,1,0,1,0,1,2349
1,1,0,0,1,0,1,2349
0,0,1,0,1,0,1,2350
1,1,0,1,1,1,2,2350
2,2,0,0,1,1,2,2350
0,0,1,0,1,0,1,2351
1,1,2,0,3,0,3,2351
2,2,1,0,4,0,4,2351
3,3,2,1,6,1,7,2351
4,4,1,0,7,1,8,2351
5,5,1,0,8,1,9,2351
6,6,0,0,8,1,9,2351
0,0,1,0,1,0,1,2352
1,1,0,0,1,0,1,2352
0,0,1,0,1,0,1,2353
1,1,0,1,1,1,2,2353
2,2,0,0,1,1,2,2353
0,0,1,0,1,0,1,2354
1,1,0,1,1,1,2,2354
2,2,0,0,1,1,2,2354
0,0,1,0,1,0,1,2355
1,1,1,0,2,0,2,2355
2,2,2,0,4,0,4,2355
3,3,0,0,4,0,4,2355
0,0,1,0,1,0,1,2356
1,1,0,0,1,0,1,2356
0,0,1,0,1,0,1,2357
1,1,1,0,2,0,2,2357
2,2,0,0,2,0,2,2357
0,0,1,0,1,0,1,2358
1,1,1,0,2,0,2,2358
2,2,2,0,4,0,4,2358
3,3,2,0,6,0,6,2358
4,4,0,0,6,0,6,2358
0,0,1,0,1,0,1,2359
1,1,0,0,1,0,1,2359
0,0,1,0,1,0,1,2360
1,1,0,0,1,0,1,2360
0,0,1,0,1,0,1,2361
1,1,1,0,2,0,2,2361
2,2,0,1,2,1,3,2361
3,3,0,0,2,1,3,2361
0,0,1,0,1,0,1,2362
1,1,2,0,3,0,3,2362
2,2,1,1,4,1,5,2362
3,3,2,2,6,3,9,2362
4,4,1,1,7,4,11,2362
5,5,1,0,8,4,12,2362
6,6,2,0,10,4,14,2362
7,7,2,0,12,4,16,2362
8,8,1,1,13,5,18,2362
9,9,2,0,15,5,20,2362
10,10,2,0,17,5,22,2362
11,11,1,0,18,5,23,2362
12,12,0,0,18,5,23,2362
0,0,1,0,1,0,1,2363
1,1,0,1,1,1,2,2363
2,2,0,0,1,1,2,2363
0,0,1,0,1,0,1,2364
1,1,1,0,2,0,2,2364
2,2,1,0,3,0,3,2364
3,3,2,1,5,1,6,2364
4,4,1,1,6,2,8,2364
5,5,1,2,7,4,11,2364
6,6,2,4,9,8,17,2364
7,7,2,1,11,9,20,2364
8,8,1,1,12,10,22,2364
9,9,0,2,12,12,24,2364
10,10,0,2,12,14,26,2364
11,11,0,1,12,15,27,2364
12,12,0,0,12,15,27,2364
0,0,1,0,1,0,1,2365
1,1,1,0,2,0,2,2365
2,2,0,0,2,0,2,2365
0,0,1,0,1,0,1,2366
1,1,0,0,1,0,1,2366
0,0,1,0,1,0,1,2367
1,1,1,0,2,0,2,2367
2,2,2,1,4,1,5,2367
3,3,0,2,4,3,7,2367
4,4,0,1,4,4,8,2367
5,5,0,0,4,4,8,2367
0,0,1,0,1,0,1,2368
1,1,1,0,2,0,2,2368
2,2,0,0,2,0,2,2368
0,0,1,0,1,0,1,2369
1,1,0,2,1,2,3,2369
2,2,0,1,1,3,4,2369
3,3,1,1,2,4,6,2369
4,4,0,0,2,4,6,2369
0,0,1,0,1,0,1,2370
1,1,0,0,1,0,1,2370
0,0,1,0,1,0,1,2371
1,1,1,0,2,0,2,2371
2,2,2,0,4,0,4,2371
3,3,0,0,4,0,4,2371
0,0,1,0,1,0,1,2372
1,1,1,0,2,0,2,2372
2,2,1,0,3,0,3,2372
3,3,1,1,4,1,5,2372
4,4,2,1,6,2,8,2372
5,5,2,1,8,3,11,2372
6,6,1,1,9,4,13,2372
7,7,1,0,10,4,14,2372
8,8,1,0,11,4,15,2372
9,9,2,0,13,4,17,2372
10,10,1,1,14,5,19,2372
11,11,2,0,16,5,21,2372
12,12,4,0,20,5,25,2372
13,13,4,1,24,6,30,2372
14,14,7,1,31,7,38,2372
15,15,4,2,35,9,44,2372
16,16,6,1,41,10,51,2372
17,17,6,0,47,10,57,2372
18,18,4,1,51,11,62,2372
19,19,4,3,55,14,69,2372
20,20,3,4,58,18,76,2372
21,21,4,1,62,19,81,2372
22,22,2,3,64,22,86,2372
23,23,1,1,65,23,88,2372
24,24,1,0,66,23,89,2372
25,25,0,0,66,23,89,2372
0,0,1,0,1,0,1,2373
1,1,0,0,1,0,1,2373
0,0,1,0,1,0,1,2374
1,1,2,0,3,0,3,2374
2,2,1,0,4,0,4,2374
3,3,0,1,4,1,5,2374
4,4,0,1,4,2,6,2374
5,5,0,0,4,2,6,2374
0,0,1,0,1,0,1,2375
1,1,1,0,2,0,2,2375
2,2,1,0,3,0,3,2375
3,3,2,0,5,0,5,2375
4,4,1,2,6,2,8,2375
5,5,1,1,7,3,10,2375
6,6,0,2,7,5,12,2375
7,7,0,0,7,5,12,2375
0,0,1,0,1,0,1,2376
1,1,2,0,3,0,3,2376
2,2,1,0,4,0,4,2376
3,3,0,0,4,0,4,2376
0,0,1,0,1,0,1,2377
1,1,4,0,5,0,5,2377
2,2,1,0,6,0,6,2377
3,3,0,1,6,1,7,2377
4,4,0,0,6,1,7,2377
0,0,1,0,1,0,1,2378
1,1,0,1,1,1,2,2378
2,2,0,0,1,1,2,2378
0,0,1,0,1,0,1,2379
1,1,1,0,2,0,2,2379
2,2,0,0,2,0,2,2379
0,0,1,0,1,0,1,2380
1,1,0,0,1,0,1,2380
0,0,1,0,1,0,1,2381
1,1,0,1,1,1,2,2381
2,2,0,0,1,1,2,2381
0,0,1,0,1,0,1,2382
1,1,2,0,3,0,3,2382
2,2,1,0,4,0,4,2382
3,3,0,0,4,0,4,2382
0,0,1,0,1,0,1,2383
1,1,1,0,2,0,2,2383
2,2,0,0,2,0,2,2383
0,0,1,0,1,0,1,2384
1,1,1,0,2,0,2,2384
2,2,0,0,2,0,2,2384
0,0,1,0,1,0,1,2385
1,1,1,0,2,0,2,2385
2,2,1,0,3,0,3,2385
3,3,0,0,3,0,3,2385
0,0,1,0,1,0,1,2386
1,1,0,0,1,0,1,2386
0,0,1,0,1,0,1,2387
1,1,2,0,3,0,3,2387
2,2,3,0,6,0,6,2387
3,3,3,1,9,1,10,2387
4,4,0,1,9,2,11,2387
5,5,0,2,9,4,13,2387
6,6,0,1,9,5,14,2387
7,7,0,2,9,7,16,2387
8,8,2,1,11,8,19,2387
9,9,1,2,12,10,22,2387
10,10,2,4,14,14,28,2387
11,11,3,2,17,16,33,2387
12,12,3,0,20,16,36,2387
13,13,1,0,21,16,37,2387
14,14,1,0,22,16,38,2387
15,15,2,0,24,16,40,2387
16,16,1,0,25,16,41,2387
17,17,2,0,27,16,43,2387
18,18,1,2,28,18,46,2387
19,19,1,2,29,20,49,2387
20,20,2,1,31,21,52,2387
21,21,1,0,32,21,53,2387
22,22,2,1,34,22,56,2387
23,23,2,0,36,22,58,2387
24,24,0,1,36,23,59,2387
25,25,0,0,36,23,59,2387
0,0,1,0,1,0,1,2388
1,1,1,0,2,0,2,2388
2,2,0,1,2,1,3,2388
3,3,0,1,2,2,4,2388
4,4,0,0,2,2,4,2388
0,0,1,0,1,0,1,2389
1,1,0,0,1,0,1,2389
0,0,1,0,1,0,1,2390
1,1,3,0,4,0,4,2390
2,2,3,0,7,0,7,2390
3,3,4,0,11,0,11,2390
4,4,5,1,16,1,17,2390
5,5,2,1,18,2,20,2390
6,6,2,1,20,3,23,2390
7,7,0,1,20,4,24,2390
8,8,0,0,20,4,24,2390
0,0,1,0,1,0,1,2391
1,1,0,0,1,0,1,2391
0,0,1,0,1,0,1,2392
1,1,1,0,2,0,2,2392
2,2,1,0,3,0,3,2392
3,3,1,0,4,0,4,2392
4,4,1,0,5,0,5,2392
5,5,0,0,5,0,5,2392
0,0,1,0,1,0,1,2393
1,1,1,0,2,0,2,2393
2,2,1,1,3,1,4,2393
3,3,1,1,4,2,6,2393
4,4,2,0,6,2,8,2393
5,5,0,0,6,2,8,2393
0,0,1,0,1,0,1,2394
1,1,1,0,2,0,2,2394
2,2,0,0,2,0,2,2394
0,0,1,0,1,0,1,2395
1,1,1,1,2,1,3,2395
2,2,1,0,3,1,4,2395
3,3,0,0,3,1,4,2395
0,0,1,0,1,0,1,2396
1,1,1,0,2,0,2,2396
2,2,2,0,4,0,4,2396
3,3,1,0,5,0,5,2396
4,4,1,0,6,0,6,2396
5,5,0,0,6,0,6,2396
0,0,1,0,1,0,1,2397
1,1,0,0,1,0,1,2397
0,0,1,0,1,0,1,2398
1,1,1,0,2,0,2,2398
2,2,0,0,2,0,2,2398
0,0,1,0,1,0,1,2399
1,1,1,0,2,0,2,2399
2,2,0,0,2,0,2,2399
0,0,1,0,1,0,1,2400
1,1,0,0,1,0,1,2400
0,0,1,0,1,0,1,2401
1,1,0,0,1,0,1,2401
0,0,1,0,1,0,1,2402
1,1,0,0,1,0,1,2402
0,0,1,0,1,0,1,2403
1,1,0,0,1,0,1,2403
0,0,1,0,1,0,1,2404
1,1,2,1,3,1,4,2404
2,2,0,2,3,3,6,2404
3,3,0,1,3,4,7,2404
4,4,2,1,5,5,10,2404
5,5,0,1,5,6,11,2404
6,6,0,1,5,7,12,2404
7,7,0,2,5,9,14,2404
8,8,1,3,6,12,18,2404
9,9,1,3,7,15,22,2404
10,10,2,4,9,19,28,2404
11,11,0,6,9,25,34,2404
12,12,0,2,9,27,36,2404
13,13,0,0,9,27,36,2404
0,0,1,0,1,0,1,2405
1,1,1,0,2,0,2,2405
2,2,1,0,3,0,3,2405
3,3,0,1,3,1,4,2405
4,4,0,0,3,1,4,2405
0,0,1,0,1,0,1,2406
1,1,2,1,3,1,4,2406
2,2,1,1,4,2,6,2406
3,3,1,1,5,3,8,2406
4,4,2,2,7,5,12,2406
5,5,0,3,7,8,15,2406
6,6,0,3,7,11,18,2406
7,7,0,3,7,14,21,2406
8,8,0,3,7,17,24,2406
9,9,0,5,7,22,29,2406
10,10,1,5,8,27,35,2406
11,11,2,5,10,32,42,2406
12,12,2,3,12,35,47,2406
13,13,4,2,16,37,53,2406
14,14,8,1,24,38,62,2406
15,15,6,0,30,38,68,2406
16,16,3,0,33,38,71,2406
17,17,3,0,36,38,74,2406
18,18,5,0,41,38,79,2406
19,19,2,1,43,39,82,2406
20,20,1,2,44,41,85,2406
21,21,0,1,44,42,86,2406
22,22,0,1,44,43,87,2406
23,23,0,0,44,43,87,2406
0,0,1,0,1,0,1,2407
1,1,0,0,1,0,1,2407
0,0,1,0,1,0,1,2408
1,1,0,0,1,0,1,2408
0,0,1,0,1,0,1,2409
1,1,0,1,1,1,2,2409
2,2,0,0,1,1,2,2409
0,0,1,0,1,0,1,2410
1,1,1,0,2,0,2,2410
2,2,0,1,2,1,3,2410
3,3,0,0,2,1,3,2410
0,0,1,0,1,0,1,2411
1,1,0,0,1,0,1,2411
0,0,1,0,1,0,1,2412
1,1,2,0,3,0,3,2412
2,2,0,1,3,1,4,2412
3,3,0,0,3,1,4,2412
0,0,1,0,1,0,1,2413
1,1,3,0,4,0,4,2413
2,2,2,1,6,1,7,2413
3,3,1,0,7,1,8,2413
4,4,2,0,9,1,10,2413
5,5,2,0,11,1,12,2413
6,6,0,0,11,1,12,2413
0,0,1,0,1,0,1,2414
1,1,0,0,1,0,1,2414
0,0,1,0,1,0,1,2415
1,1,0,0,1,0,1,2415
0,0,1,0,1,0,1,2416
1,1,0,0,1,0,1,2416
0,0,1,0,1,0,1,2417
1,1,0,0,1,0,1,2417
0,0,1,0,1,0,1,2418
1,1,0,0,1,0,1,2418
0,0,1,0,1,0,1,2419
1,1,0,0,1,0,1,2419
0,0,1,0,1,0,1,2420
1,1,1,0,2,0,2,2420
2,2,2,0,4,0,4,2420
3,3,1,0,5,0,5,2420
4,4,1,0,6,0,6,2420
5,5,0,0,6,0,6,2420
0,0,1,0,1,0,1,2421
1,1,2,0,3,0,3,2421
2,2,1,0,4,0,4,2421
3,3,3,0,7,0,7,2421
4,4,4,0,11,0,11,2421
5,5,4,1,15,1,16,2421
6,6,2,1,17,2,19,2421
7,7,5,1,22,3,25,2421
8,8,5,1,27,4,31,2421
9,9,7,1,34,5,39,2421
10,10,9,2,43,7,50,2421
11,11,6,6,49,13,62,2421
12,12,6,10,55,23,78,2421
13,13,5,12,60,35,95,2421
14,14,9,7,69,42,111,2421
15,15,9,12,78,54,132,2421
16,16,5,7,83,61,144,2421
17,17,5,5,88,66,154,2421
18,18,4,3,92,69,161,2421
19,19,1,1,93,70,163,2421
20,20,1,0,94,70,164,2421
21,21,0,0,94,70,164,2421
0,0,1,0,1,0,1,2422
1,1,2,0,3,0,3,2422
2,2,5,1,8,1,9,2422
3,3,3,2,11,3,14,2422
4,4,0,4,11,7,18,2422
5,5,0,2,11,9,20,2422
6,6,1,3,12,12,24,2422
7,7,0,4,12,16,28,2422
8,8,0,3,12,19,31,2422
9,9,0,4,12,23,35,2422
10,10,0,2,12,25,37,2422
11,11,0,2,12,27,39,2422
12,12,2,2,14,29,43,2422
13,13,1,3,15,32,47,2422
14,14,1,2,16,34,50,2422
15,15,1,1,17,35,52,2422
16,16,1,2,18,37,55,2422
17,17,1,3,19,40,59,2422
18,18,1,2,20,42,62,2422
19,19,1,1,21,43,64,2422
20,20,2,2,23,45,68,2422
21,21,2,1,25,46,71,2422
22,22,3,0,28,46,74,2422
23,23,2,0,30,46,76,2422
24,24,0,0,30,46,76,2422
0,0,1,0,1,0,1,2423
1,1,2,0,3,0,3,2423
2,2,1,0,4,0,4,2423
3,3,0,0,4,0,4,2423
0,0,1,0,1,0,1,2424
1,1,1,0,2,0,2,2424
2,2,0,0,2,0,2,2424
0,0,1,0,1,0,1,2425
1,1,0,0,1,0,1,2425
0,0,1,0,1,0,1,2426
1,1,0,0,1,0,1,2426
0,0,1,0,1,0,1,2427
1,1,1,0,2,0,2,2427
2,2,0,1,2,1,3,2427
3,3,0,2,2,3,5,2427
4,4,0,1,2,4,6,2427
5,5,0,1,2,5,7,2427
6,6,1,0,3,5,8,2427
7,7,0,0,3,5,8,2427
0,0,1,0,1,0,1,2428
1,1,0,0,1,0,1,2428
0,0,1,0,1,0,1,2429
1,1,1,0,2,0,2,2429
2,2,0,0,2,0,2,2429
0,0,1,0,1,0,1,2430
1,1,0,0,1,0,1,2430
0,0,1,0,1,0,1,2431
1,1,1,0,2,0,2,2431
2,2,1,1,3,1,4,2431
3,3,1,1,4,2,6,2431
4,4,0,0,4,2,6,2431
0,0,1,0,1,0,1,2432
1,1,0,1,1,1,2,2432
2,2,0,1,1,2,3,2432
3,3,0,0,1,2,3,2432
0,0,1,0,1,0,1,2433
1,1,0,0,1,0,1,2433
0,0,1,0,1,0,1,2434
1,1,0,1,1,1,2,2434
2,2,0,1,1,2,3,2434
3,3,0,2,1,4,5,2434
4,4,0,3,1,7,8,2434
5,5,0,2,1,9,10,2434
6,6,0,2,1,11,12,2434
7,7,0,3,1,14,15,2434
8,8,0,4,1,18,19,2434
9,9,1,4,2,22,24,2434
10,10,1,4,3,26,29,2434
11,11,2,2,5,28,33,2434
12,12,6,2,11,30,41,2434
13,13,4,1,15,31,46,2434
14,14,5,0,20,31,51,2434
15,15,4,4,24,35,59,2434
16,16,4,2,28,37,65,2434
17,17,3,1,31,38,69,2434
18,18,3,1,34,39,73,2434
19,19,4,2,38,41,79,2434
20,20,2,2,40,43,83,2434
21,21,3,0,43,43,86,2434
22,22,0,0,43,43,86,2434
0,0,1,0,1,0,1,2435
1,1,0,0,1,0,1,2435
0,0,1,0,1,0,1,2436
1,1,1,1,2,1,3,2436
2,2,1,2,3,3,6,2436
3,3,1,2,4,5,9,2436
4,4,1,4,5,9,14,2436
5,5,2,6,7,15,22,2436
6,6,1,5,8,20,28,2436
7,7,1,7,9,27,36,2436
8,8,3,6,12,33,45,2436
9,9,1,7,13,40,53,2436
10,10,0,8,13,48,61,2436
11,11,1,5,14,53,67,2436
12,12,1,3,15,56,71,2436
13,13,1,2,16,58,74,2436
14,14,1,0,17,58,75,2436
15,15,1,0,18,58,76,2436
16,16,0,0,18,58,76,2436
0,0,1,0,1,0,1,2437
1,1,0,1,1,1,2,2437
2,2,0,2,1,3,4,2437
3,3,0,2,1,5,6,2437
4,4,0,3,1,8,9,2437
5,5,1,0,2,8,10,2437
6,6,1,0,3,8,11,2437
7,7,0,0,3,8,11,2437
0,0,1,0,1,0,1,2438
1,1,0,1,1,1,2,2438
2,2,1,0,2,1,3,2438
3,3,0,0,2,1,3,2438
0,0,1,0,1,0,1,2439
1,1,1,0,2,0,2,2439
2,2,0,0,2,0,2,2439
0,0,1,0,1,0,1,2440
1,1,0,0,1,0,1,2440
0,0,1,0,1,0,1,2441
1,1,2,0,3,0,3,2441
2,2,1,0,4,0,4,2441
3,3,2,0,6,0,6,2441
4,4,1,0,7,0,7,2441
5,5,1,1,8,1,9,2441
6,6,0,1,8,2,10,2441
7,7,0,0,8,2,10,2441
0,0,1,0,1,0,1,2442
1,1,0,0,1,0,1,2442
0,0,1,0,1,0,1,2443
1,1,1,0,2,0,2,2443
2,2,0,0,2,0,2,2443
0,0,1,0,1,0,1,2444
1,1,1,0,2,0,2,2444
2,2,0,2,2,2,4,2444
3,3,0,1,2,3,5,2444
4,4,0,0,2,3,5,2444
0,0,1,0,1,0,1,2445
1,1,0,0,1,0,1,2445
0,0,1,0,1,0,1,2446
1,1,1,0,2,0,2,2446
2,2,2,0,4,0,4,2446
3,3,1,0,5,0,5,2446
4,4,2,0,7,0,7,2446
5,5,0,0,7,0,7,2446
0,0,1,0,1,0,1,2447
1,1,2,0,3,0,3,2447
2,2,0,0,3,0,3,2447
0,0,1,0,1,0,1,2448
1,1,2,0,3,0,3,2448
2,2,0,0,3,0,3,2448
0,0,1,0,1,0,1,2449
1,1,0,0,1,0,1,2449
0,0,1,0,1,0,1,2450
1,1,3,0,4,0,4,2450
2,2,1,0,5,0,5,2450
3,3,0,0,5,0,5,2450
0,0,1,0,1,0,1,2451
1,1,1,0,2,0,2,2451
2,2,2,0,4,0,4,2451
3,3,4,0,8,0,8,2451
4,4,4,0,12,0,12,2451
5,5,2,2,14,2,16,2451
6,6,1,5,15,7,22,2451
7,7,4,6,19,13,32,2451
8,8,3,8,22,21,43,2451
9,9,2,7,24,28,52,2451
10,10,5,5,29,33,62,2451
11,11,8,9,37,42,79,2451
12,12,4,13,41,55,96,2451
13,13,11,9,52,64,116,2451
14,14,13,15,65,79,144,2451
15,15,15,10,80,89,169,2451
16,16,20,17,100,106,206,2451
17,17,15,16,115,122,237,2451
18,18,16,12,131,134,265,2451
19,19,14,20,145,154,299,2451
20,20,15,20,160,174,334,2451
21,21,14,17,174,191,365,2451
22,22,13,17,187,208,395,2451
23,23,13,20,200,228,428,2451
24,24,19,12,219,240,459,2451
25,25,17,8,236,248,484,2451
26,26,16,6,252,254,506,2451
27,27,15,12,267,266,533,2451
28,28,12,7,279,273,552,2451
29,29,11,8,290,281,571,2451
30,30,12,11,302,292,594,2451
31,31,11,5,313,297,610,2451
32,32,7,5,320,302,622,2451
33,33,3,7,323,309,632,2451
34,34,3,9,326,318,644,2451
35,35,3,9,329,327,656,2451
36,36,2,8,331,335,666,2451
37,37,3,7,334,342,676,2451
38,38,5,4,339,346,685,2451
39,39,3,0,342,346,688,2451
40,40,5,0,347,346,693,2451
41,41,6,1,353,347,700,2451
42,42,2,3,355,350,705,2451
43,43,1,2,356,352,708,2451
44,44,2,2,358,354,712,2451
45,45,1,4,359,358,717,2451
46,46,1,1,360,359,719,2451
47,47,1,2,361,361,722,2451
48,48,0,3,361,364,725,2451
49,49,0,4,361,368,729,2451
50,50,1,3,362,371,733,2451
51,51,1,2,363,373,736,2451
52,52,0,1,363,374,737,2451
53,53,0,0,363,374,737,2451
0,0,1,0,1,0,1,2452
1,1,0,0,1,0,1,2452
0,0,1,0,1,0,1,2453
1,1,0,0,1,0,1,2453
0,0,1,0,1,0,1,2454
1,1,1,0,2,0,2,2454
2,2,1,1,3,1,4,2454
3,3,3,1,6,2,8,2454
4,4,5,1,11,3,14,2454
5,5,4,0,15,3,18,2454
6,6,1,0,16,3,19,2454
7,7,2,1,18,4,22,2454
8,8,2,1,20,5,25,2454
9,9,2,0,22,5,27,2454
10,10,4,0,26,5,31,2454
11,11,6,1,32,6,38,2454
12,12,6,2,38,8,46,2454
13,13,4,2,42,10,52,2454
14,14,5,2,47,12,59,2454
15,15,4,3,51,15,66,2454
16,16,5,4,56,19,75,2454
17,17,5,2,61,21,82,2454
18,18,6,2,67,23,90,2454
19,19,6,4,73,27,100,2454
20,20,6,3,79,30,109,2454
21,21,7,4,86,34,120,2454
22,22,4,0,90,34,124,2454
23,23,3,0,93,34,127,2454
24,24,2,1,95,35,130,2454
25,25,1,1,96,36,132,2454
26,26,1,0,97,36,133,2454
27,27,0,0,97,36,133,2454
0,0,1,0,1,0,1,2455
1,1,1,0,2,0,2,2455
2,2,1,0,3,0,3,2455
3,3,2,2,5,2,7,2455
4,4,2,3,7,5,12,2455
5,5,2,5,9,10,19,2455
6,6,1,2,10,12,22,2455
7,7,0,0,10,12,22,2455
0,0,1,0,1,0,1,2456
1,1,1,0,2,0,2,2456
2,2,2,0,4,0,4,2456
3,3,1,3,5,3,8,2456
4,4,0,3,5,6,11,2456
5,5,0,3,5,9,14,2456
6,6,2,4,7,13,20,2456
7,7,3,3,10,16,26,2456
8,8,4,1,14,17,31,2456
9,9,4,2,18,19,37,2456
10,10,1,1,19,20,39,2456
11,11,0,1,19,21,40,2456
12,12,0,1,19,22,41,2456
13,13,0,0,19,22,41,2456
0,0,1,0,1,0,1,2457
1,1,0,0,1,0,1,2457
0,0,1,0,1,0,1,2458
1,1,0,0,1,0,1,2458
0,0,1,0,1,0,1,2459
1,1,2,0,3,0,3,2459
2,2,2,1,5,1,6,2459
3,3,0,0,5,1,6,2459
0,0,1,0,1,0,1,2460
1,1,1,0,2,0,2,2460
2,2,0,0,2,0,2,2460
0,0,1,0,1,0,1,2461
1,1,2,0,3,0,3,2461
2,2,0,1,3,1,4,2461
3,3,0,3,3,4,7,2461
4,4,0,5,3,9,12,2461
5,5,0,8,3,17,20,2461
6,6,3,4,6,21,27,2461
7,7,3,4,9,25,34,2461
8,8,5,5,14,30,44,2461
9,9,4,5,18,35,53,2461
10,10,6,2,24,37,61,2461
11,11,3,4,27,41,68,2461
12,12,6,4,33,45,78,2461
13,13,1,2,34,47,81,2461
14,14,0,2,34,49,83,2461
15,15,1,1,35,50,85,2461
16,16,1,0,36,50,86,2461
17,17,1,0,37,50,87,2461
18,18,1,0,38,50,88,2461
19,19,1,1,39,51,90,2461
20,20,0,2,39,53,92,2461
21,21,0,4,39,57,96,2461
22,22,0,4,39,61,100,2461
23,23,1,1,40,62,102,2461
24,24,0,3,40,65,105,2461
25,25,2,2,42,67,109,2461
26,26,2,1,44,68,112,2461
27,27,1,2,45,70,115,2461
28,28,1,0,46,70,116,2461
29,29,1,0,47,70,117,2461
30,30,0,0,47,70,117,2461
0,0,1,0,1,0,1,2462
1,1,2,0,3,0,3,2462
2,2,0,1,3,1,4,2462
3,3,0,0,3,1,4,2462
0,0,1,0,1,0,1,2463
1,1,0,0,1,0,1,2463
0,0,1,0,1,0,1,2464
1,1,0,0,1,0,1,2464
0,0,1,0,1,0,1,2465
1,1,1,1,2,1,3,2465
2,2,2,0,4,1,5,2465
3,3,0,0,4,1,5,2465
0,0,1,0,1,0,1,2466
1,1,0,0,1,0,1,2466
0,0,1,0,1,0,1,2467
1,1,2,0,3,0,3,2467
2,2,1,0,4,0,4,2467
3,3,1,0,5,0,5,2467
4,4,1,1,6,1,7,2467
5,5,0,0,6,1,7,2467
0,0,1,0,1,0,1,2468
1,1,1,0,2,0,2,2468
2,2,4,0,6,0,6,2468
3,3,4,0,10,0,10,2468
4,4,4,1,14,1,15,2468
5,5,5,1,19,2,21,2468
6,6,4,4,23,6,29,2468
7,7,1,2,24,8,32,2468
8,8,1,7,25,15,40,2468
9,9,4,7,29,22,51,2468
10,10,4,4,33,26,59,2468
11,11,2,2,35,28,63,2468
12,12,2,1,37,29,66,2468
13,13,1,1,38,30,68,2468
14,14,0,1,38,31,69,2468
15,15,0,0,38,31,69,2468
0,0,1,0,1,0,1,2469
1,1,1,0,2,0,2,2469
2,2,0,0,2,0,2,2469
0,0,1,0,1,0,1,2470
1,1,2,1,3,1,4,2470
2,2,1,2,4,3,7,2470
3,3,2,0,6,3,9,2470
4,4,1,0,7,3,10,2470
5,5,1,0,8,3,11,2470
6,6,0,0,8,3,11,2470
0,0,1,0,1,0,1,2471
1,1,1,0,2,0,2,2471
2,2,1,0,3,0,3,2471
3,3,0,0,3,0,3,2471
0,0,1,0,1,0,1,2472
1,1,2,2,3,2,5,2472
2,2,0,0,3,2,5,2472
0,0,1,0,1,0,1,2473
1,1,1,0,2,0,2,2473
2,2,1,0,3,0,3,2473
3,3,0,0,3,0,3,2473
0,0,1,0,1,0,1,2474
1,1,3,0,4,0,4,2474
2,2,6,0,10,0,10,2474
3,3,2,2,12,2,14,2474
4,4,2,1,14,3,17,2474
5,5,1,1,15,4,19,2474
6,6,1,0,16,4,20,2474
7,7,0,0,16,4,20,2474
0,0,1,0,1,0,1,2475
1,1,0,0,1,0,1,2475
0,0,1,0,1,0,1,2476
1,1,0,0,1,0,1,2476
0,0,1,0,1,0,1,2477
1,1,0,0,1,0,1,2477
0,0,1,0,1,0,1,2478
1,1,0,1,1,1,2,2478
2,2,1,1,2,2,4,2478
3,3,0,1,2,3,5,2478
4,4,1,0,3,3,6,2478
5,5,1,0,4,3,7,2478
6,6,1,1,5,4,9,2478
7,7,2,0,7,4,11,2478
8,8,2,1,9,5,14,2478
9,9,4,1,13,6,19,2478
10,10,2,0,15,6,21,2478
11,11,1,0,16,6,22,2478
12,12,1,0,17,6,23,2478
13,13,0,0,17,6,23,2478
0,0,1,0,1,0,1,2479
1,1,0,0,1,0,1,2479
0,0,1,0,1,0,1,2480
1,1,0,2,1,2,3,2480
2,2,0,3,1,5,6,2480
3,3,3,3,4,8,12,2480
4,4,1,3,5,11,16,2480
5,5,0,2,5,13,18,2480
6,6,1,0,6,13,19,2480
7,7,0,0,6,13,19,2480
0,0,1,0,1,0,1,2481
1,1,0,0,1,0,1,2481
0,0,1,0,1,0,1,2482
1,1,0,0,1,0,1,2482
0,0,1,0,1,0,1,2483
1,1,0,0,1,0,1,2483
0,0,1,0,1,0,1,2484
1,1,1,0,2,0,2,2484
2,2,0,0,2,0,2,2484
0,0,1,0,1,0,1,2485
1,1,1,0,2,0,2,2485
2,2,1,0,3,0,3,2485
3,3,0,0,3,0,3,2485
0,0,1,0,1,0,1,2486
1,1,0,0,1,0,1,2486
0,0,1,0,1,0,1,2487
1,1,0,0,1,0,1,2487
0,0,1,0,1,0,1,2488
1,1,0,0,1,0,1,2488
0,0,1,0,1,0,1,2489
1,1,0,0,1,0,1,2489
0,0,1,0,1,0,1,2490
1,1,1,0,2,0,2,2490
2,2,0,0,2,0,2,2490
0,0,1,0,1,0,1,2491
1,1,0,0,1,0,1,2491
0,0,1,0,1,0,1,2492
1,1,0,0,1,0,1,2492
0,0,1,0,1,0,1,2493
1,1,1,0,2,0,2,2493
2,2,0,1,2,1,3,2493
3,3,0,1,2,2,4,2493
4,4,1,1,3,3,6,2493
5,5,2,1,5,4,9,2493
6,6,4,2,9,6,15,2493
7,7,4,2,13,8,21,2493
8,8,5,4,18,12,30,2493
9,9,3,4,21,16,37,2493
10,10,4,1,25,17,42,2493
11,11,4,3,29,20,49,2493
12,12,3,3,32,23,55,2493
13,13,4,5,36,28,64,2493
14,14,7,7,43,35,78,2493
15,15,6,3,49,38,87,2493
16,16,8,3,57,41,98,2493
17,17,7,5,64,46,110,2493
18,18,6,4,70,50,120,2493
19,19,8,2,78,52,130,2493
20,20,8,0,86,52,138,2493
21,21,10,2,96,54,150,2493
22,22,5,6,101,60,161,2493
23,23,5,5,106,65,171,2493
24,24,6,4,112,69,181,2493
25,25,3,2,115,71,186,2493
26,26,0,1,115,72,187,2493
27,27,0,0,115,72,187,2493
0,0,1,0,1,0,1,2494
1,1,0,1,1,1,2,2494
2,2,0,1,1,2,3,2494
3,3,1,1,2,3,5,2494
4,4,1,1,3,4,7,2494
5,5,0,2,3,6,9,2494
6,6,1,0,4,6,10,2494
7,7,0,0,4,6,10,2494
0,0,1,0,1,0,1,2495
1,1,0,0,1,0,1,2495
0,0,1,0,1,0,1,2496
1,1,0,0,1,0,1,2496
0,0,1,0,1,0,1,2497
1,1,1,0,2,0,2,2497
2,2,0,0,2,0,2,2497
0,0,1,0,1,0,1,2498
1,1,1,0,2,0,2,2498
2,2,0,1,2,1,3,2498
3,3,0,0,2,1,3,2498
0,0,1,0,1,0,1,2499
1,1,0,0,1,0,1,2499
0,0,1,0,1,0,1,2500
1,1,1,0,2,0,2,2500
2,2,0,1,2,1,3,2500
3,3,0,1,2,2,4,2500
4,4,0,0,2,2,4,2500
0,0,1,0,1,0,1,2501
1,1,2,0,3,0,3,2501
2,2,0,0,3,0,3,2501
0,0,1,0,1,0,1,2502
1,1,0,0,1,0,1,2502
0,0,1,0,1,0,1,2503
1,1,0,1,1,1,2,2503
2,2,0,0,1,1,2,2503
0,0,1,0,1,0,1,2504
1,1,1,0,2,0,2,2504
2,2,0,1,2,1,3,2504
3,3,0,1,2,2,4,2504
4,4,0,0,2,2,4,2504
0,0,1,0,1,0,1,2505
1,1,0,0,1,0,1,2505
0,0,1,0,1,0,1,2506
1,1,2,0,3,0,3,2506
2,2,0,4,3,4,7,2506
3,3,3,3,6,7,13,2506
4,4,2,0,8,7,15,2506
5,5,6,0,14,7,21,2506
6,6,4,0,18,7,25,2506
7,7,3,1,21,8,29,2506
8,8,3,2,24,10,34,2506
9,9,4,0,28,10,38,2506
10,10,3,1,31,11,42,2506
11,11,3,2,34,13,47,2506
12,12,5,2,39,15,54,2506
13,13,6,2,45,17,62,2506
14,14,4,1,49,18,67,2506
15,15,1,2,50,20,70,2506
16,16,2,2,52,22,74,2506
17,17,1,4,53,26,79,2506
18,18,1,1,54,27,81,2506
19,19,0,1,54,28,82,2506
20,20,0,0,54,28,82,2506
0,0,1,0,1,0,1,2507
1,1,1,0,2,0,2,2507
2,2,1,0,3,0,3,2507
3,3,0,0,3,0,3,2507
0,0,1,0,1,0,1,2508
1,1,0,0,1,0,1,2508
0,0,1,0,1,0,1,2509
1,1,0,0,1,0,1,2509
0,0,1,0,1,0,1,2510
1,1,2,0,3,0,3,2510
2,2,1,0,4,0,4,2510
3,3,1,0,5,0,5,2510
4,4,1,0,6,0,6,2510
5,5,0,0,6,0,6,2510
0,0,1,0,1,0,1,2511
1,1,2,0,3,0,3,2511
2,2,3,0,6,0,6,2511
3,3,1,0,7,0,7,2511
4,4,2,0,9,0,9,2511
5,5,1,0,10,0,10,2511
6,6,2,0,12,0,12,2511
7,7,1,0,13,0,13,2511
8,8,2,1,15,1,16,2511
9,9,3,0,18,1,19,2511
10,10,2,2,20,3,23,2511
11,11,2,1,22,4,26,2511
12,12,2,2,24,6,30,2511
13,13,3,2,27,8,35,2511
14,14,3,2,30,10,40,2511
15,15,1,2,31,12,43,2511
16,16,0,3,31,15,46,2511
17,17,1,0,32,15,47,2511
18,18,0,0,32,15,47,2511
0,0,1,0,1,0,1,2512
1,1,1,0,2,0,2,2512
2,2,2,1,4,1,5,2512
3,3,1,0,5,1,6,2512
4,4,0,0,5,1,6,2512
0,0,1,0,1,0,1,2513
1,1,1,0,2,0,2,2513
2,2,2,0,4,0,4,2513
3,3,1,0,5,0,5,2513
4,4,1,0,6,0,6,2513
5,5,1,0,7,0,7,2513
6,6,0,1,7,1,8,2513
7,7,0,0,7,1,8,2513
0,0,1,0,1,0,1,2514
1,1,1,0,2,0,2,2514
2,2,0,0,2,0,2,2514
0,0,1,0,1,0,1,2515
1,1,1,0,2,0,2,2515
2,2,0,0,2,0,2,2515
0,0,1,0,1,0,1,2516
1,1,0,0,1,0,1,2516
0,0,1,0,1,0,1,2517
1,1,1,0,2,0,2,2517
2,2,1,0,3,0,3,2517
3,3,1,0,4,0,4,2517
4,4,0,0,4,0,4,2517
0,0,1,0,1,0,1,2518
1,1,1,0,2,0,2,2518
2,2,0,0,2,0,2,2518
0,0,1,0,1,0,1,2519
1,1,0,0,1,0,1,2519
0,0,1,0,1,0,1,2520
1,1,0,0,1,0,1,2520
0,0,1,0,1,0,1,2521
1,1,0,0,1,0,1,2521
0,0,1,0,1,0,1,2522
1,1,0,0,1,0,1,2522
0,0,1,0,1,0,1,2523
1,1,1,0,2,0,2,2523
2,2,0,0,2,0,2,2523
0,0,1,0,1,0,1,2524
1,1,3,1,4,1,5,2524
2,2,3,1,7,2,9,2524
3,3,3,1,10,3,13,2524
4,4,0,0,10,3,13,2524
0,0,1,0,1,0,1,2525
1,1,1,0,2,0,2,2525
2,2,1,0,3,0,3,2525
3,3,0,0,3,0,3,2525
0,0,1,0,1,0,1,2526
1,1,1,0,2,0,2,2526
2,2,0,0,2,0,2,2526
0,0,1,0,1,0,1,2527
1,1,1,0,2,0,2,2527
2,2,1,0,3,0,3,2527
3,3,1,0,4,0,4,2527
4,4,0,0,4,0,4,2527
0,0,1,0,1,0,1,2528
1,1,0,0,1,0,1,2528
0,0,1,0,1,0,1,2529
1,1,0,0,1,0,1,2529
0,0,1,0,1,0,1,2530
1,1,1,0,2,0,2,2530
2,2,1,0,3,0,3,2530
3,3,0,0,3,0,3,2530
0,0,1,0,1,0,1,2531
1,1,0,0,1,0,1,2531
0,0,1,0,1,0,1,2532
1,1,0,0,1,0,1,2532
0,0,1,0,1,0,1,2533
1,1,1,2,2,2,4,2533
2,2,1,2,3,4,7,2533
3,3,1,2,4,6,10,2533
4,4,1,1,5,7,12,2533
5,5,0,4,5,11,16,2533
6,6,0,3,5,14,19,2533
7,7,2,1,7,15,22,2533
8,8,1,2,8,17,25,2533
9,9,1,1,9,18,27,2533
10,10,1,2,10,20,30,2533
11,11,1,3,11,23,34,2533
12,12,2,2,13,25,38,2533
13,13,1,1,14,26,40,2533
14,14,0,0,14,26,40,2533
0,0,1,0,1,0,1,2534
1,1,1,0,2,0,2,2534
2,2,0,0,2,0,2,2534
0,0,1,0,1,0,1,2535
1,1,0,0,1,0,1,2535
0,0,1,0,1,0,1,2536
1,1,0,0,1,0,1,2536
0,0,1,0,1,0,1,2537
1,1,1,0,2,0,2,2537
2,2,0,0,2,0,2,2537
0,0,1,0,1,0,1,2538
1,1,0,0,1,0,1,2538
0,0,1,0,1,0,1,2539
1,1,1,0,2,0,2,2539
2,2,0,0,2,0,2,2539
0,0,1,0,1,0,1,2540
1,1,0,0,1,0,1,2540
0,0,1,0,1,0,1,2541
1,1,1,0,2,0,2,2541
2,2,0,0,2,0,2,2541
0,0,1,0,1,0,1,2542
1,1,1,0,2,0,2,2542
2,2,1,0,3,0,3,2542
3,3,0,0,3,0,3,2542
0,0,1,0,1,0,1,2543
1,1,1,0,2,0,2,2543
2,2,0,0,2,0,2,2543
0,0,1,0,1,0,1,2544
1,1,0,0,1,0,1,2544
0,0,1,0,1,0,1,2545
1,1,0,0,1,0,1,2545
0,0,1,0,1,0,1,2546
1,1,1,0,2,0,2,2546
2,2,1,0,3,0,3,2546
3,3,2,1,5,1,6,2546
4,4,1,1,6,2,8,2546
5,5,0,0,6,2,8,2546
0,0,1,0,1,0,1,2547
1,1,1,0,2,0,2,2547
2,2,0,1,2,1,3,2547
3,3,1,0,3,1,4,2547
4,4,0,0,3,1,4,2547
0,0,1,0,1,0,1,2548
1,1,0,1,1,1,2,2548
2,2,1,0,2,1,3,2548
3,3,2,0,4,1,5,2548
4,4,0,0,4,1,5,2548
0,0,1,0,1,0,1,2549
1,1,0,0,1,0,1,2549
0,0,1,0,1,0,1,2550
1,1,0,0,1,0,1,2550
0,0,1,0,1,0,1,2551
1,1,0,0,1,0,1,2551
0,0,1,0,1,0,1,2552
1,1,1,0,2,0,2,2552
2,2,0,0,2,0,2,2552
0,0,1,0,1,0,1,2553
1,1,0,0,1,0,1,2553
0,0,1,0,1,0,1,2554
1,1,0,0,1,0,1,2554
0,0,1,0,1,0,1,2555
1,1,0,0,1,0,1,2555
0,0,1,0,1,0,1,2556
1,1,0,0,1,0,1,2556
0,0,1,0,1,0,1,2557
1,1,1,1,2,1,3,2557
2,2,0,1,2,2,4,2557
3,3,1,3,3,5,8,2557
4,4,2,4,5,9,14,2557
5,5,3,2,8,11,19,2557
6,6,2,0,10,11,21,2557
7,7,1,2,11,13,24,2557
8,8,0,2,11,15,26,2557
9,9,0,1,11,16,27,2557
10,10,0,0,11,16,27,2557
0,0,1,0,1,0,1,2558
1,1,2,0,3,0,3,2558
2,2,0,1,3,1,4,2558
3,3,0,0,3,1,4,2558
0,0,1,0,1,0,1,2559
1,1,2,0,3,0,3,2559
2,2,3,1,6,1,7,2559
3,3,4,0,10,1,11,2559
4,4,3,1,13,2,15,2559
5,5,2,1,15,3,18,2559
6,6,2,3,17,6,23,2559
7,7,3,3,20,9,29,2559
8,8,1,4,21,13,34,2559
9,9,1,3,22,16,38,2559
10,10,3,1,25,17,42,2559
11,11,1,0,26,17,43,2559
12,12,0,0,26,17,43,2559
0,0,1,0,1,0,1,2560
1,1,0,0,1,0,1,2560
0,0,1,0,1,0,1,2561
1,1,0,1,1,1,2,2561
2,2,0,1,1,2,3,2561
3,3,0,1,1,3,4,2561
4,4,0,2,1,5,6,2561
5,5,3,3,4,8,12,2561
6,6,2,2,6,10,16,2561
7,7,1,0,7,10,17,2561
8,8,0,1,7,11,18,2561
9,9,0,0,7,11,18,2561
0,0,1,0,1,0,1,2562
1,1,0,1,1,1,2,2562
2,2,1,1,2,2,4,2562
3,3,1,0,3,2,5,2562
4,4,0,0,3,2,5,2562
0,0,1,0,1,0,1,2563
1,1,3,1,4,1,5,2563
2,2,6,1,10,2,12,2563
3,3,9,2,19,4,23,2563
4,4,7,3,26,7,33,2563
5,5,7,2,33,9,42,2563
6,6,6,3,39,12,51,2563
7,7,4,2,43,14,57,2563
8,8,6,2,49,16,65,2563
9,9,9,4,58,20,78,2563
10,10,8,6,66,26,92,2563
11,11,8,2,74,28,102,2563
12,12,7,4,81,32,113,2563
13,13,10,7,91,39,130,2563
14,14,16,6,107,45,152,2563
15,15,9,14,116,59,175,2563
16,16,10,10,126,69,195,2563
17,17,7,5,133,74,207,2563
18,18,2,5,135,79,214,2563
19,19,2,1,137,80,217,2563
20,20,0,2,137,82,219,2563
21,21,0,0,137,82,219,2563
0,0,1,0,1,0,1,2564
1,1,0,0,1,0,1,2564
0,0,1,0,1,0,1,2565
1,1,0,0,1,0,1,2565
0,0,1,0,1,0,1,2566
1,1,0,0,1,0,1,2566
0,0,1,0,1,0,1,2567
1,1,0,0,1,0,1,2567
0,0,1,0,1,0,1,2568
1,1,2,0,3,0,3,2568
2,2,1,0,4,0,4,2568
3,3,0,0,4,0,4,2568
0,0,1,0,1,0,1,2569
1,1,1,0,2,0,2,2569
2,2,0,0,2,0,2,2569
0,0,1,0,1,0,1,2570
1,1,2,0,3,0,3,2570
2,2,1,0,4,0,4,2570
3,3,0,0,4,0,4,2570
0,0,1,0,1,0,1,2571
1,1,1,0,2,0,2,2571
2,2,0,0,2,0,2,2571
0,0,1,0,1,0,1,2572
1,1,2,1,3,1,4,2572
2,2,0,0,3,1,4,2572
0,0,1,0,1,0,1,2573
1,1,0,0,1,0,1,2573
0,0,1,0,1,0,1,2574
1,1,1,2,2,2,4,2574
2,2,2,3,4,5,9,2574
3,3,2,2,6,7,13,2574
4,4,0,1,6,8,14,2574
5,5,0,0,6,8,14,2574
0,0,1,0,1,0,1,2575
1,1,1,0,2,0,2,2575
2,2,0,0,2,0,2,2575
0,0,1,0,1,0,1,2576
1,1,1,0,2,0,2,2576
2,2,2,0,4,0,4,2576
3,3,1,0,5,0,5,2576
4,4,2,0,7,0,7,2576
5,5,2,0,9,0,9,2576
6,6,3,0,12,0,12,2576
7,7,3,0,15,0,15,2576
8,8,1,1,16,1,17,2576
9,9,1,2,17,3,20,2576
10,10,1,1,18,4,22,2576
11,11,1,0,19,4,23,2576
12,12,1,0,20,4,24,2576
13,13,2,0,22,4,26,2576
14,14,1,0,23,4,27,2576
15,15,0,1,23,5,28,2576
16,16,0,0,23,5,28,2576
0,0,1,0,1,0,1,2577
1,1,1,0,2,0,2,2577
2,2,0,0,2,0,2,2577
0,0,1,0,1,0,1,2578
1,1,2,0,3,0,3,2578
2,2,1,0,4,0,4,2578
3,3,0,0,4,0,4,2578
0,0,1,0,1,0,1,2579
1,1,2,0,3,0,3,2579
2,2,0,0,3,0,3,2579
0,0,1,0,1,0,1,2580
1,1,0,1,1,1,2,2580
2,2,0,0,1,1,2,2580
0,0,1,0,1,0,1,2581
1,1,0,0,1,0,1,2581
0,0,1,0,1,0,1,2582
1,1,0,0,1,0,1,2582
0,0,1,0,1,0,1,2583
1,1,1,0,2,0,2,2583
2,2,2,0,4,0,4,2583
3,3,0,1,4,1,5,2583
4,4,0,0,4,1,5,2583
0,0,1,0,1,0,1,2584
1,1,0,0,1,0,1,2584
0,0,1,0,1,0,1,2585
1,1,1,0,2,0,2,2585
2,2,2,0,4,0,4,2585
3,3,2,0,6,0,6,2585
4,4,0,1,6,1,7,2585
5,5,0,1,6,2,8,2585
6,6,0,0,6,2,8,2585
0,0,1,0,1,0,1,2586
1,1,0,0,1,0,1,2586
0,0,1,0,1,0,1,2587
1,1,2,0,3,0,3,2587
2,2,3,0,6,0,6,2587
3,3,1,1,7,1,8,2587
4,4,0,1,7,2,9,2587
5,5,0,1,7,3,10,2587
6,6,0,0,7,3,10,2587
0,0,1,0,1,0,1,2588
1,1,1,0,2,0,2,2588
2,2,1,0,3,0,3,2588
3,3,2,0,5,0,5,2588
4,4,0,0,5,0,5,2588
0,0,1,0,1,0,1,2589
1,1,0,0,1,0,1,2589
0,0,1,0,1,0,1,2590
1,1,0,0,1,0,1,2590
0,0,1,0,1,0,1,2591
1,1,0,1,1,1,2,2591
2,2,0,4,1,5,6,2591
3,3,0,0,1,5,6,2591
0,0,1,0,1,0,1,2592
1,1,0,0,1,0,1,2592
0,0,1,0,1,0,1,2593
1,1,0,0,1,0,1,2593
0,0,1,0,1,0,1,2594
1,1,0,0,1,0,1,2594
0,0,1,0,1,0,1,2595
1,1,1,0,2,0,2,2595
2,2,0,0,2,0,2,2595
0,0,1,0,1,0,1,2596
1,1,2,0,3,0,3,2596
2,2,2,1,5,1,6,2596
3,3,3,3,8,4,12,2596
4,4,3,1,11,5,16,2596
5,5,3,2,14,7,21,2596
6,6,3,4,17,11,28,2596
7,7,2,4,19,15,34,2596
8,8,5,5,24,20,44,2596
9,9,5,5,29,25,54,2596
10,10,3,4,32,29,61,2596
11,11,3,6,35,35,70,2596
12,12,2,2,37,37,74,2596
13,13,2,3,39,40,79,2596
14,14,1,2,40,42,82,2596
15,15,3,1,43,43,86,2596
16,16,2,3,45,46,91,2596
17,17,1,1,46,47,93,2596
18,18,2,0,48,47,95,2596
19,19,1,0,49,47,96,2596
20,20,2,0,51,47,98,2596
21,21,0,0,51,47,98,2596
0,0,1,0,1,0,1,2597
1,1,0,0,1,0,1,2597
0,0,1,0,1,0,1,2598
1,1,0,0,1,0,1,2598
0,0,1,0,1,0,1,2599
1,1,0,0,1,0,1,2599
0,0,1,0,1,0,1,2600
1,1,1,0,2,0,2,2600
2,2,0,0,2,0,2,2600
0,0,1,0,1,0,1,2601
1,1,1,0,2,0,2,2601
2,2,1,0,3,0,3,2601
3,3,0,0,3,0,3,2601
0,0,1,0,1,0,1,2602
1,1,0,0,1,0,1,2602
0,0,1,0,1,0,1,2603
1,1,2,1,3,1,4,2603
2,2,2,0,5,1,6,2603
3,3,1,1,6,2,8,2603
4,4,0,0,6,2,8,2603
0,0,1,0,1,0,1,2604
1,1,0,0,1,0,1,2604
0,0,1,0,1,0,1,2605
1,1,0,0,1,0,1,2605
0,0,1,0,1,0,1,2606
1,1,0,0,1,0,1,2606
0,0,1,0,1,0,1,2607
1,1,1,0,2,0,2,2607
2,2,1,0,3,0,3,2607
3,3,2,1,5,1,6,2607
4,4,0,1,5,2,7,2607
5,5,0,0,5,2,7,2607
0,0,1,0,1,0,1,2608
1,1,0,1,1,1,2,2608
2,2,1,1,2,2,4,2608
3,3,1,1,3,3,6,2608
4,4,2,1,5,4,9,2608
5,5,0,2,5,6,11,2608
6,6,0,1,5,7,12,2608
7,7,1,0,6,7,13,2608
8,8,2,0,8,7,15,2608
9,9,1,0,9,7,16,2608
10,10,0,0,9,7,16,2608
0,0,1,0,1,0,1,2609
1,1,0,0,1,0,1,2609
0,0,1,0,1,0,1,2610
1,1,2,0,3,0,3,2610
2,2,0,1,3,1,4,2610
3,3,0,1,3,2,5,2610
4,4,0,4,3,6,9,2610
5,5,1,3,4,9,13,2610
6,6,2,3,6,12,18,2610
7,7,2,1,8,13,21,2610
8,8,1,0,9,13,22,2610
9,9,3,0,12,13,25,2610
10,10,1,0,13,13,26,2610
11,11,2,0,15,13,28,2610
12,12,1,1,16,14,30,2610
13,13,3,1,19,15,34,2610
14,14,2,0,21,15,36,2610
15,15,1,0,22,15,37,2610
16,16,1,0,23,15,38,2610
17,17,0,0,23,15,38,2610
0,0,1,0,1,0,1,2611
1,1,1,0,2,0,2,2611
2,2,1,0,3,0,3,2611
3,3,1,0,4,0,4,2611
4,4,0,0,4,0,4,2611
0,0,1,0,1,0,1,2612
1,1,1,1,2,1,3,2612
2,2,3,0,5,1,6,2612
3,3,1,1,6,2,8,2612
4,4,1,0,7,2,9,2612
5,5,1,0,8,2,10,2612
6,6,1,0,9,2,11,2612
7,7,1,0,10,2,12,2612
8,8,0,0,10,2,12,2612
0,0,1,0,1,0,1,2613
1,1,0,0,1,0,1,2613
0,0,1,0,1,0,1,2614
1,1,1,0,2,0,2,2614
2,2,0,0,2,0,2,2614
0,0,1,0,1,0,1,2615
1,1,2,0,3,0,3,2615
2,2,0,0,3,0,3,2615
0,0,1,0,1,0,1,2616
1,1,0,0,1,0,1,2616
0,0,1,0,1,0,1,2617
1,1,1,0,2,0,2,2617
2,2,0,0,2,0,2,2617
0,0,1,0,1,0,1,2618
1,1,1,0,2,0,2,2618
2,2,0,1,2,1,3,2618
3,3,0,0,2,1,3,2618
0,0,1,0,1,0,1,2619
1,1,1,0,2,0,2,2619
2,2,1,0,3,0,3,2619
3,3,3,0,6,0,6,2619
4,4,1,1,7,1,8,2619
5,5,2,0,9,1,10,2619
6,6,1,1,10,2,12,2619
7,7,0,2,10,4,14,2619
8,8,0,2,10,6,16,2619
9,9,0,0,10,6,16,2619
0,0,1,0,1,0,1,2620
1,1,1,0,2,0,2,2620
2,2,1,0,3,0,3,2620
3,3,1,0,4,0,4,2620
4,4,0,0,4,0,4,2620
0,0,1,0,1,0,1,2621
1,1,0,0,1,0,1,2621
0,0,1,0,1,0,1,2622
1,1,1,0,2,0,2,2622
2,2,1,0,3,0,3,2622
3,3,2,0,5,0,5,2622
4,4,2,1,7,1,8,2622
5,5,1,1,8,2,10,2622
6,6,0,0,8,2,10,2622
0,0,1,0,1,0,1,2623
1,1,0,0,1,0,1,2623
0,0,1,0,1,0,1,2624
1,1,1,0,2,0,2,2624
2,2,0,0,2,0,2,2624
0,0,1,0,1,0,1,2625
1,1,2,0,3,0,3,2625
2,2,1,0,4,0,4,2625
3,3,0,0,4,0,4,2625
0,0,1,0,1,0,1,2626
1,1,0,0,1,0,1,2626
0,0,1,0,1,0,1,2627
1,1,4,0,5,0,5,2627
2,2,2,0,7,0,7,2627
3,3,1,0,8,0,8,2627
4,4,0,1,8,1,9,2627
5,5,0,0,8,1,9,2627
0,0,1,0,1,0,1,2628
1,1,0,0,1,0,1,2628
0,0,1,0,1,0,1,2629
1,1,0,0,1,0,1,2629
0,0,1,0,1,0,1,2630
1,1,0,0,1,0,1,2630
0,0,1,0,1,0,1,2631
1,1,0,0,1,0,1,2631
0,0,1,0,1,0,1,2632
1,1,0,1,1,1,2,2632
2,2,0,2,1,3,4,2632
3,3,0,2,1,5,6,2632
4,4,0,1,1,6,7,2632
5,5,0,1,1,7,8,2632
6,6,0,1,1,8,9,2632
7,7,1,2,2,10,12,2632
8,8,1,2,3,12,15,2632
9,9,4,2,7,14,21,2632
10,10,9,4,16,18,34,2632
11,11,8,3,24,21,45,2632
12,12,5,6,29,27,56,2632
13,13,2,7,31,34,65,2632
14,14,2,5,33,39,72,2632
15,15,2,2,35,41,76,2632
16,16,1,1,36,42,78,2632
17,17,3,1,39,43,82,2632
18,18,6,3,45,46,91,2632
19,19,6,3,51,49,100,2632
20,20,5,4,56,53,109,2632
21,21,5,1,61,54,115,2632
22,22,6,1,67,55,122,2632
23,23,7,2,74,57,131,2632
24,24,5,2,79,59,138,2632
25,25,6,1,85,60,145,2632
26,26,3,1,88,61,149,2632
27,27,1,3,89,64,153,2632
28,28,0,0,89,64,153,2632
0,0,1,0,1,0,1,2633
1,1,0,0,1,0,1,2633
0,0,1,0,1,0,1,2634
1,1,0,0,1,0,1,2634
0,0,1,0,1,0,1,2635
1,1,1,0,2,0,2,2635
2,2,1,0,3,0,3,2635
3,3,0,0,3,0,3,2635
0,0,1,0,1,0,1,2636
1,1,0,0,1,0,1,2636
0,0,1,0,1,0,1,2637
1,1,1,0,2,0,2,2637
2,2,1,0,3,0,3,2637
3,3,1,2,4,2,6,2637
4,4,1,0,5,2,7,2637
5,5,1,0,6,2,8,2637
6,6,1,2,7,4,11,2637
7,7,2,1,9,5,14,2637
8,8,0,2,9,7,16,2637
9,9,0,1,9,8,17,2637
10,10,0,2,9,10,19,2637
11,11,0,0,9,10,19,2637
0,0,1,0,1,0,1,2638
1,1,0,0,1,0,1,2638
0,0,1,0,1,0,1,2639
1,1,1,0,2,0,2,2639
2,2,0,0,2,0,2,2639
0,0,1,0,1,0,1,2640
1,1,0,0,1,0,1,2640
0,0,1,0,1,0,1,2641
1,1,0,1,1,1,2,2641
2,2,0,0,1,1,2,2641
0,0,1,0,1,0,1,2642
1,1,3,0,4,0,4,2642
2,2,2,0,6,0,6,2642
3,3,1,1,7,1,8,2642
4,4,0,1,7,2,9,2642
5,5,0,0,7,2,9,2642
0,0,1,0,1,0,1,2643
1,1,1,1,2,1,3,2643
2,2,0,0,2,1,3,2643
0,0,1,0,1,0,1,2644
1,1,3,0,4,0,4,2644
2,2,0,2,4,2,6,2644
3,3,0,2,4,4,8,2644
4,4,0,2,4,6,10,2644
5,5,0,0,4,6,10,2644
0,0,1,0,1,0,1,2645
1,1,1,0,2,0,2,2645
2,2,0,0,2,0,2,2645
0,0,1,0,1,0,1,2646
1,1,1,0,2,0,2,2646
2,2,0,0,2,0,2,2646
0,0,1,0,1,0,1,2647
1,1,1,0,2,0,2,2647
2,2,1,1,3,1,4,2647
3,3,1,0,4,1,5,2647
4,4,0,0,4,1,5,2647
0,0,1,0,1,0,1,2648
1,1,1,0,2,0,2,2648
2,2,0,0,2,0,2,2648
0,0,1,0,1,0,1,2649
1,1,1,0,2,0,2,2649
2,2,0,0,2,0,2,2649
0,0,1,0,1,0,1,2650
1,1,1,0,2,0,2,2650
2,2,1,0,3,0,3,2650
3,3,0,0,3,0,3,2650
0,0,1,0,1,0,1,2651
1,1,2,0,3,0,3,2651
2,2,2,0,5,0,5,2651
3,3,1,0,6,0,6,2651
4,4,2,0,8,0,8,2651
5,5,2,0,10,0,10,2651
6,6,0,0,10,0,10,2651
0,0,1,0,1,0,1,2652
1,1,1,0,2,0,2,2652
2,2,0,0,2,0,2,2652
0,0,1,0,1,0,1,2653
1,1,2,0,3,0,3,2653
2,2,2,1,5,1,6,2653
3,3,1,1,6,2,8,2653
4,4,1,1,7,3,10,2653
5,5,0,0,7,3,10,2653
0,0,1,0,1,0,1,2654
1,1,2,0,3,0,3,2654
2,2,3,1,6,1,7,2654
3,3,5,1,11,2,13,2654
4,4,8,2,19,4,23,2654
5,5,11,1,30,5,35,2654
6,6,9,0,39,5,44,2654
7,7,7,2,46,7,53,2654
8,8,12,2,58,9,67,2654
9,9,5,3,63,12,75,2654
10,10,5,4,68,16,84,2654
11,11,3,8,71,24,95,2654
12,12,4,11,75,35,110,2654
13,13,8,7,83,42,125,2654
14,14,9,6,92,48,140,2654
15,15,7,9,99,57,156,2654
16,16,8,4,107,61,168,2654
17,17,7,3,114,64,178,2654
18,18,7,6,121,70,191,2654
19,19,4,4,125,74,199,2654
20,20,6,3,131,77,208,2654
21,21,2,4,133,81,214,2654
22,22,4,3,137,84,221,2654
23,23,7,1,144,85,229,2654
24,24,6,3,150,88,238,2654
25,25,4,3,154,91,245,2654
26,26,2,1,156,92,248,2654
27,27,0,1,156,93,249,2654
28,28,0,0,156,93,249,2654
0,0,1,0,1,0,1,2655
1,1,0,0,1,0,1,2655
0,0,1,0,1,0,1,2656
1,1,0,0,1,0,1,2656
0,0,1,0,1,0,1,2657
1,1,1,0,2,0,2,2657
2,2,2,0,4,0,4,2657
3,3,0,0,4,0,4,2657
0,0,1,0,1,0,1,2658
1,1,2,0,3,0,3,2658
2,2,1,0,4,0,4,2658
3,3,0,0,4,0,4,2658
0,0,1,0,1,0,1,2659
1,1,0,0,1,0,1,2659
0,0,1,0,1,0,1,2660
1,1,0,0,1,0,1,2660
0,0,1,0,1,0,1,2661
1,1,0,0,1,0,1,2661
0,0,1,0,1,0,1,2662
1,1,0,0,1,0,1,2662
0,0,1,0,1,0,1,2663
1,1,0,1,1,1,2,2663
2,2,0,2,1,3,4,2663
3,3,1,0,2,3,5,2663
4,4,2,0,4,3,7,2663
5,5,0,0,4,3,7,2663
0,0,1,0,1,0,1,2664
1,1,0,0,1,0,1,2664
0,0,1,0,1,0,1,2665
1,1,0,0,1,0,1,2665
0,0,1,0,1,0,1,2666
1,1,0,0,1,0,1,2666
0,0,1,0,1,0,1,2667
1,1,1,0,2,0,2,2667
2,2,0,0,2,0,2,2667
0,0,1,0,1,0,1,2668
1,1,0,0,1,0,1,2668
0,0,1,0,1,0,1,2669
1,1,0,0,1,0,1,2669
0,0,1,0,1,0,1,2670
1,1,1,0,2,0,2,2670
2,2,1,0,3,0,3,2670
3,3,3,0,6,0,6,2670
4,4,3,2,9,2,11,2670
5,5,1,5,10,7,17,2670
6,6,1,4,11,11,22,2670
7,7,0,4,11,15,26,2670
8,8,1,3,12,18,30,2670
9,9,2,4,14,22,36,2670
10,10,2,4,16,26,42,2670
11,11,2,6,18,32,50,2670
12,12,6,2,24,34,58,2670
13,13,6,1,30,35,65,2670
14,14,8,4,38,39,77,2670
15,15,7,4,45,43,88,2670
16,16,4,3,49,46,95,2670
17,17,4,3,53,49,102,2670
18,18,3,8,56,57,113,2670
19,19,3,2,59,59,118,2670
20,20,5,2,64,61,125,2670
21,21,5,2,69,63,132,2670
22,22,7,3,76,66,142,2670
23,23,7,6,83,72,155,2670
24,24,10,5,93,77,170,2670
25,25,3,6,96,83,179,2670
26,26,2,8,98,91,189,2670
27,27,2,2,100,93,193,2670
28,28,6,3,106,96,202,2670
29,29,5,2,111,98,209,2670
30,30,3,4,114,102,216,2670
31,31,3,5,117,107,224,2670
32,32,3,3,120,110,230,2670
33,33,4,1,124,111,235,2670
34,34,4,0,128,111,239,2670
35,35,3,1,131,112,243,2670
36,36,1,3,132,115,247,2670
37,37,1,2,133,117,250,2670
38,38,3,1,136,118,254,2670
39,39,3,0,139,118,257,2670
40,40,1,2,140,120,260,2670
41,41,0,3,140,123,263,2670
42,42,0,1,140,124,264,2670
43,43,0,2,140,126,266,2670
44,44,0,3,140,129,269,2670
45,45,2,3,142,132,274,2670
46,46,2,4,144,136,280,2670
47,47,5,2,149,138,287,2670
48,48,6,3,155,141,296,2670
49,49,4,6,159,147,306,2670
50,50,2,1,161,148,309,2670
51,51,1,1,162,149,311,2670
52,52,1,1,163,150,313,2670
53,53,2,0,165,150,315,2670
54,54,1,0,166,150,316,2670
55,55,0,0,166,150,316,2670
0,0,1,0,1,0,1,2671
1,1,1,1,2,1,3,2671
2,2,1,2,3,3,6,2671
3,3,0,1,3,4,7,2671
4,4,0,2,3,6,9,2671
5,5,0,1,3,7,10,2671
6,6,0,1,3,8,11,2671
7,7,0,0,3,8,11,2671
0,0,1,0,1,0,1,2672
1,1,2,0,3,0,3,2672
2,2,2,0,5,0,5,2672
3,3,3,0,8,0,8,2672
4,4,1,0,9,0,9,2672
5,5,1,0,10,0,10,2672
6,6,1,0,11,0,11,2672
7,7,0,0,11,0,11,2672
0,0,1,0,1,0,1,2673
1,1,0,0,1,0,1,2673
0,0,1,0,1,0,1,2674
1,1,0,0,1,0,1,2674
0,0,1,0,1,0,1,2675
1,1,1,0,2,0,2,2675
2,2,1,0,3,0,3,2675
3,3,3,0,6,0,6,2675
4,4,0,0,6,0,6,2675
0,0,1,0,1,0,1,2676
1,1,0,0,1,0,1,2676
0,0,1,0,1,0,1,2677
1,1,0,0,1,0,1,2677
0,0,1,0,1,0,1,2678
1,1,2,0,3,0,3,2678
2,2,2,1,5,1,6,2678
3,3,0,4,5,5,10,2678
4,4,0,6,5,11,16,2678
5,5,1,6,6,17,23,2678
6,6,0,3,6,20,26,2678
7,7,0,4,6,24,30,2678
8,8,4,2,10,26,36,2678
9,9,3,1,13,27,40,2678
10,10,4,0,17,27,44,2678
11,11,1,0,18,27,45,2678
12,12,0,0,18,27,45,2678
0,0,1,0,1,0,1,2679
1,1,1,0,2,0,2,2679
2,2,2,0,4,0,4,2679
3,3,2,0,6,0,6,2679
4,4,6,0,12,0,12,2679
5,5,6,1,18,1,19,2679
6,6,4,0,22,1,23,2679
7,7,2,0,24,1,25,2679
8,8,3,0,27,1,28,2679
9,9,1,0,28,1,29,2679
10,10,0,0,28,1,29,2679
0,0,1,0,1,0,1,2680
1,1,0,0,1,0,1,2680
0,0,1,0,1,0,1,2681
1,1,2,0,3,0,3,2681
2,2,1,0,4,0,4,2681
3,3,2,0,6,0,6,2681
4,4,2,0,8,0,8,2681
5,5,3,0,11,0,11,2681
6,6,0,0,11,0,11,2681
0,0,1,0,1,0,1,2682
1,1,1,0,2,0,2,2682
2,2,0,0,2,0,2,2682
0,0,1,0,1,0,1,2683
1,1,0,0,1,0,1,2683
0,0,1,0,1,0,1,2684
1,1,0,0,1,0,1,2684
0,0,1,0,1,0,1,2685
1,1,2,0,3,0,3,2685
2,2,1,1,4,1,5,2685
3,3,1,2,5,3,8,2685
4,4,0,1,5,4,9,2685
5,5,0,0,5,4,9,2685
0,0,1,0,1,0,1,2686
1,1,1,1,2,1,3,2686
2,2,1,1,3,2,5,2686
3,3,0,1,3,3,6,2686
4,4,0,1,3,4,7,2686
5,5,0,2,3,6,9,2686
6,6,0,3,3,9,12,2686
7,7,1,0,4,9,13,2686
8,8,0,0,4,9,13,2686
0,0,1,0,1,0,1,2687
1,1,0,0,1,0,1,2687
0,0,1,0,1,0,1,2688
1,1,1,0,2,0,2,2688
2,2,2,0,4,0,4,2688
3,3,0,1,4,1,5,2688
4,4,0,1,4,2,6,2688
5,5,0,1,4,3,7,2688
6,6,0,1,4,4,8,2688
7,7,1,1,5,5,10,2688
8,8,1,2,6,7,13,2688
9,9,1,1,7,8,15,2688
10,10,3,1,10,9,19,2688
11,11,3,1,13,10,23,2688
12,12,1,0,14,10,24,2688
13,13,1,0,15,10,25,2688
14,14,3,0,18,10,28,2688
15,15,1,0,19,10,29,2688
16,16,0,0,19,10,29,2688
0,0,1,0,1,0,1,2689
1,1,2,0,3,0,3,2689
2,2,0,0,3,0,3,2689
0,0,1,0,1,0,1,2690
1,1,0,0,1,0,1,2690
0,0,1,0,1,0,1,2691
1,1,0,0,1,0,1,2691
0,0,1,0,1,0,1,2692
1,1,3,1,4,1,5,2692
2,2,1,1,5,2,7,2692
3,3,0,1,5,3,8,2692
4,4,1,2,6,5,11,2692
5,5,0,2,6,7,13,2692
6,6,0,1,6,8,14,2692
7,7,0,0,6,8,14,2692
0,0,1,0,1,0,1,2693
1,1,0,0,1,0,1,2693
0,0,1,0,1,0,1,2694
1,1,1,1,2,1,3,2694
2,2,2,1,4,2,6,2694
3,3,4,0,8,2,10,2694
4,4,3,1,11,3,14,2694
5,5,3,4,14,7,21,2694
6,6,4,1,18,8,26,2694
7,7,3,3,21,11,32,2694
8,8,2,2,23,13,36,2694
9,9,1,4,24,17,41,2694
10,10,3,2,27,19,46,2694
11,11,2,3,29,22,51,2694
12,12,0,1,29,23,52,2694
13,13,0,2,29,25,54,2694
14,14,1,3,30,28,58,2694
15,15,2,2,32,30,62,2694
16,16,1,2,33,32,65,2694
17,17,2,2,35,34,69,2694
18,18,5,0,40,34,74,2694
19,19,1,1,41,35,76,2694
20,20,0,1,41,36,77,2694
21,21,0,0,41,36,77,2694
0,0,1,0,1,0,1,2695
1,1,1,0,2,0,2,2695
2,2,2,0,4,0,4,2695
3,3,0,0,4,0,4,2695
0,0,1,0,1,0,1,2696
1,1,2,1,3,1,4,2696
2,2,1,0,4,1,5,2696
3,3,0,1,4,2,6,2696
4,4,0,0,4,2,6,2696
0,0,1,0,1,0,1,2697
1,1,2,0,3,0,3,2697
2,2,0,1,3,1,4,2697
3,3,1,0,4,1,5,2697
4,4,0,0,4,1,5,2697
0,0,1,0,1,0,1,2698
1,1,1,0,2,0,2,2698
2,2,0,0,2,0,2,2698
0,0,1,0,1,0,1,2699
1,1,0,0,1,0,1,2699
0,0,1,0,1,0,1,2700
1,1,0,1,1,1,2,2700
2,2,0,1,1,2,3,2700
3,3,0,0,1,2,3,2700
0,0,1,0,1,0,1,2701
1,1,1,0,2,0,2,2701
2,2,0,0,2,0,2,2701
0,0,1,0,1,0,1,2702
1,1,1,1,2,1,3,2702
2,2,3,1,5,2,7,2702
3,3,1,2,6,4,10,2702
4,4,0,1,6,5,11,2702
5,5,1,3,7,8,15,2702
6,6,0,1,7,9,16,2702
7,7,0,0,7,9,16,2702
0,0,1,0,1,0,1,2703
1,1,0,0,1,0,1,2703
0,0,1,0,1,0,1,2704
1,1,0,0,1,0,1,2704
0,0,1,0,1,0,1,2705
1,1,1,0,2,0,2,2705
2,2,1,0,3,0,3,2705
3,3,0,0,3,0,3,2705
0,0,1,0,1,0,1,2706
1,1,0,0,1,0,1,2706
0,0,1,0,1,0,1,2707
1,1,1,0,2,0,2,2707
2,2,0,0,2,0,2,2707
0,0,1,0,1,0,1,2708
1,1,3,0,4,0,4,2708
2,2,1,0,5,0,5,2708
3,3,1,0,6,0,6,2708
4,4,0,0,6,0,6,2708
0,0,1,0,1,0,1,2709
1,1,0,1,1,1,2,2709
2,2,0,0,1,1,2,2709
0,0,1,0,1,0,1,2710
1,1,2,0,3,0,3,2710
2,2,0,0,3,0,3,2710
0,0,1,0,1,0,1,2711
1,1,0,0,1,0,1,2711
0,0,1,0,1,0,1,2712
1,1,2,0,3,0,3,2712
2,2,1,1,4,1,5,2712
3,3,2,1,6,2,8,2712
4,4,4,1,10,3,13,2712
5,5,1,2,11,5,16,2712
6,6,3,2,14,7,21,2712
7,7,3,1,17,8,25,2712
8,8,3,3,20,11,31,2712
9,9,3,3,23,14,37,2712
10,10,4,0,27,14,41,2712
11,11,5,0,32,14,46,2712
12,12,1,1,33,15,48,2712
13,13,2,1,35,16,51,2712
14,14,0,2,35,18,53,2712
15,15,0,1,35,19,54,2712
16,16,0,0,35,19,54,2712
0,0,1,0,1,0,1,2713
1,1,0,0,1,0,1,2713
0,0,1,0,1,0,1,2714
1,1,0,0,1,0,1,2714
0,0,1,0,1,0,1,2715
1,1,0,1,1,1,2,2715
2,2,0,0,1,1,2,2715
0,0,1,0,1,0,1,2716
1,1,0,0,1,0,1,2716
0,0,1,0,1,0,1,2717
1,1,1,1,2,1,3,2717
2,2,2,1,4,2,6,2717
3,3,2,1,6,3,9,2717
4,4,5,2,11,5,16,2717
5,5,4,3,15,8,23,2717
6,6,3,2,18,10,28,2717
7,7,4,1,22,11,33,2717
8,8,2,1,24,12,36,2717
9,9,4,0,28,12,40,2717
10,10,3,1,31,13,44,2717
11,11,1,4,32,17,49,2717
12,12,1,3,33,20,53,2717
13,13,4,0,37,20,57,2717
14,14,2,0,39,20,59,2717
15,15,1,0,40,20,60,2717
16,16,1,0,41,20,61,2717
17,17,2,0,43,20,63,2717
18,18,2,0,45,20,65,2717
19,19,0,0,45,20,65,2717
0,0,1,0,1,0,1,2718
1,1,0,0,1,0,1,2718
0,0,1,0,1,0,1,2719
1,1,2,0,3,0,3,2719
2,2,2,1,5,1,6,2719
3,3,0,0,5,1,6,2719
0,0,1,0,1,0,1,2720
1,1,0,0,1,0,1,2720
0,0,1,0,1,0,1,2721
1,1,0,1,1,1,2,2721
2,2,0,0,1,1,2,2721
0,0,1,0,1,0,1,2722
1,1,0,0,1,0,1,2722
0,0,1,0,1,0,1,2723
1,1,1,0,2,0,2,2723
2,2,0,0,2,0,2,2723
0,0,1,0,1,0,1,2724
1,1,0,0,1,0,1,2724
0,0,1,0,1,0,1,2725
1,1,0,0,1,0,1,2725
0,0,1,0,1,0,1,2726
1,1,1,0,2,0,2,2726
2,2,2,0,4,0,4,2726
3,3,2,0,6,0,6,2726
4,4,1,1,7,1,8,2726
5,5,0,0,7,1,8,2726
0,0,1,0,1,0,1,2727
1,1,2,1,3,1,4,2727
2,2,1,0,4,1,5,2727
3,3,2,0,6,1,7,2727
4,4,2,0,8,1,9,2727
5,5,2,0,10,1,11,2727
6,6,0,0,10,1,11,2727
0,0,1,0,1,0,1,2728
1,1,3,0,4,0,4,2728
2,2,6,0,10,0,10,2728
3,3,3,1,13,1,14,2728
4,4,0,2,13,3,16,2728
5,5,0,1,13,4,17,2728
6,6,0,0,13,4,17,2728
0,0,1,0,1,0,1,2729
1,1,0,1,1,1,2,2729
2,2,0,0,1,1,2,2729
0,0,1,0,1,0,1,2730
1,1,2,0,3,0,3,2730
2,2,2,0,5,0,5,2730
3,3,2,1,7,1,8,2730
4,4,2,2,9,3,12,2730
5,5,3,1,12,4,16,2730
6,6,5,1,17,5,22,2730
7,7,3,3,20,8,28,2730
8,8,4,1,24,9,33,2730
9,9,3,2,27,11,38,2730
10,10,4,5,31,16,47,2730
11,11,4,2,35,18,53,2730
12,12,2,3,37,21,58,2730
13,13,2,3,39,24,63,2730
14,14,1,3,40,27,67,2730
15,15,3,2,43,29,72,2730
16,16,1,3,44,32,76,2730
17,17,2,3,46,35,81,2730
18,18,0,6,46,41,87,2730
19,19,2,5,48,46,94,2730
20,20,2,3,50,49,99,2730
21,21,4,3,54,52,106,2730
22,22,5,2,59,54,113,2730
23,23,5,2,64,56,120,2730
24,24,5,1,69,57,126,2730
25,25,7,2,76,59,135,2730
26,26,8,3,84,62,146,2730
27,27,7,4,91,66,157,2730
28,28,7,3,98,69,167,2730
29,29,4,2,102,71,173,2730
30,30,5,2,107,73,180,2730
31,31,5,1,112,74,186,2730
32,32,2,2,114,76,190,2730
33,33,4,1,118,77,195,2730
34,34,3,1,121,78,199,2730
35,35,2,1,123,79,202,2730
36,36,4,1,127,80,207,2730
37,37,4,2,131,82,213,2730
38,38,4,3,135,85,220,2730
39,39,3,1,138,86,224,2730
40,40,2,2,140,88,228,2730
41,41,1,1,141,89,230,2730
42,42,1,1,142,90,232,2730
43,43,0,0,142,90,232,2730
0,0,1,0,1,0,1,2731
1,1,1,0,2,0,2,2731
2,2,0,0,2,0,2,2731
0,0,1,0,1,0,1,2732
1,1,0,0,1,0,1,2732
0,0,1,0,1,0,1,2733
1,1,0,0,1,0,1,2733
0,0,1,0,1,0,1,2734
1,1,1,0,2,0,2,2734
2,2,2,0,4,0,4,2734
3,3,3,0,7,0,7,2734
4,4,1,0,8,0,8,2734
5,5,1,0,9,0,9,2734
6,6,1,0,10,0,10,2734
7,7,0,0,10,0,10,2734
0,0,1,0,1,0,1,2735
1,1,1,1,2,1,3,2735
2,2,0,1,2,2,4,2735
3,3,0,2,2,4,6,2735
4,4,2,1,4,5,9,2735
5,5,1,0,5,5,10,2735
6,6,0,0,5,5,10,2735
0,0,1,0,1,0,1,2736
1,1,2,0,3,0,3,2736
2,2,2,0,5,0,5,2736
3,3,0,0,5,0,5,2736
0,0,1,0,1,0,1,2737
1,1,0,0,1,0,1,2737
0,0,1,0,1,0,1,2738
1,1,1,0,2,0,2,2738
2,2,0,0,2,0,2,2738
0,0,1,0,1,0,1,2739
1,1,1,0,2,0,2,2739
2,2,1,0,3,0,3,2739
3,3,0,0,3,0,3,2739
0,0,1,0,1,0,1,2740
1,1,1,0,2,0,2,2740
2,2,0,0,2,0,2,2740
0,0,1,0,1,0,1,2741
1,1,0,0,1,0,1,2741
0,0,1,0,1,0,1,2742
1,1,1,0,2,0,2,2742
2,2,1,0,3,0,3,2742
3,3,0,0,3,0,3,2742
0,0,1,0,1,0,1,2743
1,1,0,0,1,0,1,2743
0,0,1,0,1,0,1,2744
1,1,1,0,2,0,2,2744
2,2,2,0,4,0,4,2744
3,3,1,1,5,1,6,2744
4,4,0,2,5,3,8,2744
5,5,0,0,5,3,8,2744
0,0,1,0,1,0,1,2745
1,1,0,0,1,0,1,2745
0,0,1,0,1,0,1,2746
1,1,3,0,4,0,4,2746
2,2,3,0,7,0,7,2746
3,3,1,1,8,1,9,2746
4,4,2,2,10,3,13,2746
5,5,2,0,12,3,15,2746
6,6,1,0,13,3,16,2746
7,7,0,0,13,3,16,2746
0,0,1,0,1,0,1,2747
1,1,1,1,2,1,3,2747
2,2,0,0,2,1,3,2747
0,0,1,0,1,0,1,2748
1,1,1,0,2,0,2,2748
2,2,0,0,2,0,2,2748
0,0,1,0,1,0,1,2749
1,1,0,0,1,0,1,2749
0,0,1,0,1,0,1,2750
1,1,0,0,1,0,1,2750
0,0,1,0,1,0,1,2751
1,1,0,1,1,1,2,2751
2,2,0,2,1,3,4,2751
3,3,0,1,1,4,5,2751
4,4,0,1,1,5,6,2751
5,5,0,0,1,5,6,2751
0,0,1,0,1,0,1,2752
1,1,0,0,1,0,1,2752
0,0,1,0,1,0,1,2753
1,1,1,0,2,0,2,2753
2,2,1,0,3,0,3,2753
3,3,1,0,4,0,4,2753
4,4,0,0,4,0,4,2753
0,0,1,0,1,0,1,2754
1,1,0,0,1,0,1,2754
0,0,1,0,1,0,1,2755
1,1,0,0,1,0,1,2755
0,0,1,0,1,0,1,2756
1,1,0,0,1,0,1,2756
0,0,1,0,1,0,1,2757
1,1,1,0,2,0,2,2757
2,2,0,0,2,0,2,2757
0,0,1,0,1,0,1,2758
1,1,3,1,4,1,5,2758
2,2,2,0,6,1,7,2758
3,3,0,0,6,1,7,2758
0,0,1,0,1,0,1,2759
1,1,1,0,2,0,2,2759
2,2,1,0,3,0,3,2759
3,3,1,0,4,0,4,2759
4,4,0,0,4,0,4,2759
0,0,1,0,1,0,1,2760
1,1,0,0,1,0,1,2760
0,0,1,0,1,0,1,2761
1,1,1,1,2,1,3,2761
2,2,0,0,2,1,3,2761
0,0,1,0,1,0,1,2762
1,1,1,0,2,0,2,2762
2,2,2,1,4,1,5,2762
3,3,0,3,4,4,8,2762
4,4,0,0,4,4,8,2762
0,0,1,0,1,0,1,2763
1,1,1,0,2,0,2,2763
2,2,1,1,3,1,4,2763
3,3,0,0,3,1,4,2763
0,0,1,0,1,0,1,2764
1,1,0,0,1,0,1,2764
0,0,1,0,1,0,1,2765
1,1,1,0,2,0,2,2765
2,2,0,0,2,0,2,2765
0,0,1,0,1,0,1,2766
1,1,0,2,1,2,3,2766
2,2,0,2,1,4,5,2766
3,3,0,2,1,6,7,2766
4,4,1,0,2,6,8,2766
5,5,1,0,3,6,9,2766
6,6,0,0,3,6,9,2766
0,0,1,0,1,0,1,2767
1,1,0,0,1,0,1,2767
0,0,1,0,1,0,1,2768
1,1,0,0,1,0,1,2768
0,0,1,0,1,0,1,2769
1,1,1,1,2,1,3,2769
2,2,1,1,3,2,5,2769
3,3,0,0,3,2,5,2769
0,0,1,0,1,0,1,2770
1,1,0,0,1,0,1,2770
0,0,1,0,1,0,1,2771
1,1,0,0,1,0,1,2771
0,0,1,0,1,0,1,2772
1,1,0,1,1,1,2,2772
2,2,0,0,1,1,2,2772
0,0,1,0,1,0,1,2773
1,1,0,0,1,0,1,2773
0,0,1,0,1,0,1,2774
1,1,0,0,1,0,1,2774
0,0,1,0,1,0,1,2775
1,1,0,0,1,0,1,2775
0,0,1,0,1,0,1,2776
1,1,0,0,1,0,1,2776
0,0,1,0,1,0,1,2777
1,1,0,0,1,0,1,2777
0,0,1,0,1,0,1,2778
1,1,0,0,1,0,1,2778
0,0,1,0,1,0,1,2779
1,1,0,0,1,0,1,2779
0,0,1,0,1,0,1,2780
1,1,0,0,1,0,1,2780
0,0,1,0,1,0,1,2781
1,1,0,0,1,0,1,2781
0,0,1,0,1,0,1,2782
1,1,1,1,2,1,3,2782
2,2,0,1,2,2,4,2782
3,3,0,1,2,3,5,2782
4,4,0,0,2,3,5,2782
0,0,1,0,1,0,1,2783
1,1,0,0,1,0,1,2783
0,0,1,0,1,0,1,2784
1,1,1,0,2,0,2,2784
2,2,1,0,3,0,3,2784
3,3,0,0,3,0,3,2784
0,0,1,0,1,0,1,2785
1,1,0,0,1,0,1,2785
0,0,1,0,1,0,1,2786
1,1,0,0,1,0,1,2786
0,0,1,0,1,0,1,2787
1,1,0,0,1,0,1,2787
0,0,1,0,1,0,1,2788
1,1,0,0,1,0,1,2788
0,0,1,0,1,0,1,2789
1,1,0,0,1,0,1,2789
0,0,1,0,1,0,1,2790
1,1,1,0,2,0,2,2790
2,2,0,0,2,0,2,2790
0,0,1,0,1,0,1,2791
1,1,2,0,3,0,3,2791
2,2,5,0,8,0,8,2791
3,3,3,0,11,0,11,2791
4,4,2,0,13,0,13,2791
5,5,2,0,15,0,15,2791
6,6,1,0,16,0,16,2791
7,7,2,0,18,0,18,2791
8,8,0,0,18,0,18,2791
0,0,1,0,1,0,1,2792
1,1,1,0,2,0,2,2792
2,2,2,0,4,0,4,2792
3,3,2,0,6,0,6,2792
4,4,2,2,8,2,10,2792
5,5,2,0,10,2,12,2792
6,6,3,0,13,2,15,2792
7,7,2,1,15,3,18,2792
8,8,4,1,19,4,23,2792
9,9,5,1,24,5,29,2792
10,10,3,0,27,5,32,2792
11,11,0,2,27,7,34,2792
12,12,0,2,27,9,36,2792
13,13,0,3,27,12,39,2792
14,14,0,3,27,15,42,2792
15,15,1,2,28,17,45,2792
16,16,1,3,29,20,49,2792
17,17,2,2,31,22,53,2792
18,18,1,0,32,22,54,2792
19,19,1,0,33,22,55,2792
20,20,0,0,33,22,55,2792
0,0,1,0,1,0,1,2793
1,1,0,0,1,0,1,2793
0,0,1,0,1,0,1,2794
1,1,1,0,2,0,2,2794
2,2,0,1,2,1,3,2794
3,3,0,0,2,1,3,2794
0,0,1,0,1,0,1,2795
1,1,1,0,2,0,2,2795
2,2,1,0,3,0,3,2795
3,3,1,0,4,0,4,2795
4,4,1,0,5,0,5,2795
5,5,0,1,5,1,6,2795
6,6,0,1,5,2,7,2795
7,7,0,0,5,2,7,2795
0,0,1,0,1,0,1,2796
1,1,3,0,4,0,4,2796
2,2,1,0,5,0,5,2796
3,3,0,0,5,0,5,2796
0,0,1,0,1,0,1,2797
1,1,0,1,1,1,2,2797
2,2,0,0,1,1,2,2797
0,0,1,0,1,0,1,2798
1,1,0,0,1,0,1,2798
0,0,1,0,1,0,1,2799
1,1,0,0,1,0,1,2799
0,0,1,0,1,0,1,2800
1,1,2,0,3,0,3,2800
2,2,2,0,5,0,5,2800
3,3,2,0,7,0,7,2800
4,4,1,0,8,0,8,2800
5,5,1,0,9,0,9,2800
6,6,0,1,9,1,10,2800
7,7,0,3,9,4,13,2800
8,8,2,2,11,6,17,2800
9,9,2,1,13,7,20,2800
10,10,1,1,14,8,22,2800
11,11,0,0,14,8,22,2800
0,0,1,0,1,0,1,2801
1,1,0,0,1,0,1,2801
0,0,1,0,1,0,1,2802
1,1,0,0,1,0,1,2802
0,0,1,0,1,0,1,2803
1,1,1,0,2,0,2,2803
2,2,0,0,2,0,2,2803
0,0,1,0,1,0,1,2804
1,1,1,0,2,0,2,2804
2,2,1,1,3,1,4,2804
3,3,1,0,4,1,5,2804
4,4,0,0,4,1,5,2804
0,0,1,0,1,0,1,2805
1,1,4,0,5,0,5,2805
2,2,5,1,10,1,11,2805
3,3,2,3,12,4,16,2805
4,4,1,4,13,8,21,2805
5,5,1,2,14,10,24,2805
6,6,0,1,14,11,25,2805
7,7,1,0,15,11,26,2805
8,8,1,0,16,11,27,2805
9,9,0,0,16,11,27,2805
0,0,1,0,1,0,1,2806
1,1,1,1,2,1,3,2806
2,2,0,0,2,1,3,2806
0,0,1,0,1,0,1,2807
1,1,0,0,1,0,1,2807
0,0,1,0,1,0,1,2808
1,1,0,0,1,0,1,2808
0,0,1,0,1,0,1,2809
1,1,0,0,1,0,1,2809
0,0,1,0,1,0,1,2810
1,1,1,0,2,0,2,2810
2,2,0,0,2,0,2,2810
0,0,1,0,1,0,1,2811
1,1,0,0,1,0,1,2811
0,0,1,0,1,0,1,2812
1,1,1,0,2,0,2,2812
2,2,0,0,2,0,2,2812
0,0,1,0,1,0,1,2813
1,1,2,0,3,0,3,2813
2,2,3,0,6,0,6,2813
3,3,3,1,9,1,10,2813
4,4,2,2,11,3,14,2813
5,5,1,1,12,4,16,2813
6,6,0,3,12,7,19,2813
7,7,1,3,13,10,23,2813
8,8,0,5,13,15,28,2813
9,9,0,3,13,18,31,2813
10,10,1,2,14,20,34,2813
11,11,1,0,15,20,35,2813
12,12,0,0,15,20,35,2813
0,0,1,0,1,0,1,2814
1,1,1,0,2,0,2,2814
2,2,0,0,2,0,2,2814
0,0,1,0,1,0,1,2815
1,1,0,0,1,0,1,2815
0,0,1,0,1,0,1,2816
1,1,2,0,3,0,3,2816
2,2,1,1,4,1,5,2816
3,3,3,2,7,3,10,2816
4,4,3,3,10,6,16,2816
5,5,0,3,10,9,19,2816
6,6,1,1,11,10,21,2816
7,7,2,2,13,12,25,2816
8,8,2,0,15,12,27,2816
9,9,1,0,16,12,28,2816
10,10,0,0,16,12,28,2816
0,0,1,0,1,0,1,2817
1,1,0,1,1,1,2,2817
2,2,0,1,1,2,3,2817
3,3,1,2,2,4,6,2817
4,4,0,3,2,7,9,2817
5,5,0,1,2,8,10,2817
6,6,0,2,2,10,12,2817
7,7,0,0,2,10,12,2817
0,0,1,0,1,0,1,2818
1,1,1,0,2,0,2,2818
2,2,1,0,3,0,3,2818
3,3,0,0,3,0,3,2818
0,0,1,0,1,0,1,2819
1,1,1,0,2,0,2,2819
2,2,1,0,3,0,3,2819
3,3,0,0,3,0,3,2819
0,0,1,0,1,0,1,2820
1,1,0,1,1,1,2,2820
2,2,0,0,1,1,2,2820
0,0,1,0,1,0,1,2821
1,1,1,0,2,0,2,2821
2,2,1,0,3,0,3,2821
3,3,2,1,5,1,6,2821
4,4,1,2,6,3,9,2821
5,5,2,1,8,4,12,2821
6,6,2,1,10,5,15,2821
7,7,2,2,12,7,19,2821
8,8,1,2,13,9,22,2821
9,9,1,4,14,13,27,2821
10,10,1,6,15,19,34,2821
11,11,2,10,17,29,46,2821
12,12,0,7,17,36,53,2821
13,13,2,4,19,40,59,2821
14,14,3,2,22,42,64,2821
15,15,4,0,26,42,68,2821
16,16,6,1,32,43,75,2821
17,17,5,2,37,45,82,2821
18,18,4,2,41,47,88,2821
19,19,4,2,45,49,94,2821
20,20,7,1,52,50,102,2821
21,21,4,2,56,52,108,2821
22,22,2,3,58,55,113,2821
23,23,3,7,61,62,123,2821
24,24,5,6,66,68,134,2821
25,25,11,3,77,71,148,2821
26,26,10,2,87,73,160,2821
27,27,7,4,94,77,171,2821
28,28,6,7,100,84,184,2821
29,29,6,8,106,92,198,2821
30,30,8,9,114,101,215,2821
31,31,15,5,129,106,235,2821
32,32,16,7,145,113,258,2821
33,33,6,4,151,117,268,2821
34,34,6,6,157,123,280,2821
35,35,5,9,162,132,294,2821
36,36,2,5,164,137,301,2821
37,37,1,4,165,141,306,2821
38,38,4,1,169,142,311,2821
39,39,4,1,173,143,316,2821
40,40,3,2,176,145,321,2821
41,41,5,3,181,148,329,2821
42,42,7,2,188,150,338,2821
43,43,8,4,196,154,350,2821
44,44,10,1,206,155,361,2821
45,45,10,1,216,156,372,2821
46,46,8,3,224,159,383,2821
47,47,6,6,230,165,395,2821
48,48,3,5,233,170,403,2821
49,49,4,3,237,173,410,2821
50,50,4,3,241,176,417,2821
51,51,3,3,244,179,423,2821
52,52,1,6,245,185,430,2821
53,53,3,5,248,190,438,2821
54,54,4,11,252,201,453,2821
55,55,4,7,256,208,464,2821
56,56,3,7,259,215,474,2821
57,57,5,5,264,220,484,2821
58,58,8,3,272,223,495,2821
59,59,6,2,278,225,503,2821
60,60,8,2,286,227,513,2821
61,61,9,2,295,229,524,2821
62,62,8,1,303,230,533,2821
63,63,9,3,312,233,545,2821
64,64,6,4,318,237,555,2821
65,65,5,6,323,243,566,2821
66,66,7,8,330,251,581,2821
67,67,9,4,339,255,594,2821
68,68,13,4,352,259,611,2821
69,69,11,6,363,265,628,2821
70,70,11,6,374,271,645,2821
71,71,6,7,380,278,658,2821
72,72,4,2,384,280,664,2821
73,73,2,0,386,280,666,2821
74,74,2,0,388,280,668,2821
75,75,1,1,389,281,670,2821
76,76,1,0,390,281,671,2821
77,77,0,0,390,281,671,2821
0,0,1,0,1,0,1,2822
1,1,2,0,3,0,3,2822
2,2,3,0,6,0,6,2822
3,3,1,0,7,0,7,2822
4,4,0,0,7,0,7,2822
0,0,1,0,1,0,1,2823
1,1,1,0,2,0,2,2823
2,2,1,1,3,1,4,2823
3,3,3,0,6,1,7,2823
4,4,3,1,9,2,11,2823
5,5,0,2,9,4,13,2823
6,6,0,2,9,6,15,2823
7,7,0,2,9,8,17,2823
8,8,0,3,9,11,20,2823
9,9,0,6,9,17,26,2823
10,10,0,7,9,24,33,2823
11,11,1,4,10,28,38,2823
12,12,1,1,11,29,40,2823
13,13,0,4,11,33,44,2823
14,14,0,4,11,37,48,2823
15,15,2,5,13,42,55,2823
16,16,1,1,14,43,57,2823
17,17,1,1,15,44,59,2823
18,18,1,0,16,44,60,2823
19,19,0,0,16,44,60,2823
0,0,1,0,1,0,1,2824
1,1,1,0,2,0,2,2824
2,2,1,0,3,0,3,2824
3,3,1,0,4,0,4,2824
4,4,1,0,5,0,5,2824
5,5,0,0,5,0,5,2824
0,0,1,0,1,0,1,2825
1,1,0,1,1,1,2,2825
2,2,0,0,1,1,2,2825
0,0,1,0,1,0,1,2826
1,1,2,0,3,0,3,2826
2,2,1,1,4,1,5,2826
3,3,0,0,4,1,5,2826
0,0,1,0,1,0,1,2827
1,1,0,0,1,0,1,2827
0,0,1,0,1,0,1,2828
1,1,0,0,1,0,1,2828
0,0,1,0,1,0,1,2829
1,1,1,0,2,0,2,2829
2,2,1,0,3,0,3,2829
3,3,0,0,3,0,3,2829
0,0,1,0,1,0,1,2830
1,1,1,1,2,1,3,2830
2,2,2,1,4,2,6,2830
3,3,1,0,5,2,7,2830
4,4,1,0,6,2,8,2830
5,5,0,1,6,3,9,2830
6,6,0,0,6,3,9,2830
0,0,1,0,1,0,1,2831
1,1,1,0,2,0,2,2831
2,2,1,0,3,0,3,2831
3,3,0,0,3,0,3,2831
0,0,1,0,1,0,1,2832
1,1,0,0,1,0,1,2832
0,0,1,0,1,0,1,2833
1,1,0,0,1,0,1,2833
0,0,1,0,1,0,1,2834
1,1,0,0,1,0,1,2834
0,0,1,0,1,0,1,2835
1,1,0,0,1,0,1,2835
0,0,1,0,1,0,1,2836
1,1,1,1,2,1,3,2836
2,2,1,1,3,2,5,2836
3,3,2,0,5,2,7,2836
4,4,3,0,8,2,10,2836
5,5,4,1,12,3,15,2836
6,6,7,2,19,5,24,2836
7,7,4,9,23,14,37,2836
8,8,6,6,29,20,49,2836
9,9,9,9,38,29,67,2836
10,10,6,10,44,39,83,2836
11,11,6,5,50,44,94,2836
12,12,3,5,53,49,102,2836
13,13,6,3,59,52,111,2836
14,14,2,2,61,54,115,2836
15,15,1,0,62,54,116,2836
16,16,0,1,62,55,117,2836
17,17,0,1,62,56,118,2836
18,18,0,1,62,57,119,2836
19,19,0,0,62,57,119,2836
0,0,1,0,1,0,1,2837
1,1,0,0,1,0,1,2837
0,0,1,0,1,0,1,2838
1,1,2,0,3,0,3,2838
2,2,3,0,6,0,6,2838
3,3,0,4,6,4,10,2838
4,4,0,7,6,11,17,2838
5,5,1,5,7,16,23,2838
6,6,1,3,8,19,27,2838
7,7,0,4,8,23,31,2838
8,8,1,2,9,25,34,2838
9,9,1,2,10,27,37,2838
10,10,0,2,10,29,39,2838
11,11,1,1,11,30,41,2838
12,12,0,2,11,32,43,2838
13,13,1,0,12,32,44,2838
14,14,1,0,13,32,45,2838
15,15,2,0,15,32,47,2838
16,16,1,0,16,32,48,2838
17,17,0,0,16,32,48,2838
0,0,1,0,1,0,1,2839
1,1,1,0,2,0,2,2839
2,2,1,0,3,0,3,2839
3,3,1,0,4,0,4,2839
4,4,0,1,4,1,5,2839
5,5,1,1,5,2,7,2839
6,6,1,0,6,2,8,2839
7,7,2,0,8,2,10,2839
8,8,2,0,10,2,12,2839
9,9,4,0,14,2,16,2839
10,10,5,0,19,2,21,2839
11,11,3,0,22,2,24,2839
12,12,3,0,25,2,27,2839
13,13,2,1,27,3,30,2839
14,14,0,3,27,6,33,2839
15,15,1,1,28,7,35,2839
16,16,1,1,29,8,37,2839
17,17,0,3,29,11,40,2839
18,18,0,1,29,12,41,2839
19,19,0,0,29,12,41,2839
0,0,1,0,1,0,1,2840
1,1,0,0,1,0,1,2840
0,0,1,0,1,0,1,2841
1,1,1,0,2,0,2,2841
2,2,0,0,2,0,2,2841
0,0,1,0,1,0,1,2842
1,1,0,0,1,0,1,2842
0,0,1,0,1,0,1,2843
1,1,2,0,3,0,3,2843
2,2,1,1,4,1,5,2843
3,3,3,0,7,1,8,2843
4,4,1,1,8,2,10,2843
5,5,1,0,9,2,11,2843
6,6,0,0,9,2,11,2843
0,0,1,0,1,0,1,2844
1,1,1,0,2,0,2,2844
2,2,2,0,4,0,4,2844
3,3,2,2,6,2,8,2844
4,4,0,1,6,3,9,2844
5,5,0,0,6,3,9,2844
0,0,1,0,1,0,1,2845
1,1,1,0,2,0,2,2845
2,2,0,0,2,0,2,2845
0,0,1,0,1,0,1,2846
1,1,1,0,2,0,2,2846
2,2,0,0,2,0,2,2846
0,0,1,0,1,0,1,2847
1,1,2,0,3,0,3,2847
2,2,3,0,6,0,6,2847
3,3,4,0,10,0,10,2847
4,4,5,0,15,0,15,2847
5,5,7,1,22,1,23,2847
6,6,7,5,29,6,35,2847
7,7,8,5,37,11,48,2847
8,8,7,5,44,16,60,2847
9,9,5,6,49,22,71,2847
10,10,4,5,53,27,80,2847
11,11,2,9,55,36,91,2847
12,12,5,10,60,46,106,2847
13,13,3,9,63,55,118,2847
14,14,3,16,66,71,137,2847
15,15,6,10,72,81,153,2847
16,16,8,10,80,91,171,2847
17,17,10,12,90,103,193,2847
18,18,8,11,98,114,212,2847
19,19,10,12,108,126,234,2847
20,20,9,15,117,141,258,2847
21,21,8,8,125,149,274,2847
22,22,10,2,135,151,286,2847
23,23,6,1,141,152,293,2847
24,24,2,1,143,153,296,2847
25,25,1,0,144,153,297,2847
26,26,1,0,145,153,298,2847
27,27,1,1,146,154,300,2847
28,28,0,1,146,155,301,2847
29,29,0,1,146,156,302,2847
30,30,0,1,146,157,303,2847
31,31,0,0,146,157,303,2847
0,0,1,0,1,0,1,2848
1,1,4,0,5,0,5,2848
2,2,4,0,9,0,9,2848
3,3,2,0,11,0,11,2848
4,4,0,0,11,0,11,2848
0,0,1,0,1,0,1,2849
1,1,0,0,1,0,1,2849
0,0,1,0,1,0,1,2850
1,1,0,0,1,0,1,2850
0,0,1,0,1,0,1,2851
1,1,0,2,1,2,3,2851
2,2,0,2,1,4,5,2851
3,3,1,0,2,4,6,2851
4,4,1,0,3,4,7,2851
5,5,2,1,5,5,10,2851
6,6,2,1,7,6,13,2851
7,7,1,0,8,6,14,2851
8,8,0,0,8,6,14,2851
0,0,1,0,1,0,1,2852
1,1,0,0,1,0,1,2852
0,0,1,0,1,0,1,2853
1,1,0,0,1,0,1,2853
0,0,1,0,1,0,1,2854
1,1,0,1,1,1,2,2854
2,2,0,3,1,4,5,2854
3,3,1,2,2,6,8,2854
4,4,0,1,2,7,9,2854
5,5,0,1,2,8,10,2854
6,6,1,1,3,9,12,2854
7,7,1,1,4,10,14,2854
8,8,1,0,5,10,15,2854
9,9,0,0,5,10,15,2854
0,0,1,0,1,0,1,2855
1,1,0,0,1,0,1,2855
0,0,1,0,1,0,1,2856
1,1,0,1,1,1,2,2856
2,2,0,0,1,1,2,2856
0,0,1,0,1,0,1,2857
1,1,0,0,1,0,1,2857
0,0,1,0,1,0,1,2858
1,1,0,0,1,0,1,2858
0,0,1,0,1,0,1,2859
1,1,0,0,1,0,1,2859
0,0,1,0,1,0,1,2860
1,1,0,1,1,1,2,2860
2,2,0,0,1,1,2,2860
0,0,1,0,1,0,1,2861
1,1,0,0,1,0,1,2861
0,0,1,0,1,0,1,2862
1,1,1,1,2,1,3,2862
2,2,2,0,4,1,5,2862
3,3,1,0,5,1,6,2862
4,4,0,2,5,3,8,2862
5,5,0,1,5,4,9,2862
6,6,0,1,5,5,10,2862
7,7,1,0,6,5,11,2862
8,8,3,0,9,5,14,2862
9,9,6,1,15,6,21,2862
10,10,6,1,21,7,28,2862
11,11,6,2,27,9,36,2862
12,12,5,5,32,14,46,2862
13,13,3,4,35,18,53,2862
14,14,3,3,38,21,59,2862
15,15,5,2,43,23,66,2862
16,16,4,3,47,26,73,2862
17,17,5,1,52,27,79,2862
18,18,3,2,55,29,84,2862
19,19,1,1,56,30,86,2862
20,20,0,0,56,30,86,2862
0,0,1,0,1,0,1,2863
1,1,2,0,3,0,3,2863
2,2,0,1,3,1,4,2863
3,3,0,0,3,1,4,2863
0,0,1,0,1,0,1,2864
1,1,0,0,1,0,1,2864
0,0,1,0,1,0,1,2865
1,1,1,0,2,0,2,2865
2,2,0,1,2,1,3,2865
3,3,0,0,2,1,3,2865
0,0,1,0,1,0,1,2866
1,1,0,0,1,0,1,2866
0,0,1,0,1,0,1,2867
1,1,0,0,1,0,1,2867
0,0,1,0,1,0,1,2868
1,1,0,0,1,0,1,2868
0,0,1,0,1,0,1,2869
1,1,0,0,1,0,1,2869
0,0,1,0,1,0,1,2870
1,1,1,1,2,1,3,2870
2,2,0,1,2,2,4,2870
3,3,0,0,2,2,4,2870
0,0,1,0,1,0,1,2871
1,1,2,0,3,0,3,2871
2,2,4,0,7,0,7,2871
3,3,3,0,10,0,10,2871
4,4,2,2,12,2,14,2871
5,5,1,0,13,2,15,2871
6,6,0,1,13,3,16,2871
7,7,0,3,13,6,19,2871
8,8,2,1,15,7,22,2871
9,9,2,2,17,9,26,2871
10,10,3,2,20,11,31,2871
11,11,4,1,24,12,36,2871
12,12,3,2,27,14,41,2871
13,13,1,1,28,15,43,2871
14,14,2,1,30,16,46,2871
15,15,1,3,31,19,50,2871
16,16,1,3,32,22,54,2871
17,17,2,3,34,25,59,2871
18,18,1,2,35,27,62,2871
19,19,0,3,35,30,65,2871
20,20,1,1,36,31,67,2871
21,21,0,0,36,31,67,2871
0,0,1,0,1,0,1,2872
1,1,0,1,1,1,2,2872
2,2,0,0,1,1,2,2872
0,0,1,0,1,0,1,2873
1,1,0,0,1,0,1,2873
0,0,1,0,1,0,1,2874
1,1,2,0,3,0,3,2874
2,2,2,0,5,0,5,2874
3,3,3,0,8,0,8,2874
4,4,2,2,10,2,12,2874
5,5,2,2,12,4,16,2874
6,6,1,0,13,4,17,2874
7,7,1,0,14,4,18,2874
8,8,2,1,16,5,21,2874
9,9,2,1,18,6,24,2874
10,10,2,2,20,8,28,2874
11,11,2,1,22,9,31,2874
12,12,1,1,23,10,33,2874
13,13,0,1,23,11,34,2874
14,14,0,2,23,13,36,2874
15,15,1,1,24,14,38,2874
16,16,1,2,25,16,41,2874
17,17,2,0,27,16,43,2874
18,18,1,0,28,16,44,2874
19,19,0,0,28,16,44,2874
0,0,1,0,1,0,1,2875
1,1,1,0,2,0,2,2875
2,2,3,1,5,1,6,2875
3,3,2,0,7,1,8,2875
4,4,1,0,8,1,9,2875
5,5,2,0,10,1,11,2875
6,6,1,0,11,1,12,2875
7,7,1,1,12,2,14,2875
8,8,1,1,13,3,16,2875
9,9,0,1,13,4,17,2875
10,10,0,1,13,5,18,2875
11,11,0,0,13,5,18,2875
0,0,1,0,1,0,1,2876
1,1,0,0,1,0,1,2876
0,0,1,0,1,0,1,2877
1,1,0,0,1,0,1,2877
0,0,1,0,1,0,1,2878
1,1,0,0,1,0,1,2878
0,0,1,0,1,0,1,2879
1,1,1,0,2,0,2,2879
2,2,1,0,3,0,3,2879
3,3,0,0,3,0,3,2879
0,0,1,0,1,0,1,2880
1,1,0,0,1,0,1,2880
0,0,1,0,1,0,1,2881
1,1,2,0,3,0,3,2881
2,2,4,1,7,1,8,2881
3,3,6,3,13,4,17,2881
4,4,4,5,17,9,26,2881
5,5,2,5,19,14,33,2881
6,6,0,1,19,15,34,2881
7,7,0,1,19,16,35,2881
8,8,0,0,19,16,35,2881
0,0,1,0,1,0,1,2882
1,1,1,0,2,0,2,2882
2,2,1,0,3,0,3,2882
3,3,1,0,4,0,4,2882
4,4,1,0,5,0,5,2882
5,5,1,0,6,0,6,2882
6,6,2,0,8,0,8,2882
7,7,1,0,9,0,9,2882
8,8,0,0,9,0,9,2882
0,0,1,0,1,0,1,2883
1,1,1,0,2,0,2,2883
2,2,0,0,2,0,2,2883
0,0,1,0,1,0,1,2884
1,1,0,0,1,0,1,2884
0,0,1,0,1,0,1,2885
1,1,2,0,3,0,3,2885
2,2,0,0,3,0,3,2885
0,0,1,0,1,0,1,2886
1,1,1,2,2,2,4,2886
2,2,1,1,3,3,6,2886
3,3,1,1,4,4,8,2886
4,4,1,1,5,5,10,2886
5,5,0,0,5,5,10,2886
0,0,1,0,1,0,1,2887
1,1,0,2,1,2,3,2887
2,2,1,1,2,3,5,2887
3,3,0,0,2,3,5,2887
0,0,1,0,1,0,1,2888
1,1,3,0,4,0,4,2888
2,2,4,0,8,0,8,2888
3,3,3,3,11,3,14,2888
4,4,1,5,12,8,20,2888
5,5,0,2,12,10,22,2888
6,6,1,2,13,12,25,2888
7,7,0,1,13,13,26,2888
8,8,1,1,14,14,28,2888
9,9,2,1,16,15,31,2888
10,10,6,2,22,17,39,2888
11,11,8,2,30,19,49,2888
12,12,4,2,34,21,55,2888
13,13,1,2,35,23,58,2888
14,14,1,0,36,23,59,2888
15,15,1,0,37,23,60,2888
16,16,0,0,37,23,60,2888
0,0,1,0,1,0,1,2889
1,1,1,0,2,0,2,2889
2,2,3,0,5,0,5,2889
3,3,0,0,5,0,5,2889
0,0,1,0,1,0,1,2890
1,1,0,0,1,0,1,2890
0,0,1,0,1,0,1,2891
1,1,1,1,2,1,3,2891
2,2,1,1,3,2,5,2891
3,3,3,1,6,3,9,2891
4,4,1,0,7,3,10,2891
5,5,2,0,9,3,12,2891
6,6,2,0,11,3,14,2891
7,7,0,0,11,3,14,2891
0,0,1,0,1,0,1,2892
1,1,0,0,1,0,1,2892
0,0,1,0,1,0,1,2893
1,1,0,0,1,0,1,2893
0,0,1,0,1,0,1,2894
1,1,1,0,2,0,2,2894
2,2,0,0,2,0,2,2894
0,0,1,0,1,0,1,2895
1,1,1,0,2,0,2,2895
2,2,1,0,3,0,3,2895
3,3,0,0,3,0,3,2895
0,0,1,0,1,0,1,2896
1,1,1,1,2,1,3,2896
2,2,1,0,3,1,4,2896
3,3,1,0,4,1,5,2896
4,4,0,1,4,2,6,2896
5,5,0,3,4,5,9,2896
6,6,1,5,5,10,15,2896
7,7,3,6,8,16,24,2896
8,8,2,9,10,25,35,2896
9,9,3,6,13,31,44,2896
10,10,3,4,16,35,51,2896
11,11,7,5,23,40,63,2896
12,12,5,4,28,44,72,2896
13,13,3,1,31,45,76,2896
14,14,3,1,34,46,80,2896
15,15,1,0,35,46,81,2896
16,16,1,1,36,47,83,2896
17,17,1,1,37,48,85,2896
18,18,0,1,37,49,86,2896
19,19,0,2,37,51,88,2896
20,20,0,1,37,52,89,2896
21,21,0,2,37,54,91,2896
22,22,2,0,39,54,93,2896
23,23,0,0,39,54,93,2896
0,0,1,0,1,0,1,2897
1,1,2,0,3,0,3,2897
2,2,1,0,4,0,4,2897
3,3,1,0,5,0,5,2897
4,4,2,0,7,0,7,2897
5,5,2,0,9,0,9,2897
6,6,5,2,14,2,16,2897
7,7,5,2,19,4,23,2897
8,8,1,2,20,6,26,2897
9,9,2,0,22,6,28,2897
10,10,1,0,23,6,29,2897
11,11,3,0,26,6,32,2897
12,12,4,0,30,6,36,2897
13,13,5,1,35,7,42,2897
14,14,5,1,40,8,48,2897
15,15,6,3,46,11,57,2897
16,16,6,2,52,13,65,2897
17,17,3,0,55,13,68,2897
18,18,1,2,56,15,71,2897
19,19,1,5,57,20,77,2897
20,20,1,4,58,24,82,2897
21,21,2,4,60,28,88,2897
22,22,4,1,64,29,93,2897
23,23,4,1,68,30,98,2897
24,24,4,1,72,31,103,2897
25,25,5,0,77,31,108,2897
26,26,1,1,78,32,110,2897
27,27,0,3,78,35,113,2897
28,28,0,0,78,35,113,2897
0,0,1,0,1,0,1,2898
1,1,0,1,1,1,2,2898
2,2,0,3,1,4,5,2898
3,3,1,3,2,7,9,2898
4,4,2,3,4,10,14,2898
5,5,4,2,8,12,20,2898
6,6,4,1,12,13,25,2898
7,7,4,2,16,15,31,2898
8,8,3,2,19,17,36,2898
9,9,0,1,19,18,37,2898
10,10,1,0,20,18,38,2898
11,11,0,1,20,19,39,2898
12,12,0,0,20,19,39,2898
0,0,1,0,1,0,1,2899
1,1,0,0,1,0,1,2899
0,0,1,0,1,0,1,2900
1,1,1,1,2,1,3,2900
2,2,1,1,3,2,5,2900
3,3,0,0,3,2,5,2900
0,0,1,0,1,0,1,2901
1,1,0,0,1,0,1,2901
0,0,1,0,1,0,1,2902
1,1,2,0,3,0,3,2902
2,2,0,0,3,0,3,2902
0,0,1,0,1,0,1,2903
1,1,0,1,1,1,2,2903
2,2,0,0,1,1,2,2903
0,0,1,0,1,0,1,2904
1,1,1,0,2,0,2,2904
2,2,1,0,3,0,3,2904
3,3,0,0,3,0,3,2904
0,0,1,0,1,0,1,2905
1,1,3,0,4,0,4,2905
2,2,1,1,5,1,6,2905
3,3,0,0,5,1,6,2905
0,0,1,0,1,0,1,2906
1,1,1,0,2,0,2,2906
2,2,1,0,3,0,3,2906
3,3,1,0,4,0,4,2906
4,4,0,0,4,0,4,2906
0,0,1,0,1,0,1,2907
1,1,0,0,1,0,1,2907
0,0,1,0,1,0,1,2908
1,1,2,0,3,0,3,2908
2,2,0,0,3,0,3,2908
0,0,1,0,1,0,1,2909
1,1,0,0,1,0,1,2909
0,0,1,0,1,0,1,2910
1,1,1,0,2,0,2,2910
2,2,1,0,3,0,3,2910
3,3,1,0,4,0,4,2910
4,4,1,0,5,0,5,2910
5,5,2,0,7,0,7,2910
6,6,1,0,8,0,8,2910
7,7,1,1,9,1,10,2910
8,8,1,1,10,2,12,2910
9,9,1,1,11,3,14,2910
10,10,1,0,12,3,15,2910
11,11,1,0,13,3,16,2910
12,12,0,1,13,4,17,2910
13,13,0,0,13,4,17,2910
0,0,1,0,1,0,1,2911
1,1,3,0,4,0,4,2911
2,2,0,0,4,0,4,2911
0,0,1,0,1,0,1,2912
1,1,0,0,1,0,1,2912
0,0,1,0,1,0,1,2913
1,1,1,0,2,0,2,2913
2,2,0,0,2,0,2,2913
0,0,1,0,1,0,1,2914
1,1,0,0,1,0,1,2914
0,0,1,0,1,0,1,2915
1,1,0,0,1,0,1,2915
0,0,1,0,1,0,1,2916
1,1,1,1,2,1,3,2916
2,2,2,2,4,3,7,2916
3,3,1,1,5,4,9,2916
4,4,0,0,5,4,9,2916
0,0,1,0,1,0,1,2917
1,1,2,0,3,0,3,2917
2,2,4,2,7,2,9,2917
3,3,3,2,10,4,14,2917
4,4,4,1,14,5,19,2917
5,5,5,2,19,7,26,2917
6,6,3,5,22,12,34,2917
7,7,1,0,23,12,35,2917
8,8,1,0,24,12,36,2917
9,9,1,0,25,12,37,2917
10,10,1,0,26,12,38,2917
11,11,2,0,28,12,40,2917
12,12,0,0,28,12,40,2917
0,0,1,0,1,0,1,2918
1,1,1,2,2,2,4,2918
2,2,2,3,4,5,9,2918
3,3,2,1,6,6,12,2918
4,4,2,0,8,6,14,2918
5,5,2,0,10,6,16,2918
6,6,1,0,11,6,17,2918
7,7,0,0,11,6,17,2918
0,0,1,0,1,0,1,2919
1,1,1,0,2,0,2,2919
2,2,3,0,5,0,5,2919
3,3,2,2,7,2,9,2919
4,4,3,2,10,4,14,2919
5,5,1,1,11,5,16,2919
6,6,0,1,11,6,17,2919
7,7,0,2,11,8,19,2919
8,8,0,1,11,9,20,2919
9,9,0,1,11,10,21,2919
10,10,1,0,12,10,22,2919
11,11,0,1,12,11,23,2919
12,12,1,0,13,11,24,2919
13,13,0,1,13,12,25,2919
14,14,0,0,13,12,25,2919
0,0,1,0,1,0,1,2920
1,1,0,1,1,1,2,2920
2,2,0,2,1,3,4,2920
3,3,0,1,1,4,5,2920
4,4,0,1,1,5,6,2920
5,5,0,1,1,6,7,2920
6,6,0,0,1,6,7,2920
0,0,1,0,1,0,1,2921
1,1,3,0,4,0,4,2921
2,2,0,1,4,1,5,2921
3,3,0,0,4,1,5,2921
0,0,1,0,1,0,1,2922
1,1,0,0,1,0,1,2922
0,0,1,0,1,0,1,2923
1,1,0,1,1,1,2,2923
2,2,0,1,1,2,3,2923
3,3,0,1,1,3,4,2923
4,4,0,4,1,7,8,2923
5,5,1,3,2,10,12,2923
6,6,0,3,2,13,15,2923
7,7,1,0,3,13,16,2923
8,8,0,0,3,13,16,2923
0,0,1,0,1,0,1,2924
1,1,0,0,1,0,1,2924
0,0,1,0,1,0,1,2925
1,1,0,0,1,0,1,2925
0,0,1,0,1,0,1,2926
1,1,0,1,1,1,2,2926
2,2,0,1,1,2,3,2926
3,3,2,1,3,3,6,2926
4,4,3,1,6,4,10,2926
5,5,1,0,7,4,11,2926
6,6,0,0,7,4,11,2926
0,0,1,0,1,0,1,2927
1,1,0,0,1,0,1,2927
0,0,1,0,1,0,1,2928
1,1,0,0,1,0,1,2928
0,0,1,0,1,0,1,2929
1,1,2,0,3,0,3,2929
2,2,0,0,3,0,3,2929
0,0,1,0,1,0,1,2930
1,1,0,0,1,0,1,2930
0,0,1,0,1,0,1,2931
1,1,1,0,2,0,2,2931
2,2,0,1,2,1,3,2931
3,3,0,0,2,1,3,2931
0,0,1,0,1,0,1,2932
1,1,1,0,2,0,2,2932
2,2,0,0,2,0,2,2932
0,0,1,0,1,0,1,2933
1,1,1,0,2,0,2,2933
2,2,0,0,2,0,2,2933
0,0,1,0,1,0,1,2934
1,1,0,1,1,1,2,2934
2,2,1,0,2,1,3,2934
3,3,0,0,2,1,3,2934
0,0,1,0,1,0,1,2935
1,1,1,0,2,0,2,2935
2,2,0,0,2,0,2,2935
0,0,1,0,1,0,1,2936
1,1,1,0,2,0,2,2936
2,2,0,0,2,0,2,2936
0,0,1,0,1,0,1,2937
1,1,0,0,1,0,1,2937
0,0,1,0,1,0,1,2938
1,1,1,0,2,0,2,2938
2,2,1,0,3,0,3,2938
3,3,0,1,3,1,4,2938
4,4,0,0,3,1,4,2938
0,0,1,0,1,0,1,2939
1,1,1,0,2,0,2,2939
2,2,0,1,2,1,3,2939
3,3,0,1,2,2,4,2939
4,4,0,1,2,3,5,2939
5,5,1,1,3,4,7,2939
6,6,0,2,3,6,9,2939
7,7,0,0,3,6,9,2939
0,0,1,0,1,0,1,2940
1,1,1,0,2,0,2,2940
2,2,3,0,5,0,5,2940
3,3,3,1,8,1,9,2940
4,4,2,1,10,2,12,2940
5,5,1,2,11,4,15,2940
6,6,2,1,13,5,18,2940
7,7,2,1,15,6,21,2940
8,8,3,0,18,6,24,2940
9,9,0,0,18,6,24,2940
0,0,1,0,1,0,1,2941
1,1,1,0,2,0,2,2941
2,2,2,1,4,1,5,2941
3,3,2,2,6,3,9,2941
4,4,4,0,10,3,13,2941
5,5,4,2,14,5,19,2941
6,6,0,3,14,8,22,2941
7,7,1,0,15,8,23,2941
8,8,0,0,15,8,23,2941
0,0,1,0,1,0,1,2942
1,1,0,1,1,1,2,2942
2,2,0,2,1,3,4,2942
3,3,1,1,2,4,6,2942
4,4,0,1,2,5,7,2942
5,5,0,1,2,6,8,2942
6,6,0,1,2,7,9,2942
7,7,0,0,2,7,9,2942
0,0,1,0,1,0,1,2943
1,1,0,0,1,0,1,2943
0,0,1,0,1,0,1,2944
1,1,0,0,1,0,1,2944
0,0,1,0,1,0,1,2945
1,1,0,0,1,0,1,2945
0,0,1,0,1,0,1,2946
1,1,0,0,1,0,1,2946
0,0,1,0,1,0,1,2947
1,1,0,1,1,1,2,2947
2,2,0,1,1,2,3,2947
3,3,0,1,1,3,4,2947
4,4,0,0,1,3,4,2947
0,0,1,0,1,0,1,2948
1,1,3,0,4,0,4,2948
2,2,0,1,4,1,5,2948
3,3,0,0,4,1,5,2948
0,0,1,0,1,0,1,2949
1,1,0,0,1,0,1,2949
0,0,1,0,1,0,1,2950
1,1,0,0,1,0,1,2950
0,0,1,0,1,0,1,2951
1,1,1,0,2,0,2,2951
2,2,1,0,3,0,3,2951
3,3,1,1,4,1,5,2951
4,4,0,1,4,2,6,2951
5,5,0,1,4,3,7,2951
6,6,0,1,4,4,8,2951
7,7,0,1,4,5,9,2951
8,8,0,0,4,5,9,2951
0,0,1,0,1,0,1,2952
1,1,3,0,4,0,4,2952
2,2,2,0,6,0,6,2952
3,3,4,0,10,0,10,2952
4,4,5,0,15,0,15,2952
5,5,1,0,16,0,16,2952
6,6,1,0,17,0,17,2952
7,7,2,0,19,0,19,2952
8,8,3,1,22,1,23,2952
9,9,3,3,25,4,29,2952
10,10,2,5,27,9,36,2952
11,11,4,5,31,14,45,2952
12,12,3,1,34,15,49,2952
13,13,5,2,39,17,56,2952
14,14,3,3,42,20,62,2952
15,15,1,1,43,21,64,2952
16,16,1,1,44,22,66,2952
17,17,0,0,44,22,66,2952
0,0,1,0,1,0,1,2953
1,1,1,0,2,0,2,2953
2,2,0,0,2,0,2,2953
0,0,1,0,1,0,1,2954
1,1,1,0,2,0,2,2954
2,2,0,0,2,0,2,2954
0,0,1,0,1,0,1,2955
1,1,0,0,1,0,1,2955
0,0,1,0,1,0,1,2956
1,1,1,1,2,1,3,2956
2,2,1,0,3,1,4,2956
3,3,2,0,5,1,6,2956
4,4,1,0,6,1,7,2956
5,5,0,1,6,2,8,2956
6,6,0,1,6,3,9,2956
7,7,0,0,6,3,9,2956
0,0,1,0,1,0,1,2957
1,1,1,1,2,1,3,2957
2,2,1,2,3,3,6,2957
3,3,1,1,4,4,8,2957
4,4,2,0,6,4,10,2957
5,5,0,0,6,4,10,2957
0,0,1,0,1,0,1,2958
1,1,2,0,3,0,3,2958
2,2,5,1,8,1,9,2958
3,3,10,4,18,5,23,2958
4,4,10,3,28,8,36,2958
5,5,7,2,35,10,45,2958
6,6,8,6,43,16,59,2958
7,7,10,5,53,21,74,2958
8,8,11,5,64,26,90,2958
9,9,8,7,72,33,105,2958
10,10,7,2,79,35,114,2958
11,11,6,1,85,36,121,2958
12,12,4,1,89,37,126,2958
13,13,1,1,90,38,128,2958
14,14,0,0,90,38,128,2958
0,0,1,0,1,0,1,2959
1,1,0,0,1,0,1,2959
0,0,1,0,1,0,1,2960
1,1,3,0,4,0,4,2960
2,2,1,0,5,0,5,2960
3,3,0,0,5,0,5,2960
0,0,1,0,1,0,1,2961
1,1,1,2,2,2,4,2961
2,2,1,1,3,3,6,2961
3,3,3,1,6,4,10,2961
4,4,0,1,6,5,11,2961
5,5,0,2,6,7,13,2961
6,6,0,2,6,9,15,2961
7,7,0,5,6,14,20,2961
8,8,0,6,6,20,26,2961
9,9,1,4,7,24,31,2961
10,10,1,2,8,26,34,2961
11,11,0,2,8,28,36,2961
12,12,0,1,8,29,37,2961
13,13,0,1,8,30,38,2961
14,14,1,0,9,30,39,2961
15,15,1,1,10,31,41,2961
16,16,0,2,10,33,43,2961
17,17,0,1,10,34,44,2961
18,18,0,0,10,34,44,2961
0,0,1,0,1,0,1,2962
1,1,1,0,2,0,2,2962
2,2,0,0,2,0,2,2962
0,0,1,0,1,0,1,2963
1,1,0,0,1,0,1,2963
0,0,1,0,1,0,1,2964
1,1,0,0,1,0,1,2964
0,0,1,0,1,0,1,2965
1,1,0,0,1,0,1,2965
0,0,1,0,1,0,1,2966
1,1,1,0,2,0,2,2966
2,2,1,0,3,0,3,2966
3,3,2,0,5,0,5,2966
4,4,1,0,6,0,6,2966
5,5,1,0,7,0,7,2966
6,6,1,1,8,1,9,2966
7,7,1,2,9,3,12,2966
8,8,0,2,9,5,14,2966
9,9,0,1,9,6,15,2966
10,10,0,0,9,6,15,2966
0,0,1,0,1,0,1,2967
1,1,0,0,1,0,1,2967
0,0,1,0,1,0,1,2968
1,1,0,0,1,0,1,2968
0,0,1,0,1,0,1,2969
1,1,2,0,3,0,3,2969
2,2,1,0,4,0,4,2969
3,3,0,1,4,1,5,2969
4,4,0,0,4,1,5,2969
0,0,1,0,1,0,1,2970
1,1,0,0,1,0,1,2970
0,0,1,0,1,0,1,2971
1,1,2,1,3,1,4,2971
2,2,0,2,3,3,6,2971
3,3,0,1,3,4,7,2971
4,4,0,0,3,4,7,2971
0,0,1,0,1,0,1,2972
1,1,1,0,2,0,2,2972
2,2,2,0,4,0,4,2972
3,3,2,0,6,0,6,2972
4,4,0,0,6,0,6,2972
0,0,1,0,1,0,1,2973
1,1,1,1,2,1,3,2973
2,2,0,1,2,2,4,2973
3,3,0,0,2,2,4,2973
0,0,1,0,1,0,1,2974
1,1,0,1,1,1,2,2974
2,2,0,1,1,2,3,2974
3,3,0,2,1,4,5,2974
4,4,1,0,2,4,6,2974
5,5,1,0,3,4,7,2974
6,6,0,0,3,4,7,2974
0,0,1,0,1,0,1,2975
1,1,1,0,2,0,2,2975
2,2,0,0,2,0,2,2975
0,0,1,0,1,0,1,2976
1,1,1,0,2,0,2,2976
2,2,0,1,2,1,3,2976
3,3,0,0,2,1,3,2976
0,0,1,0,1,0,1,2977
1,1,1,0,2,0,2,2977
2,2,0,0,2,0,2,2977
0,0,1,0,1,0,1,2978
1,1,2,0,3,0,3,2978
2,2,1,0,4,0,4,2978
3,3,0,0,4,0,4,2978
0,0,1,0,1,0,1,2979
1,1,1,0,2,0,2,2979
2,2,2,0,4,0,4,2979
3,3,1,0,5,0,5,2979
4,4,1,0,6,0,6,2979
5,5,2,0,8,0,8,2979
6,6,1,0,9,0,9,2979
7,7,0,0,9,0,9,2979
0,0,1,0,1,0,1,2980
1,1,1,1,2,1,3,2980
2,2,0,0,2,1,3,2980
0,0,1,0,1,0,1,2981
1,1,1,1,2,1,3,2981
2,2,0,0,2,1,3,2981
0,0,1,0,1,0,1,2982
1,1,1,2,2,2,4,2982
2,2,2,1,4,3,7,2982
3,3,0,2,4,5,9,2982
4,4,1,1,5,6,11,2982
5,5,0,2,5,8,13,2982
6,6,0,5,5,13,18,2982
7,7,1,4,6,17,23,2982
8,8,0,4,6,21,27,2982
9,9,0,0,6,21,27,2982
0,0,1,0,1,0,1,2983
1,1,1,0,2,0,2,2983
2,2,2,0,4,0,4,2983
3,3,1,0,5,0,5,2983
4,4,1,0,6,0,6,2983
5,5,1,0,7,0,7,2983
6,6,0,0,7,0,7,2983
0,0,1,0,1,0,1,2984
1,1,2,1,3,1,4,2984
2,2,3,1,6,2,8,2984
3,3,5,1,11,3,14,2984
4,4,5,2,16,5,21,2984
5,5,5,0,21,5,26,2984
6,6,3,0,24,5,29,2984
7,7,1,0,25,5,30,2984
8,8,0,1,25,6,31,2984
9,9,0,0,25,6,31,2984
0,0,1,0,1,0,1,2985
1,1,1,0,2,0,2,2985
2,2,1,0,3,0,3,2985
3,3,0,2,3,2,5,2985
4,4,0,1,3,3,6,2985
5,5,1,3,4,6,10,2985
6,6,1,2,5,8,13,2985
7,7,3,2,8,10,18,2985
8,8,6,1,14,11,25,2985
9,9,5,2,19,13,32,2985
10,10,6,0,25,13,38,2985
11,11,0,5,25,18,43,2985
12,12,0,1,25,19,44,2985
13,13,1,1,26,20,46,2985
14,14,2,0,28,20,48,2985
15,15,1,0,29,20,49,2985
16,16,1,0,30,20,50,2985
17,17,0,0,30,20,50,2985
0,0,1,0,1,0,1,2986
1,1,0,1,1,1,2,2986
2,2,1,0,2,1,3,2986
3,3,1,0,3,1,4,2986
4,4,1,0,4,1,5,2986
5,5,0,0,4,1,5,2986
0,0,1,0,1,0,1,2987
1,1,0,0,1,0,1,2987
0,0,1,0,1,0,1,2988
1,1,0,0,1,0,1,2988
0,0,1,0,1,0,1,2989
1,1,0,1,1,1,2,2989
2,2,0,1,1,2,3,2989
3,3,1,0,2,2,4,2989
4,4,1,0,3,2,5,2989
5,5,1,0,4,2,6,2989
6,6,0,0,4,2,6,2989
0,0,1,0,1,0,1,2990
1,1,2,0,3,0,3,2990
2,2,0,0,3,0,3,2990
0,0,1,0,1,0,1,2991
1,1,1,0,2,0,2,2991
2,2,0,0,2,0,2,2991
0,0,1,0,1,0,1,2992
1,1,1,0,2,0,2,2992
2,2,0,0,2,0,2,2992
0,0,1,0,1,0,1,2993
1,1,0,0,1,0,1,2993
0,0,1,0,1,0,1,2994
1,1,1,1,2,1,3,2994
2,2,2,2,4,3,7,2994
3,3,3,0,7,3,10,2994
4,4,2,0,9,3,12,2994
5,5,1,0,10,3,13,2994
6,6,0,1,10,4,14,2994
7,7,0,1,10,5,15,2994
8,8,1,0,11,5,16,2994
9,9,2,0,13,5,18,2994
10,10,0,0,13,5,18,2994
0,0,1,0,1,0,1,2995
1,1,1,1,2,1,3,2995
2,2,1,1,3,2,5,2995
3,3,0,0,3,2,5,2995
0,0,1,0,1,0,1,2996
1,1,2,0,3,0,3,2996
2,2,2,0,5,0,5,2996
3,3,2,1,7,1,8,2996
4,4,2,1,9,2,11,2996
5,5,2,2,11,4,15,2996
6,6,2,2,13,6,19,2996
7,7,1,1,14,7,21,2996
8,8,0,0,14,7,21,2996
0,0,1,0,1,0,1,2997
1,1,1,1,2,1,3,2997
2,2,0,0,2,1,3,2997
0,0,1,0,1,0,1,2998
1,1,0,1,1,1,2,2998
2,2,0,0,1,1,2,2998
0,0,1,0,1,0,1,2999
1,1,0,0,1,0,1,2999
0,0,1,0,1,0,1,3000
1,1,0,0,1,0,1,3000
0,0,1,0,1,0,1,3001
1,1,1,0,2,0,2,3001
2,2,0,1,2,1,3,3001
3,3,0,1,2,2,4,3001
4,4,0,1,2,3,5,3001
5,5,0,0,2,3,5,3001
0,0,1,0,1,0,1,3002
1,1,0,0,1,0,1,3002
0,0,1,0,1,0,1,3003
1,1,1,0,2,0,2,3003
2,2,0,0,2,0,2,3003
0,0,1,0,1,0,1,3004
1,1,1,0,2,0,2,3004
2,2,1,0,3,0,3,3004
3,3,1,0,4,0,4,3004
4,4,1,0,5,0,5,3004
5,5,1,0,6,0,6,3004
6,6,3,0,9,0,9,3004
7,7,0,0,9,0,9,3004
0,0,1,0,1,0,1,3005
1,1,0,0,1,0,1,3005
0,0,1,0,1,0,1,3006
1,1,0,0,1,0,1,3006
0,0,1,0,1,0,1,3007
1,1,1,1,2,1,3,3007
2,2,1,2,3,3,6,3007
3,3,2,1,5,4,9,3007
4,4,4,0,9,4,13,3007
5,5,3,0,12,4,16,3007
6,6,0,2,12,6,18,3007
7,7,1,1,13,7,20,3007
8,8,1,1,14,8,22,3007
9,9,1,1,15,9,24,3007
10,10,0,0,15,9,24,3007
0,0,1,0,1,0,1,3008
1,1,3,0,4,0,4,3008
2,2,0,1,4,1,5,3008
3,3,0,1,4,2,6,3008
4,4,0,1,4,3,7,3008
5,5,0,1,4,4,8,3008
6,6,1,1,5,5,10,3008
7,7,0,1,5,6,11,3008
8,8,0,0,5,6,11,3008
0,0,1,0,1,0,1,3009
1,1,0,0,1,0,1,3009
0,0,1,0,1,0,1,3010
1,1,1,0,2,0,2,3010
2,2,1,1,3,1,4,3010
3,3,0,2,3,3,6,3010
4,4,0,2,3,5,8,3010
5,5,1,1,4,6,10,3010
6,6,2,0,6,6,12,3010
7,7,3,0,9,6,15,3010
8,8,0,2,9,8,17,3010
9,9,0,0,9,8,17,3010
0,0,1,0,1,0,1,3011
1,1,0,0,1,0,1,3011
0,0,1,0,1,0,1,3012
1,1,0,0,1,0,1,3012
0,0,1,0,1,0,1,3013
1,1,2,0,3,0,3,3013
2,2,2,2,5,2,7,3013
3,3,1,3,6,5,11,3013
4,4,0,0,6,5,11,3013
0,0,1,0,1,0,1,3014
1,1,0,1,1,1,2,3014
2,2,0,0,1,1,2,3014
0,0,1,0,1,0,1,3015
1,1,0,0,1,0,1,3015
0,0,1,0,1,0,1,3016
1,1,0,0,1,0,1,3016
0,0,1,0,1,0,1,3017
1,1,1,0,2,0,2,3017
2,2,0,0,2,0,2,3017
0,0,1,0,1,0,1,3018
1,1,0,0,1,0,1,3018
0,0,1,0,1,0,1,3019
1,1,1,0,2,0,2,3019
2,2,0,0,2,0,2,3019
0,0,1,0,1,0,1,3020
1,1,0,0,1,0,1,3020
0,0,1,0,1,0,1,3021
1,1,1,0,2,0,2,3021
2,2,1,0,3,0,3,3021
3,3,0,0,3,0,3,3021
0,0,1,0,1,0,1,3022
1,1,1,0,2,0,2,3022
2,2,1,1,3,1,4,3022
3,3,0,0,3,1,4,3022
0,0,1,0,1,0,1,3023
1,1,1,0,2,0,2,3023
2,2,2,0,4,0,4,3023
3,3,7,0,11,0,11,3023
4,4,2,1,13,1,14,3023
5,5,0,1,13,2,15,3023
6,6,0,0,13,2,15,3023
0,0,1,0,1,0,1,3024
1,1,0,0,1,0,1,3024
0,0,1,0,1,0,1,3025
1,1,1,0,2,0,2,3025
2,2,1,0,3,0,3,3025
3,3,2,0,5,0,5,3025
4,4,1,1,6,1,7,3025
5,5,0,1,6,2,8,3025
6,6,0,1,6,3,9,3025
7,7,0,1,6,4,10,3025
8,8,0,0,6,4,10,3025
0,0,1,0,1,0,1,3026
1,1,0,0,1,0,1,3026
0,0,1,0,1,0,1,3027
1,1,1,0,2,0,2,3027
2,2,0,1,2,1,3,3027
3,3,0,1,2,2,4,3027
4,4,0,1,2,3,5,3027
5,5,0,1,2,4,6,3027
6,6,0,1,2,5,7,3027
7,7,0,1,2,6,8,3027
8,8,0,1,2,7,9,3027
9,9,1,0,3,7,10,3027
10,10,0,0,3,7,10,3027
0,0,1,0,1,0,1,3028
1,1,2,0,3,0,3,3028
2,2,1,0,4,0,4,3028
3,3,0,0,4,0,4,3028
0,0,1,0,1,0,1,3029
1,1,0,0,1,0,1,3029
0,0,1,0,1,0,1,3030
1,1,1,0,2,0,2,3030
2,2,0,0,2,0,2,3030
0,0,1,0,1,0,1,3031
1,1,3,0,4,0,4,3031
2,2,0,1,4,1,5,3031
3,3,0,0,4,1,5,3031
0,0,1,0,1,0,1,3032
1,1,0,1,1,1,2,3032
2,2,0,1,1,2,3,3032
3,3,0,1,1,3,4,3032
4,4,0,2,1,5,6,3032
5,5,1,2,2,7,9,3032
6,6,4,1,6,8,14,3032
7,7,5,3,11,11,22,3032
8,8,4,0,15,11,26,3032
9,9,2,0,17,11,28,3032
10,10,3,0,20,11,31,3032
11,11,2,1,22,12,34,3032
12,12,1,0,23,12,35,3032
13,13,3,0,26,12,38,3032
14,14,3,1,29,13,42,3032
15,15,2,3,31,16,47,3032
16,16,0,7,31,23,54,3032
17,17,2,7,33,30,63,3032
18,18,0,11,33,41,74,3032
19,19,3,12,36,53,89,3032
20,20,4,9,40,62,102,3032
21,21,4,8,44,70,114,3032
22,22,4,7,48,77,125,3032
23,23,4,9,52,86,138,3032
24,24,2,17,54,103,157,3032
25,25,6,14,60,117,177,3032
26,26,4,9,64,126,190,3032
27,27,8,8,72,134,206,3032
28,28,10,11,82,145,227,3032
29,29,6,14,88,159,247,3032
30,30,4,11,92,170,262,3032
31,31,7,5,99,175,274,3032
32,32,6,8,105,183,288,3032
33,33,4,5,109,188,297,3032
34,34,2,3,111,191,302,3032
35,35,2,3,113,194,307,3032
36,36,1,5,114,199,313,3032
37,37,1,1,115,200,315,3032
38,38,1,1,116,201,317,3032
39,39,1,2,117,203,320,3032
40,40,1,3,118,206,324,3032
41,41,1,3,119,209,328,3032
42,42,1,4,120,213,333,3032
43,43,4,3,124,216,340,3032
44,44,2,2,126,218,344,3032
45,45,2,3,128,221,349,3032
46,46,5,4,133,225,358,3032
47,47,3,2,136,227,363,3032
48,48,8,2,144,229,373,3032
49,49,9,2,153,231,384,3032
50,50,3,1,156,232,388,3032
51,51,7,3,163,235,398,3032
52,52,4,7,167,242,409,3032
53,53,2,5,169,247,416,3032
54,54,3,4,172,251,423,3032
55,55,4,3,176,254,430,3032
56,56,6,1,182,255,437,3032
57,57,7,2,189,257,446,3032
58,58,3,1,192,258,450,3032
59,59,1,1,193,259,452,3032
60,60,0,1,193,260,453,3032
61,61,0,0,193,260,453,3032
0,0,1,0,1,0,1,3033
1,1,0,0,1,0,1,3033
0,0,1,0,1,0,1,3034
1,1,1,0,2,0,2,3034
2,2,1,0,3,0,3,3034
3,3,2,0,5,0,5,3034
4,4,4,0,9,0,9,3034
5,5,4,1,13,1,14,3034
6,6,4,1,17,2,19,3034
7,7,3,0,20,2,22,3034
8,8,3,0,23,2,25,3034
9,9,4,0,27,2,29,3034
10,10,2,0,29,2,31,3034
11,11,0,0,29,2,31,3034
0,0,1,0,1,0,1,3035
1,1,1,0,2,0,2,3035
2,2,3,0,5,0,5,3035
3,3,1,0,6,0,6,3035
4,4,3,0,9,0,9,3035
5,5,4,0,13,0,13,3035
6,6,3,0,16,0,16,3035
7,7,2,1,18,1,19,3035
8,8,4,0,22,1,23,3035
9,9,1,1,23,2,25,3035
10,10,0,1,23,3,26,3035
11,11,0,0,23,3,26,3035
0,0,1,0,1,0,1,3036
1,1,1,0,2,0,2,3036
2,2,1,0,3,0,3,3036
3,3,1,0,4,0,4,3036
4,4,0,0,4,0,4,3036
0,0,1,0,1,0,1,3037
1,1,0,0,1,0,1,3037
0,0,1,0,1,0,1,3038
1,1,2,0,3,0,3,3038
2,2,1,0,4,0,4,3038
3,3,1,1,5,1,6,3038
4,4,2,0,7,1,8,3038
5,5,3,0,10,1,11,3038
6,6,3,1,13,2,15,3038
7,7,3,3,16,5,21,3038
8,8,0,8,16,13,29,3038
9,9,1,3,17,16,33,3038
10,10,2,1,19,17,36,3038
11,11,3,0,22,17,39,3038
12,12,6,0,28,17,45,3038
13,13,6,2,34,19,53,3038
14,14,5,5,39,24,63,3038
15,15,7,7,46,31,77,3038
16,16,6,12,52,43,95,3038
17,17,8,9,60,52,112,3038
18,18,13,10,73,62,135,3038
19,19,15,4,88,66,154,3038
20,20,14,2,102,68,170,3038
21,21,7,6,109,74,183,3038
22,22,7,6,116,80,196,3038
23,23,9,6,125,86,211,3038
24,24,6,16,131,102,233,3038
25,25,6,18,137,120,257,3038
26,26,8,14,145,134,279,3038
27,27,8,12,153,146,299,3038
28,28,6,7,159,153,312,3038
29,29,4,9,163,162,325,3038
30,30,2,8,165,170,335,3038
31,31,9,6,174,176,350,3038
32,32,10,5,184,181,365,3038
33,33,5,3,189,184,373,3038
34,34,2,4,191,188,379,3038
35,35,2,2,193,190,383,3038
36,36,1,3,194,193,387,3038
37,37,1,3,195,196,391,3038
38,38,3,0,198,196,394,3038
39,39,4,1,202,197,399,3038
40,40,5,3,207,200,407,3038
41,41,5,4,212,204,416,3038
42,42,4,7,216,211,427,3038
43,43,4,7,220,218,438,3038
44,44,3,2,223,220,443,3038
45,45,6,4,229,224,453,3038
46,46,5,6,234,230,464,3038
47,47,6,4,240,234,474,3038
48,48,5,5,245,239,484,3038
49,49,3,3,248,242,490,3038
50,50,1,3,249,245,494,3038
51,51,4,2,253,247,500,3038
52,52,3,2,256,249,505,3038
53,53,1,1,257,250,507,3038
54,54,1,0,258,250,508,3038
55,55,2,0,260,250,510,3038
56,56,0,0,260,250,510,3038
0,0,1,0,1,0,1,3039
1,1,1,1,2,1,3,3039
2,2,0,0,2,1,3,3039
0,0,1,0,1,0,1,3040
1,1,0,0,1,0,1,3040
0,0,1,0,1,0,1,3041
1,1,0,2,1,2,3,3041
2,2,1,0,2,2,4,3041
3,3,0,0,2,2,4,3041
0,0,1,0,1,0,1,3042
1,1,2,0,3,0,3,3042
2,2,0,1,3,1,4,3042
3,3,0,1,3,2,5,3042
4,4,1,1,4,3,7,3042
5,5,0,2,4,5,9,3042
6,6,0,3,4,8,12,3042
7,7,0,1,4,9,13,3042
8,8,0,0,4,9,13,3042
0,0,1,0,1,0,1,3043
1,1,2,0,3,0,3,3043
2,2,0,0,3,0,3,3043
0,0,1,0,1,0,1,3044
1,1,0,0,1,0,1,3044
0,0,1,0,1,0,1,3045
1,1,1,0,2,0,2,3045
2,2,1,0,3,0,3,3045
3,3,1,1,4,1,5,3045
4,4,1,0,5,1,6,3045
5,5,0,0,5,1,6,3045
0,0,1,0,1,0,1,3046
1,1,1,0,2,0,2,3046
2,2,2,0,4,0,4,3046
3,3,0,1,4,1,5,3046
4,4,0,0,4,1,5,3046
0,0,1,0,1,0,1,3047
1,1,1,1,2,1,3,3047
2,2,1,3,3,4,7,3047
3,3,0,0,3,4,7,3047
0,0,1,0,1,0,1,3048
1,1,0,0,1,0,1,3048
0,0,1,0,1,0,1,3049
1,1,1,0,2,0,2,3049
2,2,1,0,3,0,3,3049
3,3,0,0,3,0,3,3049
0,0,1,0,1,0,1,3050
1,1,0,0,1,0,1,3050
0,0,1,0,1,0,1,3051
1,1,0,0,1,0,1,3051
0,0,1,0,1,0,1,3052
1,1,2,0,3,0,3,3052
2,2,2,0,5,0,5,3052
3,3,2,0,7,0,7,3052
4,4,2,2,9,2,11,3052
5,5,3,1,12,3,15,3052
6,6,5,0,17,3,20,3052
7,7,1,2,18,5,23,3052
8,8,1,0,19,5,24,3052
9,9,0,1,19,6,25,3052
10,10,1,0,20,6,26,3052
11,11,0,1,20,7,27,3052
12,12,0,0,20,7,27,3052
0,0,1,0,1,0,1,3053
1,1,0,0,1,0,1,3053
0,0,1,0,1,0,1,3054
1,1,0,0,1,0,1,3054
0,0,1,0,1,0,1,3055
1,1,1,0,2,0,2,3055
2,2,3,0,5,0,5,3055
3,3,2,0,7,0,7,3055
4,4,0,0,7,0,7,3055
0,0,1,0,1,0,1,3056
1,1,0,0,1,0,1,3056
0,0,1,0,1,0,1,3057
1,1,0,0,1,0,1,3057
0,0,1,0,1,0,1,3058
1,1,0,0,1,0,1,3058
0,0,1,0,1,0,1,3059
1,1,0,0,1,0,1,3059
0,0,1,0,1,0,1,3060
1,1,2,0,3,0,3,3060
2,2,1,0,4,0,4,3060
3,3,0,0,4,0,4,3060
0,0,1,0,1,0,1,3061
1,1,0,0,1,0,1,3061
0,0,1,0,1,0,1,3062
1,1,2,0,3,0,3,3062
2,2,0,0,3,0,3,3062
0,0,1,0,1,0,1,3063
1,1,0,1,1,1,2,3063
2,2,1,0,2,1,3,3063
3,3,1,0,3,1,4,3063
4,4,1,0,4,1,5,3063
5,5,1,0,5,1,6,3063
6,6,2,0,7,1,8,3063
7,7,1,0,8,1,9,3063
8,8,0,0,8,1,9,3063
0,0,1,0,1,0,1,3064
1,1,3,0,4,0,4,3064
2,2,1,1,5,1,6,3064
3,3,1,3,6,4,10,3064
4,4,0,4,6,8,14,3064
5,5,0,3,6,11,17,3064
6,6,1,1,7,12,19,3064
7,7,2,1,9,13,22,3064
8,8,1,1,10,14,24,3064
9,9,2,0,12,14,26,3064
10,10,3,0,15,14,29,3064
11,11,3,2,18,16,34,3064
12,12,3,2,21,18,39,3064
13,13,5,3,26,21,47,3064
14,14,5,4,31,25,56,3064
15,15,7,4,38,29,67,3064
16,16,8,2,46,31,77,3064
17,17,7,4,53,35,88,3064
18,18,8,4,61,39,100,3064
19,19,7,4,68,43,111,3064
20,20,6,3,74,46,120,3064
21,21,3,1,77,47,124,3064
22,22,3,2,80,49,129,3064
23,23,1,1,81,50,131,3064
24,24,0,1,81,51,132,3064
25,25,0,1,81,52,133,3064
26,26,0,0,81,52,133,3064
0,0,1,0,1,0,1,3065
1,1,0,0,1,0,1,3065
0,0,1,0,1,0,1,3066
1,1,1,0,2,0,2,3066
2,2,0,0,2,0,2,3066
0,0,1,0,1,0,1,3067
1,1,0,0,1,0,1,3067
0,0,1,0,1,0,1,3068
1,1,1,0,2,0,2,3068
2,2,2,0,4,0,4,3068
3,3,1,0,5,0,5,3068
4,4,1,0,6,0,6,3068
5,5,1,1,7,1,8,3068
6,6,0,0,7,1,8,3068
0,0,1,0,1,0,1,3069
1,1,1,0,2,0,2,3069
2,2,0,2,2,2,4,3069
3,3,0,2,2,4,6,3069
4,4,1,1,3,5,8,3069
5,5,2,0,5,5,10,3069
6,6,0,0,5,5,10,3069
0,0,1,0,1,0,1,3070
1,1,0,0,1,0,1,3070
0,0,1,0,1,0,1,3071
1,1,0,0,1,0,1,3071
0,0,1,0,1,0,1,3072
1,1,1,0,2,0,2,3072
2,2,1,0,3,0,3,3072
3,3,0,0,3,0,3,3072
0,0,1,0,1,0,1,3073
1,1,0,0,1,0,1,3073
0,0,1,0,1,0,1,3074
1,1,0,0,1,0,1,3074
0,0,1,0,1,0,1,3075
1,1,1,0,2,0,2,3075
2,2,1,0,3,0,3,3075
3,3,2,0,5,0,5,3075
4,4,0,1,5,1,6,3075
5,5,0,0,5,1,6,3075
0,0,1,0,1,0,1,3076
1,1,3,0,4,0,4,3076
2,2,2,0,6,0,6,3076
3,3,1,0,7,0,7,3076
4,4,2,0,9,0,9,3076
5,5,3,0,12,0,12,3076
6,6,1,3,13,3,16,3076
7,7,6,0,19,3,22,3076
8,8,2,0,21,3,24,3076
9,9,0,0,21,3,24,3076
0,0,1,0,1,0,1,3077
1,1,0,0,1,0,1,3077
0,0,1,0,1,0,1,3078
1,1,0,0,1,0,1,3078
0,0,1,0,1,0,1,3079
1,1,0,0,1,0,1,3079
0,0,1,0,1,0,1,3080
1,1,1,0,2,0,2,3080
2,2,0,0,2,0,2,3080
0,0,1,0,1,0,1,3081
1,1,0,0,1,0,1,3081
0,0,1,0,1,0,1,3082
1,1,3,0,4,0,4,3082
2,2,0,0,4,0,4,3082
0,0,1,0,1,0,1,3083
1,1,0,0,1,0,1,3083
0,0,1,0,1,0,1,3084
1,1,0,1,1,1,2,3084
2,2,0,0,1,1,2,3084
0,0,1,0,1,0,1,3085
1,1,0,0,1,0,1,3085
0,0,1,0,1,0,1,3086
1,1,1,0,2,0,2,3086
2,2,2,0,4,0,4,3086
3,3,0,0,4,0,4,3086
0,0,1,0,1,0,1,3087
1,1,1,0,2,0,2,3087
2,2,0,0,2,0,2,3087
0,0,1,0,1,0,1,3088
1,1,0,0,1,0,1,3088
0,0,1,0,1,0,1,3089
1,1,1,0,2,0,2,3089
2,2,0,0,2,0,2,3089
0,0,1,0,1,0,1,3090
1,1,0,0,1,0,1,3090
0,0,1,0,1,0,1,3091
1,1,0,0,1,0,1,3091
0,0,1,0,1,0,1,3092
1,1,0,0,1,0,1,3092
0,0,1,0,1,0,1,3093
1,1,2,0,3,0,3,3093
2,2,0,1,3,1,4,3093
3,3,0,1,3,2,5,3093
4,4,1,0,4,2,6,3093
5,5,1,0,5,2,7,3093
6,6,1,1,6,3,9,3093
7,7,0,0,6,3,9,3093
0,0,1,0,1,0,1,3094
1,1,1,0,2,0,2,3094
2,2,1,0,3,0,3,3094
3,3,0,0,3,0,3,3094
0,0,1,0,1,0,1,3095
1,1,1,1,2,1,3,3095
2,2,1,0,3,1,4,3095
3,3,2,0,5,1,6,3095
4,4,3,1,8,2,10,3095
5,5,1,2,9,4,13,3095
6,6,0,2,9,6,15,3095
7,7,0,2,9,8,17,3095
8,8,1,1,10,9,19,3095
9,9,0,0,10,9,19,3095
0,0,1,0,1,0,1,3096
1,1,1,0,2,0,2,3096
2,2,1,0,3,0,3,3096
3,3,0,1,3,1,4,3096
4,4,0,0,3,1,4,3096
0,0,1,0,1,0,1,3097
1,1,0,0,1,0,1,3097
0,0,1,0,1,0,1,3098
1,1,0,0,1,0,1,3098
0,0,1,0,1,0,1,3099
1,1,0,0,1,0,1,3099
0,0,1,0,1,0,1,3100
1,1,0,0,1,0,1,3100
0,0,1,0,1,0,1,3101
1,1,0,1,1,1,2,3101
2,2,2,0,3,1,4,3101
3,3,2,0,5,1,6,3101
4,4,3,1,8,2,10,3101
5,5,2,2,10,4,14,3101
6,6,2,1,12,5,17,3101
7,7,3,1,15,6,21,3101
8,8,3,1,18,7,25,3101
9,9,1,0,19,7,26,3101
10,10,0,0,19,7,26,3101
0,0,1,0,1,0,1,3102
1,1,0,0,1,0,1,3102
0,0,1,0,1,0,1,3103
1,1,2,0,3,0,3,3103
2,2,4,0,7,0,7,3103
3,3,2,2,9,2,11,3103
4,4,1,1,10,3,13,3103
5,5,2,0,12,3,15,3103
6,6,1,1,13,4,17,3103
7,7,0,0,13,4,17,3103
0,0,1,0,1,0,1,3104
1,1,0,0,1,0,1,3104
0,0,1,0,1,0,1,3105
1,1,1,1,2,1,3,3105
2,2,1,0,3,1,4,3105
3,3,1,0,4,1,5,3105
4,4,0,0,4,1,5,3105
0,0,1,0,1,0,1,3106
1,1,0,0,1,0,1,3106
0,0,1,0,1,0,1,3107
1,1,3,0,4,0,4,3107
2,2,3,0,7,0,7,3107
3,3,3,0,10,0,10,3107
4,4,1,1,11,1,12,3107
5,5,1,2,12,3,15,3107
6,6,0,1,12,4,16,3107
7,7,2,1,14,5,19,3107
8,8,3,3,17,8,25,3107
9,9,2,2,19,10,29,3107
10,10,1,1,20,11,31,3107
11,11,3,2,23,13,36,3107
12,12,1,3,24,16,40,3107
13,13,0,5,24,21,45,3107
14,14,3,5,27,26,53,3107
15,15,2,5,29,31,60,3107
16,16,2,5,31,36,67,3107
17,17,3,1,34,37,71,3107
18,18,2,4,36,41,77,3107
19,19,4,6,40,47,87,3107
20,20,6,3,46,50,96,3107
21,21,2,5,48,55,103,3107
22,22,3,4,51,59,110,3107
23,23,2,4,53,63,116,3107
24,24,5,6,58,69,127,3107
25,25,1,3,59,72,131,3107
26,26,4,7,63,79,142,3107
27,27,7,4,70,83,153,3107
28,28,5,3,75,86,161,3107
29,29,6,3,81,89,170,3107
30,30,1,3,82,92,174,3107
31,31,1,1,83,93,176,3107
32,32,1,2,84,95,179,3107
33,33,5,1,89,96,185,3107
34,34,6,1,95,97,192,3107
35,35,4,4,99,101,200,3107
36,36,4,5,103,106,209,3107
37,37,1,9,104,115,219,3107
38,38,3,5,107,120,227,3107
39,39,3,5,110,125,235,3107
40,40,7,4,117,129,246,3107
41,41,4,3,121,132,253,3107
42,42,4,5,125,137,262,3107
43,43,6,1,131,138,269,3107
44,44,4,1,135,139,274,3107
45,45,2,1,137,140,277,3107
46,46,2,2,139,142,281,3107
47,47,1,2,140,144,284,3107
48,48,2,2,142,146,288,3107
49,49,4,1,146,147,293,3107
50,50,4,1,150,148,298,3107
51,51,3,0,153,148,301,3107
52,52,2,1,155,149,304,3107
53,53,3,2,158,151,309,3107
54,54,0,1,158,152,310,3107
55,55,1,1,159,153,312,3107
56,56,0,0,159,153,312,3107
0,0,1,0,1,0,1,3108
1,1,0,1,1,1,2,3108
2,2,0,1,1,2,3,3108
3,3,0,2,1,4,5,3108
4,4,0,1,1,5,6,3108
5,5,0,0,1,5,6,3108
0,0,1,0,1,0,1,3109
1,1,1,0,2,0,2,3109
2,2,2,0,4,0,4,3109
3,3,1,0,5,0,5,3109
4,4,0,1,5,1,6,3109
5,5,0,0,5,1,6,3109
0,0,1,0,1,0,1,3110
1,1,0,0,1,0,1,3110
0,0,1,0,1,0,1,3111
1,1,0,0,1,0,1,3111
0,0,1,0,1,0,1,3112
1,1,1,0,2,0,2,3112
2,2,0,1,2,1,3,3112
3,3,1,1,3,2,5,3112
4,4,1,1,4,3,7,3112
5,5,2,0,6,3,9,3112
6,6,0,2,6,5,11,3112
7,7,0,1,6,6,12,3112
8,8,0,0,6,6,12,3112
0,0,1,0,1,0,1,3113
1,1,0,0,1,0,1,3113
0,0,1,0,1,0,1,3114
1,1,0,2,1,2,3,3114
2,2,1,1,2,3,5,3114
3,3,0,1,2,4,6,3114
4,4,0,0,2,4,6,3114
0,0,1,0,1,0,1,3115
1,1,1,0,2,0,2,3115
2,2,1,0,3,0,3,3115
3,3,1,0,4,0,4,3115
4,4,2,1,6,1,7,3115
5,5,2,0,8,1,9,3115
6,6,1,0,9,1,10,3115
7,7,1,0,10,1,11,3115
8,8,0,0,10,1,11,3115
0,0,1,0,1,0,1,3116
1,1,0,0,1,0,1,3116
0,0,1,0,1,0,1,3117
1,1,0,0,1,0,1,3117
0,0,1,0,1,0,1,3118
1,1,2,0,3,0,3,3118
2,2,4,1,7,1,8,3118
3,3,2,1,9,2,11,3118
4,4,2,3,11,5,16,3118
5,5,1,0,12,5,17,3118
6,6,0,0,12,5,17,3118
0,0,1,0,1,0,1,3119
1,1,2,0,3,0,3,3119
2,2,2,0,5,0,5,3119
3,3,1,0,6,0,6,3119
4,4,0,0,6,0,6,3119
0,0,1,0,1,0,1,3120
1,1,2,0,3,0,3,3120
2,2,0,0,3,0,3,3120
0,0,1,0,1,0,1,3121
1,1,0,0,1,0,1,3121
0,0,1,0,1,0,1,3122
1,1,0,0,1,0,1,3122
0,0,1,0,1,0,1,3123
1,1,1,0,2,0,2,3123
2,2,1,0,3,0,3,3123
3,3,0,1,3,1,4,3123
4,4,0,1,3,2,5,3123
5,5,0,0,3,2,5,3123
0,0,1,0,1,0,1,3124
1,1,0,0,1,0,1,3124
0,0,1,0,1,0,1,3125
1,1,0,1,1,1,2,3125
2,2,0,0,1,1,2,3125
0,0,1,0,1,0,1,3126
1,1,1,0,2,0,2,3126
2,2,1,0,3,0,3,3126
3,3,2,0,5,0,5,3126
4,4,2,0,7,0,7,3126
5,5,0,0,7,0,7,3126
0,0,1,0,1,0,1,3127
1,1,0,0,1,0,1,3127
0,0,1,0,1,0,1,3128
1,1,0,1,1,1,2,3128
2,2,0,1,1,2,3,3128
3,3,0,2,1,4,5,3128
4,4,1,1,2,5,7,3128
5,5,0,1,2,6,8,3128
6,6,0,0,2,6,8,3128
0,0,1,0,1,0,1,3129
1,1,2,1,3,1,4,3129
2,2,1,2,4,3,7,3129
3,3,0,1,4,4,8,3129
4,4,0,0,4,4,8,3129
0,0,1,0,1,0,1,3130
1,1,1,0,2,0,2,3130
2,2,0,0,2,0,2,3130
0,0,1,0,1,0,1,3131
1,1,0,0,1,0,1,3131
0,0,1,0,1,0,1,3132
1,1,2,1,3,1,4,3132
2,2,1,2,4,3,7,3132
3,3,2,1,6,4,10,3132
4,4,0,4,6,8,14,3132
5,5,0,1,6,9,15,3132
6,6,0,3,6,12,18,3132
7,7,0,2,6,14,20,3132
8,8,1,1,7,15,22,3132
9,9,1,2,8,17,25,3132
10,10,0,1,8,18,26,3132
11,11,0,0,8,18,26,3132
0,0,1,0,1,0,1,3133
1,1,1,1,2,1,3,3133
2,2,2,3,4,4,8,3133
3,3,1,3,5,7,12,3133
4,4,2,2,7,9,16,3133
5,5,4,3,11,12,23,3133
6,6,4,2,15,14,29,3133
7,7,1,2,16,16,32,3133
8,8,1,0,17,16,33,3133
9,9,0,0,17,16,33,3133
0,0,1,0,1,0,1,3134
1,1,0,0,1,0,1,3134
0,0,1,0,1,0,1,3135
1,1,2,0,3,0,3,3135
2,2,1,1,4,1,5,3135
3,3,2,0,6,1,7,3135
4,4,1,0,7,1,8,3135
5,5,0,0,7,1,8,3135
0,0,1,0,1,0,1,3136
1,1,0,0,1,0,1,3136
0,0,1,0,1,0,1,3137
1,1,2,1,3,1,4,3137
2,2,1,1,4,2,6,3137
3,3,1,0,5,2,7,3137
4,4,1,0,6,2,8,3137
5,5,1,0,7,2,9,3137
6,6,0,0,7,2,9,3137
0,0,1,0,1,0,1,3138
1,1,0,0,1,0,1,3138
0,0,1,0,1,0,1,3139
1,1,2,0,3,0,3,3139
2,2,0,0,3,0,3,3139
0,0,1,0,1,0,1,3140
1,1,0,0,1,0,1,3140
0,0,1,0,1,0,1,3141
1,1,1,0,2,0,2,3141
2,2,0,1,2,1,3,3141
3,3,0,1,2,2,4,3141
4,4,0,1,2,3,5,3141
5,5,0,2,2,5,7,3141
6,6,0,2,2,7,9,3141
7,7,0,4,2,11,13,3141
8,8,1,1,3,12,15,3141
9,9,0,0,3,12,15,3141
0,0,1,0,1,0,1,3142
1,1,3,0,4,0,4,3142
2,2,2,1,6,1,7,3142
3,3,0,1,6,2,8,3142
4,4,0,3,6,5,11,3142
5,5,1,4,7,9,16,3142
6,6,2,5,9,14,23,3142
7,7,2,6,11,20,31,3142
8,8,3,2,14,22,36,3142
9,9,3,2,17,24,41,3142
10,10,4,1,21,25,46,3142
11,11,1,3,22,28,50,3142
12,12,4,0,26,28,54,3142
13,13,6,2,32,30,62,3142
14,14,3,0,35,30,65,3142
15,15,4,0,39,30,69,3142
16,16,2,1,41,31,72,3142
17,17,1,2,42,33,75,3142
18,18,0,2,42,35,77,3142
19,19,0,3,42,38,80,3142
20,20,0,3,42,41,83,3142
21,21,1,5,43,46,89,3142
22,22,1,3,44,49,93,3142
23,23,4,2,48,51,99,3142
24,24,3,3,51,54,105,3142
25,25,2,4,53,58,111,3142
26,26,2,7,55,65,120,3142
27,27,2,5,57,70,127,3142
28,28,2,3,59,73,132,3142
29,29,1,3,60,76,136,3142
30,30,0,0,60,76,136,3142
0,0,1,0,1,0,1,3143
1,1,0,0,1,0,1,3143
0,0,1,0,1,0,1,3144
1,1,1,0,2,0,2,3144
2,2,1,0,3,0,3,3144
3,3,1,1,4,1,5,3144
4,4,1,0,5,1,6,3144
5,5,0,0,5,1,6,3144
0,0,1,0,1,0,1,3145
1,1,1,0,2,0,2,3145
2,2,1,0,3,0,3,3145
3,3,0,1,3,1,4,3145
4,4,0,2,3,3,6,3145
5,5,1,3,4,6,10,3145
6,6,3,2,7,8,15,3145
7,7,3,2,10,10,20,3145
8,8,3,3,13,13,26,3145
9,9,1,1,14,14,28,3145
10,10,1,0,15,14,29,3145
11,11,0,0,15,14,29,3145
0,0,1,0,1,0,1,3146
1,1,1,0,2,0,2,3146
2,2,0,2,2,2,4,3146
3,3,0,3,2,5,7,3146
4,4,0,1,2,6,8,3146
5,5,0,0,2,6,8,3146
0,0,1,0,1,0,1,3147
1,1,1,1,2,1,3,3147
2,2,0,1,2,2,4,3147
3,3,0,0,2,2,4,3147
0,0,1,0,1,0,1,3148
1,1,1,0,2,0,2,3148
2,2,1,0,3,0,3,3148
3,3,1,0,4,0,4,3148
4,4,0,0,4,0,4,3148
0,0,1,0,1,0,1,3149
1,1,0,1,1,1,2,3149
2,2,0,1,1,2,3,3149
3,3,0,1,1,3,4,3149
4,4,1,0,2,3,5,3149
5,5,1,0,3,3,6,3149
6,6,2,0,5,3,8,3149
7,7,1,0,6,3,9,3149
8,8,2,1,8,4,12,3149
9,9,0,3,8,7,15,3149
10,10,0,3,8,10,18,3149
11,11,0,2,8,12,20,3149
12,12,0,1,8,13,21,3149
13,13,1,2,9,15,24,3149
14,14,1,0,10,15,25,3149
15,15,2,0,12,15,27,3149
16,16,3,0,15,15,30,3149
17,17,4,1,19,16,35,3149
18,18,2,1,21,17,38,3149
19,19,0,1,21,18,39,3149
20,20,0,1,21,19,40,3149
21,21,1,0,22,19,41,3149
22,22,1,1,23,20,43,3149
23,23,1,2,24,22,46,3149
24,24,0,2,24,24,48,3149
25,25,0,0,24,24,48,3149
0,0,1,0,1,0,1,3150
1,1,0,0,1,0,1,3150
0,0,1,0,1,0,1,3151
1,1,2,0,3,0,3,3151
2,2,2,0,5,0,5,3151
3,3,2,0,7,0,7,3151
4,4,0,1,7,1,8,3151
5,5,0,0,7,1,8,3151
0,0,1,0,1,0,1,3152
1,1,1,0,2,0,2,3152
2,2,2,0,4,0,4,3152
3,3,1,0,5,0,5,3152
4,4,3,0,8,0,8,3152
5,5,1,0,9,0,9,3152
6,6,0,0,9,0,9,3152
0,0,1,0,1,0,1,3153
1,1,0,0,1,0,1,3153
0,0,1,0,1,0,1,3154
1,1,0,1,1,1,2,3154
2,2,1,1,2,2,4,3154
3,3,0,5,2,7,9,3154
4,4,0,1,2,8,10,3154
5,5,1,0,3,8,11,3154
6,6,1,0,4,8,12,3154
7,7,1,0,5,8,13,3154
8,8,1,0,6,8,14,3154
9,9,0,0,6,8,14,3154
0,0,1,0,1,0,1,3155
1,1,0,0,1,0,1,3155
0,0,1,0,1,0,1,3156
1,1,1,0,2,0,2,3156
2,2,1,0,3,0,3,3156
3,3,1,0,4,0,4,3156
4,4,1,0,5,0,5,3156
5,5,1,1,6,1,7,3156
6,6,0,1,6,2,8,3156
7,7,1,0,7,2,9,3156
8,8,1,0,8,2,10,3156
9,9,0,0,8,2,10,3156
0,0,1,0,1,0,1,3157
1,1,0,0,1,0,1,3157
0,0,1,0,1,0,1,3158
1,1,1,0,2,0,2,3158
2,2,2,0,4,0,4,3158
3,3,1,1,5,1,6,3158
4,4,2,0,7,1,8,3158
5,5,0,0,7,1,8,3158
0,0,1,0,1,0,1,3159
1,1,1,0,2,0,2,3159
2,2,0,0,2,0,2,3159
0,0,1,0,1,0,1,3160
1,1,0,0,1,0,1,3160
0,0,1,0,1,0,1,3161
1,1,0,0,1,0,1,3161
0,0,1,0,1,0,1,3162
1,1,0,1,1,1,2,3162
2,2,0,0,1,1,2,3162
0,0,1,0,1,0,1,3163
1,1,0,1,1,1,2,3163
2,2,0,1,1,2,3,3163
3,3,1,2,2,4,6,3163
4,4,3,1,5,5,10,3163
5,5,3,0,8,5,13,3163
6,6,3,1,11,6,17,3163
7,7,3,0,14,6,20,3163
8,8,2,1,16,7,23,3163
9,9,1,2,17,9,26,3163
10,10,0,1,17,10,27,3163
11,11,0,1,17,11,28,3163
12,12,0,1,17,12,29,3163
13,13,0,0,17,12,29,3163
0,0,1,0,1,0,1,3164
1,1,1,0,2,0,2,3164
2,2,0,0,2,0,2,3164
0,0,1,0,1,0,1,3165
1,1,0,0,1,0,1,3165
0,0,1,0,1,0,1,3166
1,1,0,1,1,1,2,3166
2,2,0,1,1,2,3,3166
3,3,0,1,1,3,4,3166
4,4,0,1,1,4,5,3166
5,5,0,0,1,4,5,3166
0,0,1,0,1,0,1,3167
1,1,0,0,1,0,1,3167
0,0,1,0,1,0,1,3168
1,1,1,0,2,0,2,3168
2,2,1,0,3,0,3,3168
3,3,0,0,3,0,3,3168
0,0,1,0,1,0,1,3169
1,1,0,0,1,0,1,3169
0,0,1,0,1,0,1,3170
1,1,1,0,2,0,2,3170
2,2,0,1,2,1,3,3170
3,3,0,1,2,2,4,3170
4,4,0,0,2,2,4,3170
0,0,1,0,1,0,1,3171
1,1,1,0,2,0,2,3171
2,2,0,0,2,0,2,3171
0,0,1,0,1,0,1,3172
1,1,1,0,2,0,2,3172
2,2,0,0,2,0,2,3172
0,0,1,0,1,0,1,3173
1,1,0,0,1,0,1,3173
0,0,1,0,1,0,1,3174
1,1,1,1,2,1,3,3174
2,2,1,0,3,1,4,3174
3,3,1,0,4,1,5,3174
4,4,1,0,5,1,6,3174
5,5,0,1,5,2,7,3174
6,6,0,1,5,3,8,3174
7,7,0,2,5,5,10,3174
8,8,2,3,7,8,15,3174
9,9,1,4,8,12,20,3174
10,10,1,1,9,13,22,3174
11,11,1,1,10,14,24,3174
12,12,1,2,11,16,27,3174
13,13,0,3,11,19,30,3174
14,14,1,3,12,22,34,3174
15,15,3,1,15,23,38,3174
16,16,3,1,18,24,42,3174
17,17,3,1,21,25,46,3174
18,18,0,2,21,27,48,3174
19,19,1,2,22,29,51,3174
20,20,2,1,24,30,54,3174
21,21,1,4,25,34,59,3174
22,22,1,4,26,38,64,3174
23,23,2,2,28,40,68,3174
24,24,2,4,30,44,74,3174
25,25,1,2,31,46,77,3174
26,26,2,0,33,46,79,3174
27,27,2,0,35,46,81,3174
28,28,1,0,36,46,82,3174
29,29,0,0,36,46,82,3174
0,0,1,0,1,0,1,3175
1,1,0,0,1,0,1,3175
0,0,1,0,1,0,1,3176
1,1,1,0,2,0,2,3176
2,2,2,0,4,0,4,3176
3,3,1,0,5,0,5,3176
4,4,0,0,5,0,5,3176
0,0,1,0,1,0,1,3177
1,1,1,0,2,0,2,3177
2,2,0,0,2,0,2,3177
0,0,1,0,1,0,1,3178
1,1,1,0,2,0,2,3178
2,2,1,2,3,2,5,3178
3,3,0,4,3,6,9,3178
4,4,2,2,5,8,13,3178
5,5,2,2,7,10,17,3178
6,6,3,0,10,10,20,3178
7,7,1,2,11,12,23,3178
8,8,1,2,12,14,26,3178
9,9,0,1,12,15,27,3178
10,10,0,1,12,16,28,3178
11,11,0,2,12,18,30,3178
12,12,0,2,12,20,32,3178
13,13,0,5,12,25,37,3178
14,14,1,5,13,30,43,3178
15,15,1,6,14,36,50,3178
16,16,1,2,15,38,53,3178
17,17,1,4,16,42,58,3178
18,18,2,3,18,45,63,3178
19,19,3,1,21,46,67,3178
20,20,3,1,24,47,71,3178
21,21,2,0,26,47,73,3178
22,22,2,1,28,48,76,3178
23,23,3,3,31,51,82,3178
24,24,5,3,36,54,90,3178
25,25,2,4,38,58,96,3178
26,26,1,1,39,59,98,3178
27,27,1,0,40,59,99,3178
28,28,0,0,40,59,99,3178
0,0,1,0,1,0,1,3179
1,1,0,0,1,0,1,3179
0,0,1,0,1,0,1,3180
1,1,0,0,1,0,1,3180
0,0,1,0,1,0,1,3181
1,1,0,0,1,0,1,3181
0,0,1,0,1,0,1,3182
1,1,1,0,2,0,2,3182
2,2,0,0,2,0,2,3182
0,0,1,0,1,0,1,3183
1,1,0,0,1,0,1,3183
0,0,1,0,1,0,1,3184
1,1,0,1,1,1,2,3184
2,2,0,0,1,1,2,3184
0,0,1,0,1,0,1,3185
1,1,1,0,2,0,2,3185
2,2,2,0,4,0,4,3185
3,3,1,0,5,0,5,3185
4,4,0,0,5,0,5,3185
0,0,1,0,1,0,1,3186
1,1,2,0,3,0,3,3186
2,2,3,2,6,2,8,3186
3,3,1,1,7,3,10,3186
4,4,1,1,8,4,12,3186
5,5,2,1,10,5,15,3186
6,6,0,0,10,5,15,3186
0,0,1,0,1,0,1,3187
1,1,0,0,1,0,1,3187
0,0,1,0,1,0,1,3188
1,1,0,0,1,0,1,3188
0,0,1,0,1,0,1,3189
1,1,1,0,2,0,2,3189
2,2,0,1,2,1,3,3189
3,3,0,1,2,2,4,3189
4,4,0,2,2,4,6,3189
5,5,0,0,2,4,6,3189
0,0,1,0,1,0,1,3190
1,1,0,0,1,0,1,3190
0,0,1,0,1,0,1,3191
1,1,0,1,1,1,2,3191
2,2,0,0,1,1,2,3191
0,0,1,0,1,0,1,3192
1,1,2,0,3,0,3,3192
2,2,0,1,3,1,4,3192
3,3,1,0,4,1,5,3192
4,4,1,0,5,1,6,3192
5,5,0,0,5,1,6,3192
0,0,1,0,1,0,1,3193
1,1,2,0,3,0,3,3193
2,2,0,0,3,0,3,3193
0,0,1,0,1,0,1,3194
1,1,0,0,1,0,1,3194
0,0,1,0,1,0,1,3195
1,1,0,1,1,1,2,3195
2,2,0,2,1,3,4,3195
3,3,0,3,1,6,7,3195
4,4,1,2,2,8,10,3195
5,5,0,3,2,11,13,3195
6,6,0,0,2,11,13,3195
0,0,1,0,1,0,1,3196
1,1,1,0,2,0,2,3196
2,2,0,0,2,0,2,3196
0,0,1,0,1,0,1,3197
1,1,1,0,2,0,2,3197
2,2,2,0,4,0,4,3197
3,3,4,1,8,1,9,3197
4,4,3,3,11,4,15,3197
5,5,2,2,13,6,19,3197
6,6,6,2,19,8,27,3197
7,7,4,2,23,10,33,3197
8,8,1,4,24,14,38,3197
9,9,1,4,25,18,43,3197
10,10,3,2,28,20,48,3197
11,11,0,1,28,21,49,3197
12,12,0,0,28,21,49,3197
0,0,1,0,1,0,1,3198
1,1,0,0,1,0,1,3198
0,0,1,0,1,0,1,3199
1,1,0,1,1,1,2,3199
2,2,0,0,1,1,2,3199
0,0,1,0,1,0,1,3200
1,1,0,1,1,1,2,3200
2,2,0,2,1,3,4,3200
3,3,1,1,2,4,6,3200
4,4,2,2,4,6,10,3200
5,5,1,2,5,8,13,3200
6,6,0,1,5,9,14,3200
7,7,0,2,5,11,16,3200
8,8,0,1,5,12,17,3200
9,9,0,1,5,13,18,3200
10,10,0,0,5,13,18,3200
0,0,1,0,1,0,1,3201
1,1,1,0,2,0,2,3201
2,2,0,0,2,0,2,3201
0,0,1,0,1,0,1,3202
1,1,0,0,1,0,1,3202
0,0,1,0,1,0,1,3203
1,1,1,0,2,0,2,3203
2,2,1,0,3,0,3,3203
3,3,0,0,3,0,3,3203
0,0,1,0,1,0,1,3204
1,1,2,0,3,0,3,3204
2,2,1,0,4,0,4,3204
3,3,1,0,5,0,5,3204
4,4,0,1,5,1,6,3204
5,5,0,0,5,1,6,3204
0,0,1,0,1,0,1,3205
1,1,1,0,2,0,2,3205
2,2,0,0,2,0,2,3205
0,0,1,0,1,0,1,3206
1,1,1,0,2,0,2,3206
2,2,0,0,2,0,2,3206
0,0,1,0,1,0,1,3207
1,1,2,0,3,0,3,3207
2,2,0,0,3,0,3,3207
0,0,1,0,1,0,1,3208
1,1,1,0,2,0,2,3208
2,2,0,0,2,0,2,3208
0,0,1,0,1,0,1,3209
1,1,0,0,1,0,1,3209
0,0,1,0,1,0,1,3210
1,1,0,0,1,0,1,3210
0,0,1,0,1,0,1,3211
1,1,1,0,2,0,2,3211
2,2,1,0,3,0,3,3211
3,3,1,0,4,0,4,3211
4,4,0,0,4,0,4,3211
0,0,1,0,1,0,1,3212
1,1,1,0,2,0,2,3212
2,2,0,0,2,0,2,3212
0,0,1,0,1,0,1,3213
1,1,0,1,1,1,2,3213
2,2,0,0,1,1,2,3213
0,0,1,0,1,0,1,3214
1,1,0,0,1,0,1,3214
0,0,1,0,1,0,1,3215
1,1,0,0,1,0,1,3215
0,0,1,0,1,0,1,3216
1,1,0,1,1,1,2,3216
2,2,0,0,1,1,2,3216
0,0,1,0,1,0,1,3217
1,1,0,0,1,0,1,3217
0,0,1,0,1,0,1,3218
1,1,1,0,2,0,2,3218
2,2,0,2,2,2,4,3218
3,3,0,2,2,4,6,3218
4,4,0,2,2,6,8,3218
5,5,0,0,2,6,8,3218
0,0,1,0,1,0,1,3219
1,1,0,0,1,0,1,3219
0,0,1,0,1,0,1,3220
1,1,0,0,1,0,1,3220
0,0,1,0,1,0,1,3221
1,1,1,0,2,0,2,3221
2,2,1,0,3,0,3,3221
3,3,0,0,3,0,3,3221
0,0,1,0,1,0,1,3222
1,1,0,0,1,0,1,3222
0,0,1,0,1,0,1,3223
1,1,0,0,1,0,1,3223
0,0,1,0,1,0,1,3224
1,1,0,0,1,0,1,3224
0,0,1,0,1,0,1,3225
1,1,2,0,3,0,3,3225
2,2,1,0,4,0,4,3225
3,3,0,0,4,0,4,3225
0,0,1,0,1,0,1,3226
1,1,0,0,1,0,1,3226
0,0,1,0,1,0,1,3227
1,1,1,0,2,0,2,3227
2,2,0,0,2,0,2,3227
0,0,1,0,1,0,1,3228
1,1,1,1,2,1,3,3228
2,2,3,1,5,2,7,3228
3,3,3,2,8,4,12,3228
4,4,2,1,10,5,15,3228
5,5,3,1,13,6,19,3228
6,6,2,1,15,7,22,3228
7,7,0,1,15,8,23,3228
8,8,0,1,15,9,24,3228
9,9,0,0,15,9,24,3228
0,0,1,0,1,0,1,3229
1,1,0,0,1,0,1,3229
0,0,1,0,1,0,1,3230
1,1,0,1,1,1,2,3230
2,2,0,0,1,1,2,3230
0,0,1,0,1,0,1,3231
1,1,0,0,1,0,1,3231
0,0,1,0,1,0,1,3232
1,1,0,0,1,0,1,3232
0,0,1,0,1,0,1,3233
1,1,0,0,1,0,1,3233
0,0,1,0,1,0,1,3234
1,1,1,0,2,0,2,3234
2,2,1,0,3,0,3,3234
3,3,0,0,3,0,3,3234
0,0,1,0,1,0,1,3235
1,1,0,0,1,0,1,3235
0,0,1,0,1,0,1,3236
1,1,0,0,1,0,1,3236
0,0,1,0,1,0,1,3237
1,1,0,0,1,0,1,3237
0,0,1,0,1,0,1,3238
1,1,0,0,1,0,1,3238
0,0,1,0,1,0,1,3239
1,1,3,0,4,0,4,3239
2,2,4,0,8,0,8,3239
3,3,4,1,12,1,13,3239
4,4,5,2,17,3,20,3239
5,5,1,1,18,4,22,3239
6,6,1,0,19,4,23,3239
7,7,0,1,19,5,24,3239
8,8,1,0,20,5,25,3239
9,9,0,0,20,5,25,3239
0,0,1,0,1,0,1,3240
1,1,0,0,1,0,1,3240
0,0,1,0,1,0,1,3241
1,1,2,0,3,0,3,3241
2,2,1,1,4,1,5,3241
3,3,0,2,4,3,7,3241
4,4,0,1,4,4,8,3241
5,5,0,1,4,5,9,3241
6,6,0,2,4,7,11,3241
7,7,0,1,4,8,12,3241
8,8,0,0,4,8,12,3241
0,0,1,0,1,0,1,3242
1,1,0,0,1,0,1,3242
0,0,1,0,1,0,1,3243
1,1,3,0,4,0,4,3243
2,2,0,1,4,1,5,3243
3,3,1,1,5,2,7,3243
4,4,1,1,6,3,9,3243
5,5,2,0,8,3,11,3243
6,6,4,1,12,4,16,3243
7,7,2,2,14,6,20,3243
8,8,1,1,15,7,22,3243
9,9,3,0,18,7,25,3243
10,10,1,0,19,7,26,3243
11,11,0,0,19,7,26,3243
0,0,1,0,1,0,1,3244
1,1,1,0,2,0,2,3244
2,2,1,0,3,0,3,3244
3,3,3,0,6,0,6,3244
4,4,1,0,7,0,7,3244
5,5,1,0,8,0,8,3244
6,6,0,0,8,0,8,3244
0,0,1,0,1,0,1,3245
1,1,0,0,1,0,1,3245
0,0,1,0,1,0,1,3246
1,1,1,0,2,0,2,3246
2,2,2,0,4,0,4,3246
3,3,0,1,4,1,5,3246
4,4,0,0,4,1,5,3246
0,0,1,0,1,0,1,3247
1,1,2,1,3,1,4,3247
2,2,0,1,3,2,5,3247
3,3,0,1,3,3,6,3247
4,4,0,3,3,6,9,3247
5,5,1,3,4,9,13,3247
6,6,2,0,6,9,15,3247
7,7,3,1,9,10,19,3247
8,8,3,0,12,10,22,3247
9,9,2,1,14,11,25,3247
10,10,2,0,16,11,27,3247
11,11,0,0,16,11,27,3247
0,0,1,0,1,0,1,3248
1,1,1,0,2,0,2,3248
2,2,0,0,2,0,2,3248
0,0,1,0,1,0,1,3249
1,1,1,0,2,0,2,3249
2,2,2,0,4,0,4,3249
3,3,0,0,4,0,4,3249
0,0,1,0,1,0,1,3250
1,1,1,1,2,1,3,3250
2,2,1,1,3,2,5,3250
3,3,0,0,3,2,5,3250
0,0,1,0,1,0,1,3251
1,1,0,0,1,0,1,3251
0,0,1,0,1,0,1,3252
1,1,1,0,2,0,2,3252
2,2,0,0,2,0,2,3252
0,0,1,0,1,0,1,3253
1,1,1,0,2,0,2,3253
2,2,1,0,3,0,3,3253
3,3,2,0,5,0,5,3253
4,4,0,0,5,0,5,3253
0,0,1,0,1,0,1,3254
1,1,0,0,1,0,1,3254
0,0,1,0,1,0,1,3255
1,1,2,1,3,1,4,3255
2,2,3,1,6,2,8,3255
3,3,0,0,6,2,8,3255
0,0,1,0,1,0,1,3256
1,1,2,0,3,0,3,3256
2,2,1,1,4,1,5,3256
3,3,1,0,5,1,6,3256
4,4,2,0,7,1,8,3256
5,5,2,0,9,1,10,3256
6,6,0,1,9,2,11,3256
7,7,0,1,9,3,12,3256
8,8,0,0,9,3,12,3256
0,0,1,0,1,0,1,3257
1,1,0,0,1,0,1,3257
0,0,1,0,1,0,1,3258
1,1,1,0,2,0,2,3258
2,2,1,1,3,1,4,3258
3,3,0,0,3,1,4,3258
0,0,1,0,1,0,1,3259
1,1,1,0,2,0,2,3259
2,2,1,1,3,1,4,3259
3,3,0,0,3,1,4,3259
0,0,1,0,1,0,1,3260
1,1,1,1,2,1,3,3260
2,2,5,1,7,2,9,3260
3,3,4,2,11,4,15,3260
4,4,2,1,13,5,18,3260
5,5,2,0,15,5,20,3260
6,6,3,0,18,5,23,3260
7,7,3,0,21,5,26,3260
8,8,3,1,24,6,30,3260
9,9,1,1,25,7,32,3260
10,10,2,2,27,9,36,3260
11,11,1,1,28,10,38,3260
12,12,0,2,28,12,40,3260
13,13,0,1,28,13,41,3260
14,14,0,1,28,14,42,3260
15,15,1,0,29,14,43,3260
16,16,2,1,31,15,46,3260
17,17,2,2,33,17,50,3260
18,18,1,4,34,21,55,3260
19,19,2,1,36,22,58,3260
20,20,1,0,37,22,59,3260
21,21,1,1,38,23,61,3260
22,22,2,0,40,23,63,3260
23,23,3,0,43,23,66,3260
24,24,3,0,46,23,69,3260
25,25,2,0,48,23,71,3260
26,26,2,0,50,23,73,3260
27,27,4,1,54,24,78,3260
28,28,2,2,56,26,82,3260
29,29,2,2,58,28,86,3260
30,30,1,4,59,32,91,3260
31,31,0,2,59,34,93,3260
32,32,1,1,60,35,95,3260
33,33,0,4,60,39,99,3260
34,34,1,4,61,43,104,3260
35,35,2,1,63,44,107,3260
36,36,1,2,64,46,110,3260
37,37,2,0,66,46,112,3260
38,38,0,0,66,46,112,3260
0,0,1,0,1,0,1,3261
1,1,1,0,2,0,2,3261
2,2,1,0,3,0,3,3261
3,3,1,0,4,0,4,3261
4,4,0,0,4,0,4,3261
0,0,1,0,1,0,1,3262
1,1,0,1,1,1,2,3262
2,2,0,0,1,1,2,3262
0,0,1,0,1,0,1,3263
1,1,0,1,1,1,2,3263
2,2,1,0,2,1,3,3263
3,3,1,0,3,1,4,3263
4,4,0,0,3,1,4,3263
0,0,1,0,1,0,1,3264
1,1,1,1,2,1,3,3264
2,2,2,1,4,2,6,3264
3,3,3,1,7,3,10,3264
4,4,2,3,9,6,15,3264
5,5,1,2,10,8,18,3264
6,6,1,2,11,10,21,3264
7,7,0,1,11,11,22,3264
8,8,0,2,11,13,24,3264
9,9,0,3,11,16,27,3264
10,10,0,3,11,19,30,3264
11,11,0,1,11,20,31,3264
12,12,0,1,11,21,32,3264
13,13,0,0,11,21,32,3264
0,0,1,0,1,0,1,3265
1,1,0,0,1,0,1,3265
0,0,1,0,1,0,1,3266
1,1,1,0,2,0,2,3266
2,2,1,0,3,0,3,3266
3,3,1,1,4,1,5,3266
4,4,1,1,5,2,7,3266
5,5,1,1,6,3,9,3266
6,6,0,1,6,4,10,3266
7,7,0,1,6,5,11,3266
8,8,0,0,6,5,11,3266
0,0,1,0,1,0,1,3267
1,1,0,1,1,1,2,3267
2,2,0,0,1,1,2,3267
0,0,1,0,1,0,1,3268
1,1,2,1,3,1,4,3268
2,2,2,1,5,2,7,3268
3,3,4,1,9,3,12,3268
4,4,4,1,13,4,17,3268
5,5,2,2,15,6,21,3268
6,6,2,1,17,7,24,3268
7,7,3,4,20,11,31,3268
8,8,2,4,22,15,37,3268
9,9,2,3,24,18,42,3268
10,10,2,1,26,19,45,3268
11,11,3,2,29,21,50,3268
12,12,2,2,31,23,54,3268
13,13,0,2,31,25,56,3268
14,14,0,2,31,27,58,3268
15,15,1,0,32,27,59,3268
16,16,0,0,32,27,59,3268
0,0,1,0,1,0,1,3269
1,1,2,0,3,0,3,3269
2,2,1,2,4,2,6,3269
3,3,4,3,8,5,13,3269
4,4,11,3,19,8,27,3269
5,5,5,6,24,14,38,3269
6,6,6,0,30,14,44,3269
7,7,2,2,32,16,48,3269
8,8,2,0,34,16,50,3269
9,9,1,1,35,17,52,3269
10,10,1,2,36,19,55,3269
11,11,0,1,36,20,56,3269
12,12,0,1,36,21,57,3269
13,13,1,2,37,23,60,3269
14,14,0,2,37,25,62,3269
15,15,0,2,37,27,64,3269
16,16,0,4,37,31,68,3269
17,17,3,2,40,33,73,3269
18,18,2,5,42,38,80,3269
19,19,1,5,43,43,86,3269
20,20,0,2,43,45,88,3269
21,21,0,3,43,48,91,3269
22,22,1,2,44,50,94,3269
23,23,2,3,46,53,99,3269
24,24,3,6,49,59,108,3269
25,25,2,5,51,64,115,3269
26,26,3,3,54,67,121,3269
27,27,5,4,59,71,130,3269
28,28,2,3,61,74,135,3269
29,29,1,1,62,75,137,3269
30,30,2,0,64,75,139,3269
31,31,2,0,66,75,141,3269
32,32,1,0,67,75,142,3269
33,33,0,1,67,76,143,3269
34,34,0,0,67,76,143,3269
0,0,1,0,1,0,1,3270
1,1,0,0,1,0,1,3270
0,0,1,0,1,0,1,3271
1,1,1,0,2,0,2,3271
2,2,0,0,2,0,2,3271
0,0,1,0,1,0,1,3272
1,1,2,0,3,0,3,3272
2,2,2,1,5,1,6,3272
3,3,1,1,6,2,8,3272
4,4,1,1,7,3,10,3272
5,5,1,0,8,3,11,3272
6,6,1,0,9,3,12,3272
7,7,2,0,11,3,14,3272
8,8,4,0,15,3,18,3272
9,9,0,0,15,3,18,3272
0,0,1,0,1,0,1,3273
1,1,2,0,3,0,3,3273
2,2,3,1,6,1,7,3273
3,3,6,4,12,5,17,3273
4,4,5,4,17,9,26,3273
5,5,6,5,23,14,37,3273
6,6,3,6,26,20,46,3273
7,7,5,6,31,26,57,3273
8,8,9,5,40,31,71,3273
9,9,10,6,50,37,87,3273
10,10,5,5,55,42,97,3273
11,11,5,6,60,48,108,3273
12,12,2,4,62,52,114,3273
13,13,3,3,65,55,120,3273
14,14,4,3,69,58,127,3273
15,15,2,2,71,60,131,3273
16,16,1,3,72,63,135,3273
17,17,2,1,74,64,138,3273
18,18,3,0,77,64,141,3273
19,19,7,0,84,64,148,3273
20,20,6,0,90,64,154,3273
21,21,5,1,95,65,160,3273
22,22,1,1,96,66,162,3273
23,23,3,0,99,66,165,3273
24,24,0,2,99,68,167,3273
25,25,0,2,99,70,169,3273
26,26,0,0,99,70,169,3273
0,0,1,0,1,0,1,3274
1,1,1,0,2,0,2,3274
2,2,0,2,2,2,4,3274
3,3,1,1,3,3,6,3274
4,4,3,1,6,4,10,3274
5,5,3,3,9,7,16,3274
6,6,4,4,13,11,24,3274
7,7,5,1,18,12,30,3274
8,8,4,0,22,12,34,3274
9,9,4,0,26,12,38,3274
10,10,2,0,28,12,40,3274
11,11,2,0,30,12,42,3274
12,12,2,0,32,12,44,3274
13,13,2,1,34,13,47,3274
14,14,3,2,37,15,52,3274
15,15,2,2,39,17,56,3274
16,16,1,1,40,18,58,3274
17,17,2,1,42,19,61,3274
18,18,4,2,46,21,67,3274
19,19,2,2,48,23,71,3274
20,20,1,1,49,24,73,3274
21,21,2,0,51,24,75,3274
22,22,1,2,52,26,78,3274
23,23,0,1,52,27,79,3274
24,24,1,1,53,28,81,3274
25,25,0,1,53,29,82,3274
26,26,0,2,53,31,84,3274
27,27,1,2,54,33,87,3274
28,28,0,3,54,36,90,3274
29,29,0,3,54,39,93,3274
30,30,0,1,54,40,94,3274
31,31,2,0,56,40,96,3274
32,32,1,0,57,40,97,3274
33,33,1,0,58,40,98,3274
34,34,1,0,59,40,99,3274
35,35,2,0,61,40,101,3274
36,36,3,1,64,41,105,3274
37,37,0,2,64,43,107,3274
38,38,1,1,65,44,109,3274
39,39,1,2,66,46,112,3274
40,40,3,2,69,48,117,3274
41,41,3,2,72,50,122,3274
42,42,4,0,76,50,126,3274
43,43,2,1,78,51,129,3274
44,44,3,1,81,52,133,3274
45,45,4,2,85,54,139,3274
46,46,5,6,90,60,150,3274
47,47,9,5,99,65,164,3274
48,48,7,1,106,66,172,3274
49,49,5,3,111,69,180,3274
50,50,2,5,113,74,187,3274
51,51,4,4,117,78,195,3274
52,52,4,2,121,80,201,3274
53,53,1,2,122,82,204,3274
54,54,1,1,123,83,206,3274
55,55,4,1,127,84,211,3274
56,56,4,3,131,87,218,3274
57,57,2,5,133,92,225,3274
58,58,1,5,134,97,231,3274
59,59,3,8,137,105,242,3274
60,60,8,4,145,109,254,3274
61,61,3,4,148,113,261,3274
62,62,3,9,151,122,273,3274
63,63,3,6,154,128,282,3274
64,64,5,7,159,135,294,3274
65,65,2,10,161,145,306,3274
66,66,1,10,162,155,317,3274
67,67,1,12,163,167,330,3274
68,68,1,16,164,183,347,3274
69,69,2,8,166,191,357,3274
70,70,3,9,169,200,369,3274
71,71,5,8,174,208,382,3274
72,72,4,3,178,211,389,3274
73,73,1,3,179,214,393,3274
74,74,1,3,180,217,397,3274
75,75,0,1,180,218,398,3274
76,76,0,1,180,219,399,3274
77,77,0,0,180,219,399,3274
0,0,1,0,1,0,1,3275
1,1,0,0,1,0,1,3275
0,0,1,0,1,0,1,3276
1,1,1,0,2,0,2,3276
2,2,0,0,2,0,2,3276
0,0,1,0,1,0,1,3277
1,1,2,0,3,0,3,3277
2,2,0,0,3,0,3,3277
0,0,1,0,1,0,1,3278
1,1,0,0,1,0,1,3278
0,0,1,0,1,0,1,3279
1,1,1,0,2,0,2,3279
2,2,1,0,3,0,3,3279
3,3,0,0,3,0,3,3279
0,0,1,0,1,0,1,3280
1,1,0,0,1,0,1,3280
0,0,1,0,1,0,1,3281
1,1,2,0,3,0,3,3281
2,2,4,0,7,0,7,3281
3,3,3,1,10,1,11,3281
4,4,4,0,14,1,15,3281
5,5,2,0,16,1,17,3281
6,6,3,0,19,1,20,3281
7,7,2,0,21,1,22,3281
8,8,1,0,22,1,23,3281
9,9,0,0,22,1,23,3281
0,0,1,0,1,0,1,3282
1,1,0,0,1,0,1,3282
0,0,1,0,1,0,1,3283
1,1,1,1,2,1,3,3283
2,2,0,0,2,1,3,3283
0,0,1,0,1,0,1,3284
1,1,1,0,2,0,2,3284
2,2,0,0,2,0,2,3284
0,0,1,0,1,0,1,3285
1,1,0,0,1,0,1,3285
0,0,1,0,1,0,1,3286
1,1,1,1,2,1,3,3286
2,2,3,1,5,2,7,3286
3,3,3,0,8,2,10,3286
4,4,2,1,10,3,13,3286
5,5,0,1,10,4,14,3286
6,6,0,0,10,4,14,3286
0,0,1,0,1,0,1,3287
1,1,0,0,1,0,1,3287
0,0,1,0,1,0,1,3288
1,1,0,0,1,0,1,3288
0,0,1,0,1,0,1,3289
1,1,0,0,1,0,1,3289
0,0,1,0,1,0,1,3290
1,1,1,0,2,0,2,3290
2,2,1,0,3,0,3,3290
3,3,0,1,3,1,4,3290
4,4,0,0,3,1,4,3290
0,0,1,0,1,0,1,3291
1,1,1,1,2,1,3,3291
2,2,1,0,3,1,4,3291
3,3,1,0,4,1,5,3291
4,4,0,0,4,1,5,3291
0,0,1,0,1,0,1,3292
1,1,2,0,3,0,3,3292
2,2,1,0,4,0,4,3292
3,3,0,0,4,0,4,3292
0,0,1,0,1,0,1,3293
1,1,1,0,2,0,2,3293
2,2,1,0,3,0,3,3293
3,3,0,0,3,0,3,3293
0,0,1,0,1,0,1,3294
1,1,1,0,2,0,2,3294
2,2,0,0,2,0,2,3294
0,0,1,0,1,0,1,3295
1,1,1,0,2,0,2,3295
2,2,0,0,2,0,2,3295
0,0,1,0,1,0,1,3296
1,1,0,0,1,0,1,3296
0,0,1,0,1,0,1,3297
1,1,0,0,1,0,1,3297
0,0,1,0,1,0,1,3298
1,1,0,0,1,0,1,3298
0,0,1,0,1,0,1,3299
1,1,1,0,2,0,2,3299
2,2,0,0,2,0,2,3299
0,0,1,0,1,0,1,3300
1,1,2,1,3,1,4,3300
2,2,0,2,3,3,6,3300
3,3,0,3,3,6,9,3300
4,4,1,4,4,10,14,3300
5,5,1,2,5,12,17,3300
6,6,2,1,7,13,20,3300
7,7,0,1,7,14,21,3300
8,8,0,1,7,15,22,3300
9,9,0,1,7,16,23,3300
10,10,0,0,7,16,23,3300
0,0,1,0,1,0,1,3301
1,1,1,1,2,1,3,3301
2,2,0,1,2,2,4,3301
3,3,0,0,2,2,4,3301
0,0,1,0,1,0,1,3302
1,1,1,0,2,0,2,3302
2,2,0,0,2,0,2,3302
0,0,1,0,1,0,1,3303
1,1,1,0,2,0,2,3303
2,2,0,1,2,1,3,3303
3,3,1,2,3,3,6,3303
4,4,2,2,5,5,10,3303
5,5,3,5,8,10,18,3303
6,6,4,2,12,12,24,3303
7,7,5,1,17,13,30,3303
8,8,3,1,20,14,34,3303
9,9,1,3,21,17,38,3303
10,10,2,4,23,21,44,3303
11,11,2,6,25,27,52,3303
12,12,2,6,27,33,60,3303
13,13,4,2,31,35,66,3303
14,14,8,4,39,39,78,3303
15,15,7,1,46,40,86,3303
16,16,6,2,52,42,94,3303
17,17,5,2,57,44,101,3303
18,18,3,6,60,50,110,3303
19,19,1,7,61,57,118,3303
20,20,1,5,62,62,124,3303
21,21,3,4,65,66,131,3303
22,22,2,5,67,71,138,3303
23,23,2,5,69,76,145,3303
24,24,1,4,70,80,150,3303
25,25,3,4,73,84,157,3303
26,26,0,4,73,88,161,3303
27,27,1,3,74,91,165,3303
28,28,2,2,76,93,169,3303
29,29,3,3,79,96,175,3303
30,30,2,3,81,99,180,3303
31,31,2,4,83,103,186,3303
32,32,4,3,87,106,193,3303
33,33,3,3,90,109,199,3303
34,34,4,6,94,115,209,3303
35,35,2,1,96,116,212,3303
36,36,0,1,96,117,213,3303
37,37,0,0,96,117,213,3303
0,0,1,0,1,0,1,3304
1,1,1,0,2,0,2,3304
2,2,0,0,2,0,2,3304
0,0,1,0,1,0,1,3305
1,1,1,0,2,0,2,3305
2,2,1,0,3,0,3,3305
3,3,0,0,3,0,3,3305
0,0,1,0,1,0,1,3306
1,1,0,0,1,0,1,3306
0,0,1,0,1,0,1,3307
1,1,2,0,3,0,3,3307
2,2,3,0,6,0,6,3307
3,3,2,0,8,0,8,3307
4,4,1,2,9,2,11,3307
5,5,1,2,10,4,14,3307
6,6,1,3,11,7,18,3307
7,7,2,5,13,12,25,3307
8,8,1,3,14,15,29,3307
9,9,1,5,15,20,35,3307
10,10,3,3,18,23,41,3307
11,11,6,3,24,26,50,3307
12,12,7,4,31,30,61,3307
13,13,5,2,36,32,68,3307
14,14,2,2,38,34,72,3307
15,15,4,6,42,40,82,3307
16,16,3,11,45,51,96,3307
17,17,2,8,47,59,106,3307
18,18,1,5,48,64,112,3307
19,19,2,4,50,68,118,3307
20,20,2,1,52,69,121,3307
21,21,1,0,53,69,122,3307
22,22,0,0,53,69,122,3307
0,0,1,0,1,0,1,3308
1,1,0,1,1,1,2,3308
2,2,0,1,1,2,3,3308
3,3,1,0,2,2,4,3308
4,4,1,1,3,3,6,3308
5,5,0,1,3,4,7,3308
6,6,1,1,4,5,9,3308
7,7,1,0,5,5,10,3308
8,8,1,0,6,5,11,3308
9,9,1,0,7,5,12,3308
10,10,2,0,9,5,14,3308
11,11,2,1,11,6,17,3308
12,12,1,2,12,8,20,3308
13,13,1,0,13,8,21,3308
14,14,0,0,13,8,21,3308
0,0,1,0,1,0,1,3309
1,1,1,1,2,1,3,3309
2,2,1,1,3,2,5,3309
3,3,0,0,3,2,5,3309
0,0,1,0,1,0,1,3310
1,1,2,0,3,0,3,3310
2,2,0,3,3,3,6,3310
3,3,2,4,5,7,12,3310
4,4,8,4,13,11,24,3310
5,5,5,3,18,14,32,3310
6,6,5,6,23,20,43,3310
7,7,4,3,27,23,50,3310
8,8,1,6,28,29,57,3310
9,9,1,6,29,35,64,3310
10,10,3,4,32,39,71,3310
11,11,2,2,34,41,75,3310
12,12,1,4,35,45,80,3310
13,13,1,1,36,46,82,3310
14,14,0,1,36,47,83,3310
15,15,0,0,36,47,83,3310
0,0,1,0,1,0,1,3311
1,1,1,0,2,0,2,3311
2,2,0,0,2,0,2,3311
0,0,1,0,1,0,1,3312
1,1,1,0,2,0,2,3312
2,2,1,1,3,1,4,3312
3,3,0,2,3,3,6,3312
4,4,0,1,3,4,7,3312
5,5,0,0,3,4,7,3312
0,0,1,0,1,0,1,3313
1,1,0,0,1,0,1,3313
0,0,1,0,1,0,1,3314
1,1,0,0,1,0,1,3314
0,0,1,0,1,0,1,3315
1,1,0,0,1,0,1,3315
0,0,1,0,1,0,1,3316
1,1,3,0,4,0,4,3316
2,2,2,0,6,0,6,3316
3,3,2,0,8,0,8,3316
4,4,1,0,9,0,9,3316
5,5,1,0,10,0,10,3316
6,6,0,0,10,0,10,3316
0,0,1,0,1,0,1,3317
1,1,0,1,1,1,2,3317
2,2,1,0,2,1,3,3317
3,3,1,0,3,1,4,3317
4,4,1,1,4,2,6,3317
5,5,0,1,4,3,7,3317
6,6,0,0,4,3,7,3317
0,0,1,0,1,0,1,3318
1,1,0,0,1,0,1,3318
0,0,1,0,1,0,1,3319
1,1,3,0,4,0,4,3319
2,2,1,0,5,0,5,3319
3,3,1,0,6,0,6,3319
4,4,0,0,6,0,6,3319
0,0,1,0,1,0,1,3320
1,1,1,0,2,0,2,3320
2,2,3,0,5,0,5,3320
3,3,5,0,10,0,10,3320
4,4,4,1,14,1,15,3320
5,5,7,0,21,1,22,3320
6,6,4,2,25,3,28,3320
7,7,4,3,29,6,35,3320
8,8,4,2,33,8,41,3320
9,9,5,4,38,12,50,3320
10,10,5,3,43,15,58,3320
11,11,4,3,47,18,65,3320
12,12,3,1,50,19,69,3320
13,13,3,0,53,19,72,3320
14,14,4,1,57,20,77,3320
15,15,4,1,61,21,82,3320
16,16,2,2,63,23,86,3320
17,17,1,1,64,24,88,3320
18,18,0,1,64,25,89,3320
19,19,0,0,64,25,89,3320
0,0,1,0,1,0,1,3321
1,1,1,0,2,0,2,3321
2,2,1,0,3,0,3,3321
3,3,2,0,5,0,5,3321
4,4,0,1,5,1,6,3321
5,5,1,1,6,2,8,3321
6,6,1,0,7,2,9,3321
7,7,1,1,8,3,11,3321
8,8,3,1,11,4,15,3321
9,9,2,0,13,4,17,3321
10,10,1,1,14,5,19,3321
11,11,1,1,15,6,21,3321
12,12,0,1,15,7,22,3321
13,13,0,1,15,8,23,3321
14,14,0,0,15,8,23,3321
0,0,1,0,1,0,1,3322
1,1,3,0,4,0,4,3322
2,2,0,0,4,0,4,3322
0,0,1,0,1,0,1,3323
1,1,0,0,1,0,1,3323
0,0,1,0,1,0,1,3324
1,1,1,0,2,0,2,3324
2,2,0,0,2,0,2,3324
0,0,1,0,1,0,1,3325
1,1,2,1,3,1,4,3325
2,2,3,2,6,3,9,3325
3,3,0,2,6,5,11,3325
4,4,1,2,7,7,14,3325
5,5,1,0,8,7,15,3325
6,6,1,0,9,7,16,3325
7,7,1,0,10,7,17,3325
8,8,1,0,11,7,18,3325
9,9,0,0,11,7,18,3325
0,0,1,0,1,0,1,3326
1,1,1,0,2,0,2,3326
2,2,1,0,3,0,3,3326
3,3,0,0,3,0,3,3326
0,0,1,0,1,0,1,3327
1,1,0,0,1,0,1,3327
0,0,1,0,1,0,1,3328
1,1,0,1,1,1,2,3328
2,2,1,0,2,1,3,3328
3,3,0,0,2,1,3,3328
0,0,1,0,1,0,1,3329
1,1,0,1,1,1,2,3329
2,2,1,1,2,2,4,3329
3,3,0,2,2,4,6,3329
4,4,0,2,2,6,8,3329
5,5,1,1,3,7,10,3329
6,6,0,1,3,8,11,3329
7,7,0,1,3,9,12,3329
8,8,0,0,3,9,12,3329
0,0,1,0,1,0,1,3330
1,1,0,0,1,0,1,3330
0,0,1,0,1,0,1,3331
1,1,1,0,2,0,2,3331
2,2,1,0,3,0,3,3331
3,3,0,0,3,0,3,3331
0,0,1,0,1,0,1,3332
1,1,1,0,2,0,2,3332
2,2,0,0,2,0,2,3332
0,0,1,0,1,0,1,3333
1,1,2,0,3,0,3,3333
2,2,2,0,5,0,5,3333
3,3,1,1,6,1,7,3333
4,4,1,1,7,2,9,3333
5,5,1,1,8,3,11,3333
6,6,0,1,8,4,12,3333
7,7,0,0,8,4,12,3333
0,0,1,0,1,0,1,3334
1,1,0,0,1,0,1,3334
0,0,1,0,1,0,1,3335
1,1,0,1,1,1,2,3335
2,2,0,3,1,4,5,3335
3,3,0,2,1,6,7,3335
4,4,1,0,2,6,8,3335
5,5,0,0,2,6,8,3335
0,0,1,0,1,0,1,3336
1,1,2,0,3,0,3,3336
2,2,0,0,3,0,3,3336
0,0,1,0,1,0,1,3337
1,1,1,0,2,0,2,3337
2,2,0,1,2,1,3,3337
3,3,0,0,2,1,3,3337
0,0,1,0,1,0,1,3338
1,1,0,0,1,0,1,3338
0,0,1,0,1,0,1,3339
1,1,2,0,3,0,3,3339
2,2,1,0,4,0,4,3339
3,3,0,0,4,0,4,3339
0,0,1,0,1,0,1,3340
1,1,0,1,1,1,2,3340
2,2,0,0,1,1,2,3340
0,0,1,0,1,0,1,3341
1,1,0,1,1,1,2,3341
2,2,1,1,2,2,4,3341
3,3,2,2,4,4,8,3341
4,4,0,0,4,4,8,3341
0,0,1,0,1,0,1,3342
1,1,2,0,3,0,3,3342
2,2,1,0,4,0,4,3342
3,3,2,1,6,1,7,3342
4,4,1,2,7,3,10,3342
5,5,2,1,9,4,13,3342
6,6,1,1,10,5,15,3342
7,7,0,2,10,7,17,3342
8,8,1,1,11,8,19,3342
9,9,0,0,11,8,19,3342
0,0,1,0,1,0,1,3343
1,1,1,0,2,0,2,3343
2,2,1,0,3,0,3,3343
3,3,1,0,4,0,4,3343
4,4,0,0,4,0,4,3343
0,0,1,0,1,0,1,3344
1,1,0,0,1,0,1,3344
0,0,1,0,1,0,1,3345
1,1,1,0,2,0,2,3345
2,2,1,0,3,0,3,3345
3,3,0,0,3,0,3,3345
0,0,1,0,1,0,1,3346
1,1,0,0,1,0,1,3346
0,0,1,0,1,0,1,3347
1,1,0,0,1,0,1,3347
0,0,1,0,1,0,1,3348
1,1,1,0,2,0,2,3348
2,2,1,0,3,0,3,3348
3,3,0,0,3,0,3,3348
0,0,1,0,1,0,1,3349
1,1,2,3,3,3,6,3349
2,2,0,4,3,7,10,3349
3,3,0,5,3,12,15,3349
4,4,0,3,3,15,18,3349
5,5,0,2,3,17,20,3349
6,6,0,1,3,18,21,3349
7,7,1,1,4,19,23,3349
8,8,0,1,4,20,24,3349
9,9,0,1,4,21,25,3349
10,10,0,1,4,22,26,3349
11,11,0,0,4,22,26,3349
0,0,1,0,1,0,1,3350
1,1,0,0,1,0,1,3350
0,0,1,0,1,0,1,3351
1,1,1,1,2,1,3,3351
2,2,1,1,3,2,5,3351
3,3,2,1,5,3,8,3351
4,4,1,1,6,4,10,3351
5,5,0,0,6,4,10,3351
0,0,1,0,1,0,1,3352
1,1,1,0,2,0,2,3352
2,2,1,0,3,0,3,3352
3,3,1,0,4,0,4,3352
4,4,1,0,5,0,5,3352
5,5,2,0,7,0,7,3352
6,6,2,0,9,0,9,3352
7,7,4,0,13,0,13,3352
8,8,2,1,15,1,16,3352
9,9,3,0,18,1,19,3352
10,10,0,0,18,1,19,3352
0,0,1,0,1,0,1,3353
1,1,0,0,1,0,1,3353
0,0,1,0,1,0,1,3354
1,1,1,0,2,0,2,3354
2,2,1,1,3,1,4,3354
3,3,0,1,3,2,5,3354
4,4,0,0,3,2,5,3354
0,0,1,0,1,0,1,3355
1,1,2,0,3,0,3,3355
2,2,1,0,4,0,4,3355
3,3,0,1,4,1,5,3355
4,4,0,1,4,2,6,3355
5,5,0,0,4,2,6,3355
0,0,1,0,1,0,1,3356
1,1,0,0,1,0,1,3356
0,0,1,0,1,0,1,3357
1,1,1,0,2,0,2,3357
2,2,0,0,2,0,2,3357
0,0,1,0,1,0,1,3358
1,1,0,0,1,0,1,3358
0,0,1,0,1,0,1,3359
1,1,1,0,2,0,2,3359
2,2,0,0,2,0,2,3359
0,0,1,0,1,0,1,3360
1,1,1,0,2,0,2,3360
2,2,2,1,4,1,5,3360
3,3,3,0,7,1,8,3360
4,4,3,0,10,1,11,3360
5,5,1,0,11,1,12,3360
6,6,1,0,12,1,13,3360
7,7,2,0,14,1,15,3360
8,8,0,0,14,1,15,3360
0,0,1,0,1,0,1,3361
1,1,2,0,3,0,3,3361
2,2,1,0,4,0,4,3361
3,3,1,0,5,0,5,3361
4,4,1,0,6,0,6,3361
5,5,1,0,7,0,7,3361
6,6,1,1,8,1,9,3361
7,7,3,0,11,1,12,3361
8,8,4,0,15,1,16,3361
9,9,1,2,16,3,19,3361
10,10,1,2,17,5,22,3361
11,11,1,2,18,7,25,3361
12,12,0,1,18,8,26,3361
13,13,1,1,19,9,28,3361
14,14,0,0,19,9,28,3361
0,0,1,0,1,0,1,3362
1,1,1,0,2,0,2,3362
2,2,1,1,3,1,4,3362
3,3,2,2,5,3,8,3362
4,4,1,0,6,3,9,3362
5,5,1,0,7,3,10,3362
6,6,1,0,8,3,11,3362
7,7,2,0,10,3,13,3362
8,8,1,0,11,3,14,3362
9,9,1,0,12,3,15,3362
10,10,1,0,13,3,16,3362
11,11,2,0,15,3,18,3362
12,12,3,0,18,3,21,3362
13,13,0,0,18,3,21,3362
0,0,1,0,1,0,1,3363
1,1,0,0,1,0,1,3363
0,0,1,0,1,0,1,3364
1,1,0,0,1,0,1,3364
0,0,1,0,1,0,1,3365
1,1,2,0,3,0,3,3365
2,2,4,0,7,0,7,3365
3,3,3,1,10,1,11,3365
4,4,0,3,10,4,14,3365
5,5,2,1,12,5,17,3365
6,6,1,0,13,5,18,3365
7,7,1,0,14,5,19,3365
8,8,0,0,14,5,19,3365
0,0,1,0,1,0,1,3366
1,1,2,0,3,0,3,3366
2,2,2,0,5,0,5,3366
3,3,1,2,6,2,8,3366
4,4,1,0,7,2,9,3366
5,5,0,0,7,2,9,3366
0,0,1,0,1,0,1,3367
1,1,3,0,4,0,4,3367
2,2,2,0,6,0,6,3367
3,3,1,1,7,1,8,3367
4,4,1,0,8,1,9,3367
5,5,0,0,8,1,9,3367
0,0,1,0,1,0,1,3368
1,1,1,0,2,0,2,3368
2,2,0,0,2,0,2,3368
0,0,1,0,1,0,1,3369
1,1,2,1,3,1,4,3369
2,2,3,3,6,4,10,3369
3,3,3,6,9,10,19,3369
4,4,4,3,13,13,26,3369
5,5,5,0,18,13,31,3369
6,6,3,1,21,14,35,3369
7,7,0,2,21,16,37,3369
8,8,0,2,21,18,39,3369
9,9,0,1,21,19,40,3369
10,10,0,0,21,19,40,3369
0,0,1,0,1,0,1,3370
1,1,1,0,2,0,2,3370
2,2,0,0,2,0,2,3370
0,0,1,0,1,0,1,3371
1,1,0,1,1,1,2,3371
2,2,0,0,1,1,2,3371
0,0,1,0,1,0,1,3372
1,1,2,0,3,0,3,3372
2,2,2,0,5,0,5,3372
3,3,0,0,5,0,5,3372
0,0,1,0,1,0,1,3373
1,1,0,0,1,0,1,3373
0,0,1,0,1,0,1,3374
1,1,0,0,1,0,1,3374
0,0,1,0,1,0,1,3375
1,1,3,0,4,0,4,3375
2,2,1,0,5,0,5,3375
3,3,0,0,5,0,5,3375
0,0,1,0,1,0,1,3376
1,1,0,0,1,0,1,3376
0,0,1,0,1,0,1,3377
1,1,0,0,1,0,1,3377
0,0,1,0,1,0,1,3378
1,1,0,1,1,1,2,3378
2,2,1,0,2,1,3,3378
3,3,2,1,4,2,6,3378
4,4,1,0,5,2,7,3378
5,5,0,0,5,2,7,3378
0,0,1,0,1,0,1,3379
1,1,0,1,1,1,2,3379
2,2,0,1,1,2,3,3379
3,3,0,1,1,3,4,3379
4,4,2,1,3,4,7,3379
5,5,1,1,4,5,9,3379
6,6,0,1,4,6,10,3379
7,7,0,1,4,7,11,3379
8,8,0,1,4,8,12,3379
9,9,0,1,4,9,13,3379
10,10,1,2,5,11,16,3379
11,11,0,4,5,15,20,3379
12,12,2,1,7,16,23,3379
13,13,2,0,9,16,25,3379
14,14,1,0,10,16,26,3379
15,15,1,2,11,18,29,3379
16,16,0,2,11,20,31,3379
17,17,0,1,11,21,32,3379
18,18,0,1,11,22,33,3379
19,19,1,0,12,22,34,3379
20,20,1,0,13,22,35,3379
21,21,1,1,14,23,37,3379
22,22,0,1,14,24,38,3379
23,23,0,0,14,24,38,3379
0,0,1,0,1,0,1,3380
1,1,0,0,1,0,1,3380
0,0,1,0,1,0,1,3381
1,1,2,1,3,1,4,3381
2,2,0,1,3,2,5,3381
3,3,0,1,3,3,6,3381
4,4,1,2,4,5,9,3381
5,5,2,3,6,8,14,3381
6,6,4,2,10,10,20,3381
7,7,1,0,11,10,21,3381
8,8,1,0,12,10,22,3381
9,9,2,0,14,10,24,3381
10,10,1,1,15,11,26,3381
11,11,0,0,15,11,26,3381
0,0,1,0,1,0,1,3382
1,1,0,0,1,0,1,3382
0,0,1,0,1,0,1,3383
1,1,1,0,2,0,2,3383
2,2,1,0,3,0,3,3383
3,3,0,0,3,0,3,3383
0,0,1,0,1,0,1,3384
1,1,2,0,3,0,3,3384
2,2,4,0,7,0,7,3384
3,3,3,1,10,1,11,3384
4,4,1,2,11,3,14,3384
5,5,1,3,12,6,18,3384
6,6,0,2,12,8,20,3384
7,7,0,0,12,8,20,3384
0,0,1,0,1,0,1,3385
1,1,0,0,1,0,1,3385
0,0,1,0,1,0,1,3386
1,1,1,0,2,0,2,3386
2,2,2,0,4,0,4,3386
3,3,0,0,4,0,4,3386
0,0,1,0,1,0,1,3387
1,1,2,0,3,0,3,3387
2,2,2,0,5,0,5,3387
3,3,2,0,7,0,7,3387
4,4,1,0,8,0,8,3387
5,5,0,0,8,0,8,3387
0,0,1,0,1,0,1,3388
1,1,2,1,3,1,4,3388
2,2,1,1,4,2,6,3388
3,3,1,1,5,3,8,3388
4,4,0,1,5,4,9,3388
5,5,0,2,5,6,11,3388
6,6,0,3,5,9,14,3388
7,7,0,1,5,10,15,3388
8,8,0,1,5,11,16,3388
9,9,0,1,5,12,17,3388
10,10,0,0,5,12,17,3388
0,0,1,0,1,0,1,3389
1,1,1,0,2,0,2,3389
2,2,0,0,2,0,2,3389
0,0,1,0,1,0,1,3390
1,1,0,0,1,0,1,3390
0,0,1,0,1,0,1,3391
1,1,2,0,3,0,3,3391
2,2,0,0,3,0,3,3391
0,0,1,0,1,0,1,3392
1,1,0,0,1,0,1,3392
0,0,1,0,1,0,1,3393
1,1,0,1,1,1,2,3393
2,2,1,1,2,2,4,3393
3,3,0,2,2,4,6,3393
4,4,0,2,2,6,8,3393
5,5,0,1,2,7,9,3393
6,6,0,0,2,7,9,3393
0,0,1,0,1,0,1,3394
1,1,1,0,2,0,2,3394
2,2,2,0,4,0,4,3394
3,3,1,2,5,2,7,3394
4,4,3,1,8,3,11,3394
5,5,3,1,11,4,15,3394
6,6,1,0,12,4,16,3394
7,7,0,0,12,4,16,3394
0,0,1,0,1,0,1,3395
1,1,1,1,2,1,3,3395
2,2,1,3,3,4,7,3395
3,3,2,3,5,7,12,3395
4,4,2,5,7,12,19,3395
5,5,1,1,8,13,21,3395
6,6,1,1,9,14,23,3395
7,7,1,1,10,15,25,3395
8,8,1,0,11,15,26,3395
9,9,1,1,12,16,28,3395
10,10,0,0,12,16,28,3395
0,0,1,0,1,0,1,3396
1,1,1,0,2,0,2,3396
2,2,0,0,2,0,2,3396
0,0,1,0,1,0,1,3397
1,1,0,0,1,0,1,3397
0,0,1,0,1,0,1,3398
1,1,1,0,2,0,2,3398
2,2,1,0,3,0,3,3398
3,3,3,0,6,0,6,3398
4,4,2,3,8,3,11,3398
5,5,0,2,8,5,13,3398
6,6,0,3,8,8,16,3398
7,7,0,4,8,12,20,3398
8,8,1,2,9,14,23,3398
9,9,1,3,10,17,27,3398
10,10,0,5,10,22,32,3398
11,11,0,2,10,24,34,3398
12,12,0,0,10,24,34,3398
0,0,1,0,1,0,1,3399
1,1,1,0,2,0,2,3399
2,2,0,0,2,0,2,3399
0,0,1,0,1,0,1,3400
1,1,0,0,1,0,1,3400
0,0,1,0,1,0,1,3401
1,1,0,0,1,0,1,3401
0,0,1,0,1,0,1,3402
1,1,1,1,2,1,3,3402
2,2,0,1,2,2,4,3402
3,3,0,0,2,2,4,3402
0,0,1,0,1,0,1,3403
1,1,1,0,2,0,2,3403
2,2,1,0,3,0,3,3403
3,3,2,0,5,0,5,3403
4,4,1,0,6,0,6,3403
5,5,0,0,6,0,6,3403
0,0,1,0,1,0,1,3404
1,1,0,0,1,0,1,3404
0,0,1,0,1,0,1,3405
1,1,0,0,1,0,1,3405
0,0,1,0,1,0,1,3406
1,1,0,0,1,0,1,3406
0,0,1,0,1,0,1,3407
1,1,0,1,1,1,2,3407
2,2,0,1,1,2,3,3407
3,3,1,1,2,3,5,3407
4,4,2,0,4,3,7,3407
5,5,3,0,7,3,10,3407
6,6,2,0,9,3,12,3407
7,7,5,1,14,4,18,3407
8,8,4,1,18,5,23,3407
9,9,4,1,22,6,28,3407
10,10,4,3,26,9,35,3407
11,11,4,0,30,9,39,3407
12,12,2,1,32,10,42,3407
13,13,1,1,33,11,44,3407
14,14,4,0,37,11,48,3407
15,15,4,1,41,12,53,3407
16,16,1,4,42,16,58,3407
17,17,1,6,43,22,65,3407
18,18,3,6,46,28,74,3407
19,19,6,8,52,36,88,3407
20,20,8,8,60,44,104,3407
21,21,12,6,72,50,122,3407
22,22,4,8,76,58,134,3407
23,23,10,4,86,62,148,3407
24,24,8,9,94,71,165,3407
25,25,6,9,100,80,180,3407
26,26,5,3,105,83,188,3407
27,27,3,3,108,86,194,3407
28,28,2,5,110,91,201,3407
29,29,3,2,113,93,206,3407
30,30,0,2,113,95,208,3407
31,31,1,0,114,95,209,3407
32,32,1,1,115,96,211,3407
33,33,3,2,118,98,216,3407
34,34,1,3,119,101,220,3407
35,35,0,4,119,105,224,3407
36,36,0,4,119,109,228,3407
37,37,0,3,119,112,231,3407
38,38,0,3,119,115,234,3407
39,39,0,2,119,117,236,3407
40,40,0,2,119,119,238,3407
41,41,0,1,119,120,239,3407
42,42,0,1,119,121,240,3407
43,43,0,1,119,122,241,3407
44,44,0,0,119,122,241,3407
0,0,1,0,1,0,1,3408
1,1,1,0,2,0,2,3408
2,2,0,0,2,0,2,3408
0,0,1,0,1,0,1,3409
1,1,0,0,1,0,1,3409
0,0,1,0,1,0,1,3410
1,1,0,0,1,0,1,3410
0,0,1,0,1,0,1,3411
1,1,2,1,3,1,4,3411
2,2,2,2,5,3,8,3411
3,3,1,2,6,5,11,3411
4,4,1,3,7,8,15,3411
5,5,0,3,7,11,18,3411
6,6,0,4,7,15,22,3411
7,7,0,1,7,16,23,3411
8,8,0,1,7,17,24,3411
9,9,0,0,7,17,24,3411
0,0,1,0,1,0,1,3412
1,1,0,0,1,0,1,3412
0,0,1,0,1,0,1,3413
1,1,0,0,1,0,1,3413
0,0,1,0,1,0,1,3414
1,1,1,0,2,0,2,3414
2,2,0,0,2,0,2,3414
0,0,1,0,1,0,1,3415
1,1,2,0,3,0,3,3415
2,2,2,0,5,0,5,3415
3,3,1,1,6,1,7,3415
4,4,1,2,7,3,10,3415
5,5,3,2,10,5,15,3415
6,6,1,0,11,5,16,3415
7,7,1,0,12,5,17,3415
8,8,0,0,12,5,17,3415
0,0,1,0,1,0,1,3416
1,1,0,0,1,0,1,3416
0,0,1,0,1,0,1,3417
1,1,1,0,2,0,2,3417
2,2,0,0,2,0,2,3417
0,0,1,0,1,0,1,3418
1,1,3,0,4,0,4,3418
2,2,2,0,6,0,6,3418
3,3,0,2,6,2,8,3418
4,4,0,1,6,3,9,3418
5,5,0,0,6,3,9,3418
0,0,1,0,1,0,1,3419
1,1,0,0,1,0,1,3419
0,0,1,0,1,0,1,3420
1,1,1,0,2,0,2,3420
2,2,0,0,2,0,2,3420
0,0,1,0,1,0,1,3421
1,1,0,0,1,0,1,3421
0,0,1,0,1,0,1,3422
1,1,2,0,3,0,3,3422
2,2,1,0,4,0,4,3422
3,3,0,0,4,0,4,3422
0,0,1,0,1,0,1,3423
1,1,1,0,2,0,2,3423
2,2,0,0,2,0,2,3423
0,0,1,0,1,0,1,3424
1,1,2,0,3,0,3,3424
2,2,3,0,6,0,6,3424
3,3,2,2,8,2,10,3424
4,4,1,1,9,3,12,3424
5,5,0,1,9,4,13,3424
6,6,0,2,9,6,15,3424
7,7,0,2,9,8,17,3424
8,8,0,1,9,9,18,3424
9,9,0,1,9,10,19,3424
10,10,0,1,9,11,20,3424
11,11,0,2,9,13,22,3424
12,12,1,2,10,15,25,3424
13,13,1,1,11,16,27,3424
14,14,1,1,12,17,29,3424
15,15,0,1,12,18,30,3424
16,16,0,2,12,20,32,3424
17,17,0,3,12,23,35,3424
18,18,0,3,12,26,38,3424
19,19,0,3,12,29,41,3424
20,20,1,4,13,33,46,3424
21,21,0,3,13,36,49,3424
22,22,0,4,13,40,53,3424
23,23,2,4,15,44,59,3424
24,24,2,2,17,46,63,3424
25,25,1,4,18,50,68,3424
26,26,3,3,21,53,74,3424
27,27,4,4,25,57,82,3424
28,28,2,3,27,60,87,3424
29,29,2,1,29,61,90,3424
30,30,3,0,32,61,93,3424
31,31,3,0,35,61,96,3424
32,32,2,2,37,63,100,3424
33,33,1,2,38,65,103,3424
34,34,1,1,39,66,105,3424
35,35,1,1,40,67,107,3424
36,36,0,0,40,67,107,3424
0,0,1,0,1,0,1,3425
1,1,2,0,3,0,3,3425
2,2,2,2,5,2,7,3425
3,3,0,1,5,3,8,3425
4,4,0,0,5,3,8,3425
0,0,1,0,1,0,1,3426
1,1,0,0,1,0,1,3426
0,0,1,0,1,0,1,3427
1,1,0,0,1,0,1,3427
0,0,1,0,1,0,1,3428
1,1,1,0,2,0,2,3428
2,2,2,1,4,1,5,3428
3,3,1,1,5,2,7,3428
4,4,0,2,5,4,9,3428
5,5,0,1,5,5,10,3428
6,6,0,3,5,8,13,3428
7,7,2,4,7,12,19,3428
8,8,1,3,8,15,23,3428
9,9,1,0,9,15,24,3428
10,10,0,0,9,15,24,3428
0,0,1,0,1,0,1,3429
1,1,1,0,2,0,2,3429
2,2,1,0,3,0,3,3429
3,3,3,0,6,0,6,3429
4,4,1,1,7,1,8,3429
5,5,1,0,8,1,9,3429
6,6,0,0,8,1,9,3429
0,0,1,0,1,0,1,3430
1,1,1,1,2,1,3,3430
2,2,2,0,4,1,5,3430
3,3,0,2,4,3,7,3430
4,4,0,4,4,7,11,3430
5,5,1,3,5,10,15,3430
6,6,3,3,8,13,21,3430
7,7,3,4,11,17,28,3430
8,8,1,5,12,22,34,3430
9,9,3,4,15,26,41,3430
10,10,2,3,17,29,46,3430
11,11,1,1,18,30,48,3430
12,12,0,3,18,33,51,3430
13,13,0,2,18,35,53,3430
14,14,0,3,18,38,56,3430
15,15,1,2,19,40,59,3430
16,16,0,1,19,41,60,3430
17,17,0,0,19,41,60,3430
0,0,1,0,1,0,1,3431
1,1,0,0,1,0,1,3431
0,0,1,0,1,0,1,3432
1,1,1,0,2,0,2,3432
2,2,1,0,3,0,3,3432
3,3,1,0,4,0,4,3432
4,4,1,0,5,0,5,3432
5,5,0,0,5,0,5,3432
0,0,1,0,1,0,1,3433
1,1,1,0,2,0,2,3433
2,2,1,0,3,0,3,3433
3,3,0,1,3,1,4,3433
4,4,1,1,4,2,6,3433
5,5,0,2,4,4,8,3433
6,6,0,0,4,4,8,3433
0,0,1,0,1,0,1,3434
1,1,1,1,2,1,3,3434
2,2,1,2,3,3,6,3434
3,3,0,1,3,4,7,3434
4,4,1,0,4,4,8,3434
5,5,0,0,4,4,8,3434
0,0,1,0,1,0,1,3435
1,1,2,0,3,0,3,3435
2,2,1,0,4,0,4,3435
3,3,2,0,6,0,6,3435
4,4,3,0,9,0,9,3435
5,5,0,1,9,1,10,3435
6,6,1,0,10,1,11,3435
7,7,0,0,10,1,11,3435
0,0,1,0,1,0,1,3436
1,1,0,0,1,0,1,3436
0,0,1,0,1,0,1,3437
1,1,1,0,2,0,2,3437
2,2,1,0,3,0,3,3437
3,3,1,0,4,0,4,3437
4,4,1,0,5,0,5,3437
5,5,2,0,7,0,7,3437
6,6,1,0,8,0,8,3437
7,7,2,1,10,1,11,3437
8,8,1,1,11,2,13,3437
9,9,1,1,12,3,15,3437
10,10,1,1,13,4,17,3437
11,11,0,0,13,4,17,3437
0,0,1,0,1,0,1,3438
1,1,1,0,2,0,2,3438
2,2,0,0,2,0,2,3438
0,0,1,0,1,0,1,3439
1,1,2,0,3,0,3,3439
2,2,1,0,4,0,4,3439
3,3,0,0,4,0,4,3439
0,0,1,0,1,0,1,3440
1,1,0,0,1,0,1,3440
0,0,1,0,1,0,1,3441
1,1,1,0,2,0,2,3441
2,2,0,1,2,1,3,3441
3,3,0,4,2,5,7,3441
4,4,1,1,3,6,9,3441
5,5,2,0,5,6,11,3441
6,6,0,0,5,6,11,3441
0,0,1,0,1,0,1,3442
1,1,0,0,1,0,1,3442
0,0,1,0,1,0,1,3443
1,1,2,0,3,0,3,3443
2,2,0,1,3,1,4,3443
3,3,0,2,3,3,6,3443
4,4,3,1,6,4,10,3443
5,5,3,3,9,7,16,3443
6,6,5,1,14,8,22,3443
7,7,2,0,16,8,24,3443
8,8,1,0,17,8,25,3443
9,9,1,1,18,9,27,3443
10,10,1,3,19,12,31,3443
11,11,1,3,20,15,35,3443
12,12,1,3,21,18,39,3443
13,13,2,3,23,21,44,3443
14,14,0,2,23,23,46,3443
15,15,0,0,23,23,46,3443
0,0,1,0,1,0,1,3444
1,1,0,0,1,0,1,3444
0,0,1,0,1,0,1,3445
1,1,0,0,1,0,1,3445
0,0,1,0,1,0,1,3446
1,1,0,0,1,0,1,3446
0,0,1,0,1,0,1,3447
1,1,0,1,1,1,2,3447
2,2,0,2,1,3,4,3447
3,3,0,2,1,5,6,3447
4,4,0,1,1,6,7,3447
5,5,0,2,1,8,9,3447
6,6,0,0,1,8,9,3447
0,0,1,0,1,0,1,3448
1,1,0,0,1,0,1,3448
0,0,1,0,1,0,1,3449
1,1,2,0,3,0,3,3449
2,2,1,0,4,0,4,3449
3,3,0,0,4,0,4,3449
0,0,1,0,1,0,1,3450
1,1,0,0,1,0,1,3450
0,0,1,0,1,0,1,3451
1,1,1,0,2,0,2,3451
2,2,1,0,3,0,3,3451
3,3,0,0,3,0,3,3451
0,0,1,0,1,0,1,3452
1,1,0,1,1,1,2,3452
2,2,0,0,1,1,2,3452
0,0,1,0,1,0,1,3453
1,1,0,1,1,1,2,3453
2,2,0,0,1,1,2,3453
0,0,1,0,1,0,1,3454
1,1,2,0,3,0,3,3454
2,2,2,0,5,0,5,3454
3,3,0,0,5,0,5,3454
0,0,1,0,1,0,1,3455
1,1,1,1,2,1,3,3455
2,2,1,2,3,3,6,3455
3,3,0,2,3,5,8,3455
4,4,1,1,4,6,10,3455
5,5,1,0,5,6,11,3455
6,6,0,0,5,6,11,3455
0,0,1,0,1,0,1,3456
1,1,0,0,1,0,1,3456
0,0,1,0,1,0,1,3457
1,1,1,0,2,0,2,3457
2,2,0,0,2,0,2,3457
0,0,1,0,1,0,1,3458
1,1,0,1,1,1,2,3458
2,2,0,0,1,1,2,3458
0,0,1,0,1,0,1,3459
1,1,0,0,1,0,1,3459
0,0,1,0,1,0,1,3460
1,1,0,0,1,0,1,3460
0,0,1,0,1,0,1,3461
1,1,2,1,3,1,4,3461
2,2,3,1,6,2,8,3461
3,3,2,2,8,4,12,3461
4,4,3,1,11,5,16,3461
5,5,2,0,13,5,18,3461
6,6,2,0,15,5,20,3461
7,7,0,0,15,5,20,3461
0,0,1,0,1,0,1,3462
1,1,1,0,2,0,2,3462
2,2,0,0,2,0,2,3462
0,0,1,0,1,0,1,3463
1,1,0,1,1,1,2,3463
2,2,0,0,1,1,2,3463
0,0,1,0,1,0,1,3464
1,1,1,0,2,0,2,3464
2,2,0,0,2,0,2,3464
0,0,1,0,1,0,1,3465
1,1,0,0,1,0,1,3465
0,0,1,0,1,0,1,3466
1,1,1,0,2,0,2,3466
2,2,1,0,3,0,3,3466
3,3,2,0,5,0,5,3466
4,4,1,0,6,0,6,3466
5,5,0,0,6,0,6,3466
0,0,1,0,1,0,1,3467
1,1,3,0,4,0,4,3467
2,2,3,0,7,0,7,3467
3,3,0,0,7,0,7,3467
0,0,1,0,1,0,1,3468
1,1,1,0,2,0,2,3468
2,2,3,1,5,1,6,3468
3,3,0,1,5,2,7,3468
4,4,0,0,5,2,7,3468
0,0,1,0,1,0,1,3469
1,1,1,0,2,0,2,3469
2,2,1,0,3,0,3,3469
3,3,2,0,5,0,5,3469
4,4,3,0,8,0,8,3469
5,5,4,0,12,0,12,3469
6,6,2,2,14,2,16,3469
7,7,2,2,16,4,20,3469
8,8,3,3,19,7,26,3469
9,9,2,3,21,10,31,3469
10,10,3,5,24,15,39,3469
11,11,3,3,27,18,45,3469
12,12,4,5,31,23,54,3469
13,13,1,3,32,26,58,3469
14,14,3,2,35,28,63,3469
15,15,0,2,35,30,65,3469
16,16,0,3,35,33,68,3469
17,17,0,3,35,36,71,3469
18,18,1,2,36,38,74,3469
19,19,1,4,37,42,79,3469
20,20,0,4,37,46,83,3469
21,21,1,2,38,48,86,3469
22,22,2,2,40,50,90,3469
23,23,1,1,41,51,92,3469
24,24,2,1,43,52,95,3469
25,25,2,1,45,53,98,3469
26,26,2,0,47,53,100,3469
27,27,5,0,52,53,105,3469
28,28,9,0,61,53,114,3469
29,29,12,1,73,54,127,3469
30,30,12,4,85,58,143,3469
31,31,13,5,98,63,161,3469
32,32,7,4,105,67,172,3469
33,33,6,5,111,72,183,3469
34,34,4,1,115,73,188,3469
35,35,2,0,117,73,190,3469
36,36,2,0,119,73,192,3469
37,37,4,0,123,73,196,3469
38,38,4,1,127,74,201,3469
39,39,2,0,129,74,203,3469
40,40,2,0,131,74,205,3469
41,41,1,1,132,75,207,3469
42,42,5,2,137,77,214,3469
43,43,3,2,140,79,219,3469
44,44,2,1,142,80,222,3469
45,45,1,0,143,80,223,3469
46,46,1,0,144,80,224,3469
47,47,0,0,144,80,224,3469
0,0,1,0,1,0,1,3470
1,1,1,1,2,1,3,3470
2,2,0,1,2,2,4,3470
3,3,1,1,3,3,6,3470
4,4,0,1,3,4,7,3470
5,5,0,2,3,6,9,3470
6,6,0,4,3,10,13,3470
7,7,1,2,4,12,16,3470
8,8,0,3,4,15,19,3470
9,9,0,1,4,16,20,3470
10,10,0,1,4,17,21,3470
11,11,0,1,4,18,22,3470
12,12,0,2,4,20,24,3470
13,13,0,1,4,21,25,3470
14,14,0,1,4,22,26,3470
15,15,0,1,4,23,27,3470
16,16,0,1,4,24,28,3470
17,17,0,1,4,25,29,3470
18,18,1,1,5,26,31,3470
19,19,1,0,6,26,32,3470
20,20,3,0,9,26,35,3470
21,21,3,0,12,26,38,3470
22,22,2,2,14,28,42,3470
23,23,0,0,14,28,42,3470
0,0,1,0,1,0,1,3471
1,1,0,2,1,2,3,3471
2,2,1,1,2,3,5,3471
3,3,1,0,3,3,6,3471
4,4,0,0,3,3,6,3471
0,0,1,0,1,0,1,3472
1,1,0,0,1,0,1,3472
0,0,1,0,1,0,1,3473
1,1,0,0,1,0,1,3473
0,0,1,0,1,0,1,3474
1,1,2,0,3,0,3,3474
2,2,1,0,4,0,4,3474
3,3,0,0,4,0,4,3474
0,0,1,0,1,0,1,3475
1,1,1,0,2,0,2,3475
2,2,0,2,2,2,4,3475
3,3,0,0,2,2,4,3475
0,0,1,0,1,0,1,3476
1,1,0,0,1,0,1,3476
0,0,1,0,1,0,1,3477
1,1,0,1,1,1,2,3477
2,2,0,0,1,1,2,3477
0,0,1,0,1,0,1,3478
1,1,1,0,2,0,2,3478
2,2,0,0,2,0,2,3478
0,0,1,0,1,0,1,3479
1,1,0,0,1,0,1,3479
0,0,1,0,1,0,1,3480
1,1,1,1,2,1,3,3480
2,2,1,1,3,2,5,3480
3,3,1,1,4,3,7,3480
4,4,0,0,4,3,7,3480
0,0,1,0,1,0,1,3481
1,1,1,0,2,0,2,3481
2,2,1,0,3,0,3,3481
3,3,0,0,3,0,3,3481
0,0,1,0,1,0,1,3482
1,1,0,0,1,0,1,3482
0,0,1,0,1,0,1,3483
1,1,1,0,2,0,2,3483
2,2,1,0,3,0,3,3483
3,3,0,0,3,0,3,3483
0,0,1,0,1,0,1,3484
1,1,1,0,2,0,2,3484
2,2,1,0,3,0,3,3484
3,3,2,1,5,1,6,3484
4,4,4,0,9,1,10,3484
5,5,5,1,14,2,16,3484
6,6,2,1,16,3,19,3484
7,7,1,1,17,4,21,3484
8,8,1,0,18,4,22,3484
9,9,1,0,19,4,23,3484
10,10,0,1,19,5,24,3484
11,11,0,0,19,5,24,3484
0,0,1,0,1,0,1,3485
1,1,0,0,1,0,1,3485
0,0,1,0,1,0,1,3486
1,1,0,0,1,0,1,3486
0,0,1,0,1,0,1,3487
1,1,1,0,2,0,2,3487
2,2,1,1,3,1,4,3487
3,3,2,1,5,2,7,3487
4,4,0,1,5,3,8,3487
5,5,1,1,6,4,10,3487
6,6,1,2,7,6,13,3487
7,7,1,0,8,6,14,3487
8,8,0,1,8,7,15,3487
9,9,0,1,8,8,16,3487
10,10,1,1,9,9,18,3487
11,11,2,0,11,9,20,3487
12,12,3,0,14,9,23,3487
13,13,3,0,17,9,26,3487
14,14,2,0,19,9,28,3487
15,15,1,1,20,10,30,3487
16,16,0,2,20,12,32,3487
17,17,1,2,21,14,35,3487
18,18,0,3,21,17,38,3487
19,19,0,4,21,21,42,3487
20,20,2,0,23,21,44,3487
21,21,2,0,25,21,46,3487
22,22,1,0,26,21,47,3487
23,23,0,0,26,21,47,3487
0,0,1,0,1,0,1,3488
1,1,1,1,2,1,3,3488
2,2,0,0,2,1,3,3488
0,0,1,0,1,0,1,3489
1,1,0,1,1,1,2,3489
2,2,0,0,1,1,2,3489
0,0,1,0,1,0,1,3490
1,1,1,1,2,1,3,3490
2,2,1,0,3,1,4,3490
3,3,0,1,3,2,5,3490
4,4,0,0,3,2,5,3490
0,0,1,0,1,0,1,3491
1,1,3,0,4,0,4,3491
2,2,0,0,4,0,4,3491
0,0,1,0,1,0,1,3492
1,1,2,0,3,0,3,3492
2,2,2,0,5,0,5,3492
3,3,2,0,7,0,7,3492
4,4,2,1,9,1,10,3492
5,5,1,1,10,2,12,3492
6,6,0,2,10,4,14,3492
7,7,0,1,10,5,15,3492
8,8,0,0,10,5,15,3492
0,0,1,0,1,0,1,3493
1,1,2,0,3,0,3,3493
2,2,1,0,4,0,4,3493
3,3,0,0,4,0,4,3493
0,0,1,0,1,0,1,3494
1,1,0,0,1,0,1,3494
0,0,1,0,1,0,1,3495
1,1,1,0,2,0,2,3495
2,2,0,0,2,0,2,3495
0,0,1,0,1,0,1,3496
1,1,1,0,2,0,2,3496
2,2,2,0,4,0,4,3496
3,3,3,0,7,0,7,3496
4,4,1,0,8,0,8,3496
5,5,0,0,8,0,8,3496
0,0,1,0,1,0,1,3497
1,1,0,0,1,0,1,3497
0,0,1,0,1,0,1,3498
1,1,1,0,2,0,2,3498
2,2,0,0,2,0,2,3498
0,0,1,0,1,0,1,3499
1,1,1,1,2,1,3,3499
2,2,0,0,2,1,3,3499
0,0,1,0,1,0,1,3500
1,1,2,1,3,1,4,3500
2,2,0,1,3,2,5,3500
3,3,0,2,3,4,7,3500
4,4,0,2,3,6,9,3500
5,5,1,3,4,9,13,3500
6,6,0,0,4,9,13,3500
0,0,1,0,1,0,1,3501
1,1,0,0,1,0,1,3501
0,0,1,0,1,0,1,3502
1,1,2,0,3,0,3,3502
2,2,7,0,10,0,10,3502
3,3,6,0,16,0,16,3502
4,4,6,0,22,0,22,3502
5,5,8,0,30,0,30,3502
6,6,8,3,38,3,41,3502
7,7,4,5,42,8,50,3502
8,8,5,3,47,11,58,3502
9,9,3,1,50,12,62,3502
10,10,4,2,54,14,68,3502
11,11,2,1,56,15,71,3502
12,12,4,0,60,15,75,3502
13,13,1,0,61,15,76,3502
14,14,0,0,61,15,76,3502
0,0,1,0,1,0,1,3503
1,1,1,0,2,0,2,3503
2,2,0,0,2,0,2,3503
0,0,1,0,1,0,1,3504
1,1,2,0,3,0,3,3504
2,2,3,0,6,0,6,3504
3,3,1,1,7,1,8,3504
4,4,0,0,7,1,8,3504
0,0,1,0,1,0,1,3505
1,1,0,0,1,0,1,3505
0,0,1,0,1,0,1,3506
1,1,1,0,2,0,2,3506
2,2,3,1,5,1,6,3506
3,3,5,1,10,2,12,3506
4,4,7,1,17,3,20,3506
5,5,2,4,19,7,26,3506
6,6,1,3,20,10,30,3506
7,7,2,4,22,14,36,3506
8,8,1,4,23,18,41,3506
9,9,0,4,23,22,45,3506
10,10,1,4,24,26,50,3506
11,11,3,6,27,32,59,3506
12,12,1,7,28,39,67,3506
13,13,0,4,28,43,71,3506
14,14,0,3,28,46,74,3506
15,15,0,1,28,47,75,3506
16,16,0,0,28,47,75,3506
0,0,1,0,1,0,1,3507
1,1,1,0,2,0,2,3507
2,2,1,1,3,1,4,3507
3,3,1,2,4,3,7,3507
4,4,2,2,6,5,11,3507
5,5,1,2,7,7,14,3507
6,6,2,2,9,9,18,3507
7,7,2,1,11,10,21,3507
8,8,3,0,14,10,24,3507
9,9,1,1,15,11,26,3507
10,10,0,3,15,14,29,3507
11,11,1,0,16,14,30,3507
12,12,1,0,17,14,31,3507
13,13,2,0,19,14,33,3507
14,14,0,0,19,14,33,3507
0,0,1,0,1,0,1,3508
1,1,0,1,1,1,2,3508
2,2,0,2,1,3,4,3508
3,3,0,0,1,3,4,3508
0,0,1,0,1,0,1,3509
1,1,0,0,1,0,1,3509
0,0,1,0,1,0,1,3510
1,1,2,0,3,0,3,3510
2,2,0,0,3,0,3,3510
0,0,1,0,1,0,1,3511
1,1,1,0,2,0,2,3511
2,2,1,0,3,0,3,3511
3,3,0,0,3,0,3,3511
0,0,1,0,1,0,1,3512
1,1,1,0,2,0,2,3512
2,2,2,1,4,1,5,3512
3,3,1,2,5,3,8,3512
4,4,0,2,5,5,10,3512
5,5,0,5,5,10,15,3512
6,6,0,2,5,12,17,3512
7,7,1,1,6,13,19,3512
8,8,0,2,6,15,21,3512
9,9,1,3,7,18,25,3512
10,10,2,1,9,19,28,3512
11,11,0,1,9,20,29,3512
12,12,0,4,9,24,33,3512
13,13,1,2,10,26,36,3512
14,14,1,4,11,30,41,3512
15,15,1,4,12,34,46,3512
16,16,1,1,13,35,48,3512
17,17,1,2,14,37,51,3512
18,18,5,2,19,39,58,3512
19,19,2,2,21,41,62,3512
20,20,2,2,23,43,66,3512
21,21,1,0,24,43,67,3512
22,22,1,0,25,43,68,3512
23,23,0,0,25,43,68,3512
0,0,1,0,1,0,1,3513
1,1,0,0,1,0,1,3513
0,0,1,0,1,0,1,3514
1,1,0,0,1,0,1,3514
0,0,1,0,1,0,1,3515
1,1,0,2,1,2,3,3515
2,2,0,3,1,5,6,3515
3,3,3,4,4,9,13,3515
4,4,5,3,9,12,21,3515
5,5,1,4,10,16,26,3515
6,6,0,6,10,22,32,3515
7,7,3,6,13,28,41,3515
8,8,5,3,18,31,49,3515
9,9,5,4,23,35,58,3515
10,10,3,2,26,37,63,3515
11,11,4,2,30,39,69,3515
12,12,1,3,31,42,73,3515
13,13,1,3,32,45,77,3515
14,14,4,2,36,47,83,3515
15,15,3,2,39,49,88,3515
16,16,2,2,41,51,92,3515
17,17,2,3,43,54,97,3515
18,18,0,5,43,59,102,3515
19,19,0,1,43,60,103,3515
20,20,0,2,43,62,105,3515
21,21,1,2,44,64,108,3515
22,22,1,0,45,64,109,3515
23,23,1,0,46,64,110,3515
24,24,2,0,48,64,112,3515
25,25,3,1,51,65,116,3515
26,26,0,0,51,65,116,3515
0,0,1,0,1,0,1,3516
1,1,1,1,2,1,3,3516
2,2,0,0,2,1,3,3516
0,0,1,0,1,0,1,3517
1,1,0,0,1,0,1,3517
0,0,1,0,1,0,1,3518
1,1,0,0,1,0,1,3518
0,0,1,0,1,0,1,3519
1,1,0,0,1,0,1,3519
0,0,1,0,1,0,1,3520
1,1,1,0,2,0,2,3520
2,2,1,0,3,0,3,3520
3,3,0,0,3,0,3,3520
0,0,1,0,1,0,1,3521
1,1,0,0,1,0,1,3521
0,0,1,0,1,0,1,3522
1,1,0,0,1,0,1,3522
0,0,1,0,1,0,1,3523
1,1,1,0,2,0,2,3523
2,2,0,0,2,0,2,3523
0,0,1,0,1,0,1,3524
1,1,0,0,1,0,1,3524
0,0,1,0,1,0,1,3525
1,1,3,0,4,0,4,3525
2,2,2,0,6,0,6,3525
3,3,1,1,7,1,8,3525
4,4,1,1,8,2,10,3525
5,5,0,2,8,4,12,3525
6,6,0,0,8,4,12,3525
0,0,1,0,1,0,1,3526
1,1,0,0,1,0,1,3526
0,0,1,0,1,0,1,3527
1,1,2,0,3,0,3,3527
2,2,4,0,7,0,7,3527
3,3,5,1,12,1,13,3527
4,4,2,3,14,4,18,3527
5,5,3,3,17,7,24,3527
6,6,2,2,19,9,28,3527
7,7,2,1,21,10,31,3527
8,8,0,2,21,12,33,3527
9,9,1,0,22,12,34,3527
10,10,1,0,23,12,35,3527
11,11,0,1,23,13,36,3527
12,12,0,1,23,14,37,3527
13,13,0,1,23,15,38,3527
14,14,1,2,24,17,41,3527
15,15,2,1,26,18,44,3527
16,16,2,1,28,19,47,3527
17,17,1,4,29,23,52,3527
18,18,1,3,30,26,56,3527
19,19,3,1,33,27,60,3527
20,20,1,3,34,30,64,3527
21,21,0,3,34,33,67,3527
22,22,1,1,35,34,69,3527
23,23,0,0,35,34,69,3527
0,0,1,0,1,0,1,3528
1,1,0,0,1,0,1,3528
0,0,1,0,1,0,1,3529
1,1,0,1,1,1,2,3529
2,2,0,0,1,1,2,3529
0,0,1,0,1,0,1,3530
1,1,1,0,2,0,2,3530
2,2,1,0,3,0,3,3530
3,3,0,0,3,0,3,3530
0,0,1,0,1,0,1,3531
1,1,0,0,1,0,1,3531
0,0,1,0,1,0,1,3532
1,1,0,0,1,0,1,3532
0,0,1,0,1,0,1,3533
1,1,2,0,3,0,3,3533
2,2,0,0,3,0,3,3533
0,0,1,0,1,0,1,3534
1,1,1,0,2,0,2,3534
2,2,0,0,2,0,2,3534
0,0,1,0,1,0,1,3535
1,1,0,0,1,0,1,3535
0,0,1,0,1,0,1,3536
1,1,0,0,1,0,1,3536
0,0,1,0,1,0,1,3537
1,1,2,1,3,1,4,3537
2,2,2,2,5,3,8,3537
3,3,1,2,6,5,11,3537
4,4,0,0,6,5,11,3537
0,0,1,0,1,0,1,3538
1,1,1,0,2,0,2,3538
2,2,1,0,3,0,3,3538
3,3,2,0,5,0,5,3538
4,4,2,1,7,1,8,3538
5,5,3,1,10,2,12,3538
6,6,2,1,12,3,15,3538
7,7,1,1,13,4,17,3538
8,8,0,2,13,6,19,3538
9,9,0,1,13,7,20,3538
10,10,2,2,15,9,24,3538
11,11,2,1,17,10,27,3538
12,12,2,1,19,11,30,3538
13,13,2,3,21,14,35,3538
14,14,5,1,26,15,41,3538
15,15,3,1,29,16,45,3538
16,16,3,1,32,17,49,3538
17,17,0,0,32,17,49,3538
0,0,1,0,1,0,1,3539
1,1,0,0,1,0,1,3539
0,0,1,0,1,0,1,3540
1,1,0,0,1,0,1,3540
0,0,1,0,1,0,1,3541
1,1,1,0,2,0,2,3541
2,2,1,0,3,0,3,3541
3,3,0,0,3,0,3,3541
0,0,1,0,1,0,1,3542
1,1,2,0,3,0,3,3542
2,2,1,0,4,0,4,3542
3,3,0,1,4,1,5,3542
4,4,0,1,4,2,6,3542
5,5,1,0,5,2,7,3542
6,6,1,0,6,2,8,3542
7,7,1,2,7,4,11,3542
8,8,0,0,7,4,11,3542
0,0,1,0,1,0,1,3543
1,1,0,0,1,0,1,3543
0,0,1,0,1,0,1,3544
1,1,2,1,3,1,4,3544
2,2,2,2,5,3,8,3544
3,3,1,0,6,3,9,3544
4,4,2,0,8,3,11,3544
5,5,2,0,10,3,13,3544
6,6,2,1,12,4,16,3544
7,7,5,0,17,4,21,3544
8,8,4,0,21,4,25,3544
9,9,6,2,27,6,33,3544
10,10,4,4,31,10,41,3544
11,11,0,4,31,14,45,3544
12,12,0,3,31,17,48,3544
13,13,1,3,32,20,52,3544
14,14,2,3,34,23,57,3544
15,15,0,2,34,25,59,3544
16,16,0,2,34,27,61,3544
17,17,0,4,34,31,65,3544
18,18,1,2,35,33,68,3544
19,19,1,0,36,33,69,3544
20,20,1,0,37,33,70,3544
21,21,0,0,37,33,70,3544
0,0,1,0,1,0,1,3545
1,1,0,0,1,0,1,3545
0,0,1,0,1,0,1,3546
1,1,1,0,2,0,2,3546
2,2,1,0,3,0,3,3546
3,3,1,0,4,0,4,3546
4,4,0,1,4,1,5,3546
5,5,0,0,4,1,5,3546
0,0,1,0,1,0,1,3547
1,1,2,0,3,0,3,3547
2,2,3,1,6,1,7,3547
3,3,7,1,13,2,15,3547
4,4,4,1,17,3,20,3547
5,5,4,0,21,3,24,3547
6,6,4,2,25,5,30,3547
7,7,2,2,27,7,34,3547
8,8,1,4,28,11,39,3547
9,9,2,2,30,13,43,3547
10,10,2,3,32,16,48,3547
11,11,3,2,35,18,53,3547
12,12,1,2,36,20,56,3547
13,13,3,0,39,20,59,3547
14,14,0,0,39,20,59,3547
0,0,1,0,1,0,1,3548
1,1,3,0,4,0,4,3548
2,2,0,2,4,2,6,3548
3,3,1,1,5,3,8,3548
4,4,0,2,5,5,10,3548
5,5,0,2,5,7,12,3548
6,6,0,1,5,8,13,3548
7,7,0,1,5,9,14,3548
8,8,0,1,5,10,15,3548
9,9,0,0,5,10,15,3548
0,0,1,0,1,0,1,3549
1,1,2,0,3,0,3,3549
2,2,3,1,6,1,7,3549
3,3,0,1,6,2,8,3549
4,4,0,2,6,4,10,3549
5,5,2,0,8,4,12,3549
6,6,0,0,8,4,12,3549
0,0,1,0,1,0,1,3550
1,1,3,0,4,0,4,3550
2,2,2,1,6,1,7,3550
3,3,0,2,6,3,9,3550
4,4,0,2,6,5,11,3550
5,5,0,2,6,7,13,3550
6,6,1,1,7,8,15,3550
7,7,1,1,8,9,17,3550
8,8,0,0,8,9,17,3550
0,0,1,0,1,0,1,3551
1,1,0,2,1,2,3,3551
2,2,1,2,2,4,6,3551
3,3,0,0,2,4,6,3551
0,0,1,0,1,0,1,3552
1,1,0,0,1,0,1,3552
0,0,1,0,1,0,1,3553
1,1,1,0,2,0,2,3553
2,2,2,0,4,0,4,3553
3,3,1,1,5,1,6,3553
4,4,0,0,5,1,6,3553
0,0,1,0,1,0,1,3554
1,1,2,0,3,0,3,3554
2,2,6,1,9,1,10,3554
3,3,7,2,16,3,19,3554
4,4,5,2,21,5,26,3554
5,5,4,4,25,9,34,3554
6,6,3,3,28,12,40,3554
7,7,2,3,30,15,45,3554
8,8,4,4,34,19,53,3554
9,9,1,5,35,24,59,3554
10,10,0,2,35,26,61,3554
11,11,0,3,35,29,64,3554
12,12,1,1,36,30,66,3554
13,13,0,0,36,30,66,3554
0,0,1,0,1,0,1,3555
1,1,1,0,2,0,2,3555
2,2,0,0,2,0,2,3555
0,0,1,0,1,0,1,3556
1,1,0,0,1,0,1,3556
0,0,1,0,1,0,1,3557
1,1,2,0,3,0,3,3557
2,2,3,0,6,0,6,3557
3,3,4,0,10,0,10,3557
4,4,2,0,12,0,12,3557
5,5,0,0,12,0,12,3557
0,0,1,0,1,0,1,3558
1,1,0,0,1,0,1,3558
0,0,1,0,1,0,1,3559
1,1,2,0,3,0,3,3559
2,2,2,0,5,0,5,3559
3,3,0,0,5,0,5,3559
0,0,1,0,1,0,1,3560
1,1,0,0,1,0,1,3560
0,0,1,0,1,0,1,3561
1,1,0,0,1,0,1,3561
0,0,1,0,1,0,1,3562
1,1,0,0,1,0,1,3562
0,0,1,0,1,0,1,3563
1,1,3,0,4,0,4,3563
2,2,2,1,6,1,7,3563
3,3,2,2,8,3,11,3563
4,4,0,2,8,5,13,3563
5,5,0,2,8,7,15,3563
6,6,0,1,8,8,16,3563
7,7,0,1,8,9,17,3563
8,8,0,1,8,10,18,3563
9,9,0,0,8,10,18,3563
0,0,1,0,1,0,1,3564
1,1,0,0,1,0,1,3564
0,0,1,0,1,0,1,3565
1,1,3,0,4,0,4,3565
2,2,1,2,5,2,7,3565
3,3,2,0,7,2,9,3565
4,4,2,0,9,2,11,3565
5,5,1,0,10,2,12,3565
6,6,0,1,10,3,13,3565
7,7,0,0,10,3,13,3565
0,0,1,0,1,0,1,3566
1,1,1,0,2,0,2,3566
2,2,1,0,3,0,3,3566
3,3,0,0,3,0,3,3566
0,0,1,0,1,0,1,3567
1,1,1,0,2,0,2,3567
2,2,0,0,2,0,2,3567
0,0,1,0,1,0,1,3568
1,1,1,1,2,1,3,3568
2,2,0,2,2,3,5,3568
3,3,1,0,3,3,6,3568
4,4,1,0,4,3,7,3568
5,5,0,1,4,4,8,3568
6,6,0,0,4,4,8,3568
0,0,1,0,1,0,1,3569
1,1,1,0,2,0,2,3569
2,2,2,0,4,0,4,3569
3,3,1,1,5,1,6,3569
4,4,0,0,5,1,6,3569
0,0,1,0,1,0,1,3570
1,1,2,0,3,0,3,3570
2,2,3,0,6,0,6,3570
3,3,0,0,6,0,6,3570
0,0,1,0,1,0,1,3571
1,1,1,1,2,1,3,3571
2,2,1,1,3,2,5,3571
3,3,1,3,4,5,9,3571
4,4,0,1,4,6,10,3571
5,5,0,0,4,6,10,3571
0,0,1,0,1,0,1,3572
1,1,1,0,2,0,2,3572
2,2,1,0,3,0,3,3572
3,3,2,0,5,0,5,3572
4,4,3,0,8,0,8,3572
5,5,3,0,11,0,11,3572
6,6,2,0,13,0,13,3572
7,7,2,1,15,1,16,3572
8,8,0,0,15,1,16,3572
0,0,1,0,1,0,1,3573
1,1,1,0,2,0,2,3573
2,2,1,0,3,0,3,3573
3,3,2,0,5,0,5,3573
4,4,2,0,7,0,7,3573
5,5,1,1,8,1,9,3573
6,6,0,2,8,3,11,3573
7,7,1,1,9,4,13,3573
8,8,1,2,10,6,16,3573
9,9,0,2,10,8,18,3573
10,10,2,3,12,11,23,3573
11,11,1,0,13,11,24,3573
12,12,0,0,13,11,24,3573
0,0,1,0,1,0,1,3574
1,1,2,1,3,1,4,3574
2,2,2,0,5,1,6,3574
3,3,1,0,6,1,7,3574
4,4,0,1,6,2,8,3574
5,5,0,0,6,2,8,3574
0,0,1,0,1,0,1,3575
1,1,0,0,1,0,1,3575
0,0,1,0,1,0,1,3576
1,1,0,0,1,0,1,3576
0,0,1,0,1,0,1,3577
1,1,1,0,2,0,2,3577
2,2,0,0,2,0,2,3577
0,0,1,0,1,0,1,3578
1,1,0,0,1,0,1,3578
0,0,1,0,1,0,1,3579
1,1,1,0,2,0,2,3579
2,2,0,0,2,0,2,3579
0,0,1,0,1,0,1,3580
1,1,1,0,2,0,2,3580
2,2,0,1,2,1,3,3580
3,3,0,0,2,1,3,3580
0,0,1,0,1,0,1,3581
1,1,0,0,1,0,1,3581
0,0,1,0,1,0,1,3582
1,1,0,1,1,1,2,3582
2,2,0,0,1,1,2,3582
0,0,1,0,1,0,1,3583
1,1,3,1,4,1,5,3583
2,2,3,1,7,2,9,3583
3,3,4,1,11,3,14,3583
4,4,2,0,13,3,16,3583
5,5,2,0,15,3,18,3583
6,6,2,0,17,3,20,3583
7,7,1,0,18,3,21,3583
8,8,2,0,20,3,23,3583
9,9,0,1,20,4,24,3583
10,10,1,1,21,5,26,3583
11,11,1,2,22,7,29,3583
12,12,1,5,23,12,35,3583
13,13,1,2,24,14,38,3583
14,14,1,2,25,16,41,3583
15,15,1,0,26,16,42,3583
16,16,0,0,26,16,42,3583
0,0,1,0,1,0,1,3584
1,1,2,0,3,0,3,3584
2,2,0,0,3,0,3,3584
0,0,1,0,1,0,1,3585
1,1,0,0,1,0,1,3585
0,0,1,0,1,0,1,3586
1,1,0,0,1,0,1,3586
0,0,1,0,1,0,1,3587
1,1,0,0,1,0,1,3587
0,0,1,0,1,0,1,3588
1,1,1,0,2,0,2,3588
2,2,0,1,2,1,3,3588
3,3,0,2,2,3,5,3588
4,4,1,2,3,5,8,3588
5,5,2,2,5,7,12,3588
6,6,3,1,8,8,16,3588
7,7,2,0,10,8,18,3588
8,8,2,2,12,10,22,3588
9,9,0,2,12,12,24,3588
10,10,0,1,12,13,25,3588
11,11,0,2,12,15,27,3588
12,12,0,3,12,18,30,3588
13,13,0,2,12,20,32,3588
14,14,0,2,12,22,34,3588
15,15,1,3,13,25,38,3588
16,16,1,2,14,27,41,3588
17,17,1,2,15,29,44,3588
18,18,0,0,15,29,44,3588
0,0,1,0,1,0,1,3589
1,1,1,0,2,0,2,3589
2,2,0,0,2,0,2,3589
0,0,1,0,1,0,1,3590
1,1,0,1,1,1,2,3590
2,2,0,0,1,1,2,3590
0,0,1,0,1,0,1,3591
1,1,0,0,1,0,1,3591
0,0,1,0,1,0,1,3592
1,1,0,0,1,0,1,3592
0,0,1,0,1,0,1,3593
1,1,1,1,2,1,3,3593
2,2,0,0,2,1,3,3593
0,0,1,0,1,0,1,3594
1,1,1,1,2,1,3,3594
2,2,0,0,2,1,3,3594
0,0,1,0,1,0,1,3595
1,1,1,0,2,0,2,3595
2,2,1,1,3,1,4,3595
3,3,1,0,4,1,5,3595
4,4,0,0,4,1,5,3595
0,0,1,0,1,0,1,3596
1,1,2,0,3,0,3,3596
2,2,0,0,3,0,3,3596
0,0,1,0,1,0,1,3597
1,1,0,1,1,1,2,3597
2,2,0,0,1,1,2,3597
0,0,1,0,1,0,1,3598
1,1,0,1,1,1,2,3598
2,2,0,0,1,1,2,3598
0,0,1,0,1,0,1,3599
1,1,0,0,1,0,1,3599
0,0,1,0,1,0,1,3600
1,1,0,0,1,0,1,3600
0,0,1,0,1,0,1,3601
1,1,1,1,2,1,3,3601
2,2,2,1,4,2,6,3601
3,3,2,0,6,2,8,3601
4,4,3,0,9,2,11,3601
5,5,3,0,12,2,14,3601
6,6,2,0,14,2,16,3601
7,7,1,0,15,2,17,3601
8,8,1,0,16,2,18,3601
9,9,0,0,16,2,18,3601
0,0,1,0,1,0,1,3602
1,1,0,1,1,1,2,3602
2,2,0,1,1,2,3,3602
3,3,0,0,1,2,3,3602
0,0,1,0,1,0,1,3603
1,1,1,0,2,0,2,3603
2,2,2,0,4,0,4,3603
3,3,1,0,5,0,5,3603
4,4,0,0,5,0,5,3603
0,0,1,0,1,0,1,3604
1,1,0,1,1,1,2,3604
2,2,0,1,1,2,3,3604
3,3,0,0,1,2,3,3604
0,0,1,0,1,0,1,3605
1,1,0,0,1,0,1,3605
0,0,1,0,1,0,1,3606
1,1,1,1,2,1,3,3606
2,2,2,0,4,1,5,3606
3,3,2,0,6,1,7,3606
4,4,0,0,6,1,7,3606
0,0,1,0,1,0,1,3607
1,1,2,0,3,0,3,3607
2,2,3,0,6,0,6,3607
3,3,1,1,7,1,8,3607
4,4,1,2,8,3,11,3607
5,5,1,0,9,3,12,3607
6,6,1,0,10,3,13,3607
7,7,0,0,10,3,13,3607
0,0,1,0,1,0,1,3608
1,1,0,0,1,0,1,3608
0,0,1,0,1,0,1,3609
1,1,0,0,1,0,1,3609
0,0,1,0,1,0,1,3610
1,1,0,0,1,0,1,3610
0,0,1,0,1,0,1,3611
1,1,0,0,1,0,1,3611
0,0,1,0,1,0,1,3612
1,1,0,0,1,0,1,3612
0,0,1,0,1,0,1,3613
1,1,0,0,1,0,1,3613
0,0,1,0,1,0,1,3614
1,1,1,0,2,0,2,3614
2,2,0,0,2,0,2,3614
0,0,1,0,1,0,1,3615
1,1,0,0,1,0,1,3615
0,0,1,0,1,0,1,3616
1,1,1,0,2,0,2,3616
2,2,0,0,2,0,2,3616
0,0,1,0,1,0,1,3617
1,1,1,1,2,1,3,3617
2,2,3,0,5,1,6,3617
3,3,4,0,9,1,10,3617
4,4,3,2,12,3,15,3617
5,5,0,3,12,6,18,3617
6,6,0,2,12,8,20,3617
7,7,0,1,12,9,21,3617
8,8,0,0,12,9,21,3617
0,0,1,0,1,0,1,3618
1,1,2,1,3,1,4,3618
2,2,1,0,4,1,5,3618
3,3,2,0,6,1,7,3618
4,4,2,2,8,3,11,3618
5,5,1,1,9,4,13,3618
6,6,1,0,10,4,14,3618
7,7,1,0,11,4,15,3618
8,8,1,0,12,4,16,3618
9,9,1,0,13,4,17,3618
10,10,0,0,13,4,17,3618
0,0,1,0,1,0,1,3619
1,1,2,0,3,0,3,3619
2,2,2,0,5,0,5,3619
3,3,2,0,7,0,7,3619
4,4,1,0,8,0,8,3619
5,5,0,0,8,0,8,3619
0,0,1,0,1,0,1,3620
1,1,0,1,1,1,2,3620
2,2,0,1,1,2,3,3620
3,3,0,0,1,2,3,3620
0,0,1,0,1,0,1,3621
1,1,0,0,1,0,1,3621
0,0,1,0,1,0,1,3622
1,1,0,0,1,0,1,3622
0,0,1,0,1,0,1,3623
1,1,1,1,2,1,3,3623
2,2,0,2,2,3,5,3623
3,3,1,3,3,6,9,3623
4,4,1,2,4,8,12,3623
5,5,0,1,4,9,13,3623
6,6,1,3,5,12,17,3623
7,7,1,3,6,15,21,3623
8,8,2,0,8,15,23,3623
9,9,3,0,11,15,26,3623
10,10,1,1,12,16,28,3623
11,11,1,0,13,16,29,3623
12,12,0,0,13,16,29,3623
0,0,1,0,1,0,1,3624
1,1,1,0,2,0,2,3624
2,2,0,0,2,0,2,3624
0,0,1,0,1,0,1,3625
1,1,0,0,1,0,1,3625
0,0,1,0,1,0,1,3626
1,1,1,0,2,0,2,3626
2,2,0,0,2,0,2,3626
0,0,1,0,1,0,1,3627
1,1,1,0,2,0,2,3627
2,2,0,0,2,0,2,3627
0,0,1,0,1,0,1,3628
1,1,3,0,4,0,4,3628
2,2,2,0,6,0,6,3628
3,3,0,0,6,0,6,3628
0,0,1,0,1,0,1,3629
1,1,2,0,3,0,3,3629
2,2,3,0,6,0,6,3629
3,3,1,1,7,1,8,3629
4,4,1,2,8,3,11,3629
5,5,0,3,8,6,14,3629
6,6,0,0,8,6,14,3629
0,0,1,0,1,0,1,3630
1,1,0,0,1,0,1,3630
0,0,1,0,1,0,1,3631
1,1,1,1,2,1,3,3631
2,2,1,2,3,3,6,3631
3,3,1,3,4,6,10,3631
4,4,2,0,6,6,12,3631
5,5,1,0,7,6,13,3631
6,6,0,0,7,6,13,3631
0,0,1,0,1,0,1,3632
1,1,1,0,2,0,2,3632
2,2,2,0,4,0,4,3632
3,3,1,0,5,0,5,3632
4,4,1,0,6,0,6,3632
5,5,0,1,6,1,7,3632
6,6,1,1,7,2,9,3632
7,7,0,2,7,4,11,3632
8,8,0,0,7,4,11,3632
0,0,1,0,1,0,1,3633
1,1,0,0,1,0,1,3633
0,0,1,0,1,0,1,3634
1,1,0,0,1,0,1,3634
0,0,1,0,1,0,1,3635
1,1,1,0,2,0,2,3635
2,2,1,0,3,0,3,3635
3,3,0,0,3,0,3,3635
0,0,1,0,1,0,1,3636
1,1,2,0,3,0,3,3636
2,2,3,0,6,0,6,3636
3,3,1,1,7,1,8,3636
4,4,2,1,9,2,11,3636
5,5,2,1,11,3,14,3636
6,6,0,1,11,4,15,3636
7,7,0,1,11,5,16,3636
8,8,0,1,11,6,17,3636
9,9,1,2,12,8,20,3636
10,10,1,2,13,10,23,3636
11,11,0,2,13,12,25,3636
12,12,0,2,13,14,27,3636
13,13,1,1,14,15,29,3636
14,14,0,0,14,15,29,3636
0,0,1,0,1,0,1,3637
1,1,0,0,1,0,1,3637
0,0,1,0,1,0,1,3638
1,1,0,0,1,0,1,3638
0,0,1,0,1,0,1,3639
1,1,1,1,2,1,3,3639
2,2,1,2,3,3,6,3639
3,3,0,2,3,5,8,3639
4,4,1,0,4,5,9,3639
5,5,1,0,5,5,10,3639
6,6,0,0,5,5,10,3639
0,0,1,0,1,0,1,3640
1,1,0,0,1,0,1,3640
0,0,1,0,1,0,1,3641
1,1,1,0,2,0,2,3641
2,2,0,0,2,0,2,3641
0,0,1,0,1,0,1,3642
1,1,1,1,2,1,3,3642
2,2,0,0,2,1,3,3642
0,0,1,0,1,0,1,3643
1,1,0,0,1,0,1,3643
0,0,1,0,1,0,1,3644
1,1,2,0,3,0,3,3644
2,2,1,0,4,0,4,3644
3,3,0,0,4,0,4,3644
0,0,1,0,1,0,1,3645
1,1,0,0,1,0,1,3645
0,0,1,0,1,0,1,3646
1,1,1,0,2,0,2,3646
2,2,3,0,5,0,5,3646
3,3,4,0,9,0,9,3646
4,4,1,0,10,0,10,3646
5,5,0,0,10,0,10,3646
0,0,1,0,1,0,1,3647
1,1,2,0,3,0,3,3647
2,2,0,0,3,0,3,3647
0,0,1,0,1,0,1,3648
1,1,1,0,2,0,2,3648
2,2,1,0,3,0,3,3648
3,3,1,0,4,0,4,3648
4,4,0,0,4,0,4,3648
0,0,1,0,1,0,1,3649
1,1,1,0,2,0,2,3649
2,2,1,0,3,0,3,3649
3,3,2,0,5,0,5,3649
4,4,4,0,9,0,9,3649
5,5,4,1,13,1,14,3649
6,6,5,3,18,4,22,3649
7,7,8,3,26,7,33,3649
8,8,6,2,32,9,41,3649
9,9,7,2,39,11,50,3649
10,10,7,4,46,15,61,3649
11,11,7,2,53,17,70,3649
12,12,6,3,59,20,79,3649
13,13,5,2,64,22,86,3649
14,14,5,2,69,24,93,3649
15,15,2,3,71,27,98,3649
16,16,2,3,73,30,103,3649
17,17,0,3,73,33,106,3649
18,18,2,0,75,33,108,3649
19,19,1,0,76,33,109,3649
20,20,0,0,76,33,109,3649
0,0,1,0,1,0,1,3650
1,1,0,0,1,0,1,3650
0,0,1,0,1,0,1,3651
1,1,0,0,1,0,1,3651
0,0,1,0,1,0,1,3652
1,1,0,1,1,1,2,3652
2,2,0,0,1,1,2,3652
0,0,1,0,1,0,1,3653
1,1,0,0,1,0,1,3653
0,0,1,0,1,0,1,3654
1,1,1,2,2,2,4,3654
2,2,2,2,4,4,8,3654
3,3,2,3,6,7,13,3654
4,4,2,0,8,7,15,3654
5,5,1,0,9,7,16,3654
6,6,2,0,11,7,18,3654
7,7,2,1,13,8,21,3654
8,8,2,1,15,9,24,3654
9,9,2,2,17,11,28,3654
10,10,1,2,18,13,31,3654
11,11,1,2,19,15,34,3654
12,12,0,0,19,15,34,3654
0,0,1,0,1,0,1,3655
1,1,2,0,3,0,3,3655
2,2,1,0,4,0,4,3655
3,3,0,0,4,0,4,3655
0,0,1,0,1,0,1,3656
1,1,0,1,1,1,2,3656
2,2,0,1,1,2,3,3656
3,3,0,2,1,4,5,3656
4,4,1,2,2,6,8,3656
5,5,0,2,2,8,10,3656
6,6,0,2,2,10,12,3656
7,7,0,2,2,12,14,3656
8,8,2,0,4,12,16,3656
9,9,2,0,6,12,18,3656
10,10,0,1,6,13,19,3656
11,11,0,0,6,13,19,3656
0,0,1,0,1,0,1,3657
1,1,3,0,4,0,4,3657
2,2,0,0,4,0,4,3657
0,0,1,0,1,0,1,3658
1,1,1,0,2,0,2,3658
2,2,2,0,4,0,4,3658
3,3,2,0,6,0,6,3658
4,4,4,0,10,0,10,3658
5,5,3,3,13,3,16,3658
6,6,0,4,13,7,20,3658
7,7,1,3,14,10,24,3658
8,8,2,5,16,15,31,3658
9,9,2,9,18,24,42,3658
10,10,1,5,19,29,48,3658
11,11,4,3,23,32,55,3658
12,12,2,3,25,35,60,3658
13,13,1,2,26,37,63,3658
14,14,1,3,27,40,67,3658
15,15,0,2,27,42,69,3658
16,16,0,2,27,44,71,3658
17,17,1,1,28,45,73,3658
18,18,0,1,28,46,74,3658
19,19,2,1,30,47,77,3658
20,20,1,1,31,48,79,3658
21,21,1,1,32,49,81,3658
22,22,2,2,34,51,85,3658
23,23,1,2,35,53,88,3658
24,24,0,0,35,53,88,3658
0,0,1,0,1,0,1,3659
1,1,2,1,3,1,4,3659
2,2,2,2,5,3,8,3659
3,3,2,1,7,4,11,3659
4,4,1,0,8,4,12,3659
5,5,1,0,9,4,13,3659
6,6,1,0,10,4,14,3659
7,7,1,1,11,5,16,3659
8,8,1,2,12,7,19,3659
9,9,0,1,12,8,20,3659
10,10,0,0,12,8,20,3659
0,0,1,0,1,0,1,3660
1,1,0,0,1,0,1,3660
0,0,1,0,1,0,1,3661
1,1,0,0,1,0,1,3661
0,0,1,0,1,0,1,3662
1,1,0,0,1,0,1,3662
0,0,1,0,1,0,1,3663
1,1,1,0,2,0,2,3663
2,2,0,0,2,0,2,3663
0,0,1,0,1,0,1,3664
1,1,0,0,1,0,1,3664
0,0,1,0,1,0,1,3665
1,1,0,0,1,0,1,3665
0,0,1,0,1,0,1,3666
1,1,1,0,2,0,2,3666
2,2,1,0,3,0,3,3666
3,3,0,0,3,0,3,3666
0,0,1,0,1,0,1,3667
1,1,2,0,3,0,3,3667
2,2,3,0,6,0,6,3667
3,3,0,1,6,1,7,3667
4,4,0,0,6,1,7,3667
0,0,1,0,1,0,1,3668
1,1,0,1,1,1,2,3668
2,2,0,0,1,1,2,3668
0,0,1,0,1,0,1,3669
1,1,0,0,1,0,1,3669
0,0,1,0,1,0,1,3670
1,1,1,0,2,0,2,3670
2,2,0,0,2,0,2,3670
0,0,1,0,1,0,1,3671
1,1,0,1,1,1,2,3671
2,2,0,2,1,3,4,3671
3,3,0,1,1,4,5,3671
4,4,0,1,1,5,6,3671
5,5,0,1,1,6,7,3671
6,6,1,0,2,6,8,3671
7,7,1,0,3,6,9,3671
8,8,1,1,4,7,11,3671
9,9,2,2,6,9,15,3671
10,10,0,4,6,13,19,3671
11,11,0,1,6,14,20,3671
12,12,0,0,6,14,20,3671
0,0,1,0,1,0,1,3672
1,1,1,0,2,0,2,3672
2,2,0,0,2,0,2,3672
0,0,1,0,1,0,1,3673
1,1,0,0,1,0,1,3673
0,0,1,0,1,0,1,3674
1,1,0,1,1,1,2,3674
2,2,0,2,1,3,4,3674
3,3,0,1,1,4,5,3674
4,4,0,0,1,4,5,3674
0,0,1,0,1,0,1,3675
1,1,3,1,4,1,5,3675
2,2,1,0,5,1,6,3675
3,3,1,0,6,1,7,3675
4,4,0,0,6,1,7,3675
0,0,1,0,1,0,1,3676
1,1,1,0,2,0,2,3676
2,2,1,1,3,1,4,3676
3,3,0,1,3,2,5,3676
4,4,0,1,3,3,6,3676
5,5,1,1,4,4,8,3676
6,6,0,0,4,4,8,3676
0,0,1,0,1,0,1,3677
1,1,0,0,1,0,1,3677
0,0,1,0,1,0,1,3678
1,1,1,0,2,0,2,3678
2,2,1,0,3,0,3,3678
3,3,0,0,3,0,3,3678
0,0,1,0,1,0,1,3679
1,1,0,0,1,0,1,3679
0,0,1,0,1,0,1,3680
1,1,1,0,2,0,2,3680
2,2,0,0,2,0,2,3680
0,0,1,0,1,0,1,3681
1,1,1,0,2,0,2,3681
2,2,0,0,2,0,2,3681
0,0,1,0,1,0,1,3682
1,1,1,0,2,0,2,3682
2,2,1,0,3,0,3,3682
3,3,2,0,5,0,5,3682
4,4,0,0,5,0,5,3682
0,0,1,0,1,0,1,3683
1,1,0,0,1,0,1,3683
0,0,1,0,1,0,1,3684
1,1,3,0,4,0,4,3684
2,2,1,0,5,0,5,3684
3,3,0,0,5,0,5,3684
0,0,1,0,1,0,1,3685
1,1,1,0,2,0,2,3685
2,2,1,0,3,0,3,3685
3,3,0,0,3,0,3,3685
0,0,1,0,1,0,1,3686
1,1,0,0,1,0,1,3686
0,0,1,0,1,0,1,3687
1,1,0,0,1,0,1,3687
0,0,1,0,1,0,1,3688
1,1,1,0,2,0,2,3688
2,2,1,1,3,1,4,3688
3,3,1,1,4,2,6,3688
4,4,0,0,4,2,6,3688
0,0,1,0,1,0,1,3689
1,1,1,0,2,0,2,3689
2,2,0,0,2,0,2,3689
0,0,1,0,1,0,1,3690
1,1,2,1,3,1,4,3690
2,2,1,0,4,1,5,3690
3,3,2,0,6,1,7,3690
4,4,0,0,6,1,7,3690
0,0,1,0,1,0,1,3691
1,1,0,0,1,0,1,3691
0,0,1,0,1,0,1,3692
1,1,0,0,1,0,1,3692
0,0,1,0,1,0,1,3693
1,1,1,0,2,0,2,3693
2,2,4,1,6,1,7,3693
3,3,3,1,9,2,11,3693
4,4,1,2,10,4,14,3693
5,5,1,0,11,4,15,3693
6,6,1,0,12,4,16,3693
7,7,1,0,13,4,17,3693
8,8,0,0,13,4,17,3693
0,0,1,0,1,0,1,3694
1,1,0,0,1,0,1,3694
0,0,1,0,1,0,1,3695
1,1,0,1,1,1,2,3695
2,2,0,0,1,1,2,3695
0,0,1,0,1,0,1,3696
1,1,1,0,2,0,2,3696
2,2,0,0,2,0,2,3696
0,0,1,0,1,0,1,3697
1,1,0,1,1,1,2,3697
2,2,1,0,2,1,3,3697
3,3,1,0,3,1,4,3697
4,4,0,0,3,1,4,3697
0,0,1,0,1,0,1,3698
1,1,1,0,2,0,2,3698
2,2,0,0,2,0,2,3698
0,0,1,0,1,0,1,3699
1,1,0,1,1,1,2,3699
2,2,0,1,1,2,3,3699
3,3,1,1,2,3,5,3699
4,4,1,2,3,5,8,3699
5,5,2,1,5,6,11,3699
6,6,2,1,7,7,14,3699
7,7,0,3,7,10,17,3699
8,8,2,3,9,13,22,3699
9,9,4,2,13,15,28,3699
10,10,5,1,18,16,34,3699
11,11,6,1,24,17,41,3699
12,12,1,2,25,19,44,3699
13,13,0,0,25,19,44,3699
0,0,1,0,1,0,1,3700
1,1,1,0,2,0,2,3700
2,2,0,0,2,0,2,3700
0,0,1,0,1,0,1,3701
1,1,2,0,3,0,3,3701
2,2,3,0,6,0,6,3701
3,3,2,3,8,3,11,3701
4,4,2,3,10,6,16,3701
5,5,2,3,12,9,21,3701
6,6,1,3,13,12,25,3701
7,7,0,2,13,14,27,3701
8,8,0,2,13,16,29,3701
9,9,1,1,14,17,31,3701
10,10,1,2,15,19,34,3701
11,11,3,0,18,19,37,3701
12,12,3,1,21,20,41,3701
13,13,2,1,23,21,44,3701
14,14,3,1,26,22,48,3701
15,15,1,2,27,24,51,3701
16,16,2,3,29,27,56,3701
17,17,1,3,30,30,60,3701
18,18,0,1,30,31,61,3701
19,19,0,1,30,32,62,3701
20,20,0,0,30,32,62,3701
0,0,1,0,1,0,1,3702
1,1,1,0,2,0,2,3702
2,2,1,0,3,0,3,3702
3,3,0,0,3,0,3,3702
0,0,1,0,1,0,1,3703
1,1,3,0,4,0,4,3703
2,2,4,1,8,1,9,3703
3,3,1,1,9,2,11,3703
4,4,0,0,9,2,11,3703
0,0,1,0,1,0,1,3704
1,1,1,0,2,0,2,3704
2,2,2,1,4,1,5,3704
3,3,4,1,8,2,10,3704
4,4,2,1,10,3,13,3704
5,5,0,1,10,4,14,3704
6,6,0,2,10,6,16,3704
7,7,0,1,10,7,17,3704
8,8,0,1,10,8,18,3704
9,9,0,1,10,9,19,3704
10,10,0,0,10,9,19,3704
0,0,1,0,1,0,1,3705
1,1,1,0,2,0,2,3705
2,2,1,0,3,0,3,3705
3,3,0,0,3,0,3,3705
0,0,1,0,1,0,1,3706
1,1,2,0,3,0,3,3706
2,2,2,0,5,0,5,3706
3,3,2,0,7,0,7,3706
4,4,3,2,10,2,12,3706
5,5,2,2,12,4,16,3706
6,6,1,0,13,4,17,3706
7,7,0,0,13,4,17,3706
0,0,1,0,1,0,1,3707
1,1,0,0,1,0,1,3707
0,0,1,0,1,0,1,3708
1,1,0,1,1,1,2,3708
2,2,0,1,1,2,3,3708
3,3,0,2,1,4,5,3708
4,4,1,2,2,6,8,3708
5,5,1,2,3,8,11,3708
6,6,1,2,4,10,14,3708
7,7,2,2,6,12,18,3708
8,8,3,7,9,19,28,3708
9,9,1,7,10,26,36,3708
10,10,3,5,13,31,44,3708
11,11,5,2,18,33,51,3708
12,12,4,2,22,35,57,3708
13,13,4,0,26,35,61,3708
14,14,2,1,28,36,64,3708
15,15,3,1,31,37,68,3708
16,16,5,3,36,40,76,3708
17,17,11,4,47,44,91,3708
18,18,5,3,52,47,99,3708
19,19,4,1,56,48,104,3708
20,20,4,3,60,51,111,3708
21,21,1,3,61,54,115,3708
22,22,1,3,62,57,119,3708
23,23,3,1,65,58,123,3708
24,24,4,0,69,58,127,3708
25,25,4,1,73,59,132,3708
26,26,4,4,77,63,140,3708
27,27,3,1,80,64,144,3708
28,28,0,1,80,65,145,3708
29,29,0,0,80,65,145,3708
0,0,1,0,1,0,1,3709
1,1,1,0,2,0,2,3709
2,2,2,0,4,0,4,3709
3,3,1,0,5,0,5,3709
4,4,0,0,5,0,5,3709
0,0,1,0,1,0,1,3710
1,1,0,1,1,1,2,3710
2,2,0,1,1,2,3,3710
3,3,0,1,1,3,4,3710
4,4,0,0,1,3,4,3710
0,0,1,0,1,0,1,3711
1,1,1,0,2,0,2,3711
2,2,1,0,3,0,3,3711
3,3,0,0,3,0,3,3711
0,0,1,0,1,0,1,3712
1,1,0,0,1,0,1,3712
0,0,1,0,1,0,1,3713
1,1,0,0,1,0,1,3713
0,0,1,0,1,0,1,3714
1,1,0,0,1,0,1,3714
0,0,1,0,1,0,1,3715
1,1,1,0,2,0,2,3715
2,2,3,0,5,0,5,3715
3,3,4,0,9,0,9,3715
4,4,2,0,11,0,11,3715
5,5,2,1,13,1,14,3715
6,6,2,2,15,3,18,3715
7,7,0,1,15,4,19,3715
8,8,0,2,15,6,21,3715
9,9,0,0,15,6,21,3715
0,0,1,0,1,0,1,3716
1,1,1,0,2,0,2,3716
2,2,3,0,5,0,5,3716
3,3,5,1,10,1,11,3716
4,4,2,2,12,3,15,3716
5,5,3,2,15,5,20,3716
6,6,2,3,17,8,25,3716
7,7,3,1,20,9,29,3716
8,8,4,3,24,12,36,3716
9,9,3,4,27,16,43,3716
10,10,3,2,30,18,48,3716
11,11,3,4,33,22,55,3716
12,12,3,4,36,26,62,3716
13,13,4,4,40,30,70,3716
14,14,3,3,43,33,76,3716
15,15,0,3,43,36,79,3716
16,16,0,4,43,40,83,3716
17,17,1,6,44,46,90,3716
18,18,0,6,44,52,96,3716
19,19,0,7,44,59,103,3716
20,20,0,6,44,65,109,3716
21,21,1,5,45,70,115,3716
22,22,0,3,45,73,118,3716
23,23,0,6,45,79,124,3716
24,24,1,8,46,87,133,3716
25,25,0,3,46,90,136,3716
26,26,0,2,46,92,138,3716
27,27,0,3,46,95,141,3716
28,28,1,4,47,99,146,3716
29,29,0,4,47,103,150,3716
30,30,2,2,49,105,154,3716
31,31,3,1,52,106,158,3716
32,32,6,0,58,106,164,3716
33,33,8,1,66,107,173,3716
34,34,4,3,70,110,180,3716
35,35,4,2,74,112,186,3716
36,36,3,1,77,113,190,3716
37,37,2,2,79,115,194,3716
38,38,1,1,80,116,196,3716
39,39,1,0,81,116,197,3716
40,40,0,0,81,116,197,3716
0,0,1,0,1,0,1,3717
1,1,0,0,1,0,1,3717
0,0,1,0,1,0,1,3718
1,1,1,0,2,0,2,3718
2,2,0,0,2,0,2,3718
0,0,1,0,1,0,1,3719
1,1,0,2,1,2,3,3719
2,2,0,2,1,4,5,3719
3,3,0,1,1,5,6,3719
4,4,0,2,1,7,8,3719
5,5,0,1,1,8,9,3719
6,6,0,1,1,9,10,3719
7,7,0,0,1,9,10,3719
0,0,1,0,1,0,1,3720
1,1,1,0,2,0,2,3720
2,2,0,0,2,0,2,3720
0,0,1,0,1,0,1,3721
1,1,1,0,2,0,2,3721
2,2,0,0,2,0,2,3721
0,0,1,0,1,0,1,3722
1,1,0,0,1,0,1,3722
0,0,1,0,1,0,1,3723
1,1,1,0,2,0,2,3723
2,2,0,0,2,0,2,3723
0,0,1,0,1,0,1,3724
1,1,0,0,1,0,1,3724
0,0,1,0,1,0,1,3725
1,1,1,0,2,0,2,3725
2,2,0,1,2,1,3,3725
3,3,0,2,2,3,5,3725
4,4,0,2,2,5,7,3725
5,5,0,0,2,5,7,3725
0,0,1,0,1,0,1,3726
1,1,1,0,2,0,2,3726
2,2,1,0,3,0,3,3726
3,3,1,0,4,0,4,3726
4,4,0,0,4,0,4,3726
0,0,1,0,1,0,1,3727
1,1,1,0,2,0,2,3727
2,2,1,0,3,0,3,3727
3,3,2,0,5,0,5,3727
4,4,0,1,5,1,6,3727
5,5,0,1,5,2,7,3727
6,6,0,0,5,2,7,3727
0,0,1,0,1,0,1,3728
1,1,0,1,1,1,2,3728
2,2,0,0,1,1,2,3728
0,0,1,0,1,0,1,3729
1,1,2,0,3,0,3,3729
2,2,0,0,3,0,3,3729
0,0,1,0,1,0,1,3730
1,1,1,0,2,0,2,3730
2,2,0,0,2,0,2,3730
0,0,1,0,1,0,1,3731
1,1,2,0,3,0,3,3731
2,2,1,0,4,0,4,3731
3,3,1,2,5,2,7,3731
4,4,1,3,6,5,11,3731
5,5,1,3,7,8,15,3731
6,6,0,2,7,10,17,3731
7,7,0,0,7,10,17,3731
0,0,1,0,1,0,1,3732
1,1,0,0,1,0,1,3732
0,0,1,0,1,0,1,3733
1,1,1,0,2,0,2,3733
2,2,0,0,2,0,2,3733
0,0,1,0,1,0,1,3734
1,1,2,0,3,0,3,3734
2,2,1,1,4,1,5,3734
3,3,2,1,6,2,8,3734
4,4,0,4,6,6,12,3734
5,5,0,2,6,8,14,3734
6,6,1,0,7,8,15,3734
7,7,0,0,7,8,15,3734
0,0,1,0,1,0,1,3735
1,1,1,0,2,0,2,3735
2,2,0,0,2,0,2,3735
0,0,1,0,1,0,1,3736
1,1,1,2,2,2,4,3736
2,2,0,1,2,3,5,3736
3,3,0,0,2,3,5,3736
0,0,1,0,1,0,1,3737
1,1,0,0,1,0,1,3737
0,0,1,0,1,0,1,3738
1,1,1,0,2,0,2,3738
2,2,1,0,3,0,3,3738
3,3,0,0,3,0,3,3738
0,0,1,0,1,0,1,3739
1,1,0,0,1,0,1,3739
0,0,1,0,1,0,1,3740
1,1,1,0,2,0,2,3740
2,2,0,1,2,1,3,3740
3,3,1,0,3,1,4,3740
4,4,1,0,4,1,5,3740
5,5,1,0,5,1,6,3740
6,6,0,0,5,1,6,3740
0,0,1,0,1,0,1,3741
1,1,3,0,4,0,4,3741
2,2,2,2,6,2,8,3741
3,3,1,1,7,3,10,3741
4,4,0,0,7,3,10,3741
0,0,1,0,1,0,1,3742
1,1,0,0,1,0,1,3742
0,0,1,0,1,0,1,3743
1,1,0,0,1,0,1,3743
0,0,1,0,1,0,1,3744
1,1,0,1,1,1,2,3744
2,2,0,1,1,2,3,3744
3,3,1,0,2,2,4,3744
4,4,0,0,2,2,4,3744
0,0,1,0,1,0,1,3745
1,1,0,0,1,0,1,3745
0,0,1,0,1,0,1,3746
1,1,3,0,4,0,4,3746
2,2,3,0,7,0,7,3746
3,3,3,1,10,1,11,3746
4,4,1,1,11,2,13,3746
5,5,2,0,13,2,15,3746
6,6,1,1,14,3,17,3746
7,7,0,1,14,4,18,3746
8,8,0,0,14,4,18,3746
0,0,1,0,1,0,1,3747
1,1,0,0,1,0,1,3747
0,0,1,0,1,0,1,3748
1,1,1,0,2,0,2,3748
2,2,1,0,3,0,3,3748
3,3,1,0,4,0,4,3748
4,4,2,0,6,0,6,3748
5,5,2,2,8,2,10,3748
6,6,3,5,11,7,18,3748
7,7,8,3,19,10,29,3748
8,8,3,2,22,12,34,3748
9,9,1,1,23,13,36,3748
10,10,2,1,25,14,39,3748
11,11,5,1,30,15,45,3748
12,12,3,3,33,18,51,3748
13,13,5,0,38,18,56,3748
14,14,8,0,46,18,64,3748
15,15,6,2,52,20,72,3748
16,16,5,1,57,21,78,3748
17,17,6,2,63,23,86,3748
18,18,6,1,69,24,93,3748
19,19,4,2,73,26,99,3748
20,20,7,3,80,29,109,3748
21,21,2,1,82,30,112,3748
22,22,2,2,84,32,116,3748
23,23,1,0,85,32,117,3748
24,24,1,0,86,32,118,3748
25,25,0,0,86,32,118,3748
0,0,1,0,1,0,1,3749
1,1,1,0,2,0,2,3749
2,2,0,0,2,0,2,3749
0,0,1,0,1,0,1,3750
1,1,1,0,2,0,2,3750
2,2,1,0,3,0,3,3750
3,3,0,0,3,0,3,3750
0,0,1,0,1,0,1,3751
1,1,0,0,1,0,1,3751
0,0,1,0,1,0,1,3752
1,1,1,0,2,0,2,3752
2,2,0,1,2,1,3,3752
3,3,0,0,2,1,3,3752
0,0,1,0,1,0,1,3753
1,1,0,0,1,0,1,3753
0,0,1,0,1,0,1,3754
1,1,2,1,3,1,4,3754
2,2,1,1,4,2,6,3754
3,3,0,1,4,3,7,3754
4,4,0,2,4,5,9,3754
5,5,0,0,4,5,9,3754
0,0,1,0,1,0,1,3755
1,1,0,0,1,0,1,3755
0,0,1,0,1,0,1,3756
1,1,0,0,1,0,1,3756
0,0,1,0,1,0,1,3757
1,1,0,0,1,0,1,3757
0,0,1,0,1,0,1,3758
1,1,2,0,3,0,3,3758
2,2,3,1,6,1,7,3758
3,3,4,1,10,2,12,3758
4,4,2,1,12,3,15,3758
5,5,1,0,13,3,16,3758
6,6,3,1,16,4,20,3758
7,7,3,0,19,4,23,3758
8,8,5,0,24,4,28,3758
9,9,4,0,28,4,32,3758
10,10,2,0,30,4,34,3758
11,11,0,0,30,4,34,3758
0,0,1,0,1,0,1,3759
1,1,1,0,2,0,2,3759
2,2,0,0,2,0,2,3759
0,0,1,0,1,0,1,3760
1,1,1,0,2,0,2,3760
2,2,2,0,4,0,4,3760
3,3,3,0,7,0,7,3760
4,4,3,1,10,1,11,3760
5,5,2,0,12,1,13,3760
6,6,3,0,15,1,16,3760
7,7,5,1,20,2,22,3760
8,8,5,2,25,4,29,3760
9,9,2,1,27,5,32,3760
10,10,1,1,28,6,34,3760
11,11,2,1,30,7,37,3760
12,12,0,1,30,8,38,3760
13,13,0,0,30,8,38,3760
0,0,1,0,1,0,1,3761
1,1,2,0,3,0,3,3761
2,2,4,1,7,1,8,3761
3,3,2,0,9,1,10,3761
4,4,2,2,11,3,14,3761
5,5,2,1,13,4,17,3761
6,6,2,3,15,7,22,3761
7,7,3,2,18,9,27,3761
8,8,2,1,20,10,30,3761
9,9,5,1,25,11,36,3761
10,10,5,2,30,13,43,3761
11,11,4,5,34,18,52,3761
12,12,5,3,39,21,60,3761
13,13,5,4,44,25,69,3761
14,14,3,7,47,32,79,3761
15,15,5,7,52,39,91,3761
16,16,5,11,57,50,107,3761
17,17,6,10,63,60,123,3761
18,18,6,7,69,67,136,3761
19,19,8,6,77,73,150,3761
20,20,4,5,81,78,159,3761
21,21,0,7,81,85,166,3761
22,22,1,3,82,88,170,3761
23,23,0,4,82,92,174,3761
24,24,0,3,82,95,177,3761
25,25,0,0,82,95,177,3761
0,0,1,0,1,0,1,3762
1,1,0,0,1,0,1,3762
0,0,1,0,1,0,1,3763
1,1,2,0,3,0,3,3763
2,2,0,0,3,0,3,3763
0,0,1,0,1,0,1,3764
1,1,1,1,2,1,3,3764
2,2,0,1,2,2,4,3764
3,3,0,0,2,2,4,3764
0,0,1,0,1,0,1,3765
1,1,3,1,4,1,5,3765
2,2,1,0,5,1,6,3765
3,3,0,0,5,1,6,3765
0,0,1,0,1,0,1,3766
1,1,2,0,3,0,3,3766
2,2,1,1,4,1,5,3766
3,3,2,0,6,1,7,3766
4,4,1,0,7,1,8,3766
5,5,0,0,7,1,8,3766
0,0,1,0,1,0,1,3767
1,1,0,0,1,0,1,3767
0,0,1,0,1,0,1,3768
1,1,1,0,2,0,2,3768
2,2,0,1,2,1,3,3768
3,3,1,2,3,3,6,3768
4,4,0,1,3,4,7,3768
5,5,0,0,3,4,7,3768
0,0,1,0,1,0,1,3769
1,1,1,1,2,1,3,3769
2,2,2,0,4,1,5,3769
3,3,1,0,5,1,6,3769
4,4,1,0,6,1,7,3769
5,5,1,0,7,1,8,3769
6,6,0,0,7,1,8,3769
0,0,1,0,1,0,1,3770
1,1,1,0,2,0,2,3770
2,2,0,1,2,1,3,3770
3,3,0,0,2,1,3,3770
0,0,1,0,1,0,1,3771
1,1,0,1,1,1,2,3771
2,2,0,0,1,1,2,3771
0,0,1,0,1,0,1,3772
1,1,0,0,1,0,1,3772
0,0,1,0,1,0,1,3773
1,1,1,0,2,0,2,3773
2,2,1,0,3,0,3,3773
3,3,1,1,4,1,5,3773
4,4,0,2,4,3,7,3773
5,5,1,0,5,3,8,3773
6,6,1,0,6,3,9,3773
7,7,0,0,6,3,9,3773
0,0,1,0,1,0,1,3774
1,1,0,0,1,0,1,3774
0,0,1,0,1,0,1,3775
1,1,1,0,2,0,2,3775
2,2,1,0,3,0,3,3775
3,3,1,0,4,0,4,3775
4,4,0,0,4,0,4,3775
0,0,1,0,1,0,1,3776
1,1,0,0,1,0,1,3776
0,0,1,0,1,0,1,3777
1,1,0,0,1,0,1,3777
0,0,1,0,1,0,1,3778
1,1,1,1,2,1,3,3778
2,2,2,0,4,1,5,3778
3,3,0,0,4,1,5,3778
0,0,1,0,1,0,1,3779
1,1,0,0,1,0,1,3779
0,0,1,0,1,0,1,3780
1,1,0,0,1,0,1,3780
0,0,1,0,1,0,1,3781
1,1,0,0,1,0,1,3781
0,0,1,0,1,0,1,3782
1,1,1,0,2,0,2,3782
2,2,0,0,2,0,2,3782
0,0,1,0,1,0,1,3783
1,1,1,0,2,0,2,3783
2,2,0,1,2,1,3,3783
3,3,1,0,3,1,4,3783
4,4,1,0,4,1,5,3783
5,5,0,0,4,1,5,3783
0,0,1,0,1,0,1,3784
1,1,0,0,1,0,1,3784
0,0,1,0,1,0,1,3785
1,1,0,1,1,1,2,3785
2,2,0,0,1,1,2,3785
0,0,1,0,1,0,1,3786
1,1,0,0,1,0,1,3786
0,0,1,0,1,0,1,3787
1,1,0,0,1,0,1,3787
0,0,1,0,1,0,1,3788
1,1,0,0,1,0,1,3788
0,0,1,0,1,0,1,3789
1,1,1,0,2,0,2,3789
2,2,0,0,2,0,2,3789
0,0,1,0,1,0,1,3790
1,1,0,1,1,1,2,3790
2,2,1,0,2,1,3,3790
3,3,2,1,4,2,6,3790
4,4,1,2,5,4,9,3790
5,5,2,1,7,5,12,3790
6,6,2,0,9,5,14,3790
7,7,1,1,10,6,16,3790
8,8,0,0,10,6,16,3790
0,0,1,0,1,0,1,3791
1,1,0,0,1,0,1,3791
0,0,1,0,1,0,1,3792
1,1,3,0,4,0,4,3792
2,2,2,0,6,0,6,3792
3,3,0,0,6,0,6,3792
0,0,1,0,1,0,1,3793
1,1,0,1,1,1,2,3793
2,2,0,1,1,2,3,3793
3,3,0,1,1,3,4,3793
4,4,0,0,1,3,4,3793
0,0,1,0,1,0,1,3794
1,1,1,0,2,0,2,3794
2,2,0,0,2,0,2,3794
0,0,1,0,1,0,1,3795
1,1,0,0,1,0,1,3795
0,0,1,0,1,0,1,3796
1,1,2,0,3,0,3,3796
2,2,3,0,6,0,6,3796
3,3,4,1,10,1,11,3796
4,4,3,1,13,2,15,3796
5,5,1,2,14,4,18,3796
6,6,2,1,16,5,21,3796
7,7,1,2,17,7,24,3796
8,8,1,2,18,9,27,3796
9,9,1,3,19,12,31,3796
10,10,0,3,19,15,34,3796
11,11,0,3,19,18,37,3796
12,12,0,4,19,22,41,3796
13,13,1,2,20,24,44,3796
14,14,2,3,22,27,49,3796
15,15,1,1,23,28,51,3796
16,16,0,0,23,28,51,3796
0,0,1,0,1,0,1,3797
1,1,0,0,1,0,1,3797
0,0,1,0,1,0,1,3798
1,1,0,0,1,0,1,3798
0,0,1,0,1,0,1,3799
1,1,2,0,3,0,3,3799
2,2,1,0,4,0,4,3799
3,3,0,1,4,1,5,3799
4,4,0,0,4,1,5,3799
0,0,1,0,1,0,1,3800
1,1,0,0,1,0,1,3800
0,0,1,0,1,0,1,3801
1,1,2,0,3,0,3,3801
2,2,1,0,4,0,4,3801
3,3,1,0,5,0,5,3801
4,4,0,0,5,0,5,3801
0,0,1,0,1,0,1,3802
1,1,0,1,1,1,2,3802
2,2,0,0,1,1,2,3802
0,0,1,0,1,0,1,3803
1,1,2,0,3,0,3,3803
2,2,1,0,4,0,4,3803
3,3,0,0,4,0,4,3803
0,0,1,0,1,0,1,3804
1,1,1,2,2,2,4,3804
2,2,1,1,3,3,6,3804
3,3,0,1,3,4,7,3804
4,4,0,1,3,5,8,3804
5,5,0,1,3,6,9,3804
6,6,0,2,3,8,11,3804
7,7,0,2,3,10,13,3804
8,8,0,0,3,10,13,3804
0,0,1,0,1,0,1,3805
1,1,1,0,2,0,2,3805
2,2,0,1,2,1,3,3805
3,3,0,0,2,1,3,3805
0,0,1,0,1,0,1,3806
1,1,0,0,1,0,1,3806
0,0,1,0,1,0,1,3807
1,1,0,1,1,1,2,3807
2,2,0,1,1,2,3,3807
3,3,0,1,1,3,4,3807
4,4,0,1,1,4,5,3807
5,5,0,1,1,5,6,3807
6,6,0,0,1,5,6,3807
0,0,1,0,1,0,1,3808
1,1,0,0,1,0,1,3808
0,0,1,0,1,0,1,3809
1,1,0,0,1,0,1,3809
0,0,1,0,1,0,1,3810
1,1,0,0,1,0,1,3810
0,0,1,0,1,0,1,3811
1,1,0,1,1,1,2,3811
2,2,0,1,1,2,3,3811
3,3,0,0,1,2,3,3811
0,0,1,0,1,0,1,3812
1,1,0,1,1,1,2,3812
2,2,0,0,1,1,2,3812
0,0,1,0,1,0,1,3813
1,1,0,0,1,0,1,3813
0,0,1,0,1,0,1,3814
1,1,0,0,1,0,1,3814
0,0,1,0,1,0,1,3815
1,1,0,0,1,0,1,3815
0,0,1,0,1,0,1,3816
1,1,0,0,1,0,1,3816
0,0,1,0,1,0,1,3817
1,1,0,0,1,0,1,3817
0,0,1,0,1,0,1,3818
1,1,2,0,3,0,3,3818
2,2,0,0,3,0,3,3818
0,0,1,0,1,0,1,3819
1,1,1,1,2,1,3,3819
2,2,0,2,2,3,5,3819
3,3,0,4,2,7,9,3819
4,4,0,6,2,13,15,3819
5,5,1,6,3,19,22,3819
6,6,1,2,4,21,25,3819
7,7,1,0,5,21,26,3819
8,8,0,0,5,21,26,3819
0,0,1,0,1,0,1,3820
1,1,2,3,3,3,6,3820
2,2,1,3,4,6,10,3820
3,3,1,1,5,7,12,3820
4,4,1,2,6,9,15,3820
5,5,0,2,6,11,17,3820
6,6,1,3,7,14,21,3820
7,7,1,2,8,16,24,3820
8,8,0,2,8,18,26,3820
9,9,1,0,9,18,27,3820
10,10,1,1,10,19,29,3820
11,11,0,0,10,19,29,3820
0,0,1,0,1,0,1,3821
1,1,2,1,3,1,4,3821
2,2,5,2,8,3,11,3821
3,3,3,2,11,5,16,3821
4,4,2,0,13,5,18,3821
5,5,0,0,13,5,18,3821
0,0,1,0,1,0,1,3822
1,1,0,0,1,0,1,3822
0,0,1,0,1,0,1,3823
1,1,1,0,2,0,2,3823
2,2,0,0,2,0,2,3823
0,0,1,0,1,0,1,3824
1,1,2,0,3,0,3,3824
2,2,0,0,3,0,3,3824
0,0,1,0,1,0,1,3825
1,1,0,1,1,1,2,3825
2,2,1,0,2,1,3,3825
3,3,0,0,2,1,3,3825
0,0,1,0,1,0,1,3826
1,1,0,0,1,0,1,3826
0,0,1,0,1,0,1,3827
1,1,1,0,2,0,2,3827
2,2,1,0,3,0,3,3827
3,3,1,0,4,0,4,3827
4,4,1,0,5,0,5,3827
5,5,1,0,6,0,6,3827
6,6,1,1,7,1,8,3827
7,7,1,0,8,1,9,3827
8,8,2,0,10,1,11,3827
9,9,1,0,11,1,12,3827
10,10,0,0,11,1,12,3827
0,0,1,0,1,0,1,3828
1,1,0,0,1,0,1,3828
0,0,1,0,1,0,1,3829
1,1,0,0,1,0,1,3829
0,0,1,0,1,0,1,3830
1,1,0,0,1,0,1,3830
0,0,1,0,1,0,1,3831
1,1,0,0,1,0,1,3831
0,0,1,0,1,0,1,3832
1,1,0,0,1,0,1,3832
0,0,1,0,1,0,1,3833
1,1,2,0,3,0,3,3833
2,2,1,2,4,2,6,3833
3,3,1,1,5,3,8,3833
4,4,2,0,7,3,10,3833
5,5,0,1,7,4,11,3833
6,6,0,0,7,4,11,3833
0,0,1,0,1,0,1,3834
1,1,0,1,1,1,2,3834
2,2,0,0,1,1,2,3834
0,0,1,0,1,0,1,3835
1,1,0,0,1,0,1,3835
0,0,1,0,1,0,1,3836
1,1,1,1,2,1,3,3836
2,2,1,1,3,2,5,3836
3,3,1,0,4,2,6,3836
4,4,2,0,6,2,8,3836
5,5,1,0,7,2,9,3836
6,6,1,0,8,2,10,3836
7,7,0,0,8,2,10,3836
0,0,1,0,1,0,1,3837
1,1,0,1,1,1,2,3837
2,2,0,1,1,2,3,3837
3,3,0,1,1,3,4,3837
4,4,0,2,1,5,6,3837
5,5,0,0,1,5,6,3837
0,0,1,0,1,0,1,3838
1,1,2,0,3,0,3,3838
2,2,1,0,4,0,4,3838
3,3,1,2,5,2,7,3838
4,4,1,2,6,4,10,3838
5,5,0,4,6,8,14,3838
6,6,1,1,7,9,16,3838
7,7,1,0,8,9,17,3838
8,8,1,1,9,10,19,3838
9,9,1,2,10,12,22,3838
10,10,0,2,10,14,24,3838
11,11,0,3,10,17,27,3838
12,12,1,1,11,18,29,3838
13,13,1,3,12,21,33,3838
14,14,0,1,12,22,34,3838
15,15,0,0,12,22,34,3838
0,0,1,0,1,0,1,3839
1,1,1,0,2,0,2,3839
2,2,0,0,2,0,2,3839
0,0,1,0,1,0,1,3840
1,1,2,1,3,1,4,3840
2,2,1,3,4,4,8,3840
3,3,2,1,6,5,11,3840
4,4,1,1,7,6,13,3840
5,5,0,1,7,7,14,3840
6,6,0,0,7,7,14,3840
0,0,1,0,1,0,1,3841
1,1,1,0,2,0,2,3841
2,2,2,0,4,0,4,3841
3,3,1,1,5,1,6,3841
4,4,0,0,5,1,6,3841
0,0,1,0,1,0,1,3842
1,1,0,0,1,0,1,3842
0,0,1,0,1,0,1,3843
1,1,1,0,2,0,2,3843
2,2,0,0,2,0,2,3843
0,0,1,0,1,0,1,3844
1,1,0,0,1,0,1,3844
0,0,1,0,1,0,1,3845
1,1,0,0,1,0,1,3845
0,0,1,0,1,0,1,3846
1,1,0,1,1,1,2,3846
2,2,0,0,1,1,2,3846
0,0,1,0,1,0,1,3847
1,1,1,0,2,0,2,3847
2,2,0,0,2,0,2,3847
0,0,1,0,1,0,1,3848
1,1,0,0,1,0,1,3848
0,0,1,0,1,0,1,3849
1,1,1,0,2,0,2,3849
2,2,1,1,3,1,4,3849
3,3,0,1,3,2,5,3849
4,4,1,1,4,3,7,3849
5,5,1,2,5,5,10,3849
6,6,1,3,6,8,14,3849
7,7,2,6,8,14,22,3849
8,8,1,3,9,17,26,3849
9,9,3,3,12,20,32,3849
10,10,0,1,12,21,33,3849
11,11,0,0,12,21,33,3849
0,0,1,0,1,0,1,3850
1,1,0,0,1,0,1,3850
0,0,1,0,1,0,1,3851
1,1,1,0,2,0,2,3851
2,2,1,0,3,0,3,3851
3,3,1,1,4,1,5,3851
4,4,1,0,5,1,6,3851
5,5,0,0,5,1,6,3851
0,0,1,0,1,0,1,3852
1,1,3,0,4,0,4,3852
2,2,2,1,6,1,7,3852
3,3,2,1,8,2,10,3852
4,4,0,2,8,4,12,3852
5,5,0,4,8,8,16,3852
6,6,1,2,9,10,19,3852
7,7,2,5,11,15,26,3852
8,8,4,6,15,21,36,3852
9,9,2,4,17,25,42,3852
10,10,5,2,22,27,49,3852
11,11,2,3,24,30,54,3852
12,12,1,2,25,32,57,3852
13,13,2,3,27,35,62,3852
14,14,1,2,28,37,65,3852
15,15,0,3,28,40,68,3852
16,16,0,2,28,42,70,3852
17,17,0,2,28,44,72,3852
18,18,0,3,28,47,75,3852
19,19,0,1,28,48,76,3852
20,20,0,1,28,49,77,3852
21,21,2,1,30,50,80,3852
22,22,0,2,30,52,82,3852
23,23,0,1,30,53,83,3852
24,24,0,0,30,53,83,3852
0,0,1,0,1,0,1,3853
1,1,0,0,1,0,1,3853
0,0,1,0,1,0,1,3854
1,1,1,0,2,0,2,3854
2,2,1,0,3,0,3,3854
3,3,1,0,4,0,4,3854
4,4,0,0,4,0,4,3854
0,0,1,0,1,0,1,3855
1,1,0,0,1,0,1,3855
0,0,1,0,1,0,1,3856
1,1,0,0,1,0,1,3856
0,0,1,0,1,0,1,3857
1,1,2,0,3,0,3,3857
2,2,0,0,3,0,3,3857
0,0,1,0,1,0,1,3858
1,1,1,0,2,0,2,3858
2,2,0,0,2,0,2,3858
0,0,1,0,1,0,1,3859
1,1,1,0,2,0,2,3859
2,2,0,0,2,0,2,3859
0,0,1,0,1,0,1,3860
1,1,2,0,3,0,3,3860
2,2,2,0,5,0,5,3860
3,3,1,1,6,1,7,3860
4,4,1,0,7,1,8,3860
5,5,1,0,8,1,9,3860
6,6,0,0,8,1,9,3860
0,0,1,0,1,0,1,3861
1,1,0,0,1,0,1,3861
0,0,1,0,1,0,1,3862
1,1,0,0,1,0,1,3862
0,0,1,0,1,0,1,3863
1,1,2,0,3,0,3,3863
2,2,2,0,5,0,5,3863
3,3,5,0,10,0,10,3863
4,4,3,0,13,0,13,3863
5,5,3,1,16,1,17,3863
6,6,7,2,23,3,26,3863
7,7,2,5,25,8,33,3863
8,8,5,3,30,11,41,3863
9,9,4,3,34,14,48,3863
10,10,2,2,36,16,52,3863
11,11,0,2,36,18,54,3863
12,12,1,2,37,20,57,3863
13,13,1,2,38,22,60,3863
14,14,1,1,39,23,62,3863
15,15,0,1,39,24,63,3863
16,16,0,0,39,24,63,3863
0,0,1,0,1,0,1,3864
1,1,1,1,2,1,3,3864
2,2,0,0,2,1,3,3864
0,0,1,0,1,0,1,3865
1,1,2,0,3,0,3,3865
2,2,0,0,3,0,3,3865
0,0,1,0,1,0,1,3866
1,1,0,0,1,0,1,3866
0,0,1,0,1,0,1,3867
1,1,0,0,1,0,1,3867
0,0,1,0,1,0,1,3868
1,1,0,0,1,0,1,3868
0,0,1,0,1,0,1,3869
1,1,0,0,1,0,1,3869
0,0,1,0,1,0,1,3870
1,1,1,0,2,0,2,3870
2,2,0,0,2,0,2,3870
0,0,1,0,1,0,1,3871
1,1,0,0,1,0,1,3871
0,0,1,0,1,0,1,3872
1,1,1,0,2,0,2,3872
2,2,1,0,3,0,3,3872
3,3,0,0,3,0,3,3872
0,0,1,0,1,0,1,3873
1,1,0,0,1,0,1,3873
0,0,1,0,1,0,1,3874
1,1,1,1,2,1,3,3874
2,2,3,1,5,2,7,3874
3,3,2,1,7,3,10,3874
4,4,0,0,7,3,10,3874
0,0,1,0,1,0,1,3875
1,1,0,0,1,0,1,3875
0,0,1,0,1,0,1,3876
1,1,0,0,1,0,1,3876
0,0,1,0,1,0,1,3877
1,1,1,0,2,0,2,3877
2,2,0,1,2,1,3,3877
3,3,0,2,2,3,5,3877
4,4,0,0,2,3,5,3877
0,0,1,0,1,0,1,3878
1,1,1,0,2,0,2,3878
2,2,0,0,2,0,2,3878
0,0,1,0,1,0,1,3879
1,1,1,1,2,1,3,3879
2,2,0,1,2,2,4,3879
3,3,0,1,2,3,5,3879
4,4,1,1,3,4,7,3879
5,5,3,0,6,4,10,3879
6,6,0,0,6,4,10,3879
0,0,1,0,1,0,1,3880
1,1,0,1,1,1,2,3880
2,2,0,2,1,3,4,3880
3,3,0,0,1,3,4,3880
0,0,1,0,1,0,1,3881
1,1,0,0,1,0,1,3881
0,0,1,0,1,0,1,3882
1,1,0,0,1,0,1,3882
0,0,1,0,1,0,1,3883
1,1,0,0,1,0,1,3883
0,0,1,0,1,0,1,3884
1,1,1,0,2,0,2,3884
2,2,0,0,2,0,2,3884
0,0,1,0,1,0,1,3885
1,1,2,0,3,0,3,3885
2,2,3,0,6,0,6,3885
3,3,4,0,10,0,10,3885
4,4,2,3,12,3,15,3885
5,5,2,3,14,6,20,3885
6,6,4,3,18,9,27,3885
7,7,3,2,21,11,32,3885
8,8,4,3,25,14,39,3885
9,9,3,3,28,17,45,3885
10,10,6,3,34,20,54,3885
11,11,6,6,40,26,66,3885
12,12,10,6,50,32,82,3885
13,13,12,5,62,37,99,3885
14,14,10,3,72,40,112,3885
15,15,6,4,78,44,122,3885
16,16,6,4,84,48,132,3885
17,17,7,4,91,52,143,3885
18,18,6,3,97,55,152,3885
19,19,4,5,101,60,161,3885
20,20,3,6,104,66,170,3885
21,21,2,5,106,71,177,3885
22,22,2,2,108,73,181,3885
23,23,0,2,108,75,183,3885
24,24,0,2,108,77,185,3885
25,25,0,2,108,79,187,3885
26,26,0,0,108,79,187,3885
0,0,1,0,1,0,1,3886
1,1,0,0,1,0,1,3886
0,0,1,0,1,0,1,3887
1,1,1,0,2,0,2,3887
2,2,1,0,3,0,3,3887
3,3,0,0,3,0,3,3887
0,0,1,0,1,0,1,3888
1,1,0,1,1,1,2,3888
2,2,0,0,1,1,2,3888
0,0,1,0,1,0,1,3889
1,1,1,0,2,0,2,3889
2,2,2,0,4,0,4,3889
3,3,2,0,6,0,6,3889
4,4,1,0,7,0,7,3889
5,5,0,0,7,0,7,3889
0,0,1,0,1,0,1,3890
1,1,2,0,3,0,3,3890
2,2,2,0,5,0,5,3890
3,3,1,2,6,2,8,3890
4,4,1,2,7,4,11,3890
5,5,2,1,9,5,14,3890
6,6,3,2,12,7,19,3890
7,7,4,3,16,10,26,3890
8,8,4,2,20,12,32,3890
9,9,2,0,22,12,34,3890
10,10,1,0,23,12,35,3890
11,11,1,1,24,13,37,3890
12,12,2,0,26,13,39,3890
13,13,1,1,27,14,41,3890
14,14,1,1,28,15,43,3890
15,15,0,1,28,16,44,3890
16,16,0,0,28,16,44,3890
0,0,1,0,1,0,1,3891
1,1,1,0,2,0,2,3891
2,2,1,0,3,0,3,3891
3,3,1,0,4,0,4,3891
4,4,0,0,4,0,4,3891
0,0,1,0,1,0,1,3892
1,1,1,0,2,0,2,3892
2,2,0,0,2,0,2,3892
0,0,1,0,1,0,1,3893
1,1,3,0,4,0,4,3893
2,2,1,0,5,0,5,3893
3,3,1,0,6,0,6,3893
4,4,0,0,6,0,6,3893
0,0,1,0,1,0,1,3894
1,1,2,0,3,0,3,3894
2,2,1,0,4,0,4,3894
3,3,1,0,5,0,5,3894
4,4,0,0,5,0,5,3894
0,0,1,0,1,0,1,3895
1,1,1,0,2,0,2,3895
2,2,0,0,2,0,2,3895
0,0,1,0,1,0,1,3896
1,1,1,1,2,1,3,3896
2,2,3,0,5,1,6,3896
3,3,1,0,6,1,7,3896
4,4,0,0,6,1,7,3896
0,0,1,0,1,0,1,3897
1,1,0,0,1,0,1,3897
0,0,1,0,1,0,1,3898
1,1,2,0,3,0,3,3898
2,2,2,0,5,0,5,3898
3,3,0,0,5,0,5,3898
0,0,1,0,1,0,1,3899
1,1,1,0,2,0,2,3899
2,2,1,0,3,0,3,3899
3,3,0,0,3,0,3,3899
0,0,1,0,1,0,1,3900
1,1,2,1,3,1,4,3900
2,2,2,3,5,4,9,3900
3,3,1,2,6,6,12,3900
4,4,1,2,7,8,15,3900
5,5,0,4,7,12,19,3900
6,6,0,2,7,14,21,3900
7,7,0,0,7,14,21,3900
0,0,1,0,1,0,1,3901
1,1,2,0,3,0,3,3901
2,2,3,0,6,0,6,3901
3,3,3,1,9,1,10,3901
4,4,2,0,11,1,12,3901
5,5,3,1,14,2,16,3901
6,6,5,0,19,2,21,3901
7,7,4,1,23,3,26,3901
8,8,0,0,23,3,26,3901
0,0,1,0,1,0,1,3902
1,1,0,0,1,0,1,3902
0,0,1,0,1,0,1,3903
1,1,2,0,3,0,3,3903
2,2,2,2,5,2,7,3903
3,3,4,4,9,6,15,3903
4,4,3,2,12,8,20,3903
5,5,3,0,15,8,23,3903
6,6,1,1,16,9,25,3903
7,7,2,1,18,10,28,3903
8,8,0,1,18,11,29,3903
9,9,0,0,18,11,29,3903
0,0,1,0,1,0,1,3904
1,1,0,0,1,0,1,3904
0,0,1,0,1,0,1,3905
1,1,0,1,1,1,2,3905
2,2,0,1,1,2,3,3905
3,3,0,0,1,2,3,3905
0,0,1,0,1,0,1,3906
1,1,3,0,4,0,4,3906
2,2,1,0,5,0,5,3906
3,3,0,0,5,0,5,3906
0,0,1,0,1,0,1,3907
1,1,1,0,2,0,2,3907
2,2,2,1,4,1,5,3907
3,3,0,0,4,1,5,3907
0,0,1,0,1,0,1,3908
1,1,2,0,3,0,3,3908
2,2,4,1,7,1,8,3908
3,3,1,2,8,3,11,3908
4,4,1,3,9,6,15,3908
5,5,4,2,13,8,21,3908
6,6,1,4,14,12,26,3908
7,7,1,5,15,17,32,3908
8,8,1,7,16,24,40,3908
9,9,3,5,19,29,48,3908
10,10,2,6,21,35,56,3908
11,11,3,5,24,40,64,3908
12,12,3,4,27,44,71,3908
13,13,0,1,27,45,72,3908
14,14,0,1,27,46,73,3908
15,15,0,1,27,47,74,3908
16,16,0,0,27,47,74,3908
0,0,1,0,1,0,1,3909
1,1,0,0,1,0,1,3909
0,0,1,0,1,0,1,3910
1,1,0,0,1,0,1,3910
0,0,1,0,1,0,1,3911
1,1,0,1,1,1,2,3911
2,2,0,3,1,4,5,3911
3,3,1,3,2,7,9,3911
4,4,0,3,2,10,12,3911
5,5,0,3,2,13,15,3911
6,6,0,4,2,17,19,3911
7,7,1,2,3,19,22,3911
8,8,1,0,4,19,23,3911
9,9,1,0,5,19,24,3911
10,10,0,0,5,19,24,3911
0,0,1,0,1,0,1,3912
1,1,0,1,1,1,2,3912
2,2,0,0,1,1,2,3912
0,0,1,0,1,0,1,3913
1,1,0,0,1,0,1,3913
0,0,1,0,1,0,1,3914
1,1,0,0,1,0,1,3914
0,0,1,0,1,0,1,3915
1,1,0,1,1,1,2,3915
2,2,0,1,1,2,3,3915
3,3,0,2,1,4,5,3915
4,4,0,5,1,9,10,3915
5,5,0,5,1,14,15,3915
6,6,1,2,2,16,18,3915
7,7,0,1,2,17,19,3915
8,8,0,1,2,18,20,3915
9,9,0,0,2,18,20,3915
0,0,1,0,1,0,1,3916
1,1,0,0,1,0,1,3916
0,0,1,0,1,0,1,3917
1,1,0,0,1,0,1,3917
0,0,1,0,1,0,1,3918
1,1,0,1,1,1,2,3918
2,2,0,0,1,1,2,3918
0,0,1,0,1,0,1,3919
1,1,1,0,2,0,2,3919
2,2,3,0,5,0,5,3919
3,3,4,0,9,0,9,3919
4,4,1,0,10,0,10,3919
5,5,0,0,10,0,10,3919
0,0,1,0,1,0,1,3920
1,1,0,0,1,0,1,3920
0,0,1,0,1,0,1,3921
1,1,1,2,2,2,4,3921
2,2,0,3,2,5,7,3921
3,3,2,6,4,11,15,3921
4,4,0,5,4,16,20,3921
5,5,0,3,4,19,23,3921
6,6,0,1,4,20,24,3921
7,7,0,1,4,21,25,3921
8,8,2,1,6,22,28,3921
9,9,1,2,7,24,31,3921
10,10,1,3,8,27,35,3921
11,11,1,2,9,29,38,3921
12,12,0,0,9,29,38,3921
0,0,1,0,1,0,1,3922
1,1,0,0,1,0,1,3922
0,0,1,0,1,0,1,3923
1,1,1,0,2,0,2,3923
2,2,1,0,3,0,3,3923
3,3,0,1,3,1,4,3923
4,4,0,0,3,1,4,3923
0,0,1,0,1,0,1,3924
1,1,0,0,1,0,1,3924
0,0,1,0,1,0,1,3925
1,1,1,0,2,0,2,3925
2,2,0,1,2,1,3,3925
3,3,0,0,2,1,3,3925
0,0,1,0,1,0,1,3926
1,1,1,0,2,0,2,3926
2,2,0,2,2,2,4,3926
3,3,0,0,2,2,4,3926
0,0,1,0,1,0,1,3927
1,1,0,1,1,1,2,3927
2,2,0,1,1,2,3,3927
3,3,0,1,1,3,4,3927
4,4,0,2,1,5,6,3927
5,5,0,2,1,7,8,3927
6,6,0,1,1,8,9,3927
7,7,0,1,1,9,10,3927
8,8,0,1,1,10,11,3927
9,9,0,5,1,15,16,3927
10,10,1,2,2,17,19,3927
11,11,0,1,2,18,20,3927
12,12,0,0,2,18,20,3927
0,0,1,0,1,0,1,3928
1,1,0,0,1,0,1,3928
0,0,1,0,1,0,1,3929
1,1,0,0,1,0,1,3929
0,0,1,0,1,0,1,3930
1,1,1,0,2,0,2,3930
2,2,0,0,2,0,2,3930
0,0,1,0,1,0,1,3931
1,1,2,0,3,0,3,3931
2,2,3,0,6,0,6,3931
3,3,1,2,7,2,9,3931
4,4,2,0,9,2,11,3931
5,5,3,0,12,2,14,3931
6,6,1,1,13,3,16,3931
7,7,1,1,14,4,18,3931
8,8,2,1,16,5,21,3931
9,9,2,1,18,6,24,3931
10,10,3,3,21,9,30,3931
11,11,2,4,23,13,36,3931
12,12,2,4,25,17,42,3931
13,13,1,4,26,21,47,3931
14,14,1,3,27,24,51,3931
15,15,1,1,28,25,53,3931
16,16,1,0,29,25,54,3931
17,17,2,0,31,25,56,3931
18,18,2,0,33,25,58,3931
19,19,5,0,38,25,63,3931
20,20,8,2,46,27,73,3931
21,21,4,2,50,29,79,3931
22,22,3,0,53,29,82,3931
23,23,2,1,55,30,85,3931
24,24,2,0,57,30,87,3931
25,25,1,0,58,30,88,3931
26,26,0,0,58,30,88,3931
0,0,1,0,1,0,1,3932
1,1,2,0,3,0,3,3932
2,2,1,1,4,1,5,3932
3,3,1,2,5,3,8,3932
4,4,2,1,7,4,11,3932
5,5,2,1,9,5,14,3932
6,6,0,2,9,7,16,3932
7,7,0,3,9,10,19,3932
8,8,0,2,9,12,21,3932
9,9,1,1,10,13,23,3932
10,10,3,2,13,15,28,3932
11,11,3,1,16,16,32,3932
12,12,2,0,18,16,34,3932
13,13,4,0,22,16,38,3932
14,14,2,0,24,16,40,3932
15,15,0,1,24,17,41,3932
16,16,0,2,24,19,43,3932
17,17,0,1,24,20,44,3932
18,18,0,0,24,20,44,3932
0,0,1,0,1,0,1,3933
1,1,0,0,1,0,1,3933
0,0,1,0,1,0,1,3934
1,1,0,0,1,0,1,3934
0,0,1,0,1,0,1,3935
1,1,0,1,1,1,2,3935
2,2,0,0,1,1,2,3935
0,0,1,0,1,0,1,3936
1,1,0,0,1,0,1,3936
0,0,1,0,1,0,1,3937
1,1,0,0,1,0,1,3937
0,0,1,0,1,0,1,3938
1,1,0,0,1,0,1,3938
0,0,1,0,1,0,1,3939
1,1,1,0,2,0,2,3939
2,2,0,0,2,0,2,3939
0,0,1,0,1,0,1,3940
1,1,1,0,2,0,2,3940
2,2,3,0,5,0,5,3940
3,3,8,0,13,0,13,3940
4,4,3,0,16,0,16,3940
5,5,2,1,18,1,19,3940
6,6,1,3,19,4,23,3940
7,7,2,1,21,5,26,3940
8,8,1,0,22,5,27,3940
9,9,3,0,25,5,30,3940
10,10,2,0,27,5,32,3940
11,11,1,0,28,5,33,3940
12,12,0,0,28,5,33,3940
0,0,1,0,1,0,1,3941
1,1,0,0,1,0,1,3941
0,0,1,0,1,0,1,3942
1,1,1,0,2,0,2,3942
2,2,2,0,4,0,4,3942
3,3,1,3,5,3,8,3942
4,4,0,4,5,7,12,3942
5,5,0,4,5,11,16,3942
6,6,2,1,7,12,19,3942
7,7,2,0,9,12,21,3942
8,8,5,0,14,12,26,3942
9,9,5,2,19,14,33,3942
10,10,1,4,20,18,38,3942
11,11,1,3,21,21,42,3942
12,12,1,1,22,22,44,3942
13,13,2,2,24,24,48,3942
14,14,3,4,27,28,55,3942
15,15,3,3,30,31,61,3942
16,16,4,6,34,37,71,3942
17,17,2,6,36,43,79,3942
18,18,2,4,38,47,85,3942
19,19,2,0,40,47,87,3942
20,20,1,0,41,47,88,3942
21,21,1,2,42,49,91,3942
22,22,0,3,42,52,94,3942
23,23,1,5,43,57,100,3942
24,24,4,1,47,58,105,3942
25,25,2,0,49,58,107,3942
26,26,1,1,50,59,109,3942
27,27,3,2,53,61,114,3942
28,28,2,3,55,64,119,3942
29,29,2,1,57,65,122,3942
30,30,1,2,58,67,125,3942
31,31,1,1,59,68,127,3942
32,32,0,0,59,68,127,3942
0,0,1,0,1,0,1,3943
1,1,0,0,1,0,1,3943
0,0,1,0,1,0,1,3944
1,1,2,0,3,0,3,3944
2,2,3,0,6,0,6,3944
3,3,4,0,10,0,10,3944
4,4,3,2,13,2,15,3944
5,5,0,0,13,2,15,3944
0,0,1,0,1,0,1,3945
1,1,1,0,2,0,2,3945
2,2,1,0,3,0,3,3945
3,3,0,0,3,0,3,3945
0,0,1,0,1,0,1,3946
1,1,3,0,4,0,4,3946
2,2,5,0,9,0,9,3946
3,3,2,0,11,0,11,3946
4,4,0,2,11,2,13,3946
5,5,0,0,11,2,13,3946
0,0,1,0,1,0,1,3947
1,1,1,0,2,0,2,3947
2,2,1,1,3,1,4,3947
3,3,0,3,3,4,7,3947
4,4,1,2,4,6,10,3947
5,5,1,1,5,7,12,3947
6,6,0,0,5,7,12,3947
0,0,1,0,1,0,1,3948
1,1,0,0,1,0,1,3948
0,0,1,0,1,0,1,3949
1,1,0,0,1,0,1,3949
0,0,1,0,1,0,1,3950
1,1,0,1,1,1,2,3950
2,2,0,2,1,3,4,3950
3,3,0,2,1,5,6,3950
4,4,1,1,2,6,8,3950
5,5,0,2,2,8,10,3950
6,6,0,2,2,10,12,3950
7,7,0,1,2,11,13,3950
8,8,0,0,2,11,13,3950
0,0,1,0,1,0,1,3951
1,1,1,0,2,0,2,3951
2,2,0,0,2,0,2,3951
0,0,1,0,1,0,1,3952
1,1,0,0,1,0,1,3952
0,0,1,0,1,0,1,3953
1,1,1,0,2,0,2,3953
2,2,0,0,2,0,2,3953
0,0,1,0,1,0,1,3954
1,1,2,0,3,0,3,3954
2,2,0,0,3,0,3,3954
0,0,1,0,1,0,1,3955
1,1,0,0,1,0,1,3955
0,0,1,0,1,0,1,3956
1,1,3,1,4,1,5,3956
2,2,2,1,6,2,8,3956
3,3,1,1,7,3,10,3956
4,4,1,0,8,3,11,3956
5,5,0,0,8,3,11,3956
0,0,1,0,1,0,1,3957
1,1,2,0,3,0,3,3957
2,2,2,0,5,0,5,3957
3,3,1,0,6,0,6,3957
4,4,1,0,7,0,7,3957
5,5,0,0,7,0,7,3957
0,0,1,0,1,0,1,3958
1,1,1,0,2,0,2,3958
2,2,1,0,3,0,3,3958
3,3,1,0,4,0,4,3958
4,4,0,0,4,0,4,3958
0,0,1,0,1,0,1,3959
1,1,0,0,1,0,1,3959
0,0,1,0,1,0,1,3960
1,1,0,1,1,1,2,3960
2,2,0,2,1,3,4,3960
3,3,1,3,2,6,8,3960
4,4,2,4,4,10,14,3960
5,5,2,5,6,15,21,3960
6,6,2,1,8,16,24,3960
7,7,0,2,8,18,26,3960
8,8,0,3,8,21,29,3960
9,9,0,4,8,25,33,3960
10,10,1,6,9,31,40,3960
11,11,1,5,10,36,46,3960
12,12,4,1,14,37,51,3960
13,13,3,1,17,38,55,3960
14,14,4,4,21,42,63,3960
15,15,3,8,24,50,74,3960
16,16,2,6,26,56,82,3960
17,17,5,6,31,62,93,3960
18,18,7,4,38,66,104,3960
19,19,4,3,42,69,111,3960
20,20,2,1,44,70,114,3960
21,21,3,2,47,72,119,3960
22,22,3,1,50,73,123,3960
23,23,4,1,54,74,128,3960
24,24,3,1,57,75,132,3960
25,25,3,1,60,76,136,3960
26,26,1,0,61,76,137,3960
27,27,1,0,62,76,138,3960
28,28,0,1,62,77,139,3960
29,29,1,1,63,78,141,3960
30,30,0,1,63,79,142,3960
31,31,0,2,63,81,144,3960
32,32,1,1,64,82,146,3960
33,33,1,0,65,82,147,3960
34,34,1,0,66,82,148,3960
35,35,0,0,66,82,148,3960
0,0,1,0,1,0,1,3961
1,1,0,0,1,0,1,3961
0,0,1,0,1,0,1,3962
1,1,0,0,1,0,1,3962
0,0,1,0,1,0,1,3963
1,1,0,0,1,0,1,3963
0,0,1,0,1,0,1,3964
1,1,1,0,2,0,2,3964
2,2,3,1,5,1,6,3964
3,3,2,2,7,3,10,3964
4,4,2,2,9,5,14,3964
5,5,1,1,10,6,16,3964
6,6,0,0,10,6,16,3964
0,0,1,0,1,0,1,3965
1,1,0,0,1,0,1,3965
0,0,1,0,1,0,1,3966
1,1,0,0,1,0,1,3966
0,0,1,0,1,0,1,3967
1,1,0,0,1,0,1,3967
0,0,1,0,1,0,1,3968
1,1,1,0,2,0,2,3968
2,2,1,0,3,0,3,3968
3,3,0,0,3,0,3,3968
0,0,1,0,1,0,1,3969
1,1,0,1,1,1,2,3969
2,2,0,1,1,2,3,3969
3,3,0,1,1,3,4,3969
4,4,0,2,1,5,6,3969
5,5,1,2,2,7,9,3969
6,6,0,3,2,10,12,3969
7,7,2,1,4,11,15,3969
8,8,3,1,7,12,19,3969
9,9,2,2,9,14,23,3969
10,10,1,2,10,16,26,3969
11,11,0,1,10,17,27,3969
12,12,1,0,11,17,28,3969
13,13,0,1,11,18,29,3969
14,14,0,2,11,20,31,3969
15,15,0,3,11,23,34,3969
16,16,1,0,12,23,35,3969
17,17,2,2,14,25,39,3969
18,18,4,2,18,27,45,3969
19,19,3,2,21,29,50,3969
20,20,1,1,22,30,52,3969
21,21,0,1,22,31,53,3969
22,22,0,0,22,31,53,3969
0,0,1,0,1,0,1,3970
1,1,0,1,1,1,2,3970
2,2,0,0,1,1,2,3970
0,0,1,0,1,0,1,3971
1,1,0,1,1,1,2,3971
2,2,0,0,1,1,2,3971
0,0,1,0,1,0,1,3972
1,1,1,0,2,0,2,3972
2,2,1,0,3,0,3,3972
3,3,0,0,3,0,3,3972
0,0,1,0,1,0,1,3973
1,1,0,0,1,0,1,3973
0,0,1,0,1,0,1,3974
1,1,2,0,3,0,3,3974
2,2,4,1,7,1,8,3974
3,3,0,2,7,3,10,3974
4,4,0,0,7,3,10,3974
0,0,1,0,1,0,1,3975
1,1,0,0,1,0,1,3975
0,0,1,0,1,0,1,3976
1,1,0,0,1,0,1,3976
0,0,1,0,1,0,1,3977
1,1,0,1,1,1,2,3977
2,2,0,0,1,1,2,3977
0,0,1,0,1,0,1,3978
1,1,0,0,1,0,1,3978
0,0,1,0,1,0,1,3979
1,1,0,1,1,1,2,3979
2,2,0,0,1,1,2,3979
0,0,1,0,1,0,1,3980
1,1,1,0,2,0,2,3980
2,2,1,0,3,0,3,3980
3,3,1,0,4,0,4,3980
4,4,0,0,4,0,4,3980
0,0,1,0,1,0,1,3981
1,1,0,0,1,0,1,3981
0,0,1,0,1,0,1,3982
1,1,2,0,3,0,3,3982
2,2,1,0,4,0,4,3982
3,3,0,0,4,0,4,3982
0,0,1,0,1,0,1,3983
1,1,2,0,3,0,3,3983
2,2,2,0,5,0,5,3983
3,3,2,1,7,1,8,3983
4,4,4,1,11,2,13,3983
5,5,4,2,15,4,19,3983
6,6,1,4,16,8,24,3983
7,7,0,2,16,10,26,3983
8,8,0,0,16,10,26,3983
0,0,1,0,1,0,1,3984
1,1,1,0,2,0,2,3984
2,2,0,0,2,0,2,3984
0,0,1,0,1,0,1,3985
1,1,0,0,1,0,1,3985
0,0,1,0,1,0,1,3986
1,1,0,0,1,0,1,3986
0,0,1,0,1,0,1,3987
1,1,0,0,1,0,1,3987
0,0,1,0,1,0,1,3988
1,1,1,1,2,1,3,3988
2,2,1,1,3,2,5,3988
3,3,2,0,5,2,7,3988
4,4,2,1,7,3,10,3988
5,5,2,2,9,5,14,3988
6,6,1,2,10,7,17,3988
7,7,1,1,11,8,19,3988
8,8,2,2,13,10,23,3988
9,9,3,1,16,11,27,3988
10,10,3,1,19,12,31,3988
11,11,2,1,21,13,34,3988
12,12,2,2,23,15,38,3988
13,13,5,5,28,20,48,3988
14,14,4,5,32,25,57,3988
15,15,5,5,37,30,67,3988
16,16,2,7,39,37,76,3988
17,17,0,6,39,43,82,3988
18,18,0,3,39,46,85,3988
19,19,1,1,40,47,87,3988
20,20,0,1,40,48,88,3988
21,21,0,1,40,49,89,3988
22,22,0,0,40,49,89,3988
0,0,1,0,1,0,1,3989
1,1,1,0,2,0,2,3989
2,2,1,0,3,0,3,3989
3,3,1,0,4,0,4,3989
4,4,2,0,6,0,6,3989
5,5,1,0,7,0,7,3989
6,6,0,0,7,0,7,3989
0,0,1,0,1,0,1,3990
1,1,0,0,1,0,1,3990
0,0,1,0,1,0,1,3991
1,1,1,0,2,0,2,3991
2,2,1,0,3,0,3,3991
3,3,0,0,3,0,3,3991
0,0,1,0,1,0,1,3992
1,1,1,0,2,0,2,3992
2,2,0,1,2,1,3,3992
3,3,0,0,2,1,3,3992
0,0,1,0,1,0,1,3993
1,1,1,0,2,0,2,3993
2,2,0,0,2,0,2,3993
0,0,1,0,1,0,1,3994
1,1,0,0,1,0,1,3994
0,0,1,0,1,0,1,3995
1,1,1,0,2,0,2,3995
2,2,0,0,2,0,2,3995
0,0,1,0,1,0,1,3996
1,1,0,0,1,0,1,3996
0,0,1,0,1,0,1,3997
1,1,0,1,1,1,2,3997
2,2,0,0,1,1,2,3997
0,0,1,0,1,0,1,3998
1,1,1,0,2,0,2,3998
2,2,4,0,6,0,6,3998
3,3,7,1,13,1,14,3998
4,4,3,1,16,2,18,3998
5,5,3,0,19,2,21,3998
6,6,1,0,20,2,22,3998
7,7,0,0,20,2,22,3998
0,0,1,0,1,0,1,3999
1,1,3,0,4,0,4,3999
2,2,1,1,5,1,6,3999
3,3,0,0,5,1,6,3999
0,0,1,0,1,0,1,4000
1,1,1,0,2,0,2,4000
2,2,1,1,3,1,4,4000
3,3,0,3,3,4,7,4000
4,4,1,3,4,7,11,4000
5,5,3,2,7,9,16,4000
6,6,4,4,11,13,24,4000
7,7,4,5,15,18,33,4000
8,8,5,4,20,22,42,4000
9,9,4,3,24,25,49,4000
10,10,3,4,27,29,56,4000
11,11,2,7,29,36,65,4000
12,12,3,8,32,44,76,4000
13,13,4,6,36,50,86,4000
14,14,4,7,40,57,97,4000
15,15,2,3,42,60,102,4000
16,16,2,4,44,64,108,4000
17,17,2,2,46,66,112,4000
18,18,0,2,46,68,114,4000
19,19,0,2,46,70,116,4000
20,20,0,1,46,71,117,4000
21,21,0,0,46,71,117,4000
0,0,1,0,1,0,1,4001
1,1,1,0,2,0,2,4001
2,2,1,0,3,0,3,4001
3,3,1,0,4,0,4,4001
4,4,0,0,4,0,4,4001
0,0,1,0,1,0,1,4002
1,1,3,1,4,1,5,4002
2,2,1,4,5,5,10,4002
3,3,1,4,6,9,15,4002
4,4,1,1,7,10,17,4002
5,5,0,1,7,11,18,4002
6,6,0,0,7,11,18,4002
0,0,1,0,1,0,1,4003
1,1,0,0,1,0,1,4003
0,0,1,0,1,0,1,4004
1,1,0,0,1,0,1,4004
0,0,1,0,1,0,1,4005
1,1,0,0,1,0,1,4005
0,0,1,0,1,0,1,4006
1,1,1,0,2,0,2,4006
2,2,0,0,2,0,2,4006
0,0,1,0,1,0,1,4007
1,1,1,0,2,0,2,4007
2,2,0,0,2,0,2,4007
0,0,1,0,1,0,1,4008
1,1,2,0,3,0,3,4008
2,2,2,0,5,0,5,4008
3,3,4,0,9,0,9,4008
4,4,1,0,10,0,10,4008
5,5,1,0,11,0,11,4008
6,6,1,0,12,0,12,4008
7,7,0,0,12,0,12,4008
0,0,1,0,1,0,1,4009
1,1,1,0,2,0,2,4009
2,2,0,0,2,0,2,4009
0,0,1,0,1,0,1,4010
1,1,1,0,2,0,2,4010
2,2,0,0,2,0,2,4010
0,0,1,0,1,0,1,4011
1,1,0,1,1,1,2,4011
2,2,0,1,1,2,3,4011
3,3,1,2,2,4,6,4011
4,4,2,2,4,6,10,4011
5,5,1,4,5,10,15,4011
6,6,0,3,5,13,18,4011
7,7,0,1,5,14,19,4011
8,8,0,0,5,14,19,4011
0,0,1,0,1,0,1,4012
1,1,0,0,1,0,1,4012
0,0,1,0,1,0,1,4013
1,1,2,0,3,0,3,4013
2,2,1,0,4,0,4,4013
3,3,1,1,5,1,6,4013
4,4,1,1,6,2,8,4013
5,5,1,0,7,2,9,4013
6,6,0,0,7,2,9,4013
0,0,1,0,1,0,1,4014
1,1,0,1,1,1,2,4014
2,2,0,1,1,2,3,4014
3,3,1,1,2,3,5,4014
4,4,1,4,3,7,10,4014
5,5,2,2,5,9,14,4014
6,6,2,4,7,13,20,4014
7,7,4,4,11,17,28,4014
8,8,5,2,16,19,35,4014
9,9,4,6,20,25,45,4014
10,10,3,9,23,34,57,4014
11,11,2,4,25,38,63,4014
12,12,3,2,28,40,68,4014
13,13,3,3,31,43,74,4014
14,14,7,4,38,47,85,4014
15,15,7,6,45,53,98,4014
16,16,6,8,51,61,112,4014
17,17,7,3,58,64,122,4014
18,18,2,5,60,69,129,4014
19,19,1,4,61,73,134,4014
20,20,3,5,64,78,142,4014
21,21,4,3,68,81,149,4014
22,22,2,0,70,81,151,4014
23,23,1,1,71,82,153,4014
24,24,1,1,72,83,155,4014
25,25,0,1,72,84,156,4014
26,26,0,0,72,84,156,4014
0,0,1,0,1,0,1,4015
1,1,0,0,1,0,1,4015
0,0,1,0,1,0,1,4016
1,1,1,0,2,0,2,4016
2,2,1,0,3,0,3,4016
3,3,0,0,3,0,3,4016
0,0,1,0,1,0,1,4017
1,1,0,0,1,0,1,4017
0,0,1,0,1,0,1,4018
1,1,0,0,1,0,1,4018
0,0,1,0,1,0,1,4019
1,1,1,0,2,0,2,4019
2,2,0,1,2,1,3,4019
3,3,0,0,2,1,3,4019
0,0,1,0,1,0,1,4020
1,1,1,1,2,1,3,4020
2,2,3,0,5,1,6,4020
3,3,0,2,5,3,8,4020
4,4,0,0,5,3,8,4020
0,0,1,0,1,0,1,4021
1,1,2,0,3,0,3,4021
2,2,2,0,5,0,5,4021
3,3,1,1,6,1,7,4021
4,4,0,5,6,6,12,4021
5,5,0,1,6,7,13,4021
6,6,0,1,6,8,14,4021
7,7,2,0,8,8,16,4021
8,8,0,1,8,9,17,4021
9,9,0,2,8,11,19,4021
10,10,0,0,8,11,19,4021
0,0,1,0,1,0,1,4022
1,1,0,0,1,0,1,4022
0,0,1,0,1,0,1,4023
1,1,0,0,1,0,1,4023
0,0,1,0,1,0,1,4024
1,1,1,0,2,0,2,4024
2,2,0,0,2,0,2,4024
0,0,1,0,1,0,1,4025
1,1,1,0,2,0,2,4025
2,2,0,0,2,0,2,4025
0,0,1,0,1,0,1,4026
1,1,0,0,1,0,1,4026
0,0,1,0,1,0,1,4027
1,1,0,0,1,0,1,4027
0,0,1,0,1,0,1,4028
1,1,1,0,2,0,2,4028
2,2,1,0,3,0,3,4028
3,3,1,0,4,0,4,4028
4,4,0,0,4,0,4,4028
0,0,1,0,1,0,1,4029
1,1,1,0,2,0,2,4029
2,2,1,0,3,0,3,4029
3,3,1,1,4,1,5,4029
4,4,2,0,6,1,7,4029
5,5,3,0,9,1,10,4029
6,6,0,0,9,1,10,4029
0,0,1,0,1,0,1,4030
1,1,1,0,2,0,2,4030
2,2,0,0,2,0,2,4030
0,0,1,0,1,0,1,4031
1,1,1,0,2,0,2,4031
2,2,0,1,2,1,3,4031
3,3,0,0,2,1,3,4031
0,0,1,0,1,0,1,4032
1,1,0,1,1,1,2,4032
2,2,0,0,1,1,2,4032
0,0,1,0,1,0,1,4033
1,1,1,0,2,0,2,4033
2,2,0,0,2,0,2,4033
0,0,1,0,1,0,1,4034
1,1,1,0,2,0,2,4034
2,2,1,0,3,0,3,4034
3,3,1,0,4,0,4,4034
4,4,0,0,4,0,4,4034
0,0,1,0,1,0,1,4035
1,1,0,0,1,0,1,4035
0,0,1,0,1,0,1,4036
1,1,0,0,1,0,1,4036
0,0,1,0,1,0,1,4037
1,1,0,0,1,0,1,4037
0,0,1,0,1,0,1,4038
1,1,0,0,1,0,1,4038
0,0,1,0,1,0,1,4039
1,1,0,0,1,0,1,4039
0,0,1,0,1,0,1,4040
1,1,1,1,2,1,3,4040
2,2,1,1,3,2,5,4040
3,3,0,2,3,4,7,4040
4,4,0,3,3,7,10,4040
5,5,0,4,3,11,14,4040
6,6,0,2,3,13,16,4040
7,7,1,2,4,15,19,4040
8,8,0,1,4,16,20,4040
9,9,0,1,4,17,21,4040
10,10,0,0,4,17,21,4040
0,0,1,0,1,0,1,4041
1,1,1,1,2,1,3,4041
2,2,0,1,2,2,4,4041
3,3,0,1,2,3,5,4041
4,4,0,0,2,3,5,4041
0,0,1,0,1,0,1,4042
1,1,1,0,2,0,2,4042
2,2,1,0,3,0,3,4042
3,3,0,0,3,0,3,4042
0,0,1,0,1,0,1,4043
1,1,1,0,2,0,2,4043
2,2,0,0,2,0,2,4043
0,0,1,0,1,0,1,4044
1,1,1,0,2,0,2,4044
2,2,1,0,3,0,3,4044
3,3,0,0,3,0,3,4044
0,0,1,0,1,0,1,4045
1,1,3,0,4,0,4,4045
2,2,3,2,7,2,9,4045
3,3,3,3,10,5,15,4045
4,4,2,2,12,7,19,4045
5,5,1,1,13,8,21,4045
6,6,0,0,13,8,21,4045
0,0,1,0,1,0,1,4046
1,1,0,1,1,1,2,4046
2,2,0,1,1,2,3,4046
3,3,0,1,1,3,4,4046
4,4,0,0,1,3,4,4046
0,0,1,0,1,0,1,4047
1,1,1,0,2,0,2,4047
2,2,0,0,2,0,2,4047
0,0,1,0,1,0,1,4048
1,1,0,0,1,0,1,4048
0,0,1,0,1,0,1,4049
1,1,2,0,3,0,3,4049
2,2,1,0,4,0,4,4049
3,3,0,1,4,1,5,4049
4,4,0,2,4,3,7,4049
5,5,0,0,4,3,7,4049
0,0,1,0,1,0,1,4050
1,1,0,0,1,0,1,4050
0,0,1,0,1,0,1,4051
1,1,0,0,1,0,1,4051
0,0,1,0,1,0,1,4052
1,1,3,0,4,0,4,4052
2,2,1,1,5,1,6,4052
3,3,3,1,8,2,10,4052
4,4,4,1,12,3,15,4052
5,5,5,2,17,5,22,4052
6,6,3,4,20,9,29,4052
7,7,1,6,21,15,36,4052
8,8,0,4,21,19,40,4052
9,9,0,4,21,23,44,4052
10,10,0,3,21,26,47,4052
11,11,0,4,21,30,51,4052
12,12,0,0,21,30,51,4052
0,0,1,0,1,0,1,4053
1,1,0,0,1,0,1,4053
0,0,1,0,1,0,1,4054
1,1,1,1,2,1,3,4054
2,2,2,1,4,2,6,4054
3,3,1,2,5,4,9,4054
4,4,2,2,7,6,13,4054
5,5,2,1,9,7,16,4054
6,6,4,0,13,7,20,4054
7,7,0,0,13,7,20,4054
0,0,1,0,1,0,1,4055
1,1,1,0,2,0,2,4055
2,2,2,0,4,0,4,4055
3,3,1,5,5,5,10,4055
4,4,2,1,7,6,13,4055
5,5,2,0,9,6,15,4055
6,6,1,0,10,6,16,4055
7,7,0,0,10,6,16,4055
0,0,1,0,1,0,1,4056
1,1,0,0,1,0,1,4056
0,0,1,0,1,0,1,4057
1,1,1,0,2,0,2,4057
2,2,0,0,2,0,2,4057
0,0,1,0,1,0,1,4058
1,1,2,1,3,1,4,4058
2,2,2,2,5,3,8,4058
3,3,3,0,8,3,11,4058
4,4,1,0,9,3,12,4058
5,5,2,0,11,3,14,4058
6,6,2,0,13,3,16,4058
7,7,0,1,13,4,17,4058
8,8,0,0,13,4,17,4058
0,0,1,0,1,0,1,4059
1,1,0,0,1,0,1,4059
0,0,1,0,1,0,1,4060
1,1,0,0,1,0,1,4060
0,0,1,0,1,0,1,4061
1,1,1,0,2,0,2,4061
2,2,1,1,3,1,4,4061
3,3,0,1,3,2,5,4061
4,4,0,1,3,3,6,4061
5,5,0,1,3,4,7,4061
6,6,0,0,3,4,7,4061
0,0,1,0,1,0,1,4062
1,1,2,0,3,0,3,4062
2,2,3,0,6,0,6,4062
3,3,3,0,9,0,9,4062
4,4,4,0,13,0,13,4062
5,5,6,0,19,0,19,4062
6,6,4,0,23,0,23,4062
7,7,1,0,24,0,24,4062
8,8,0,0,24,0,24,4062
0,0,1,0,1,0,1,4063
1,1,3,0,4,0,4,4063
2,2,2,0,6,0,6,4063
3,3,3,0,9,0,9,4063
4,4,0,1,9,1,10,4063
5,5,0,1,9,2,11,4063
6,6,0,1,9,3,12,4063
7,7,0,2,9,5,14,4063
8,8,0,1,9,6,15,4063
9,9,1,0,10,6,16,4063
10,10,0,0,10,6,16,4063
0,0,1,0,1,0,1,4064
1,1,0,0,1,0,1,4064
0,0,1,0,1,0,1,4065
1,1,0,0,1,0,1,4065
0,0,1,0,1,0,1,4066
1,1,2,0,3,0,3,4066
2,2,1,0,4,0,4,4066
3,3,1,0,5,0,5,4066
4,4,0,0,5,0,5,4066
0,0,1,0,1,0,1,4067
1,1,0,0,1,0,1,4067
0,0,1,0,1,0,1,4068
1,1,1,0,2,0,2,4068
2,2,1,0,3,0,3,4068
3,3,1,0,4,0,4,4068
4,4,1,0,5,0,5,4068
5,5,0,0,5,0,5,4068
0,0,1,0,1,0,1,4069
1,1,0,0,1,0,1,4069
0,0,1,0,1,0,1,4070
1,1,1,0,2,0,2,4070
2,2,2,0,4,0,4,4070
3,3,0,0,4,0,4,4070
0,0,1,0,1,0,1,4071
1,1,2,0,3,0,3,4071
2,2,0,0,3,0,3,4071
0,0,1,0,1,0,1,4072
1,1,1,0,2,0,2,4072
2,2,0,0,2,0,2,4072
0,0,1,0,1,0,1,4073
1,1,1,0,2,0,2,4073
2,2,2,1,4,1,5,4073
3,3,1,2,5,3,8,4073
4,4,2,0,7,3,10,4073
5,5,1,0,8,3,11,4073
6,6,0,0,8,3,11,4073
0,0,1,0,1,0,1,4074
1,1,0,0,1,0,1,4074
0,0,1,0,1,0,1,4075
1,1,0,0,1,0,1,4075
0,0,1,0,1,0,1,4076
1,1,1,0,2,0,2,4076
2,2,0,0,2,0,2,4076
0,0,1,0,1,0,1,4077
1,1,1,0,2,0,2,4077
2,2,1,0,3,0,3,4077
3,3,3,0,6,0,6,4077
4,4,2,0,8,0,8,4077
5,5,2,0,10,0,10,4077
6,6,0,1,10,1,11,4077
7,7,0,0,10,1,11,4077
0,0,1,0,1,0,1,4078
1,1,2,0,3,0,3,4078
2,2,2,0,5,0,5,4078
3,3,0,1,5,1,6,4078
4,4,1,2,6,3,9,4078
5,5,0,0,6,3,9,4078
0,0,1,0,1,0,1,4079
1,1,0,0,1,0,1,4079
0,0,1,0,1,0,1,4080
1,1,0,0,1,0,1,4080
0,0,1,0,1,0,1,4081
1,1,0,0,1,0,1,4081
0,0,1,0,1,0,1,4082
1,1,1,0,2,0,2,4082
2,2,0,0,2,0,2,4082
0,0,1,0,1,0,1,4083
1,1,1,1,2,1,3,4083
2,2,1,1,3,2,5,4083
3,3,3,0,6,2,8,4083
4,4,1,0,7,2,9,4083
5,5,0,0,7,2,9,4083
0,0,1,0,1,0,1,4084
1,1,0,0,1,0,1,4084
0,0,1,0,1,0,1,4085
1,1,0,0,1,0,1,4085
0,0,1,0,1,0,1,4086
1,1,1,0,2,0,2,4086
2,2,1,0,3,0,3,4086
3,3,3,1,6,1,7,4086
4,4,3,1,9,2,11,4086
5,5,3,0,12,2,14,4086
6,6,1,0,13,2,15,4086
7,7,2,0,15,2,17,4086
8,8,0,1,15,3,18,4086
9,9,0,0,15,3,18,4086
0,0,1,0,1,0,1,4087
1,1,1,1,2,1,3,4087
2,2,1,1,3,2,5,4087
3,3,2,1,5,3,8,4087
4,4,3,3,8,6,14,4087
5,5,0,4,8,10,18,4087
6,6,1,3,9,13,22,4087
7,7,3,1,12,14,26,4087
8,8,2,1,14,15,29,4087
9,9,2,2,16,17,33,4087
10,10,1,2,17,19,36,4087
11,11,0,0,17,19,36,4087
0,0,1,0,1,0,1,4088
1,1,1,0,2,0,2,4088
2,2,1,0,3,0,3,4088
3,3,1,0,4,0,4,4088
4,4,0,0,4,0,4,4088
0,0,1,0,1,0,1,4089
1,1,2,0,3,0,3,4089
2,2,0,0,3,0,3,4089
0,0,1,0,1,0,1,4090
1,1,1,0,2,0,2,4090
2,2,0,1,2,1,3,4090
3,3,1,1,3,2,5,4090
4,4,1,3,4,5,9,4090
5,5,1,5,5,10,15,4090
6,6,2,4,7,14,21,4090
7,7,1,4,8,18,26,4090
8,8,0,0,8,18,26,4090
0,0,1,0,1,0,1,4091
1,1,3,1,4,1,5,4091
2,2,0,3,4,4,8,4091
3,3,1,2,5,6,11,4091
4,4,0,1,5,7,12,4091
5,5,0,0,5,7,12,4091
0,0,1,0,1,0,1,4092
1,1,1,0,2,0,2,4092
2,2,2,0,4,0,4,4092
3,3,3,1,7,1,8,4092
4,4,2,2,9,3,12,4092
5,5,2,2,11,5,16,4092
6,6,2,1,13,6,19,4092
7,7,3,1,16,7,23,4092
8,8,0,1,16,8,24,4092
9,9,0,2,16,10,26,4092
10,10,0,2,16,12,28,4092
11,11,1,2,17,14,31,4092
12,12,2,3,19,17,36,4092
13,13,0,5,19,22,41,4092
14,14,2,4,21,26,47,4092
15,15,3,4,24,30,54,4092
16,16,5,8,29,38,67,4092
17,17,7,8,36,46,82,4092
18,18,5,6,41,52,93,4092
19,19,4,3,45,55,100,4092
20,20,3,4,48,59,107,4092
21,21,4,3,52,62,114,4092
22,22,1,1,53,63,116,4092
23,23,0,0,53,63,116,4092
0,0,1,0,1,0,1,4093
1,1,0,0,1,0,1,4093
0,0,1,0,1,0,1,4094
1,1,1,0,2,0,2,4094
2,2,0,0,2,0,2,4094
0,0,1,0,1,0,1,4095
1,1,0,0,1,0,1,4095
0,0,1,0,1,0,1,4096
1,1,1,0,2,0,2,4096
2,2,0,1,2,1,3,4096
3,3,0,0,2,1,3,4096
0,0,1,0,1,0,1,4097
1,1,3,0,4,0,4,4097
2,2,1,0,5,0,5,4097
3,3,1,0,6,0,6,4097
4,4,1,0,7,0,7,4097
5,5,1,1,8,1,9,4097
6,6,2,2,10,3,13,4097
7,7,3,3,13,6,19,4097
8,8,6,1,19,7,26,4097
9,9,3,1,22,8,30,4097
10,10,1,0,23,8,31,4097
11,11,1,0,24,8,32,4097
12,12,1,0,25,8,33,4097
13,13,1,0,26,8,34,4097
14,14,0,0,26,8,34,4097
0,0,1,0,1,0,1,4098
1,1,0,0,1,0,1,4098
0,0,1,0,1,0,1,4099
1,1,0,0,1,0,1,4099
0,0,1,0,1,0,1,4100
1,1,0,0,1,0,1,4100
0,0,1,0,1,0,1,4101
1,1,1,0,2,0,2,4101
2,2,0,0,2,0,2,4101
0,0,1,0,1,0,1,4102
1,1,0,0,1,0,1,4102
0,0,1,0,1,0,1,4103
1,1,0,0,1,0,1,4103
0,0,1,0,1,0,1,4104
1,1,0,0,1,0,1,4104
0,0,1,0,1,0,1,4105
1,1,1,1,2,1,3,4105
2,2,0,1,2,2,4,4105
3,3,0,0,2,2,4,4105
0,0,1,0,1,0,1,4106
1,1,1,0,2,0,2,4106
2,2,0,0,2,0,2,4106
0,0,1,0,1,0,1,4107
1,1,0,1,1,1,2,4107
2,2,0,0,1,1,2,4107
0,0,1,0,1,0,1,4108
1,1,1,0,2,0,2,4108
2,2,3,0,5,0,5,4108
3,3,2,0,7,0,7,4108
4,4,1,0,8,0,8,4108
5,5,1,0,9,0,9,4108
6,6,0,0,9,0,9,4108
0,0,1,0,1,0,1,4109
1,1,0,0,1,0,1,4109
0,0,1,0,1,0,1,4110
1,1,2,0,3,0,3,4110
2,2,0,0,3,0,3,4110
0,0,1,0,1,0,1,4111
1,1,3,0,4,0,4,4111
2,2,2,0,6,0,6,4111
3,3,2,0,8,0,8,4111
4,4,0,1,8,1,9,4111
5,5,1,0,9,1,10,4111
6,6,0,1,9,2,11,4111
7,7,0,0,9,2,11,4111
0,0,1,0,1,0,1,4112
1,1,0,0,1,0,1,4112
0,0,1,0,1,0,1,4113
1,1,1,0,2,0,2,4113
2,2,0,0,2,0,2,4113
0,0,1,0,1,0,1,4114
1,1,0,0,1,0,1,4114
0,0,1,0,1,0,1,4115
1,1,0,0,1,0,1,4115
0,0,1,0,1,0,1,4116
1,1,1,0,2,0,2,4116
2,2,0,0,2,0,2,4116
0,0,1,0,1,0,1,4117
1,1,0,0,1,0,1,4117
0,0,1,0,1,0,1,4118
1,1,3,0,4,0,4,4118
2,2,0,1,4,1,5,4118
3,3,0,0,4,1,5,4118
0,0,1,0,1,0,1,4119
1,1,1,0,2,0,2,4119
2,2,0,0,2,0,2,4119
0,0,1,0,1,0,1,4120
1,1,0,1,1,1,2,4120
2,2,0,1,1,2,3,4120
3,3,0,1,1,3,4,4120
4,4,2,1,3,4,7,4120
5,5,3,1,6,5,11,4120
6,6,2,2,8,7,15,4120
7,7,2,1,10,8,18,4120
8,8,1,0,11,8,19,4120
9,9,1,0,12,8,20,4120
10,10,0,0,12,8,20,4120
0,0,1,0,1,0,1,4121
1,1,0,0,1,0,1,4121
0,0,1,0,1,0,1,4122
1,1,1,0,2,0,2,4122
2,2,1,0,3,0,3,4122
3,3,0,1,3,1,4,4122
4,4,0,2,3,3,6,4122
5,5,0,2,3,5,8,4122
6,6,0,3,3,8,11,4122
7,7,0,4,3,12,15,4122
8,8,0,4,3,16,19,4122
9,9,0,2,3,18,21,4122
10,10,1,3,4,21,25,4122
11,11,4,5,8,26,34,4122
12,12,2,7,10,33,43,4122
13,13,3,5,13,38,51,4122
14,14,3,2,16,40,56,4122
15,15,3,1,19,41,60,4122
16,16,4,1,23,42,65,4122
17,17,4,1,27,43,70,4122
18,18,0,0,27,43,70,4122
0,0,1,0,1,0,1,4123
1,1,0,0,1,0,1,4123
0,0,1,0,1,0,1,4124
1,1,0,0,1,0,1,4124
0,0,1,0,1,0,1,4125
1,1,0,0,1,0,1,4125
0,0,1,0,1,0,1,4126
1,1,0,0,1,0,1,4126
0,0,1,0,1,0,1,4127
1,1,0,0,1,0,1,4127
0,0,1,0,1,0,1,4128
1,1,1,0,2,0,2,4128
2,2,1,0,3,0,3,4128
3,3,0,0,3,0,3,4128
0,0,1,0,1,0,1,4129
1,1,1,0,2,0,2,4129
2,2,0,0,2,0,2,4129
0,0,1,0,1,0,1,4130
1,1,1,0,2,0,2,4130
2,2,2,1,4,1,5,4130
3,3,0,2,4,3,7,4130
4,4,0,0,4,3,7,4130
0,0,1,0,1,0,1,4131
1,1,2,0,3,0,3,4131
2,2,0,1,3,1,4,4131
3,3,0,1,3,2,5,4131
4,4,0,0,3,2,5,4131
0,0,1,0,1,0,1,4132
1,1,0,1,1,1,2,4132
2,2,0,0,1,1,2,4132
0,0,1,0,1,0,1,4133
1,1,0,0,1,0,1,4133
0,0,1,0,1,0,1,4134
1,1,2,0,3,0,3,4134
2,2,0,0,3,0,3,4134
0,0,1,0,1,0,1,4135
1,1,1,0,2,0,2,4135
2,2,0,0,2,0,2,4135
0,0,1,0,1,0,1,4136
1,1,2,0,3,0,3,4136
2,2,2,0,5,0,5,4136
3,3,1,2,6,2,8,4136
4,4,0,0,6,2,8,4136
0,0,1,0,1,0,1,4137
1,1,1,0,2,0,2,4137
2,2,0,0,2,0,2,4137
0,0,1,0,1,0,1,4138
1,1,2,0,3,0,3,4138
2,2,0,0,3,0,3,4138
0,0,1,0,1,0,1,4139
1,1,0,0,1,0,1,4139
0,0,1,0,1,0,1,4140
1,1,0,0,1,0,1,4140
0,0,1,0,1,0,1,4141
1,1,0,0,1,0,1,4141
0,0,1,0,1,0,1,4142
1,1,1,0,2,0,2,4142
2,2,1,0,3,0,3,4142
3,3,0,1,3,1,4,4142
4,4,1,0,4,1,5,4142
5,5,1,0,5,1,6,4142
6,6,0,0,5,1,6,4142
0,0,1,0,1,0,1,4143
1,1,0,0,1,0,1,4143
0,0,1,0,1,0,1,4144
1,1,0,0,1,0,1,4144
0,0,1,0,1,0,1,4145
1,1,0,0,1,0,1,4145
0,0,1,0,1,0,1,4146
1,1,0,0,1,0,1,4146
0,0,1,0,1,0,1,4147
1,1,1,0,2,0,2,4147
2,2,1,0,3,0,3,4147
3,3,0,0,3,0,3,4147
0,0,1,0,1,0,1,4148
1,1,2,2,3,2,5,4148
2,2,1,1,4,3,7,4148
3,3,0,3,4,6,10,4148
4,4,1,2,5,8,13,4148
5,5,3,1,8,9,17,4148
6,6,2,0,10,9,19,4148
7,7,3,0,13,9,22,4148
8,8,2,0,15,9,24,4148
9,9,1,0,16,9,25,4148
10,10,1,0,17,9,26,4148
11,11,1,0,18,9,27,4148
12,12,2,0,20,9,29,4148
13,13,1,0,21,9,30,4148
14,14,1,0,22,9,31,4148
15,15,1,0,23,9,32,4148
16,16,0,0,23,9,32,4148
0,0,1,0,1,0,1,4149
1,1,0,0,1,0,1,4149
0,0,1,0,1,0,1,4150
1,1,1,1,2,1,3,4150
2,2,2,0,4,1,5,4150
3,3,1,2,5,3,8,4150
4,4,3,2,8,5,13,4150
5,5,1,2,9,7,16,4150
6,6,0,2,9,9,18,4150
7,7,0,1,9,10,19,4150
8,8,0,0,9,10,19,4150
0,0,1,0,1,0,1,4151
1,1,1,0,2,0,2,4151
2,2,0,2,2,2,4,4151
3,3,0,3,2,5,7,4151
4,4,1,1,3,6,9,4151
5,5,1,1,4,7,11,4151
6,6,1,1,5,8,13,4151
7,7,1,2,6,10,16,4151
8,8,0,2,6,12,18,4151
9,9,1,1,7,13,20,4151
10,10,1,4,8,17,25,4151
11,11,2,3,10,20,30,4151
12,12,4,6,14,26,40,4151
13,13,4,5,18,31,49,4151
14,14,5,8,23,39,62,4151
15,15,2,1,25,40,65,4151
16,16,0,1,25,41,66,4151
17,17,0,1,25,42,67,4151
18,18,0,0,25,42,67,4151
0,0,1,0,1,0,1,4152
1,1,0,0,1,0,1,4152
0,0,1,0,1,0,1,4153
1,1,3,1,4,1,5,4153
2,2,5,2,9,3,12,4153
3,3,7,1,16,4,20,4153
4,4,6,1,22,5,27,4153
5,5,7,0,29,5,34,4153
6,6,10,1,39,6,45,4153
7,7,8,4,47,10,57,4153
8,8,3,9,50,19,69,4153
9,9,2,9,52,28,80,4153
10,10,2,14,54,42,96,4153
11,11,2,6,56,48,104,4153
12,12,2,4,58,52,110,4153
13,13,1,4,59,56,115,4153
14,14,1,8,60,64,124,4153
15,15,4,8,64,72,136,4153
16,16,5,8,69,80,149,4153
17,17,5,5,74,85,159,4153
18,18,6,6,80,91,171,4153
19,19,4,9,84,100,184,4153
20,20,5,3,89,103,192,4153
21,21,4,2,93,105,198,4153
22,22,2,1,95,106,201,4153
23,23,2,3,97,109,206,4153
24,24,2,4,99,113,212,4153
25,25,3,4,102,117,219,4153
26,26,4,1,106,118,224,4153
27,27,1,3,107,121,228,4153
28,28,0,3,107,124,231,4153
29,29,1,4,108,128,236,4153
30,30,2,5,110,133,243,4153
31,31,2,3,112,136,248,4153
32,32,1,2,113,138,251,4153
33,33,1,1,114,139,253,4153
34,34,0,0,114,139,253,4153
0,0,1,0,1,0,1,4154
1,1,0,0,1,0,1,4154
0,0,1,0,1,0,1,4155
1,1,1,0,2,0,2,4155
2,2,0,0,2,0,2,4155
0,0,1,0,1,0,1,4156
1,1,1,0,2,0,2,4156
2,2,0,0,2,0,2,4156
0,0,1,0,1,0,1,4157
1,1,1,0,2,0,2,4157
2,2,1,0,3,0,3,4157
3,3,0,0,3,0,3,4157
0,0,1,0,1,0,1,4158
1,1,0,1,1,1,2,4158
2,2,1,0,2,1,3,4158
3,3,1,0,3,1,4,4158
4,4,0,0,3,1,4,4158
0,0,1,0,1,0,1,4159
1,1,1,0,2,0,2,4159
2,2,0,0,2,0,2,4159
0,0,1,0,1,0,1,4160
1,1,0,0,1,0,1,4160
0,0,1,0,1,0,1,4161
1,1,2,0,3,0,3,4161
2,2,3,0,6,0,6,4161
3,3,2,2,8,2,10,4161
4,4,2,1,10,3,13,4161
5,5,1,1,11,4,15,4161
6,6,0,1,11,5,16,4161
7,7,1,3,12,8,20,4161
8,8,0,0,12,8,20,4161
0,0,1,0,1,0,1,4162
1,1,0,0,1,0,1,4162
0,0,1,0,1,0,1,4163
1,1,2,0,3,0,3,4163
2,2,2,0,5,0,5,4163
3,3,1,0,6,0,6,4163
4,4,0,0,6,0,6,4163
0,0,1,0,1,0,1,4164
1,1,0,0,1,0,1,4164
0,0,1,0,1,0,1,4165
1,1,1,0,2,0,2,4165
2,2,1,0,3,0,3,4165
3,3,0,0,3,0,3,4165
0,0,1,0,1,0,1,4166
1,1,0,0,1,0,1,4166
0,0,1,0,1,0,1,4167
1,1,0,0,1,0,1,4167
0,0,1,0,1,0,1,4168
1,1,2,0,3,0,3,4168
2,2,0,0,3,0,3,4168
0,0,1,0,1,0,1,4169
1,1,0,0,1,0,1,4169
0,0,1,0,1,0,1,4170
1,1,0,0,1,0,1,4170
0,0,1,0,1,0,1,4171
1,1,2,0,3,0,3,4171
2,2,1,0,4,0,4,4171
3,3,0,0,4,0,4,4171
0,0,1,0,1,0,1,4172
1,1,1,1,2,1,3,4172
2,2,0,2,2,3,5,4172
3,3,0,2,2,5,7,4172
4,4,0,1,2,6,8,4172
5,5,0,2,2,8,10,4172
6,6,0,1,2,9,11,4172
7,7,0,1,2,10,12,4172
8,8,0,0,2,10,12,4172
0,0,1,0,1,0,1,4173
1,1,0,0,1,0,1,4173
0,0,1,0,1,0,1,4174
1,1,0,0,1,0,1,4174
0,0,1,0,1,0,1,4175
1,1,0,0,1,0,1,4175
0,0,1,0,1,0,1,4176
1,1,0,0,1,0,1,4176
0,0,1,0,1,0,1,4177
1,1,2,0,3,0,3,4177
2,2,2,1,5,1,6,4177
3,3,3,1,8,2,10,4177
4,4,0,4,8,6,14,4177
5,5,1,4,9,10,19,4177
6,6,2,2,11,12,23,4177
7,7,0,2,11,14,25,4177
8,8,0,0,11,14,25,4177
0,0,1,0,1,0,1,4178
1,1,1,0,2,0,2,4178
2,2,0,1,2,1,3,4178
3,3,0,1,2,2,4,4178
4,4,0,1,2,3,5,4178
5,5,0,1,2,4,6,4178
6,6,0,0,2,4,6,4178
0,0,1,0,1,0,1,4179
1,1,0,0,1,0,1,4179
0,0,1,0,1,0,1,4180
1,1,1,0,2,0,2,4180
2,2,0,0,2,0,2,4180
0,0,1,0,1,0,1,4181
1,1,0,0,1,0,1,4181
0,0,1,0,1,0,1,4182
1,1,1,0,2,0,2,4182
2,2,1,0,3,0,3,4182
3,3,1,0,4,0,4,4182
4,4,1,0,5,0,5,4182
5,5,1,0,6,0,6,4182
6,6,1,0,7,0,7,4182
7,7,0,0,7,0,7,4182
0,0,1,0,1,0,1,4183
1,1,2,0,3,0,3,4183
2,2,0,1,3,1,4,4183
3,3,0,0,3,1,4,4183
0,0,1,0,1,0,1,4184
1,1,3,0,4,0,4,4184
2,2,3,1,7,1,8,4184
3,3,3,0,10,1,11,4184
4,4,2,1,12,2,14,4184
5,5,2,1,14,3,17,4184
6,6,2,0,16,3,19,4184
7,7,1,0,17,3,20,4184
8,8,0,0,17,3,20,4184
0,0,1,0,1,0,1,4185
1,1,1,0,2,0,2,4185
2,2,2,1,4,1,5,4185
3,3,2,1,6,2,8,4185
4,4,0,0,6,2,8,4185
0,0,1,0,1,0,1,4186
1,1,1,1,2,1,3,4186
2,2,2,0,4,1,5,4186
3,3,1,0,5,1,6,4186
4,4,2,0,7,1,8,4186
5,5,0,1,7,2,9,4186
6,6,0,0,7,2,9,4186
0,0,1,0,1,0,1,4187
1,1,1,0,2,0,2,4187
2,2,1,0,3,0,3,4187
3,3,0,0,3,0,3,4187
0,0,1,0,1,0,1,4188
1,1,2,0,3,0,3,4188
2,2,1,0,4,0,4,4188
3,3,0,0,4,0,4,4188
0,0,1,0,1,0,1,4189
1,1,3,1,4,1,5,4189
2,2,2,2,6,3,9,4189
3,3,3,0,9,3,12,4189
4,4,3,1,12,4,16,4189
5,5,4,0,16,4,20,4189
6,6,5,0,21,4,25,4189
7,7,6,1,27,5,32,4189
8,8,6,1,33,6,39,4189
9,9,5,2,38,8,46,4189
10,10,2,4,40,12,52,4189
11,11,2,11,42,23,65,4189
12,12,3,7,45,30,75,4189
13,13,1,3,46,33,79,4189
14,14,1,1,47,34,81,4189
15,15,1,0,48,34,82,4189
16,16,2,1,50,35,85,4189
17,17,1,0,51,35,86,4189
18,18,0,0,51,35,86,4189
0,0,1,0,1,0,1,4190
1,1,1,1,2,1,3,4190
2,2,1,2,3,3,6,4190
3,3,0,2,3,5,8,4190
4,4,1,2,4,7,11,4190
5,5,0,1,4,8,12,4190
6,6,0,1,4,9,13,4190
7,7,0,0,4,9,13,4190
0,0,1,0,1,0,1,4191
1,1,0,0,1,0,1,4191
0,0,1,0,1,0,1,4192
1,1,1,0,2,0,2,4192
2,2,0,0,2,0,2,4192
0,0,1,0,1,0,1,4193
1,1,1,0,2,0,2,4193
2,2,1,1,3,1,4,4193
3,3,0,0,3,1,4,4193
0,0,1,0,1,0,1,4194
1,1,0,1,1,1,2,4194
2,2,1,1,2,2,4,4194
3,3,0,0,2,2,4,4194
0,0,1,0,1,0,1,4195
1,1,1,0,2,0,2,4195
2,2,0,0,2,0,2,4195
0,0,1,0,1,0,1,4196
1,1,1,0,2,0,2,4196
2,2,2,0,4,0,4,4196
3,3,1,0,5,0,5,4196
4,4,0,0,5,0,5,4196
0,0,1,0,1,0,1,4197
1,1,1,0,2,0,2,4197
2,2,3,0,5,0,5,4197
3,3,1,1,6,1,7,4197
4,4,0,0,6,1,7,4197
0,0,1,0,1,0,1,4198
1,1,0,0,1,0,1,4198
0,0,1,0,1,0,1,4199
1,1,1,0,2,0,2,4199
2,2,1,0,3,0,3,4199
3,3,0,0,3,0,3,4199
0,0,1,0,1,0,1,4200
1,1,1,0,2,0,2,4200
2,2,1,0,3,0,3,4200
3,3,1,0,4,0,4,4200
4,4,0,0,4,0,4,4200
0,0,1,0,1,0,1,4201
1,1,1,0,2,0,2,4201
2,2,1,0,3,0,3,4201
3,3,2,0,5,0,5,4201
4,4,2,1,7,1,8,4201
5,5,2,2,9,3,12,4201
6,6,1,1,10,4,14,4201
7,7,1,0,11,4,15,4201
8,8,1,1,12,5,17,4201
9,9,2,1,14,6,20,4201
10,10,1,4,15,10,25,4201
11,11,1,2,16,12,28,4201
12,12,0,2,16,14,30,4201
13,13,0,0,16,14,30,4201
0,0,1,0,1,0,1,4202
1,1,0,0,1,0,1,4202
0,0,1,0,1,0,1,4203
1,1,0,1,1,1,2,4203
2,2,0,1,1,2,3,4203
3,3,0,0,1,2,3,4203
0,0,1,0,1,0,1,4204
1,1,1,0,2,0,2,4204
2,2,0,0,2,0,2,4204
0,0,1,0,1,0,1,4205
1,1,0,0,1,0,1,4205
0,0,1,0,1,0,1,4206
1,1,1,1,2,1,3,4206
2,2,1,2,3,3,6,4206
3,3,0,2,3,5,8,4206
4,4,0,2,3,7,10,4206
5,5,0,3,3,10,13,4206
6,6,0,1,3,11,14,4206
7,7,0,2,3,13,16,4206
8,8,1,2,4,15,19,4206
9,9,2,1,6,16,22,4206
10,10,0,1,6,17,23,4206
11,11,1,1,7,18,25,4206
12,12,1,1,8,19,27,4206
13,13,2,2,10,21,31,4206
14,14,3,4,13,25,38,4206
15,15,2,4,15,29,44,4206
16,16,3,2,18,31,49,4206
17,17,2,1,20,32,52,4206
18,18,1,2,21,34,55,4206
19,19,1,1,22,35,57,4206
20,20,1,0,23,35,58,4206
21,21,0,1,23,36,59,4206
22,22,0,0,23,36,59,4206
0,0,1,0,1,0,1,4207
1,1,1,0,2,0,2,4207
2,2,2,1,4,1,5,4207
3,3,2,1,6,2,8,4207
4,4,0,2,6,4,10,4207
5,5,0,1,6,5,11,4207
6,6,0,0,6,5,11,4207
0,0,1,0,1,0,1,4208
1,1,1,0,2,0,2,4208
2,2,0,0,2,0,2,4208
0,0,1,0,1,0,1,4209
1,1,0,0,1,0,1,4209
0,0,1,0,1,0,1,4210
1,1,0,0,1,0,1,4210
0,0,1,0,1,0,1,4211
1,1,2,0,3,0,3,4211
2,2,1,0,4,0,4,4211
3,3,1,0,5,0,5,4211
4,4,1,0,6,0,6,4211
5,5,1,0,7,0,7,4211
6,6,0,0,7,0,7,4211
0,0,1,0,1,0,1,4212
1,1,0,0,1,0,1,4212
0,0,1,0,1,0,1,4213
1,1,0,0,1,0,1,4213
0,0,1,0,1,0,1,4214
1,1,2,1,3,1,4,4214
2,2,0,1,3,2,5,4214
3,3,0,3,3,5,8,4214
4,4,0,2,3,7,10,4214
5,5,0,2,3,9,12,4214
6,6,0,2,3,11,14,4214
7,7,0,3,3,14,17,4214
8,8,0,3,3,17,20,4214
9,9,2,4,5,21,26,4214
10,10,0,6,5,27,32,4214
11,11,2,3,7,30,37,4214
12,12,4,0,11,30,41,4214
13,13,2,1,13,31,44,4214
14,14,1,1,14,32,46,4214
15,15,3,0,17,32,49,4214
16,16,3,0,20,32,52,4214
17,17,5,0,25,32,57,4214
18,18,4,0,29,32,61,4214
19,19,6,1,35,33,68,4214
20,20,5,1,40,34,74,4214
21,21,3,4,43,38,81,4214
22,22,2,3,45,41,86,4214
23,23,1,3,46,44,90,4214
24,24,1,2,47,46,93,4214
25,25,2,1,49,47,96,4214
26,26,1,3,50,50,100,4214
27,27,1,2,51,52,103,4214
28,28,2,3,53,55,108,4214
29,29,1,3,54,58,112,4214
30,30,1,0,55,58,113,4214
31,31,1,0,56,58,114,4214
32,32,0,0,56,58,114,4214
0,0,1,0,1,0,1,4215
1,1,0,0,1,0,1,4215
0,0,1,0,1,0,1,4216
1,1,0,0,1,0,1,4216
0,0,1,0,1,0,1,4217
1,1,3,0,4,0,4,4217
2,2,1,1,5,1,6,4217
3,3,0,2,5,3,8,4217
4,4,0,1,5,4,9,4217
5,5,0,1,5,5,10,4217
6,6,0,2,5,7,12,4217
7,7,0,3,5,10,15,4217
8,8,1,1,6,11,17,4217
9,9,0,1,6,12,18,4217
10,10,0,1,6,13,19,4217
11,11,0,0,6,13,19,4217
0,0,1,0,1,0,1,4218
1,1,0,1,1,1,2,4218
2,2,0,1,1,2,3,4218
3,3,0,2,1,4,5,4218
4,4,0,0,1,4,5,4218
0,0,1,0,1,0,1,4219
1,1,0,0,1,0,1,4219
0,0,1,0,1,0,1,4220
1,1,0,1,1,1,2,4220
2,2,1,1,2,2,4,4220
3,3,1,1,3,3,6,4220
4,4,0,1,3,4,7,4220
5,5,0,1,3,5,8,4220
6,6,0,1,3,6,9,4220
7,7,0,0,3,6,9,4220
0,0,1,0,1,0,1,4221
1,1,0,0,1,0,1,4221
0,0,1,0,1,0,1,4222
1,1,1,1,2,1,3,4222
2,2,0,3,2,4,6,4222
3,3,0,3,2,7,9,4222
4,4,2,3,4,10,14,4222
5,5,1,2,5,12,17,4222
6,6,1,2,6,14,20,4222
7,7,1,0,7,14,21,4222
8,8,0,0,7,14,21,4222
0,0,1,0,1,0,1,4223
1,1,1,0,2,0,2,4223
2,2,0,0,2,0,2,4223
0,0,1,0,1,0,1,4224
1,1,1,0,2,0,2,4224
2,2,2,0,4,0,4,4224
3,3,1,0,5,0,5,4224
4,4,1,0,6,0,6,4224
5,5,0,0,6,0,6,4224
0,0,1,0,1,0,1,4225
1,1,2,0,3,0,3,4225
2,2,1,0,4,0,4,4225
3,3,0,0,4,0,4,4225
0,0,1,0,1,0,1,4226
1,1,0,1,1,1,2,4226
2,2,0,1,1,2,3,4226
3,3,1,0,2,2,4,4226
4,4,0,0,2,2,4,4226
0,0,1,0,1,0,1,4227
1,1,0,0,1,0,1,4227
0,0,1,0,1,0,1,4228
1,1,1,0,2,0,2,4228
2,2,0,0,2,0,2,4228
0,0,1,0,1,0,1,4229
1,1,2,1,3,1,4,4229
2,2,1,1,4,2,6,4229
3,3,0,1,4,3,7,4229
4,4,0,1,4,4,8,4229
5,5,0,1,4,5,9,4229
6,6,0,0,4,5,9,4229
0,0,1,0,1,0,1,4230
1,1,2,0,3,0,3,4230
2,2,2,0,5,0,5,4230
3,3,1,0,6,0,6,4230
4,4,1,0,7,0,7,4230
5,5,0,1,7,1,8,4230
6,6,0,0,7,1,8,4230
0,0,1,0,1,0,1,4231
1,1,1,0,2,0,2,4231
2,2,3,0,5,0,5,4231
3,3,0,0,5,0,5,4231
0,0,1,0,1,0,1,4232
1,1,1,0,2,0,2,4232
2,2,0,1,2,1,3,4232
3,3,0,0,2,1,3,4232
0,0,1,0,1,0,1,4233
1,1,0,0,1,0,1,4233
0,0,1,0,1,0,1,4234
1,1,0,1,1,1,2,4234
2,2,0,0,1,1,2,4234
0,0,1,0,1,0,1,4235
1,1,2,0,3,0,3,4235
2,2,4,0,7,0,7,4235
3,3,1,0,8,0,8,4235
4,4,0,0,8,0,8,4235
0,0,1,0,1,0,1,4236
1,1,0,0,1,0,1,4236
0,0,1,0,1,0,1,4237
1,1,0,0,1,0,1,4237
0,0,1,0,1,0,1,4238
1,1,0,0,1,0,1,4238
0,0,1,0,1,0,1,4239
1,1,1,0,2,0,2,4239
2,2,0,0,2,0,2,4239
0,0,1,0,1,0,1,4240
1,1,3,0,4,0,4,4240
2,2,0,2,4,2,6,4240
3,3,0,2,4,4,8,4240
4,4,1,0,5,4,9,4240
5,5,0,0,5,4,9,4240
0,0,1,0,1,0,1,4241
1,1,1,0,2,0,2,4241
2,2,0,2,2,2,4,4241
3,3,0,3,2,5,7,4241
4,4,0,3,2,8,10,4241
5,5,1,1,3,9,12,4241
6,6,0,0,3,9,12,4241
0,0,1,0,1,0,1,4242
1,1,0,0,1,0,1,4242
0,0,1,0,1,0,1,4243
1,1,0,0,1,0,1,4243
0,0,1,0,1,0,1,4244
1,1,0,0,1,0,1,4244
0,0,1,0,1,0,1,4245
1,1,0,0,1,0,1,4245
0,0,1,0,1,0,1,4246
1,1,0,0,1,0,1,4246
0,0,1,0,1,0,1,4247
1,1,3,0,4,0,4,4247
2,2,1,2,5,2,7,4247
3,3,0,1,5,3,8,4247
4,4,1,0,6,3,9,4247
5,5,2,0,8,3,11,4247
6,6,1,0,9,3,12,4247
7,7,0,1,9,4,13,4247
8,8,0,1,9,5,14,4247
9,9,0,1,9,6,15,4247
10,10,0,0,9,6,15,4247
0,0,1,0,1,0,1,4248
1,1,1,0,2,0,2,4248
2,2,0,0,2,0,2,4248
0,0,1,0,1,0,1,4249
1,1,1,0,2,0,2,4249
2,2,1,0,3,0,3,4249
3,3,0,0,3,0,3,4249
0,0,1,0,1,0,1,4250
1,1,3,0,4,0,4,4250
2,2,1,0,5,0,5,4250
3,3,2,0,7,0,7,4250
4,4,1,0,8,0,8,4250
5,5,0,0,8,0,8,4250
0,0,1,0,1,0,1,4251
1,1,0,0,1,0,1,4251
0,0,1,0,1,0,1,4252
1,1,0,0,1,0,1,4252
0,0,1,0,1,0,1,4253
1,1,1,1,2,1,3,4253
2,2,1,1,3,2,5,4253
3,3,0,1,3,3,6,4253
4,4,0,1,3,4,7,4253
5,5,0,0,3,4,7,4253
0,0,1,0,1,0,1,4254
1,1,0,1,1,1,2,4254
2,2,1,3,2,4,6,4254
3,3,2,1,4,5,9,4254
4,4,3,0,7,5,12,4254
5,5,0,1,7,6,13,4254
6,6,0,0,7,6,13,4254
0,0,1,0,1,0,1,4255
1,1,2,0,3,0,3,4255
2,2,1,0,4,0,4,4255
3,3,1,0,5,0,5,4255
4,4,1,0,6,0,6,4255
5,5,1,0,7,0,7,4255
6,6,1,0,8,0,8,4255
7,7,0,0,8,0,8,4255
0,0,1,0,1,0,1,4256
1,1,1,0,2,0,2,4256
2,2,4,0,6,0,6,4256
3,3,2,2,8,2,10,4256
4,4,1,1,9,3,12,4256
5,5,0,2,9,5,14,4256
6,6,0,0,9,5,14,4256
0,0,1,0,1,0,1,4257
1,1,1,1,2,1,3,4257
2,2,3,0,5,1,6,4257
3,3,3,1,8,2,10,4257
4,4,2,1,10,3,13,4257
5,5,5,0,15,3,18,4257
6,6,4,0,19,3,22,4257
7,7,6,0,25,3,28,4257
8,8,6,1,31,4,35,4257
9,9,8,1,39,5,44,4257
10,10,8,4,47,9,56,4257
11,11,5,1,52,10,62,4257
12,12,2,3,54,13,67,4257
13,13,2,2,56,15,71,4257
14,14,0,3,56,18,74,4257
15,15,4,1,60,19,79,4257
16,16,0,0,60,19,79,4257
0,0,1,0,1,0,1,4258
1,1,0,0,1,0,1,4258
0,0,1,0,1,0,1,4259
1,1,1,0,2,0,2,4259
2,2,1,0,3,0,3,4259
3,3,0,0,3,0,3,4259
0,0,1,0,1,0,1,4260
1,1,0,0,1,0,1,4260
0,0,1,0,1,0,1,4261
1,1,0,1,1,1,2,4261
2,2,0,0,1,1,2,4261
0,0,1,0,1,0,1,4262
1,1,0,0,1,0,1,4262
0,0,1,0,1,0,1,4263
1,1,1,1,2,1,3,4263
2,2,0,1,2,2,4,4263
3,3,1,2,3,4,7,4263
4,4,0,2,3,6,9,4263
5,5,0,1,3,7,10,4263
6,6,1,0,4,7,11,4263
7,7,0,0,4,7,11,4263
0,0,1,0,1,0,1,4264
1,1,0,0,1,0,1,4264
0,0,1,0,1,0,1,4265
1,1,0,0,1,0,1,4265
0,0,1,0,1,0,1,4266
1,1,1,0,2,0,2,4266
2,2,1,0,3,0,3,4266
3,3,1,0,4,0,4,4266
4,4,1,0,5,0,5,4266
5,5,0,0,5,0,5,4266
0,0,1,0,1,0,1,4267
1,1,1,0,2,0,2,4267
2,2,2,0,4,0,4,4267
3,3,0,0,4,0,4,4267
0,0,1,0,1,0,1,4268
1,1,0,1,1,1,2,4268
2,2,0,2,1,3,4,4268
3,3,1,1,2,4,6,4268
4,4,4,1,6,5,11,4268
5,5,4,1,10,6,16,4268
6,6,5,1,15,7,22,4268
7,7,4,0,19,7,26,4268
8,8,1,1,20,8,28,4268
9,9,3,1,23,9,32,4268
10,10,3,3,26,12,38,4268
11,11,3,2,29,14,43,4268
12,12,4,0,33,14,47,4268
13,13,2,1,35,15,50,4268
14,14,2,0,37,15,52,4268
15,15,1,1,38,16,54,4268
16,16,0,0,38,16,54,4268
0,0,1,0,1,0,1,4269
1,1,1,0,2,0,2,4269
2,2,0,0,2,0,2,4269
0,0,1,0,1,0,1,4270
1,1,0,0,1,0,1,4270
0,0,1,0,1,0,1,4271
1,1,0,0,1,0,1,4271
0,0,1,0,1,0,1,4272
1,1,1,0,2,0,2,4272
2,2,0,0,2,0,2,4272
0,0,1,0,1,0,1,4273
1,1,0,0,1,0,1,4273
0,0,1,0,1,0,1,4274
1,1,2,0,3,0,3,4274
2,2,3,0,6,0,6,4274
3,3,2,0,8,0,8,4274
4,4,1,0,9,0,9,4274
5,5,3,0,12,0,12,4274
6,6,2,0,14,0,14,4274
7,7,0,1,14,1,15,4274
8,8,1,1,15,2,17,4274
9,9,2,0,17,2,19,4274
10,10,1,0,18,2,20,4274
11,11,0,0,18,2,20,4274
0,0,1,0,1,0,1,4275
1,1,0,0,1,0,1,4275
0,0,1,0,1,0,1,4276
1,1,1,0,2,0,2,4276
2,2,0,1,2,1,3,4276
3,3,1,1,3,2,5,4276
4,4,1,1,4,3,7,4276
5,5,2,0,6,3,9,4276
6,6,4,0,10,3,13,4276
7,7,6,2,16,5,21,4276
8,8,5,3,21,8,29,4276
9,9,2,4,23,12,35,4276
10,10,2,2,25,14,39,4276
11,11,1,2,26,16,42,4276
12,12,0,1,26,17,43,4276
13,13,1,1,27,18,45,4276
14,14,0,0,27,18,45,4276
0,0,1,0,1,0,1,4277
1,1,1,0,2,0,2,4277
2,2,0,0,2,0,2,4277
0,0,1,0,1,0,1,4278
1,1,0,1,1,1,2,4278
2,2,0,0,1,1,2,4278
0,0,1,0,1,0,1,4279
1,1,1,0,2,0,2,4279
2,2,0,0,2,0,2,4279
0,0,1,0,1,0,1,4280
1,1,2,0,3,0,3,4280
2,2,1,0,4,0,4,4280
3,3,0,0,4,0,4,4280
0,0,1,0,1,0,1,4281
1,1,1,0,2,0,2,4281
2,2,0,0,2,0,2,4281
0,0,1,0,1,0,1,4282
1,1,1,0,2,0,2,4282
2,2,0,0,2,0,2,4282
0,0,1,0,1,0,1,4283
1,1,1,0,2,0,2,4283
2,2,0,0,2,0,2,4283
0,0,1,0,1,0,1,4284
1,1,0,0,1,0,1,4284
0,0,1,0,1,0,1,4285
1,1,0,0,1,0,1,4285
0,0,1,0,1,0,1,4286
1,1,1,0,2,0,2,4286
2,2,2,0,4,0,4,4286
3,3,4,0,8,0,8,4286
4,4,3,1,11,1,12,4286
5,5,3,1,14,2,16,4286
6,6,1,2,15,4,19,4286
7,7,1,1,16,5,21,4286
8,8,0,2,16,7,23,4286
9,9,0,1,16,8,24,4286
10,10,1,0,17,8,25,4286
11,11,0,0,17,8,25,4286
0,0,1,0,1,0,1,4287
1,1,1,1,2,1,3,4287
2,2,0,2,2,3,5,4287
3,3,0,2,2,5,7,4287
4,4,1,2,3,7,10,4287
5,5,0,0,3,7,10,4287
0,0,1,0,1,0,1,4288
1,1,1,0,2,0,2,4288
2,2,3,0,5,0,5,4288
3,3,3,1,8,1,9,4288
4,4,4,2,12,3,15,4288
5,5,5,5,17,8,25,4288
6,6,5,6,22,14,36,4288
7,7,3,5,25,19,44,4288
8,8,4,4,29,23,52,4288
9,9,3,5,32,28,60,4288
10,10,3,7,35,35,70,4288
11,11,1,2,36,37,73,4288
12,12,1,1,37,38,75,4288
13,13,0,1,37,39,76,4288
14,14,0,1,37,40,77,4288
15,15,0,0,37,40,77,4288
0,0,1,0,1,0,1,4289
1,1,2,0,3,0,3,4289
2,2,0,0,3,0,3,4289
0,0,1,0,1,0,1,4290
1,1,0,0,1,0,1,4290
0,0,1,0,1,0,1,4291
1,1,1,1,2,1,3,4291
2,2,1,0,3,1,4,4291
3,3,1,0,4,1,5,4291
4,4,0,0,4,1,5,4291
0,0,1,0,1,0,1,4292
1,1,1,1,2,1,3,4292
2,2,1,0,3,1,4,4292
3,3,3,1,6,2,8,4292
4,4,2,0,8,2,10,4292
5,5,0,0,8,2,10,4292
0,0,1,0,1,0,1,4293
1,1,1,0,2,0,2,4293
2,2,2,0,4,0,4,4293
3,3,3,0,7,0,7,4293
4,4,2,1,9,1,10,4293
5,5,5,2,14,3,17,4293
6,6,4,1,18,4,22,4293
7,7,2,3,20,7,27,4293
8,8,1,4,21,11,32,4293
9,9,1,2,22,13,35,4293
10,10,0,3,22,16,38,4293
11,11,0,1,22,17,39,4293
12,12,0,1,22,18,40,4293
13,13,0,0,22,18,40,4293
0,0,1,0,1,0,1,4294
1,1,2,1,3,1,4,4294
2,2,4,1,7,2,9,4294
3,3,4,0,11,2,13,4294
4,4,2,0,13,2,15,4294
5,5,1,0,14,2,16,4294
6,6,1,1,15,3,18,4294
7,7,1,0,16,3,19,4294
8,8,1,1,17,4,21,4294
9,9,2,2,19,6,25,4294
10,10,0,1,19,7,26,4294
11,11,0,1,19,8,27,4294
12,12,0,1,19,9,28,4294
13,13,0,0,19,9,28,4294
0,0,1,0,1,0,1,4295
1,1,1,0,2,0,2,4295
2,2,0,0,2,0,2,4295
0,0,1,0,1,0,1,4296
1,1,0,0,1,0,1,4296
0,0,1,0,1,0,1,4297
1,1,1,0,2,0,2,4297
2,2,0,1,2,1,3,4297
3,3,0,3,2,4,6,4297
4,4,1,2,3,6,9,4297
5,5,4,0,7,6,13,4297
6,6,3,2,10,8,18,4297
7,7,6,3,16,11,27,4297
8,8,2,5,18,16,34,4297
9,9,2,3,20,19,39,4297
10,10,3,3,23,22,45,4297
11,11,5,2,28,24,52,4297
12,12,3,2,31,26,57,4297
13,13,3,2,34,28,62,4297
14,14,6,4,40,32,72,4297
15,15,11,5,51,37,88,4297
16,16,11,8,62,45,107,4297
17,17,9,9,71,54,125,4297
18,18,7,6,78,60,138,4297
19,19,9,6,87,66,153,4297
20,20,6,5,93,71,164,4297
21,21,6,4,99,75,174,4297
22,22,4,3,103,78,181,4297
23,23,2,4,105,82,187,4297
24,24,6,4,111,86,197,4297
25,25,9,3,120,89,209,4297
26,26,14,6,134,95,229,4297
27,27,8,4,142,99,241,4297
28,28,6,4,148,103,251,4297
29,29,3,1,151,104,255,4297
30,30,3,1,154,105,259,4297
31,31,3,1,157,106,263,4297
32,32,3,0,160,106,266,4297
33,33,3,0,163,106,269,4297
34,34,0,0,163,106,269,4297
0,0,1,0,1,0,1,4298
1,1,0,1,1,1,2,4298
2,2,2,1,3,2,5,4298
3,3,3,0,6,2,8,4298
4,4,3,0,9,2,11,4298
5,5,3,0,12,2,14,4298
6,6,5,2,17,4,21,4298
7,7,9,6,26,10,36,4298
8,8,7,4,33,14,47,4298
9,9,3,2,36,16,52,4298
10,10,2,1,38,17,55,4298
11,11,2,2,40,19,59,4298
12,12,1,1,41,20,61,4298
13,13,1,2,42,22,64,4298
14,14,0,1,42,23,65,4298
15,15,0,0,42,23,65,4298
0,0,1,0,1,0,1,4299
1,1,0,0,1,0,1,4299
0,0,1,0,1,0,1,4300
1,1,1,1,2,1,3,4300
2,2,1,0,3,1,4,4300
3,3,0,0,3,1,4,4300
0,0,1,0,1,0,1,4301
1,1,1,1,2,1,3,4301
2,2,2,2,4,3,7,4301
3,3,1,2,5,5,10,4301
4,4,1,0,6,5,11,4301
5,5,2,0,8,5,13,4301
6,6,0,1,8,6,14,4301
7,7,0,1,8,7,15,4301
8,8,0,3,8,10,18,4301
9,9,1,3,9,13,22,4301
10,10,4,2,13,15,28,4301
11,11,4,3,17,18,35,4301
12,12,4,2,21,20,41,4301
13,13,4,5,25,25,50,4301
14,14,5,2,30,27,57,4301
15,15,1,2,31,29,60,4301
16,16,2,1,33,30,63,4301
17,17,2,1,35,31,66,4301
18,18,1,1,36,32,68,4301
19,19,1,0,37,32,69,4301
20,20,0,0,37,32,69,4301
0,0,1,0,1,0,1,4302
1,1,0,0,1,0,1,4302
0,0,1,0,1,0,1,4303
1,1,0,1,1,1,2,4303
2,2,0,1,1,2,3,4303
3,3,1,0,2,2,4,4303
4,4,2,0,4,2,6,4303
5,5,2,0,6,2,8,4303
6,6,0,0,6,2,8,4303
0,0,1,0,1,0,1,4304
1,1,0,0,1,0,1,4304
0,0,1,0,1,0,1,4305
1,1,1,1,2,1,3,4305
2,2,0,0,2,1,3,4305
0,0,1,0,1,0,1,4306
1,1,1,0,2,0,2,4306
2,2,1,0,3,0,3,4306
3,3,3,0,6,0,6,4306
4,4,1,0,7,0,7,4306
5,5,0,1,7,1,8,4306
6,6,0,2,7,3,10,4306
7,7,0,2,7,5,12,4306
8,8,1,0,8,5,13,4306
9,9,2,0,10,5,15,4306
10,10,1,1,11,6,17,4306
11,11,1,1,12,7,19,4306
12,12,0,1,12,8,20,4306
13,13,1,0,13,8,21,4306
14,14,0,0,13,8,21,4306
0,0,1,0,1,0,1,4307
1,1,1,0,2,0,2,4307
2,2,2,1,4,1,5,4307
3,3,1,0,5,1,6,4307
4,4,0,0,5,1,6,4307
0,0,1,0,1,0,1,4308
1,1,0,1,1,1,2,4308
2,2,1,0,2,1,3,4308
3,3,3,0,5,1,6,4308
4,4,1,0,6,1,7,4308
5,5,0,0,6,1,7,4308
0,0,1,0,1,0,1,4309
1,1,0,0,1,0,1,4309
0,0,1,0,1,0,1,4310
1,1,1,0,2,0,2,4310
2,2,1,0,3,0,3,4310
3,3,0,0,3,0,3,4310
0,0,1,0,1,0,1,4311
1,1,0,1,1,1,2,4311
2,2,0,1,1,2,3,4311
3,3,0,1,1,3,4,4311
4,4,0,1,1,4,5,4311
5,5,0,4,1,8,9,4311
6,6,1,3,2,11,13,4311
7,7,1,4,3,15,18,4311
8,8,1,1,4,16,20,4311
9,9,0,1,4,17,21,4311
10,10,0,2,4,19,23,4311
11,11,0,2,4,21,25,4311
12,12,1,1,5,22,27,4311
13,13,0,1,5,23,28,4311
14,14,0,0,5,23,28,4311
0,0,1,0,1,0,1,4312
1,1,1,1,2,1,3,4312
2,2,4,1,6,2,8,4312
3,3,3,2,9,4,13,4312
4,4,1,1,10,5,15,4312
5,5,0,1,10,6,16,4312
6,6,0,0,10,6,16,4312
0,0,1,0,1,0,1,4313
1,1,0,0,1,0,1,4313
0,0,1,0,1,0,1,4314
1,1,0,0,1,0,1,4314
0,0,1,0,1,0,1,4315
1,1,1,0,2,0,2,4315
2,2,0,0,2,0,2,4315
0,0,1,0,1,0,1,4316
1,1,0,0,1,0,1,4316
0,0,1,0,1,0,1,4317
1,1,0,0,1,0,1,4317
0,0,1,0,1,0,1,4318
1,1,1,0,2,0,2,4318
2,2,0,0,2,0,2,4318
0,0,1,0,1,0,1,4319
1,1,1,0,2,0,2,4319
2,2,1,0,3,0,3,4319
3,3,1,0,4,0,4,4319
4,4,1,1,5,1,6,4319
5,5,0,0,5,1,6,4319
0,0,1,0,1,0,1,4320
1,1,0,0,1,0,1,4320
0,0,1,0,1,0,1,4321
1,1,0,0,1,0,1,4321
0,0,1,0,1,0,1,4322
1,1,1,0,2,0,2,4322
2,2,1,0,3,0,3,4322
3,3,0,0,3,0,3,4322
0,0,1,0,1,0,1,4323
1,1,0,0,1,0,1,4323
0,0,1,0,1,0,1,4324
1,1,1,0,2,0,2,4324
2,2,0,0,2,0,2,4324
0,0,1,0,1,0,1,4325
1,1,2,1,3,1,4,4325
2,2,0,1,3,2,5,4325
3,3,0,1,3,3,6,4325
4,4,0,0,3,3,6,4325
0,0,1,0,1,0,1,4326
1,1,1,0,2,0,2,4326
2,2,0,0,2,0,2,4326
0,0,1,0,1,0,1,4327
1,1,0,0,1,0,1,4327
0,0,1,0,1,0,1,4328
1,1,0,0,1,0,1,4328
0,0,1,0,1,0,1,4329
1,1,0,0,1,0,1,4329
0,0,1,0,1,0,1,4330
1,1,2,0,3,0,3,4330
2,2,2,0,5,0,5,4330
3,3,2,0,7,0,7,4330
4,4,2,0,9,0,9,4330
5,5,3,0,12,0,12,4330
6,6,1,1,13,1,14,4330
7,7,2,0,15,1,16,4330
8,8,4,0,19,1,20,4330
9,9,4,1,23,2,25,4330
10,10,1,2,24,4,28,4330
11,11,2,3,26,7,33,4330
12,12,5,3,31,10,41,4330
13,13,7,4,38,14,52,4330
14,14,4,3,42,17,59,4330
15,15,2,6,44,23,67,4330
16,16,3,5,47,28,75,4330
17,17,3,2,50,30,80,4330
18,18,4,1,54,31,85,4330
19,19,0,1,54,32,86,4330
20,20,0,2,54,34,88,4330
21,21,1,2,55,36,91,4330
22,22,0,0,55,36,91,4330
0,0,1,0,1,0,1,4331
1,1,1,0,2,0,2,4331
2,2,0,0,2,0,2,4331
0,0,1,0,1,0,1,4332
1,1,2,0,3,0,3,4332
2,2,2,1,5,1,6,4332
3,3,2,0,7,1,8,4332
4,4,2,0,9,1,10,4332
5,5,2,0,11,1,12,4332
6,6,1,2,12,3,15,4332
7,7,3,1,15,4,19,4332
8,8,1,1,16,5,21,4332
9,9,1,0,17,5,22,4332
10,10,1,0,18,5,23,4332
11,11,2,0,20,5,25,4332
12,12,1,0,21,5,26,4332
13,13,1,0,22,5,27,4332
14,14,0,0,22,5,27,4332
0,0,1,0,1,0,1,4333
1,1,1,0,2,0,2,4333
2,2,1,0,3,0,3,4333
3,3,0,0,3,0,3,4333
0,0,1,0,1,0,1,4334
1,1,2,0,3,0,3,4334
2,2,2,0,5,0,5,4334
3,3,4,1,9,1,10,4334
4,4,2,2,11,3,14,4334
5,5,3,1,14,4,18,4334
6,6,2,1,16,5,21,4334
7,7,2,3,18,8,26,4334
8,8,2,3,20,11,31,4334
9,9,2,1,22,12,34,4334
10,10,3,1,25,13,38,4334
11,11,2,2,27,15,42,4334
12,12,3,2,30,17,47,4334
13,13,3,2,33,19,52,4334
14,14,4,3,37,22,59,4334
15,15,6,2,43,24,67,4334
16,16,5,0,48,24,72,4334
17,17,2,0,50,24,74,4334
18,18,1,0,51,24,75,4334
19,19,0,0,51,24,75,4334
0,0,1,0,1,0,1,4335
1,1,0,0,1,0,1,4335
0,0,1,0,1,0,1,4336
1,1,1,1,2,1,3,4336
2,2,0,1,2,2,4,4336
3,3,0,1,2,3,5,4336
4,4,1,0,3,3,6,4336
5,5,2,1,5,4,9,4336
6,6,0,1,5,5,10,4336
7,7,0,0,5,5,10,4336
0,0,1,0,1,0,1,4337
1,1,0,0,1,0,1,4337
0,0,1,0,1,0,1,4338
1,1,0,0,1,0,1,4338
0,0,1,0,1,0,1,4339
1,1,1,1,2,1,3,4339
2,2,1,1,3,2,5,4339
3,3,2,0,5,2,7,4339
4,4,0,0,5,2,7,4339
0,0,1,0,1,0,1,4340
1,1,0,0,1,0,1,4340
0,0,1,0,1,0,1,4341
1,1,0,0,1,0,1,4341
0,0,1,0,1,0,1,4342
1,1,1,0,2,0,2,4342
2,2,1,0,3,0,3,4342
3,3,1,0,4,0,4,4342
4,4,0,0,4,0,4,4342
0,0,1,0,1,0,1,4343
1,1,1,0,2,0,2,4343
2,2,1,0,3,0,3,4343
3,3,1,0,4,0,4,4343
4,4,2,0,6,0,6,4343
5,5,3,1,9,1,10,4343
6,6,0,1,9,2,11,4343
7,7,0,0,9,2,11,4343
0,0,1,0,1,0,1,4344
1,1,1,0,2,0,2,4344
2,2,1,0,3,0,3,4344
3,3,0,0,3,0,3,4344
0,0,1,0,1,0,1,4345
1,1,0,1,1,1,2,4345
2,2,0,0,1,1,2,4345
0,0,1,0,1,0,1,4346
1,1,0,1,1,1,2,4346
2,2,0,1,1,2,3,4346
3,3,0,1,1,3,4,4346
4,4,0,1,1,4,5,4346
5,5,0,0,1,4,5,4346
0,0,1,0,1,0,1,4347
1,1,2,0,3,0,3,4347
2,2,1,0,4,0,4,4347
3,3,0,2,4,2,6,4347
4,4,0,0,4,2,6,4347
0,0,1,0,1,0,1,4348
1,1,1,0,2,0,2,4348
2,2,0,0,2,0,2,4348
0,0,1,0,1,0,1,4349
1,1,1,0,2,0,2,4349
2,2,2,1,4,1,5,4349
3,3,0,2,4,3,7,4349
4,4,0,0,4,3,7,4349
0,0,1,0,1,0,1,4350
1,1,2,0,3,0,3,4350
2,2,1,0,4,0,4,4350
3,3,1,0,5,0,5,4350
4,4,3,0,8,0,8,4350
5,5,1,0,9,0,9,4350
6,6,2,0,11,0,11,4350
7,7,2,1,13,1,14,4350
8,8,2,3,15,4,19,4350
9,9,2,1,17,5,22,4350
10,10,3,0,20,5,25,4350
11,11,3,2,23,7,30,4350
12,12,5,2,28,9,37,4350
13,13,5,3,33,12,45,4350
14,14,4,3,37,15,52,4350
15,15,1,7,38,22,60,4350
16,16,1,7,39,29,68,4350
17,17,2,5,41,34,75,4350
18,18,0,5,41,39,80,4350
19,19,1,5,42,44,86,4350
20,20,0,3,42,47,89,4350
21,21,0,0,42,47,89,4350
0,0,1,0,1,0,1,4351
1,1,1,0,2,0,2,4351
2,2,2,0,4,0,4,4351
3,3,2,0,6,0,6,4351
4,4,1,2,7,2,9,4351
5,5,1,3,8,5,13,4351
6,6,0,0,8,5,13,4351
0,0,1,0,1,0,1,4352
1,1,1,1,2,1,3,4352
2,2,1,1,3,2,5,4352
3,3,2,1,5,3,8,4352
4,4,2,0,7,3,10,4352
5,5,0,0,7,3,10,4352
0,0,1,0,1,0,1,4353
1,1,2,0,3,0,3,4353
2,2,1,0,4,0,4,4353
3,3,0,0,4,0,4,4353
0,0,1,0,1,0,1,4354
1,1,0,0,1,0,1,4354
0,0,1,0,1,0,1,4355
1,1,0,0,1,0,1,4355
0,0,1,0,1,0,1,4356
1,1,1,0,2,0,2,4356
2,2,0,1,2,1,3,4356
3,3,0,0,2,1,3,4356
0,0,1,0,1,0,1,4357
1,1,1,0,2,0,2,4357
2,2,0,0,2,0,2,4357
0,0,1,0,1,0,1,4358
1,1,0,0,1,0,1,4358
0,0,1,0,1,0,1,4359
1,1,1,0,2,0,2,4359
2,2,2,0,4,0,4,4359
3,3,3,2,7,2,9,4359
4,4,7,2,14,4,18,4359
5,5,8,5,22,9,31,4359
6,6,7,6,29,15,44,4359
7,7,6,3,35,18,53,4359
8,8,5,4,40,22,62,4359
9,9,5,6,45,28,73,4359
10,10,4,6,49,34,83,4359
11,11,2,5,51,39,90,4359
12,12,1,6,52,45,97,4359
13,13,3,5,55,50,105,4359
14,14,4,3,59,53,112,4359
15,15,4,4,63,57,120,4359
16,16,3,4,66,61,127,4359
17,17,1,2,67,63,130,4359
18,18,1,0,68,63,131,4359
19,19,4,0,72,63,135,4359
20,20,5,0,77,63,140,4359
21,21,3,0,80,63,143,4359
22,22,0,0,80,63,143,4359
0,0,1,0,1,0,1,4360
1,1,0,0,1,0,1,4360
0,0,1,0,1,0,1,4361
1,1,2,1,3,1,4,4361
2,2,5,0,8,1,9,4361
3,3,1,1,9,2,11,4361
4,4,1,1,10,3,13,4361
5,5,0,1,10,4,14,4361
6,6,0,0,10,4,14,4361
0,0,1,0,1,0,1,4362
1,1,0,1,1,1,2,4362
2,2,0,0,1,1,2,4362
0,0,1,0,1,0,1,4363
1,1,0,0,1,0,1,4363
0,0,1,0,1,0,1,4364
1,1,0,0,1,0,1,4364
0,0,1,0,1,0,1,4365
1,1,1,0,2,0,2,4365
2,2,0,0,2,0,2,4365
0,0,1,0,1,0,1,4366
1,1,0,0,1,0,1,4366
0,0,1,0,1,0,1,4367
1,1,0,1,1,1,2,4367
2,2,1,3,2,4,6,4367
3,3,3,1,5,5,10,4367
4,4,0,1,5,6,11,4367
5,5,0,1,5,7,12,4367
6,6,1,1,6,8,14,4367
7,7,1,0,7,8,15,4367
8,8,2,0,9,8,17,4367
9,9,1,0,10,8,18,4367
10,10,1,1,11,9,20,4367
11,11,1,2,12,11,23,4367
12,12,2,3,14,14,28,4367
13,13,4,2,18,16,34,4367
14,14,4,1,22,17,39,4367
15,15,5,0,27,17,44,4367
16,16,4,0,31,17,48,4367
17,17,0,1,31,18,49,4367
18,18,1,0,32,18,50,4367
19,19,1,0,33,18,51,4367
20,20,0,1,33,19,52,4367
21,21,0,2,33,21,54,4367
22,22,3,0,36,21,57,4367
23,23,2,2,38,23,61,4367
24,24,2,1,40,24,64,4367
25,25,0,1,40,25,65,4367
26,26,0,1,40,26,66,4367
27,27,0,0,40,26,66,4367
0,0,1,0,1,0,1,4368
1,1,1,1,2,1,3,4368
2,2,0,0,2,1,3,4368
0,0,1,0,1,0,1,4369
1,1,1,0,2,0,2,4369
2,2,1,0,3,0,3,4369
3,3,0,0,3,0,3,4369
0,0,1,0,1,0,1,4370
1,1,1,0,2,0,2,4370
2,2,1,0,3,0,3,4370
3,3,1,0,4,0,4,4370
4,4,1,0,5,0,5,4370
5,5,2,0,7,0,7,4370
6,6,0,0,7,0,7,4370
0,0,1,0,1,0,1,4371
1,1,0,0,1,0,1,4371
0,0,1,0,1,0,1,4372
1,1,0,0,1,0,1,4372
0,0,1,0,1,0,1,4373
1,1,0,0,1,0,1,4373
0,0,1,0,1,0,1,4374
1,1,1,0,2,0,2,4374
2,2,0,0,2,0,2,4374
0,0,1,0,1,0,1,4375
1,1,1,0,2,0,2,4375
2,2,0,0,2,0,2,4375
0,0,1,0,1,0,1,4376
1,1,0,0,1,0,1,4376
0,0,1,0,1,0,1,4377
1,1,3,0,4,0,4,4377
2,2,2,1,6,1,7,4377
3,3,0,1,6,2,8,4377
4,4,0,2,6,4,10,4377
5,5,0,2,6,6,12,4377
6,6,0,1,6,7,13,4377
7,7,1,1,7,8,15,4377
8,8,2,3,9,11,20,4377
9,9,3,5,12,16,28,4377
10,10,5,5,17,21,38,4377
11,11,6,5,23,26,49,4377
12,12,3,6,26,32,58,4377
13,13,4,3,30,35,65,4377
14,14,3,2,33,37,70,4377
15,15,1,0,34,37,71,4377
16,16,0,0,34,37,71,4377
0,0,1,0,1,0,1,4378
1,1,1,0,2,0,2,4378
2,2,1,2,3,2,5,4378
3,3,1,0,4,2,6,4378
4,4,0,0,4,2,6,4378
0,0,1,0,1,0,1,4379
1,1,0,0,1,0,1,4379
0,0,1,0,1,0,1,4380
1,1,0,0,1,0,1,4380
0,0,1,0,1,0,1,4381
1,1,1,1,2,1,3,4381
2,2,1,0,3,1,4,4381
3,3,0,2,3,3,6,4381
4,4,0,0,3,3,6,4381
0,0,1,0,1,0,1,4382
1,1,2,0,3,0,3,4382
2,2,4,1,7,1,8,4382
3,3,1,2,8,3,11,4382
4,4,0,4,8,7,15,4382
5,5,1,3,9,10,19,4382
6,6,2,4,11,14,25,4382
7,7,0,4,11,18,29,4382
8,8,2,2,13,20,33,4382
9,9,3,3,16,23,39,4382
10,10,3,3,19,26,45,4382
11,11,4,4,23,30,53,4382
12,12,1,5,24,35,59,4382
13,13,2,2,26,37,63,4382
14,14,0,4,26,41,67,4382
15,15,1,2,27,43,70,4382
16,16,1,0,28,43,71,4382
17,17,0,0,28,43,71,4382
0,0,1,0,1,0,1,4383
1,1,0,0,1,0,1,4383
0,0,1,0,1,0,1,4384
1,1,0,1,1,1,2,4384
2,2,0,0,1,1,2,4384
0,0,1,0,1,0,1,4385
1,1,1,0,2,0,2,4385
2,2,0,0,2,0,2,4385
0,0,1,0,1,0,1,4386
1,1,1,0,2,0,2,4386
2,2,0,0,2,0,2,4386
0,0,1,0,1,0,1,4387
1,1,1,0,2,0,2,4387
2,2,1,0,3,0,3,4387
3,3,2,2,5,2,7,4387
4,4,1,1,6,3,9,4387
5,5,2,1,8,4,12,4387
6,6,2,2,10,6,16,4387
7,7,1,0,11,6,17,4387
8,8,0,0,11,6,17,4387
0,0,1,0,1,0,1,4388
1,1,0,0,1,0,1,4388
0,0,1,0,1,0,1,4389
1,1,1,0,2,0,2,4389
2,2,1,0,3,0,3,4389
3,3,0,0,3,0,3,4389
0,0,1,0,1,0,1,4390
1,1,0,0,1,0,1,4390
0,0,1,0,1,0,1,4391
1,1,0,0,1,0,1,4391
0,0,1,0,1,0,1,4392
1,1,0,0,1,0,1,4392
0,0,1,0,1,0,1,4393
1,1,0,0,1,0,1,4393
0,0,1,0,1,0,1,4394
1,1,1,0,2,0,2,4394
2,2,1,0,3,0,3,4394
3,3,1,0,4,0,4,4394
4,4,2,0,6,0,6,4394
5,5,2,0,8,0,8,4394
6,6,1,0,9,0,9,4394
7,7,1,1,10,1,11,4394
8,8,0,3,10,4,14,4394
9,9,1,2,11,6,17,4394
10,10,2,0,13,6,19,4394
11,11,3,0,16,6,22,4394
12,12,3,2,19,8,27,4394
13,13,4,3,23,11,34,4394
14,14,4,4,27,15,42,4394
15,15,3,2,30,17,47,4394
16,16,2,0,32,17,49,4394
17,17,3,1,35,18,53,4394
18,18,1,0,36,18,54,4394
19,19,1,1,37,19,56,4394
20,20,2,2,39,21,60,4394
21,21,1,0,40,21,61,4394
22,22,2,1,42,22,64,4394
23,23,2,2,44,24,68,4394
24,24,1,1,45,25,70,4394
25,25,0,1,45,26,71,4394
26,26,0,0,45,26,71,4394
0,0,1,0,1,0,1,4395
1,1,0,1,1,1,2,4395
2,2,0,1,1,2,3,4395
3,3,0,2,1,4,5,4395
4,4,0,0,1,4,5,4395
0,0,1,0,1,0,1,4396
1,1,0,0,1,0,1,4396
0,0,1,0,1,0,1,4397
1,1,1,1,2,1,3,4397
2,2,1,2,3,3,6,4397
3,3,3,2,6,5,11,4397
4,4,4,2,10,7,17,4397
5,5,2,1,12,8,20,4397
6,6,3,1,15,9,24,4397
7,7,1,2,16,11,27,4397
8,8,3,1,19,12,31,4397
9,9,2,1,21,13,34,4397
10,10,2,1,23,14,37,4397
11,11,3,0,26,14,40,4397
12,12,3,0,29,14,43,4397
13,13,1,0,30,14,44,4397
14,14,1,0,31,14,45,4397
15,15,1,2,32,16,48,4397
16,16,0,0,32,16,48,4397
0,0,1,0,1,0,1,4398
1,1,3,0,4,0,4,4398
2,2,2,0,6,0,6,4398
3,3,1,0,7,0,7,4398
4,4,1,0,8,0,8,4398
5,5,0,0,8,0,8,4398
0,0,1,0,1,0,1,4399
1,1,0,0,1,0,1,4399
0,0,1,0,1,0,1,4400
1,1,0,1,1,1,2,4400
2,2,0,2,1,3,4,4400
3,3,0,3,1,6,7,4400
4,4,1,5,2,11,13,4400
5,5,1,7,3,18,21,4400
6,6,1,9,4,27,31,4400
7,7,1,6,5,33,38,4400
8,8,3,2,8,35,43,4400
9,9,4,2,12,37,49,4400
10,10,2,3,14,40,54,4400
11,11,2,3,16,43,59,4400
12,12,2,2,18,45,63,4400
13,13,0,0,18,45,63,4400
0,0,1,0,1,0,1,4401
1,1,0,0,1,0,1,4401
0,0,1,0,1,0,1,4402
1,1,1,0,2,0,2,4402
2,2,0,1,2,1,3,4402
3,3,0,0,2,1,3,4402
0,0,1,0,1,0,1,4403
1,1,0,1,1,1,2,4403
2,2,0,1,1,2,3,4403
3,3,0,1,1,3,4,4403
4,4,0,1,1,4,5,4403
5,5,0,0,1,4,5,4403
0,0,1,0,1,0,1,4404
1,1,2,0,3,0,3,4404
2,2,0,0,3,0,3,4404
0,0,1,0,1,0,1,4405
1,1,0,0,1,0,1,4405
0,0,1,0,1,0,1,4406
1,1,2,0,3,0,3,4406
2,2,0,0,3,0,3,4406
0,0,1,0,1,0,1,4407
1,1,1,0,2,0,2,4407
2,2,1,0,3,0,3,4407
3,3,1,0,4,0,4,4407
4,4,2,0,6,0,6,4407
5,5,2,1,8,1,9,4407
6,6,0,2,8,3,11,4407
7,7,1,2,9,5,14,4407
8,8,1,1,10,6,16,4407
9,9,1,0,11,6,17,4407
10,10,0,0,11,6,17,4407
0,0,1,0,1,0,1,4408
1,1,1,0,2,0,2,4408
2,2,0,0,2,0,2,4408
0,0,1,0,1,0,1,4409
1,1,0,0,1,0,1,4409
0,0,1,0,1,0,1,4410
1,1,2,0,3,0,3,4410
2,2,3,0,6,0,6,4410
3,3,3,1,9,1,10,4410
4,4,3,1,12,2,14,4410
5,5,1,3,13,5,18,4410
6,6,0,5,13,10,23,4410
7,7,1,2,14,12,26,4410
8,8,1,3,15,15,30,4410
9,9,1,9,16,24,40,4410
10,10,2,3,18,27,45,4410
11,11,0,2,18,29,47,4410
12,12,0,2,18,31,49,4410
13,13,0,0,18,31,49,4410
0,0,1,0,1,0,1,4411
1,1,0,0,1,0,1,4411
0,0,1,0,1,0,1,4412
1,1,1,0,2,0,2,4412
2,2,0,0,2,0,2,4412
0,0,1,0,1,0,1,4413
1,1,1,0,2,0,2,4413
2,2,0,0,2,0,2,4413
0,0,1,0,1,0,1,4414
1,1,0,1,1,1,2,4414
2,2,0,0,1,1,2,4414
0,0,1,0,1,0,1,4415
1,1,1,0,2,0,2,4415
2,2,1,0,3,0,3,4415
3,3,1,1,4,1,5,4415
4,4,0,0,4,1,5,4415
0,0,1,0,1,0,1,4416
1,1,0,0,1,0,1,4416
0,0,1,0,1,0,1,4417
1,1,0,0,1,0,1,4417
0,0,1,0,1,0,1,4418
1,1,3,0,4,0,4,4418
2,2,1,0,5,0,5,4418
3,3,0,0,5,0,5,4418
0,0,1,0,1,0,1,4419
1,1,2,0,3,0,3,4419
2,2,0,0,3,0,3,4419
0,0,1,0,1,0,1,4420
1,1,1,0,2,0,2,4420
2,2,0,0,2,0,2,4420
0,0,1,0,1,0,1,4421
1,1,0,0,1,0,1,4421
0,0,1,0,1,0,1,4422
1,1,0,1,1,1,2,4422
2,2,0,2,1,3,4,4422
3,3,0,0,1,3,4,4422
0,0,1,0,1,0,1,4423
1,1,0,0,1,0,1,4423
0,0,1,0,1,0,1,4424
1,1,1,0,2,0,2,4424
2,2,3,0,5,0,5,4424
3,3,3,1,8,1,9,4424
4,4,0,3,8,4,12,4424
5,5,0,2,8,6,14,4424
6,6,1,2,9,8,17,4424
7,7,0,3,9,11,20,4424
8,8,0,1,9,12,21,4424
9,9,0,1,9,13,22,4424
10,10,0,0,9,13,22,4424
0,0,1,0,1,0,1,4425
1,1,1,0,2,0,2,4425
2,2,0,0,2,0,2,4425
0,0,1,0,1,0,1,4426
1,1,0,1,1,1,2,4426
2,2,0,2,1,3,4,4426
3,3,0,1,1,4,5,4426
4,4,0,1,1,5,6,4426
5,5,0,1,1,6,7,4426
6,6,0,0,1,6,7,4426
0,0,1,0,1,0,1,4427
1,1,0,2,1,2,3,4427
2,2,1,2,2,4,6,4427
3,3,1,2,3,6,9,4427
4,4,1,1,4,7,11,4427
5,5,3,0,7,7,14,4427
6,6,1,0,8,7,15,4427
7,7,2,1,10,8,18,4427
8,8,2,2,12,10,22,4427
9,9,1,1,13,11,24,4427
10,10,2,1,15,12,27,4427
11,11,2,2,17,14,31,4427
12,12,1,1,18,15,33,4427
13,13,0,0,18,15,33,4427
0,0,1,0,1,0,1,4428
1,1,1,0,2,0,2,4428
2,2,1,0,3,0,3,4428
3,3,0,0,3,0,3,4428
0,0,1,0,1,0,1,4429
1,1,2,0,3,0,3,4429
2,2,0,0,3,0,3,4429
0,0,1,0,1,0,1,4430
1,1,0,0,1,0,1,4430
0,0,1,0,1,0,1,4431
1,1,1,0,2,0,2,4431
2,2,0,0,2,0,2,4431
0,0,1,0,1,0,1,4432
1,1,0,0,1,0,1,4432
0,0,1,0,1,0,1,4433
1,1,0,0,1,0,1,4433
0,0,1,0,1,0,1,4434
1,1,1,0,2,0,2,4434
2,2,2,0,4,0,4,4434
3,3,2,0,6,0,6,4434
4,4,3,0,9,0,9,4434
5,5,1,0,10,0,10,4434
6,6,1,0,11,0,11,4434
7,7,1,1,12,1,13,4434
8,8,0,2,12,3,15,4434
9,9,0,0,12,3,15,4434
0,0,1,0,1,0,1,4435
1,1,0,0,1,0,1,4435
0,0,1,0,1,0,1,4436
1,1,0,0,1,0,1,4436
0,0,1,0,1,0,1,4437
1,1,0,1,1,1,2,4437
2,2,0,0,1,1,2,4437
0,0,1,0,1,0,1,4438
1,1,0,0,1,0,1,4438
0,0,1,0,1,0,1,4439
1,1,1,0,2,0,2,4439
2,2,0,0,2,0,2,4439
0,0,1,0,1,0,1,4440
1,1,0,1,1,1,2,4440
2,2,1,3,2,4,6,4440
3,3,1,3,3,7,10,4440
4,4,0,5,3,12,15,4440
5,5,0,3,3,15,18,4440
6,6,0,2,3,17,20,4440
7,7,0,2,3,19,22,4440
8,8,1,4,4,23,27,4440
9,9,0,4,4,27,31,4440
10,10,1,0,5,27,32,4440
11,11,0,1,5,28,33,4440
12,12,0,3,5,31,36,4440
13,13,0,3,5,34,39,4440
14,14,1,2,6,36,42,4440
15,15,1,2,7,38,45,4440
16,16,1,0,8,38,46,4440
17,17,0,0,8,38,46,4440
0,0,1,0,1,0,1,4441
1,1,0,0,1,0,1,4441
0,0,1,0,1,0,1,4442
1,1,1,0,2,0,2,4442
2,2,0,0,2,0,2,4442
0,0,1,0,1,0,1,4443
1,1,0,0,1,0,1,4443
0,0,1,0,1,0,1,4444
1,1,2,1,3,1,4,4444
2,2,2,1,5,2,7,4444
3,3,0,2,5,4,9,4444
4,4,0,0,5,4,9,4444
0,0,1,0,1,0,1,4445
1,1,2,0,3,0,3,4445
2,2,1,1,4,1,5,4445
3,3,1,2,5,3,8,4445
4,4,0,3,5,6,11,4445
5,5,0,2,5,8,13,4445
6,6,0,1,5,9,14,4445
7,7,0,0,5,9,14,4445
0,0,1,0,1,0,1,4446
1,1,1,0,2,0,2,4446
2,2,1,0,3,0,3,4446
3,3,2,1,5,1,6,4446
4,4,2,0,7,1,8,4446
5,5,1,0,8,1,9,4446
6,6,0,0,8,1,9,4446
0,0,1,0,1,0,1,4447
1,1,3,0,4,0,4,4447
2,2,2,0,6,0,6,4447
3,3,1,0,7,0,7,4447
4,4,0,0,7,0,7,4447
0,0,1,0,1,0,1,4448
1,1,1,0,2,0,2,4448
2,2,0,0,2,0,2,4448
0,0,1,0,1,0,1,4449
1,1,2,0,3,0,3,4449
2,2,1,0,4,0,4,4449
3,3,1,0,5,0,5,4449
4,4,1,0,6,0,6,4449
5,5,1,0,7,0,7,4449
6,6,0,0,7,0,7,4449
0,0,1,0,1,0,1,4450
1,1,1,0,2,0,2,4450
2,2,1,1,3,1,4,4450
3,3,1,3,4,4,8,4450
4,4,1,3,5,7,12,4450
5,5,1,3,6,10,16,4450
6,6,0,3,6,13,19,4450
7,7,0,4,6,17,23,4450
8,8,1,2,7,19,26,4450
9,9,0,3,7,22,29,4450
10,10,1,3,8,25,33,4450
11,11,3,2,11,27,38,4450
12,12,2,1,13,28,41,4450
13,13,4,0,17,28,45,4450
14,14,5,0,22,28,50,4450
15,15,6,3,28,31,59,4450
16,16,2,4,30,35,65,4450
17,17,0,5,30,40,70,4450
18,18,0,2,30,42,72,4450
19,19,0,1,30,43,73,4450
20,20,0,0,30,43,73,4450
0,0,1,0,1,0,1,4451
1,1,0,0,1,0,1,4451
0,0,1,0,1,0,1,4452
1,1,1,0,2,0,2,4452
2,2,2,0,4,0,4,4452
3,3,0,0,4,0,4,4452
0,0,1,0,1,0,1,4453
1,1,2,0,3,0,3,4453
2,2,0,0,3,0,3,4453
0,0,1,0,1,0,1,4454
1,1,2,0,3,0,3,4454
2,2,1,0,4,0,4,4454
3,3,0,1,4,1,5,4454
4,4,0,0,4,1,5,4454
0,0,1,0,1,0,1,4455
1,1,0,0,1,0,1,4455
0,0,1,0,1,0,1,4456
1,1,1,0,2,0,2,4456
2,2,1,0,3,0,3,4456
3,3,2,2,5,2,7,4456
4,4,2,0,7,2,9,4456
5,5,2,0,9,2,11,4456
6,6,0,1,9,3,12,4456
7,7,0,0,9,3,12,4456
0,0,1,0,1,0,1,4457
1,1,1,0,2,0,2,4457
2,2,0,0,2,0,2,4457
0,0,1,0,1,0,1,4458
1,1,0,0,1,0,1,4458
0,0,1,0,1,0,1,4459
1,1,1,0,2,0,2,4459
2,2,0,0,2,0,2,4459
0,0,1,0,1,0,1,4460
1,1,0,0,1,0,1,4460
0,0,1,0,1,0,1,4461
1,1,1,1,2,1,3,4461
2,2,0,1,2,2,4,4461
3,3,0,1,2,3,5,4461
4,4,0,0,2,3,5,4461
0,0,1,0,1,0,1,4462
1,1,0,1,1,1,2,4462
2,2,0,2,1,3,4,4462
3,3,0,1,1,4,5,4462
4,4,1,2,2,6,8,4462
5,5,1,4,3,10,13,4462
6,6,1,1,4,11,15,4462
7,7,0,2,4,13,17,4462
8,8,0,0,4,13,17,4462
0,0,1,0,1,0,1,4463
1,1,3,0,4,0,4,4463
2,2,5,0,9,0,9,4463
3,3,3,0,12,0,12,4463
4,4,2,0,14,0,14,4463
5,5,4,0,18,0,18,4463
6,6,5,0,23,0,23,4463
7,7,5,0,28,0,28,4463
8,8,3,0,31,0,31,4463
9,9,1,1,32,1,33,4463
10,10,0,0,32,1,33,4463
0,0,1,0,1,0,1,4464
1,1,1,0,2,0,2,4464
2,2,1,1,3,1,4,4464
3,3,1,1,4,2,6,4464
4,4,1,1,5,3,8,4464
5,5,0,0,5,3,8,4464
0,0,1,0,1,0,1,4465
1,1,0,1,1,1,2,4465
2,2,0,1,1,2,3,4465
3,3,0,1,1,3,4,4465
4,4,0,3,1,6,7,4465
5,5,0,3,1,9,10,4465
6,6,0,2,1,11,12,4465
7,7,1,1,2,12,14,4465
8,8,1,1,3,13,16,4465
9,9,1,1,4,14,18,4465
10,10,0,0,4,14,18,4465
0,0,1,0,1,0,1,4466
1,1,1,0,2,0,2,4466
2,2,1,0,3,0,3,4466
3,3,0,0,3,0,3,4466
0,0,1,0,1,0,1,4467
1,1,0,0,1,0,1,4467
0,0,1,0,1,0,1,4468
1,1,2,0,3,0,3,4468
2,2,1,1,4,1,5,4468
3,3,0,1,4,2,6,4468
4,4,0,0,4,2,6,4468
0,0,1,0,1,0,1,4469
1,1,0,0,1,0,1,4469
0,0,1,0,1,0,1,4470
1,1,1,0,2,0,2,4470
2,2,0,0,2,0,2,4470
0,0,1,0,1,0,1,4471
1,1,0,0,1,0,1,4471
0,0,1,0,1,0,1,4472
1,1,0,0,1,0,1,4472
0,0,1,0,1,0,1,4473
1,1,0,0,1,0,1,4473
0,0,1,0,1,0,1,4474
1,1,0,0,1,0,1,4474
0,0,1,0,1,0,1,4475
1,1,0,0,1,0,1,4475
0,0,1,0,1,0,1,4476
1,1,2,0,3,0,3,4476
2,2,0,1,3,1,4,4476
3,3,0,0,3,1,4,4476
0,0,1,0,1,0,1,4477
1,1,0,0,1,0,1,4477
0,0,1,0,1,0,1,4478
1,1,1,0,2,0,2,4478
2,2,1,0,3,0,3,4478
3,3,0,0,3,0,3,4478
0,0,1,0,1,0,1,4479
1,1,0,0,1,0,1,4479
0,0,1,0,1,0,1,4480
1,1,0,0,1,0,1,4480
0,0,1,0,1,0,1,4481
1,1,2,0,3,0,3,4481
2,2,2,0,5,0,5,4481
3,3,0,0,5,0,5,4481
0,0,1,0,1,0,1,4482
1,1,1,0,2,0,2,4482
2,2,1,0,3,0,3,4482
3,3,0,0,3,0,3,4482
0,0,1,0,1,0,1,4483
1,1,0,0,1,0,1,4483
0,0,1,0,1,0,1,4484
1,1,1,0,2,0,2,4484
2,2,1,0,3,0,3,4484
3,3,1,0,4,0,4,4484
4,4,0,0,4,0,4,4484
0,0,1,0,1,0,1,4485
1,1,0,0,1,0,1,4485
0,0,1,0,1,0,1,4486
1,1,2,0,3,0,3,4486
2,2,1,0,4,0,4,4486
3,3,0,0,4,0,4,4486
0,0,1,0,1,0,1,4487
1,1,0,0,1,0,1,4487
0,0,1,0,1,0,1,4488
1,1,0,0,1,0,1,4488
0,0,1,0,1,0,1,4489
1,1,0,0,1,0,1,4489
0,0,1,0,1,0,1,4490
1,1,0,0,1,0,1,4490
0,0,1,0,1,0,1,4491
1,1,0,0,1,0,1,4491
0,0,1,0,1,0,1,4492
1,1,1,0,2,0,2,4492
2,2,1,0,3,0,3,4492
3,3,1,0,4,0,4,4492
4,4,2,0,6,0,6,4492
5,5,1,0,7,0,7,4492
6,6,1,0,8,0,8,4492
7,7,1,0,9,0,9,4492
8,8,2,1,11,1,12,4492
9,9,1,0,12,1,13,4492
10,10,2,0,14,1,15,4492
11,11,5,0,19,1,20,4492
12,12,3,0,22,1,23,4492
13,13,0,1,22,2,24,4492
14,14,0,0,22,2,24,4492
0,0,1,0,1,0,1,4493
1,1,2,1,3,1,4,4493
2,2,2,1,5,2,7,4493
3,3,2,0,7,2,9,4493
4,4,1,0,8,2,10,4493
5,5,2,0,10,2,12,4493
6,6,2,0,12,2,14,4493
7,7,3,0,15,2,17,4493
8,8,2,0,17,2,19,4493
9,9,2,0,19,2,21,4493
10,10,0,0,19,2,21,4493
0,0,1,0,1,0,1,4494
1,1,0,1,1,1,2,4494
2,2,0,1,1,2,3,4494
3,3,1,1,2,3,5,4494
4,4,0,1,2,4,6,4494
5,5,0,2,2,6,8,4494
6,6,0,2,2,8,10,4494
7,7,1,4,3,12,15,4494
8,8,0,5,3,17,20,4494
9,9,1,1,4,18,22,4494
10,10,0,0,4,18,22,4494
0,0,1,0,1,0,1,4495
1,1,1,0,2,0,2,4495
2,2,1,0,3,0,3,4495
3,3,0,0,3,0,3,4495
0,0,1,0,1,0,1,4496
1,1,0,0,1,0,1,4496
0,0,1,0,1,0,1,4497
1,1,0,0,1,0,1,4497
0,0,1,0,1,0,1,4498
1,1,1,0,2,0,2,4498
2,2,0,0,2,0,2,4498
0,0,1,0,1,0,1,4499
1,1,0,1,1,1,2,4499
2,2,1,0,2,1,3,4499
3,3,0,0,2,1,3,4499
0,0,1,0,1,0,1,4500
1,1,0,0,1,0,1,4500
0,0,1,0,1,0,1,4501
1,1,1,0,2,0,2,4501
2,2,1,0,3,0,3,4501
3,3,0,0,3,0,3,4501
0,0,1,0,1,0,1,4502
1,1,1,0,2,0,2,4502
2,2,0,0,2,0,2,4502
0,0,1,0,1,0,1,4503
1,1,1,0,2,0,2,4503
2,2,1,1,3,1,4,4503
3,3,2,1,5,2,7,4503
4,4,3,1,8,3,11,4503
5,5,3,3,11,6,17,4503
6,6,3,2,14,8,22,4503
7,7,3,2,17,10,27,4503
8,8,0,2,17,12,29,4503
9,9,2,1,19,13,32,4503
10,10,0,1,19,14,33,4503
11,11,0,0,19,14,33,4503
0,0,1,0,1,0,1,4504
1,1,0,0,1,0,1,4504
0,0,1,0,1,0,1,4505
1,1,0,0,1,0,1,4505
0,0,1,0,1,0,1,4506
1,1,1,0,2,0,2,4506
2,2,1,0,3,0,3,4506
3,3,2,0,5,0,5,4506
4,4,1,0,6,0,6,4506
5,5,0,0,6,0,6,4506
0,0,1,0,1,0,1,4507
1,1,0,0,1,0,1,4507
0,0,1,0,1,0,1,4508
1,1,1,0,2,0,2,4508
2,2,1,0,3,0,3,4508
3,3,3,0,6,0,6,4508
4,4,2,0,8,0,8,4508
5,5,1,1,9,1,10,4508
6,6,0,0,9,1,10,4508
0,0,1,0,1,0,1,4509
1,1,1,1,2,1,3,4509
2,2,1,1,3,2,5,4509
3,3,2,1,5,3,8,4509
4,4,1,2,6,5,11,4509
5,5,1,1,7,6,13,4509
6,6,0,1,7,7,14,4509
7,7,0,0,7,7,14,4509
0,0,1,0,1,0,1,4510
1,1,1,0,2,0,2,4510
2,2,0,0,2,0,2,4510
0,0,1,0,1,0,1,4511
1,1,0,0,1,0,1,4511
0,0,1,0,1,0,1,4512
1,1,1,0,2,0,2,4512
2,2,2,1,4,1,5,4512
3,3,2,0,6,1,7,4512
4,4,0,0,6,1,7,4512
0,0,1,0,1,0,1,4513
1,1,3,0,4,0,4,4513
2,2,3,1,7,1,8,4513
3,3,4,1,11,2,13,4513
4,4,5,0,16,2,18,4513
5,5,4,0,20,2,22,4513
6,6,4,0,24,2,26,4513
7,7,3,0,27,2,29,4513
8,8,5,1,32,3,35,4513
9,9,4,2,36,5,41,4513
10,10,2,2,38,7,45,4513
11,11,2,4,40,11,51,4513
12,12,3,1,43,12,55,4513
13,13,5,1,48,13,61,4513
14,14,7,3,55,16,71,4513
15,15,4,2,59,18,77,4513
16,16,5,2,64,20,84,4513
17,17,4,0,68,20,88,4513
18,18,4,0,72,20,92,4513
19,19,4,0,76,20,96,4513
20,20,6,0,82,20,102,4513
21,21,5,2,87,22,109,4513
22,22,6,0,93,22,115,4513
23,23,4,0,97,22,119,4513
24,24,5,1,102,23,125,4513
25,25,2,0,104,23,127,4513
26,26,0,0,104,23,127,4513
0,0,1,0,1,0,1,4514
1,1,0,0,1,0,1,4514
0,0,1,0,1,0,1,4515
1,1,3,0,4,0,4,4515
2,2,2,2,6,2,8,4515
3,3,0,1,6,3,9,4515
4,4,0,3,6,6,12,4515
5,5,0,1,6,7,13,4515
6,6,0,0,6,7,13,4515
0,0,1,0,1,0,1,4516
1,1,1,0,2,0,2,4516
2,2,0,0,2,0,2,4516
0,0,1,0,1,0,1,4517
1,1,1,0,2,0,2,4517
2,2,0,0,2,0,2,4517
0,0,1,0,1,0,1,4518
1,1,1,0,2,0,2,4518
2,2,2,0,4,0,4,4518
3,3,1,0,5,0,5,4518
4,4,1,0,6,0,6,4518
5,5,0,1,6,1,7,4518
6,6,0,0,6,1,7,4518
0,0,1,0,1,0,1,4519
1,1,1,0,2,0,2,4519
2,2,1,0,3,0,3,4519
3,3,0,1,3,1,4,4519
4,4,0,0,3,1,4,4519
0,0,1,0,1,0,1,4520
1,1,0,0,1,0,1,4520
0,0,1,0,1,0,1,4521
1,1,0,0,1,0,1,4521
0,0,1,0,1,0,1,4522
1,1,0,0,1,0,1,4522
0,0,1,0,1,0,1,4523
1,1,2,1,3,1,4,4523
2,2,1,0,4,1,5,4523
3,3,1,0,5,1,6,4523
4,4,0,0,5,1,6,4523
0,0,1,0,1,0,1,4524
1,1,1,0,2,0,2,4524
2,2,0,0,2,0,2,4524
0,0,1,0,1,0,1,4525
1,1,2,0,3,0,3,4525
2,2,2,0,5,0,5,4525
3,3,4,0,9,0,9,4525
4,4,0,1,9,1,10,4525
5,5,0,1,9,2,11,4525
6,6,2,0,11,2,13,4525
7,7,1,0,12,2,14,4525
8,8,1,0,13,2,15,4525
9,9,1,0,14,2,16,4525
10,10,1,0,15,2,17,4525
11,11,1,1,16,3,19,4525
12,12,1,0,17,3,20,4525
13,13,0,0,17,3,20,4525
0,0,1,0,1,0,1,4526
1,1,1,0,2,0,2,4526
2,2,0,0,2,0,2,4526
0,0,1,0,1,0,1,4527
1,1,2,0,3,0,3,4527
2,2,3,1,6,1,7,4527
3,3,1,1,7,2,9,4527
4,4,2,2,9,4,13,4527
5,5,0,2,9,6,15,4527
6,6,1,1,10,7,17,4527
7,7,4,1,14,8,22,4527
8,8,1,1,15,9,24,4527
9,9,1,1,16,10,26,4527
10,10,0,0,16,10,26,4527
0,0,1,0,1,0,1,4528
1,1,0,0,1,0,1,4528
0,0,1,0,1,0,1,4529
1,1,1,1,2,1,3,4529
2,2,0,0,2,1,3,4529
0,0,1,0,1,0,1,4530
1,1,0,1,1,1,2,4530
2,2,0,0,1,1,2,4530
0,0,1,0,1,0,1,4531
1,1,0,0,1,0,1,4531
0,0,1,0,1,0,1,4532
1,1,0,0,1,0,1,4532
0,0,1,0,1,0,1,4533
1,1,1,0,2,0,2,4533
2,2,2,0,4,0,4,4533
3,3,0,1,4,1,5,4533
4,4,0,2,4,3,7,4533
5,5,0,2,4,5,9,4533
6,6,0,1,4,6,10,4533
7,7,1,0,5,6,11,4533
8,8,2,0,7,6,13,4533
9,9,3,1,10,7,17,4533
10,10,4,3,14,10,24,4533
11,11,4,2,18,12,30,4533
12,12,3,3,21,15,36,4533
13,13,2,2,23,17,40,4533
14,14,1,2,24,19,43,4533
15,15,1,0,25,19,44,4533
16,16,1,1,26,20,46,4533
17,17,0,1,26,21,47,4533
18,18,0,0,26,21,47,4533
0,0,1,0,1,0,1,4534
1,1,0,0,1,0,1,4534
0,0,1,0,1,0,1,4535
1,1,4,1,5,1,6,4535
2,2,4,4,9,5,14,4535
3,3,3,4,12,9,21,4535
4,4,2,8,14,17,31,4535
5,5,4,4,18,21,39,4535
6,6,9,5,27,26,53,4535
7,7,5,4,32,30,62,4535
8,8,5,2,37,32,69,4535
9,9,2,2,39,34,73,4535
10,10,0,2,39,36,75,4535
11,11,0,1,39,37,76,4535
12,12,0,0,39,37,76,4535
0,0,1,0,1,0,1,4536
1,1,2,0,3,0,3,4536
2,2,0,0,3,0,3,4536
0,0,1,0,1,0,1,4537
1,1,1,0,2,0,2,4537
2,2,1,0,3,0,3,4537
3,3,0,0,3,0,3,4537
0,0,1,0,1,0,1,4538
1,1,3,2,4,2,6,4538
2,2,2,1,6,3,9,4538
3,3,2,2,8,5,13,4538
4,4,0,0,8,5,13,4538
0,0,1,0,1,0,1,4539
1,1,0,0,1,0,1,4539
0,0,1,0,1,0,1,4540
1,1,0,0,1,0,1,4540
0,0,1,0,1,0,1,4541
1,1,0,0,1,0,1,4541
0,0,1,0,1,0,1,4542
1,1,0,1,1,1,2,4542
2,2,0,0,1,1,2,4542
0,0,1,0,1,0,1,4543
1,1,1,0,2,0,2,4543
2,2,1,0,3,0,3,4543
3,3,2,1,5,1,6,4543
4,4,2,2,7,3,10,4543
5,5,2,0,9,3,12,4543
6,6,0,0,9,3,12,4543
0,0,1,0,1,0,1,4544
1,1,2,0,3,0,3,4544
2,2,1,0,4,0,4,4544
3,3,1,0,5,0,5,4544
4,4,0,1,5,1,6,4544
5,5,0,2,5,3,8,4544
6,6,1,1,6,4,10,4544
7,7,2,0,8,4,12,4544
8,8,2,0,10,4,14,4544
9,9,1,0,11,4,15,4544
10,10,0,0,11,4,15,4544
0,0,1,0,1,0,1,4545
1,1,0,0,1,0,1,4545
0,0,1,0,1,0,1,4546
1,1,0,1,1,1,2,4546
2,2,0,0,1,1,2,4546
0,0,1,0,1,0,1,4547
1,1,0,0,1,0,1,4547
0,0,1,0,1,0,1,4548
1,1,0,1,1,1,2,4548
2,2,0,2,1,3,4,4548
3,3,0,2,1,5,6,4548
4,4,1,4,2,9,11,4548
5,5,2,5,4,14,18,4548
6,6,2,7,6,21,27,4548
7,7,5,4,11,25,36,4548
8,8,3,3,14,28,42,4548
9,9,5,5,19,33,52,4548
10,10,2,4,21,37,58,4548
11,11,1,4,22,41,63,4548
12,12,1,1,23,42,65,4548
13,13,1,3,24,45,69,4548
14,14,2,0,26,45,71,4548
15,15,0,1,26,46,72,4548
16,16,0,0,26,46,72,4548
0,0,1,0,1,0,1,4549
1,1,0,0,1,0,1,4549
0,0,1,0,1,0,1,4550
1,1,0,0,1,0,1,4550
0,0,1,0,1,0,1,4551
1,1,1,0,2,0,2,4551
2,2,1,0,3,0,3,4551
3,3,1,0,4,0,4,4551
4,4,1,0,5,0,5,4551
5,5,0,0,5,0,5,4551
0,0,1,0,1,0,1,4552
1,1,0,0,1,0,1,4552
0,0,1,0,1,0,1,4553
1,1,2,0,3,0,3,4553
2,2,0,0,3,0,3,4553
0,0,1,0,1,0,1,4554
1,1,1,0,2,0,2,4554
2,2,0,0,2,0,2,4554
0,0,1,0,1,0,1,4555
1,1,1,0,2,0,2,4555
2,2,2,0,4,0,4,4555
3,3,4,1,8,1,9,4555
4,4,2,0,10,1,11,4555
5,5,0,1,10,2,12,4555
6,6,0,2,10,4,14,4555
7,7,0,2,10,6,16,4555
8,8,0,1,10,7,17,4555
9,9,0,4,10,11,21,4555
10,10,0,4,10,15,25,4555
11,11,0,6,10,21,31,4555
12,12,3,3,13,24,37,4555
13,13,2,4,15,28,43,4555
14,14,4,2,19,30,49,4555
15,15,7,3,26,33,59,4555
16,16,4,3,30,36,66,4555
17,17,4,5,34,41,75,4555
18,18,1,5,35,46,81,4555
19,19,2,2,37,48,85,4555
20,20,1,3,38,51,89,4555
21,21,0,1,38,52,90,4555
22,22,0,0,38,52,90,4555
0,0,1,0,1,0,1,4556
1,1,1,0,2,0,2,4556
2,2,2,1,4,1,5,4556
3,3,1,1,5,2,7,4556
4,4,1,1,6,3,9,4556
5,5,2,0,8,3,11,4556
6,6,3,2,11,5,16,4556
7,7,2,1,13,6,19,4556
8,8,0,0,13,6,19,4556
0,0,1,0,1,0,1,4557
1,1,0,0,1,0,1,4557
0,0,1,0,1,0,1,4558
1,1,1,0,2,0,2,4558
2,2,0,0,2,0,2,4558
0,0,1,0,1,0,1,4559
1,1,1,0,2,0,2,4559
2,2,1,0,3,0,3,4559
3,3,0,0,3,0,3,4559
0,0,1,0,1,0,1,4560
1,1,0,0,1,0,1,4560
0,0,1,0,1,0,1,4561
1,1,3,0,4,0,4,4561
2,2,2,1,6,1,7,4561
3,3,1,0,7,1,8,4561
4,4,1,0,8,1,9,4561
5,5,0,0,8,1,9,4561
0,0,1,0,1,0,1,4562
1,1,0,0,1,0,1,4562
0,0,1,0,1,0,1,4563
1,1,2,0,3,0,3,4563
2,2,0,0,3,0,3,4563
0,0,1,0,1,0,1,4564
1,1,4,1,5,1,6,4564
2,2,4,1,9,2,11,4564
3,3,5,0,14,2,16,4564
4,4,6,1,20,3,23,4564
5,5,4,0,24,3,27,4564
6,6,1,0,25,3,28,4564
7,7,0,0,25,3,28,4564
0,0,1,0,1,0,1,4565
1,1,0,0,1,0,1,4565
0,0,1,0,1,0,1,4566
1,1,1,0,2,0,2,4566
2,2,0,0,2,0,2,4566
0,0,1,0,1,0,1,4567
1,1,1,1,2,1,3,4567
2,2,1,1,3,2,5,4567
3,3,0,1,3,3,6,4567
4,4,0,1,3,4,7,4567
5,5,0,0,3,4,7,4567
0,0,1,0,1,0,1,4568
1,1,0,0,1,0,1,4568
0,0,1,0,1,0,1,4569
1,1,0,0,1,0,1,4569
0,0,1,0,1,0,1,4570
1,1,0,0,1,0,1,4570
0,0,1,0,1,0,1,4571
1,1,0,0,1,0,1,4571
0,0,1,0,1,0,1,4572
1,1,1,0,2,0,2,4572
2,2,0,0,2,0,2,4572
0,0,1,0,1,0,1,4573
1,1,2,0,3,0,3,4573
2,2,1,0,4,0,4,4573
3,3,1,0,5,0,5,4573
4,4,2,0,7,0,7,4573
5,5,1,0,8,0,8,4573
6,6,2,1,10,1,11,4573
7,7,4,1,14,2,16,4573
8,8,1,0,15,2,17,4573
9,9,0,0,15,2,17,4573
0,0,1,0,1,0,1,4574
1,1,1,0,2,0,2,4574
2,2,1,0,3,0,3,4574
3,3,2,0,5,0,5,4574
4,4,0,0,5,0,5,4574
0,0,1,0,1,0,1,4575
1,1,2,0,3,0,3,4575
2,2,1,0,4,0,4,4575
3,3,0,0,4,0,4,4575
0,0,1,0,1,0,1,4576
1,1,1,0,2,0,2,4576
2,2,3,0,5,0,5,4576
3,3,2,1,7,1,8,4576
4,4,1,3,8,4,12,4576
5,5,1,2,9,6,15,4576
6,6,0,0,9,6,15,4576
0,0,1,0,1,0,1,4577
1,1,1,1,2,1,3,4577
2,2,2,1,4,2,6,4577
3,3,2,0,6,2,8,4577
4,4,3,0,9,2,11,4577
5,5,1,0,10,2,12,4577
6,6,1,0,11,2,13,4577
7,7,0,0,11,2,13,4577
0,0,1,0,1,0,1,4578
1,1,0,0,1,0,1,4578
0,0,1,0,1,0,1,4579
1,1,0,0,1,0,1,4579
0,0,1,0,1,0,1,4580
1,1,1,1,2,1,3,4580
2,2,1,2,3,3,6,4580
3,3,0,1,3,4,7,4580
4,4,0,1,3,5,8,4580
5,5,0,0,3,5,8,4580
0,0,1,0,1,0,1,4581
1,1,2,0,3,0,3,4581
2,2,1,1,4,1,5,4581
3,3,1,1,5,2,7,4581
4,4,0,1,5,3,8,4581
5,5,0,1,5,4,9,4581
6,6,0,0,5,4,9,4581
0,0,1,0,1,0,1,4582
1,1,0,0,1,0,1,4582
0,0,1,0,1,0,1,4583
1,1,0,0,1,0,1,4583
0,0,1,0,1,0,1,4584
1,1,0,0,1,0,1,4584
0,0,1,0,1,0,1,4585
1,1,0,0,1,0,1,4585
0,0,1,0,1,0,1,4586
1,1,0,0,1,0,1,4586
0,0,1,0,1,0,1,4587
1,1,0,0,1,0,1,4587
0,0,1,0,1,0,1,4588
1,1,0,0,1,0,1,4588
0,0,1,0,1,0,1,4589
1,1,0,0,1,0,1,4589
0,0,1,0,1,0,1,4590
1,1,0,1,1,1,2,4590
2,2,1,1,2,2,4,4590
3,3,0,1,2,3,5,4590
4,4,0,0,2,3,5,4590
0,0,1,0,1,0,1,4591
1,1,0,0,1,0,1,4591
0,0,1,0,1,0,1,4592
1,1,0,0,1,0,1,4592
0,0,1,0,1,0,1,4593
1,1,0,0,1,0,1,4593
0,0,1,0,1,0,1,4594
1,1,3,0,4,0,4,4594
2,2,4,1,8,1,9,4594
3,3,6,1,14,2,16,4594
4,4,4,1,18,3,21,4594
5,5,2,2,20,5,25,4594
6,6,1,2,21,7,28,4594
7,7,1,1,22,8,30,4594
8,8,0,2,22,10,32,4594
9,9,1,0,23,10,33,4594
10,10,0,0,23,10,33,4594
0,0,1,0,1,0,1,4595
1,1,1,0,2,0,2,4595
2,2,2,0,4,0,4,4595
3,3,2,0,6,0,6,4595
4,4,2,1,8,1,9,4595
5,5,1,0,9,1,10,4595
6,6,1,0,10,1,11,4595
7,7,0,0,10,1,11,4595
0,0,1,0,1,0,1,4596
1,1,1,0,2,0,2,4596
2,2,3,0,5,0,5,4596
3,3,1,0,6,0,6,4596
4,4,1,0,7,0,7,4596
5,5,1,1,8,1,9,4596
6,6,1,0,9,1,10,4596
7,7,1,0,10,1,11,4596
8,8,0,1,10,2,12,4596
9,9,0,1,10,3,13,4596
10,10,0,3,10,6,16,4596
11,11,3,1,13,7,20,4596
12,12,1,2,14,9,23,4596
13,13,2,0,16,9,25,4596
14,14,2,0,18,9,27,4596
15,15,0,1,18,10,28,4596
16,16,0,0,18,10,28,4596
0,0,1,0,1,0,1,4597
1,1,1,0,2,0,2,4597
2,2,1,0,3,0,3,4597
3,3,0,0,3,0,3,4597
0,0,1,0,1,0,1,4598
1,1,3,0,4,0,4,4598
2,2,2,0,6,0,6,4598
3,3,2,0,8,0,8,4598
4,4,0,0,8,0,8,4598
0,0,1,0,1,0,1,4599
1,1,0,0,1,0,1,4599
0,0,1,0,1,0,1,4600
1,1,0,0,1,0,1,4600
0,0,1,0,1,0,1,4601
1,1,1,0,2,0,2,4601
2,2,0,1,2,1,3,4601
3,3,0,2,2,3,5,4601
4,4,0,3,2,6,8,4601
5,5,1,1,3,7,10,4601
6,6,0,1,3,8,11,4601
7,7,0,0,3,8,11,4601
0,0,1,0,1,0,1,4602
1,1,0,1,1,1,2,4602
2,2,0,0,1,1,2,4602
0,0,1,0,1,0,1,4603
1,1,0,0,1,0,1,4603
0,0,1,0,1,0,1,4604
1,1,0,0,1,0,1,4604
0,0,1,0,1,0,1,4605
1,1,1,0,2,0,2,4605
2,2,1,1,3,1,4,4605
3,3,1,0,4,1,5,4605
4,4,0,0,4,1,5,4605
0,0,1,0,1,0,1,4606
1,1,0,0,1,0,1,4606
0,0,1,0,1,0,1,4607
1,1,0,0,1,0,1,4607
0,0,1,0,1,0,1,4608
1,1,1,0,2,0,2,4608
2,2,1,0,3,0,3,4608
3,3,0,0,3,0,3,4608
0,0,1,0,1,0,1,4609
1,1,0,0,1,0,1,4609
0,0,1,0,1,0,1,4610
1,1,0,1,1,1,2,4610
2,2,0,2,1,3,4,4610
3,3,0,0,1,3,4,4610
0,0,1,0,1,0,1,4611
1,1,0,0,1,0,1,4611
0,0,1,0,1,0,1,4612
1,1,1,0,2,0,2,4612
2,2,1,0,3,0,3,4612
3,3,1,0,4,0,4,4612
4,4,0,0,4,0,4,4612
0,0,1,0,1,0,1,4613
1,1,0,1,1,1,2,4613
2,2,1,0,2,1,3,4613
3,3,2,0,4,1,5,4613
4,4,1,1,5,2,7,4613
5,5,0,1,5,3,8,4613
6,6,0,2,5,5,10,4613
7,7,0,3,5,8,13,4613
8,8,0,2,5,10,15,4613
9,9,1,3,6,13,19,4613
10,10,3,2,9,15,24,4613
11,11,2,0,11,15,26,4613
12,12,2,0,13,15,28,4613
13,13,1,0,14,15,29,4613
14,14,0,0,14,15,29,4613
0,0,1,0,1,0,1,4614
1,1,2,0,3,0,3,4614
2,2,4,0,7,0,7,4614
3,3,4,1,11,1,12,4614
4,4,4,2,15,3,18,4614
5,5,3,2,18,5,23,4614
6,6,4,1,22,6,28,4614
7,7,4,1,26,7,33,4614
8,8,2,1,28,8,36,4614
9,9,3,1,31,9,40,4614
10,10,2,1,33,10,43,4614
11,11,0,2,33,12,45,4614
12,12,0,1,33,13,46,4614
13,13,0,0,33,13,46,4614
0,0,1,0,1,0,1,4615
1,1,1,0,2,0,2,4615
2,2,0,0,2,0,2,4615
0,0,1,0,1,0,1,4616
1,1,0,1,1,1,2,4616
2,2,2,0,3,1,4,4616
3,3,1,0,4,1,5,4616
4,4,0,0,4,1,5,4616
0,0,1,0,1,0,1,4617
1,1,0,0,1,0,1,4617
0,0,1,0,1,0,1,4618
1,1,1,0,2,0,2,4618
2,2,0,1,2,1,3,4618
3,3,2,2,4,3,7,4618
4,4,0,1,4,4,8,4618
5,5,1,0,5,4,9,4618
6,6,0,1,5,5,10,4618
7,7,0,1,5,6,11,4618
8,8,0,0,5,6,11,4618
0,0,1,0,1,0,1,4619
1,1,3,0,4,0,4,4619
2,2,2,1,6,1,7,4619
3,3,2,0,8,1,9,4619
4,4,0,1,8,2,10,4619
5,5,0,0,8,2,10,4619
0,0,1,0,1,0,1,4620
1,1,1,0,2,0,2,4620
2,2,2,0,4,0,4,4620
3,3,1,0,5,0,5,4620
4,4,1,0,6,0,6,4620
5,5,1,0,7,0,7,4620
6,6,0,0,7,0,7,4620
0,0,1,0,1,0,1,4621
1,1,0,0,1,0,1,4621
0,0,1,0,1,0,1,4622
1,1,1,1,2,1,3,4622
2,2,1,4,3,5,8,4622
3,3,2,4,5,9,14,4622
4,4,4,4,9,13,22,4622
5,5,5,3,14,16,30,4622
6,6,6,1,20,17,37,4622
7,7,5,1,25,18,43,4622
8,8,4,0,29,18,47,4622
9,9,7,1,36,19,55,4622
10,10,7,1,43,20,63,4622
11,11,6,1,49,21,70,4622
12,12,1,1,50,22,72,4622
13,13,1,1,51,23,74,4622
14,14,3,2,54,25,79,4622
15,15,1,1,55,26,81,4622
16,16,0,1,55,27,82,4622
17,17,0,0,55,27,82,4622
0,0,1,0,1,0,1,4623
1,1,0,0,1,0,1,4623
0,0,1,0,1,0,1,4624
1,1,0,1,1,1,2,4624
2,2,0,3,1,4,5,4624
3,3,0,5,1,9,10,4624
4,4,0,6,1,15,16,4624
5,5,2,5,3,20,23,4624
6,6,2,1,5,21,26,4624
7,7,1,1,6,22,28,4624
8,8,2,1,8,23,31,4624
9,9,1,1,9,24,33,4624
10,10,1,1,10,25,35,4624
11,11,0,0,10,25,35,4624
0,0,1,0,1,0,1,4625
1,1,0,0,1,0,1,4625
0,0,1,0,1,0,1,4626
1,1,2,0,3,0,3,4626
2,2,2,0,5,0,5,4626
3,3,0,1,5,1,6,4626
4,4,0,0,5,1,6,4626
0,0,1,0,1,0,1,4627
1,1,0,0,1,0,1,4627
0,0,1,0,1,0,1,4628
1,1,0,0,1,0,1,4628
0,0,1,0,1,0,1,4629
1,1,1,0,2,0,2,4629
2,2,0,0,2,0,2,4629
0,0,1,0,1,0,1,4630
1,1,0,0,1,0,1,4630
0,0,1,0,1,0,1,4631
1,1,0,0,1,0,1,4631
0,0,1,0,1,0,1,4632
1,1,0,0,1,0,1,4632
0,0,1,0,1,0,1,4633
1,1,0,0,1,0,1,4633
0,0,1,0,1,0,1,4634
1,1,0,0,1,0,1,4634
0,0,1,0,1,0,1,4635
1,1,0,0,1,0,1,4635
0,0,1,0,1,0,1,4636
1,1,0,0,1,0,1,4636
0,0,1,0,1,0,1,4637
1,1,0,0,1,0,1,4637
0,0,1,0,1,0,1,4638
1,1,0,0,1,0,1,4638
0,0,1,0,1,0,1,4639
1,1,0,0,1,0,1,4639
0,0,1,0,1,0,1,4640
1,1,0,0,1,0,1,4640
0,0,1,0,1,0,1,4641
1,1,0,0,1,0,1,4641
0,0,1,0,1,0,1,4642
1,1,0,0,1,0,1,4642
0,0,1,0,1,0,1,4643
1,1,0,0,1,0,1,4643
0,0,1,0,1,0,1,4644
1,1,1,0,2,0,2,4644
2,2,0,0,2,0,2,4644
0,0,1,0,1,0,1,4645
1,1,0,0,1,0,1,4645
0,0,1,0,1,0,1,4646
1,1,0,0,1,0,1,4646
0,0,1,0,1,0,1,4647
1,1,0,0,1,0,1,4647
0,0,1,0,1,0,1,4648
1,1,1,0,2,0,2,4648
2,2,1,1,3,1,4,4648
3,3,0,1,3,2,5,4648
4,4,0,2,3,4,7,4648
5,5,0,0,3,4,7,4648
0,0,1,0,1,0,1,4649
1,1,0,1,1,1,2,4649
2,2,0,0,1,1,2,4649
0,0,1,0,1,0,1,4650
1,1,2,0,3,0,3,4650
2,2,3,1,6,1,7,4650
3,3,2,3,8,4,12,4650
4,4,5,2,13,6,19,4650
5,5,11,2,24,8,32,4650
6,6,8,4,32,12,44,4650
7,7,5,2,37,14,51,4650
8,8,2,0,39,14,53,4650
9,9,2,2,41,16,57,4650
10,10,1,1,42,17,59,4650
11,11,0,0,42,17,59,4650
0,0,1,0,1,0,1,4651
1,1,0,0,1,0,1,4651
0,0,1,0,1,0,1,4652
1,1,1,0,2,0,2,4652
2,2,2,0,4,0,4,4652
3,3,0,1,4,1,5,4652
4,4,0,1,4,2,6,4652
5,5,0,0,4,2,6,4652
0,0,1,0,1,0,1,4653
1,1,1,0,2,0,2,4653
2,2,3,1,5,1,6,4653
3,3,1,0,6,1,7,4653
4,4,1,0,7,1,8,4653
5,5,0,0,7,1,8,4653
0,0,1,0,1,0,1,4654
1,1,1,0,2,0,2,4654
2,2,0,0,2,0,2,4654
0,0,1,0,1,0,1,4655
1,1,1,1,2,1,3,4655
2,2,0,1,2,2,4,4655
3,3,0,1,2,3,5,4655
4,4,0,1,2,4,6,4655
5,5,0,1,2,5,7,4655
6,6,0,1,2,6,8,4655
7,7,0,0,2,6,8,4655
0,0,1,0,1,0,1,4656
1,1,1,0,2,0,2,4656
2,2,1,0,3,0,3,4656
3,3,0,0,3,0,3,4656
0,0,1,0,1,0,1,4657
1,1,1,0,2,0,2,4657
2,2,2,0,4,0,4,4657
3,3,2,0,6,0,6,4657
4,4,2,1,8,1,9,4657
5,5,0,0,8,1,9,4657
0,0,1,0,1,0,1,4658
1,1,0,0,1,0,1,4658
0,0,1,0,1,0,1,4659
1,1,0,0,1,0,1,4659
0,0,1,0,1,0,1,4660
1,1,1,1,2,1,3,4660
2,2,0,3,2,4,6,4660
3,3,0,4,2,8,10,4660
4,4,1,3,3,11,14,4660
5,5,2,1,5,12,17,4660
6,6,0,1,5,13,18,4660
7,7,0,4,5,17,22,4660
8,8,0,3,5,20,25,4660
9,9,0,3,5,23,28,4660
10,10,2,2,7,25,32,4660
11,11,6,1,13,26,39,4660
12,12,4,4,17,30,47,4660
13,13,5,4,22,34,56,4660
14,14,5,7,27,41,68,4660
15,15,4,9,31,50,81,4660
16,16,4,13,35,63,98,4660
17,17,1,11,36,74,110,4660
18,18,1,9,37,83,120,4660
19,19,2,10,39,93,132,4660
20,20,5,8,44,101,145,4660
21,21,4,7,48,108,156,4660
22,22,6,10,54,118,172,4660
23,23,11,7,65,125,190,4660
24,24,13,6,78,131,209,4660
25,25,12,12,90,143,233,4660
26,26,10,12,100,155,255,4660
27,27,10,14,110,169,279,4660
28,28,7,11,117,180,297,4660
29,29,10,7,127,187,314,4660
30,30,8,7,135,194,329,4660
31,31,9,9,144,203,347,4660
32,32,5,13,149,216,365,4660
33,33,8,15,157,231,388,4660
34,34,7,14,164,245,409,4660
35,35,6,12,170,257,427,4660
36,36,4,13,174,270,444,4660
37,37,6,12,180,282,462,4660
38,38,7,8,187,290,477,4660
39,39,6,9,193,299,492,4660
40,40,6,5,199,304,503,4660
41,41,6,2,205,306,511,4660
42,42,4,2,209,308,517,4660
43,43,5,1,214,309,523,4660
44,44,2,1,216,310,526,4660
45,45,2,2,218,312,530,4660
46,46,3,3,221,315,536,4660
47,47,3,4,224,319,543,4660
48,48,1,2,225,321,546,4660
49,49,1,3,226,324,550,4660
50,50,2,1,228,325,553,4660
51,51,0,2,228,327,555,4660
52,52,0,1,228,328,556,4660
53,53,0,1,228,329,557,4660
54,54,0,2,228,331,559,4660
55,55,1,0,229,331,560,4660
56,56,1,0,230,331,561,4660
57,57,1,1,231,332,563,4660
58,58,3,0,234,332,566,4660
59,59,4,0,238,332,570,4660
60,60,5,1,243,333,576,4660
61,61,4,0,247,333,580,4660
62,62,2,0,249,333,582,4660
63,63,1,0,250,333,583,4660
64,64,1,0,251,333,584,4660
65,65,2,0,253,333,586,4660
66,66,2,0,255,333,588,4660
67,67,5,1,260,334,594,4660
68,68,6,0,266,334,600,4660
69,69,5,0,271,334,605,4660
70,70,7,3,278,337,615,4660
71,71,4,6,282,343,625,4660
72,72,5,5,287,348,635,4660
73,73,2,3,289,351,640,4660
74,74,6,3,295,354,649,4660
75,75,9,3,304,357,661,4660
76,76,8,3,312,360,672,4660
77,77,0,2,312,362,674,4660
78,78,0,2,312,364,676,4660
79,79,0,0,312,364,676,4660
0,0,1,0,1,0,1,4661
1,1,1,0,2,0,2,4661
2,2,0,0,2,0,2,4661
0,0,1,0,1,0,1,4662
1,1,0,0,1,0,1,4662
0,0,1,0,1,0,1,4663
1,1,0,0,1,0,1,4663
0,0,1,0,1,0,1,4664
1,1,0,0,1,0,1,4664
0,0,1,0,1,0,1,4665
1,1,0,0,1,0,1,4665
0,0,1,0,1,0,1,4666
1,1,0,0,1,0,1,4666
0,0,1,0,1,0,1,4667
1,1,1,0,2,0,2,4667
2,2,0,0,2,0,2,4667
0,0,1,0,1,0,1,4668
1,1,2,0,3,0,3,4668
2,2,3,1,6,1,7,4668
3,3,3,3,9,4,13,4668
4,4,2,1,11,5,16,4668
5,5,0,2,11,7,18,4668
6,6,0,0,11,7,18,4668
0,0,1,0,1,0,1,4669
1,1,1,0,2,0,2,4669
2,2,2,0,4,0,4,4669
3,3,1,0,5,0,5,4669
4,4,1,0,6,0,6,4669
5,5,0,0,6,0,6,4669
0,0,1,0,1,0,1,4670
1,1,0,0,1,0,1,4670
0,0,1,0,1,0,1,4671
1,1,0,1,1,1,2,4671
2,2,0,0,1,1,2,4671
0,0,1,0,1,0,1,4672
1,1,0,0,1,0,1,4672
0,0,1,0,1,0,1,4673
1,1,0,0,1,0,1,4673
0,0,1,0,1,0,1,4674
1,1,0,0,1,0,1,4674
0,0,1,0,1,0,1,4675
1,1,1,0,2,0,2,4675
2,2,6,0,8,0,8,4675
3,3,5,1,13,1,14,4675
4,4,3,0,16,1,17,4675
5,5,5,1,21,2,23,4675
6,6,2,0,23,2,25,4675
7,7,0,0,23,2,25,4675
0,0,1,0,1,0,1,4676
1,1,1,0,2,0,2,4676
2,2,1,1,3,1,4,4676
3,3,0,2,3,3,6,4676
4,4,0,1,3,4,7,4676
5,5,1,0,4,4,8,4676
6,6,2,0,6,4,10,4676
7,7,1,1,7,5,12,4676
8,8,0,0,7,5,12,4676
0,0,1,0,1,0,1,4677
1,1,2,2,3,2,5,4677
2,2,2,3,5,5,10,4677
3,3,3,2,8,7,15,4677
4,4,3,1,11,8,19,4677
5,5,0,1,11,9,20,4677
6,6,0,0,11,9,20,4677
0,0,1,0,1,0,1,4678
1,1,2,0,3,0,3,4678
2,2,0,0,3,0,3,4678
0,0,1,0,1,0,1,4679
1,1,0,0,1,0,1,4679
0,0,1,0,1,0,1,4680
1,1,2,0,3,0,3,4680
2,2,2,1,5,1,6,4680
3,3,0,1,5,2,7,4680
4,4,0,1,5,3,8,4680
5,5,0,0,5,3,8,4680
0,0,1,0,1,0,1,4681
1,1,2,0,3,0,3,4681
2,2,1,1,4,1,5,4681
3,3,0,0,4,1,5,4681
0,0,1,0,1,0,1,4682
1,1,1,0,2,0,2,4682
2,2,1,0,3,0,3,4682
3,3,2,0,5,0,5,4682
4,4,2,0,7,0,7,4682
5,5,1,2,8,2,10,4682
6,6,2,1,10,3,13,4682
7,7,1,2,11,5,16,4682
8,8,0,1,11,6,17,4682
9,9,0,1,11,7,18,4682
10,10,0,1,11,8,19,4682
11,11,0,0,11,8,19,4682
0,0,1,0,1,0,1,4683
1,1,0,0,1,0,1,4683
0,0,1,0,1,0,1,4684
1,1,0,0,1,0,1,4684
0,0,1,0,1,0,1,4685
1,1,0,0,1,0,1,4685
0,0,1,0,1,0,1,4686
1,1,0,0,1,0,1,4686
0,0,1,0,1,0,1,4687
1,1,1,0,2,0,2,4687
2,2,1,0,3,0,3,4687
3,3,0,0,3,0,3,4687
0,0,1,0,1,0,1,4688
1,1,2,0,3,0,3,4688
2,2,1,0,4,0,4,4688
3,3,0,0,4,0,4,4688
0,0,1,0,1,0,1,4689
1,1,1,0,2,0,2,4689
2,2,0,0,2,0,2,4689
0,0,1,0,1,0,1,4690
1,1,3,0,4,0,4,4690
2,2,2,0,6,0,6,4690
3,3,1,0,7,0,7,4690
4,4,0,0,7,0,7,4690
0,0,1,0,1,0,1,4691
1,1,0,0,1,0,1,4691
0,0,1,0,1,0,1,4692
1,1,0,0,1,0,1,4692
0,0,1,0,1,0,1,4693
1,1,2,0,3,0,3,4693
2,2,0,0,3,0,3,4693
0,0,1,0,1,0,1,4694
1,1,0,0,1,0,1,4694
0,0,1,0,1,0,1,4695
1,1,0,0,1,0,1,4695
0,0,1,0,1,0,1,4696
1,1,3,0,4,0,4,4696
2,2,2,0,6,0,6,4696
3,3,1,0,7,0,7,4696
4,4,0,0,7,0,7,4696
0,0,1,0,1,0,1,4697
1,1,1,0,2,0,2,4697
2,2,2,0,4,0,4,4697
3,3,4,0,8,0,8,4697
4,4,5,1,13,1,14,4697
5,5,1,4,14,5,19,4697
6,6,2,3,16,8,24,4697
7,7,1,3,17,11,28,4697
8,8,2,1,19,12,31,4697
9,9,2,1,21,13,34,4697
10,10,0,0,21,13,34,4697
0,0,1,0,1,0,1,4698
1,1,0,0,1,0,1,4698
0,0,1,0,1,0,1,4699
1,1,0,0,1,0,1,4699
0,0,1,0,1,0,1,4700
1,1,1,0,2,0,2,4700
2,2,1,0,3,0,3,4700
3,3,1,1,4,1,5,4700
4,4,1,0,5,1,6,4700
5,5,1,0,6,1,7,4700
6,6,0,0,6,1,7,4700
0,0,1,0,1,0,1,4701
1,1,1,0,2,0,2,4701
2,2,2,0,4,0,4,4701
3,3,1,0,5,0,5,4701
4,4,1,0,6,0,6,4701
5,5,1,0,7,0,7,4701
6,6,0,0,7,0,7,4701
0,0,1,0,1,0,1,4702
1,1,2,0,3,0,3,4702
2,2,3,1,6,1,7,4702
3,3,1,0,7,1,8,4702
4,4,0,0,7,1,8,4702
0,0,1,0,1,0,1,4703
1,1,0,0,1,0,1,4703
0,0,1,0,1,0,1,4704
1,1,0,0,1,0,1,4704
0,0,1,0,1,0,1,4705
1,1,1,0,2,0,2,4705
2,2,2,0,4,0,4,4705
3,3,1,1,5,1,6,4705
4,4,0,0,5,1,6,4705
0,0,1,0,1,0,1,4706
1,1,4,0,5,0,5,4706
2,2,2,0,7,0,7,4706
3,3,1,0,8,0,8,4706
4,4,1,0,9,0,9,4706
5,5,1,0,10,0,10,4706
6,6,3,1,13,1,14,4706
7,7,3,2,16,3,19,4706
8,8,2,4,18,7,25,4706
9,9,2,3,20,10,30,4706
10,10,4,3,24,13,37,4706
11,11,1,3,25,16,41,4706
12,12,0,1,25,17,42,4706
13,13,0,1,25,18,43,4706
14,14,0,2,25,20,45,4706
15,15,0,0,25,20,45,4706
0,0,1,0,1,0,1,4707
1,1,0,1,1,1,2,4707
2,2,0,2,1,3,4,4707
3,3,1,2,2,5,7,4707
4,4,1,2,3,7,10,4707
5,5,0,1,3,8,11,4707
6,6,1,0,4,8,12,4707
7,7,1,0,5,8,13,4707
8,8,0,0,5,8,13,4707
0,0,1,0,1,0,1,4708
1,1,0,0,1,0,1,4708
0,0,1,0,1,0,1,4709
1,1,1,1,2,1,3,4709
2,2,0,1,2,2,4,4709
3,3,0,0,2,2,4,4709
0,0,1,0,1,0,1,4710
1,1,0,0,1,0,1,4710
0,0,1,0,1,0,1,4711
1,1,2,0,3,0,3,4711
2,2,1,0,4,0,4,4711
3,3,1,0,5,0,5,4711
4,4,0,0,5,0,5,4711
0,0,1,0,1,0,1,4712
1,1,0,0,1,0,1,4712
0,0,1,0,1,0,1,4713
1,1,1,0,2,0,2,4713
2,2,0,0,2,0,2,4713
0,0,1,0,1,0,1,4714
1,1,0,0,1,0,1,4714
0,0,1,0,1,0,1,4715
1,1,0,0,1,0,1,4715
0,0,1,0,1,0,1,4716
1,1,1,0,2,0,2,4716
2,2,0,1,2,1,3,4716
3,3,0,2,2,3,5,4716
4,4,0,2,2,5,7,4716
5,5,0,2,2,7,9,4716
6,6,1,0,3,7,10,4716
7,7,1,0,4,7,11,4716
8,8,0,0,4,7,11,4716
0,0,1,0,1,0,1,4717
1,1,0,0,1,0,1,4717
0,0,1,0,1,0,1,4718
1,1,0,0,1,0,1,4718
0,0,1,0,1,0,1,4719
1,1,2,0,3,0,3,4719
2,2,1,1,4,1,5,4719
3,3,1,1,5,2,7,4719
4,4,1,0,6,2,8,4719
5,5,2,0,8,2,10,4719
6,6,4,0,12,2,14,4719
7,7,2,1,14,3,17,4719
8,8,1,1,15,4,19,4719
9,9,0,1,15,5,20,4719
10,10,0,0,15,5,20,4719
0,0,1,0,1,0,1,4720
1,1,0,0,1,0,1,4720
0,0,1,0,1,0,1,4721
1,1,0,0,1,0,1,4721
0,0,1,0,1,0,1,4722
1,1,1,0,2,0,2,4722
2,2,1,0,3,0,3,4722
3,3,0,0,3,0,3,4722
0,0,1,0,1,0,1,4723
1,1,0,0,1,0,1,4723
0,0,1,0,1,0,1,4724
1,1,1,1,2,1,3,4724
2,2,0,0,2,1,3,4724
0,0,1,0,1,0,1,4725
1,1,1,0,2,0,2,4725
2,2,0,0,2,0,2,4725
0,0,1,0,1,0,1,4726
1,1,0,0,1,0,1,4726
0,0,1,0,1,0,1,4727
1,1,1,2,2,2,4,4727
2,2,0,0,2,2,4,4727
0,0,1,0,1,0,1,4728
1,1,0,0,1,0,1,4728
0,0,1,0,1,0,1,4729
1,1,0,0,1,0,1,4729
0,0,1,0,1,0,1,4730
1,1,1,0,2,0,2,4730
2,2,0,0,2,0,2,4730
0,0,1,0,1,0,1,4731
1,1,1,0,2,0,2,4731
2,2,0,0,2,0,2,4731
0,0,1,0,1,0,1,4732
1,1,1,0,2,0,2,4732
2,2,0,0,2,0,2,4732
0,0,1,0,1,0,1,4733
1,1,0,0,1,0,1,4733
0,0,1,0,1,0,1,4734
1,1,1,0,2,0,2,4734
2,2,0,0,2,0,2,4734
0,0,1,0,1,0,1,4735
1,1,0,0,1,0,1,4735
0,0,1,0,1,0,1,4736
1,1,0,0,1,0,1,4736
0,0,1,0,1,0,1,4737
1,1,1,0,2,0,2,4737
2,2,0,0,2,0,2,4737
0,0,1,0,1,0,1,4738
1,1,0,0,1,0,1,4738
0,0,1,0,1,0,1,4739
1,1,2,0,3,0,3,4739
2,2,3,0,6,0,6,4739
3,3,3,0,9,0,9,4739
4,4,6,2,15,2,17,4739
5,5,5,2,20,4,24,4739
6,6,7,4,27,8,35,4739
7,7,8,3,35,11,46,4739
8,8,10,4,45,15,60,4739
9,9,10,5,55,20,75,4739
10,10,5,4,60,24,84,4739
11,11,0,4,60,28,88,4739
12,12,1,2,61,30,91,4739
13,13,2,0,63,30,93,4739
14,14,1,0,64,30,94,4739
15,15,0,0,64,30,94,4739
0,0,1,0,1,0,1,4740
1,1,1,0,2,0,2,4740
2,2,0,0,2,0,2,4740
0,0,1,0,1,0,1,4741
1,1,0,0,1,0,1,4741
0,0,1,0,1,0,1,4742
1,1,0,1,1,1,2,4742
2,2,0,1,1,2,3,4742
3,3,0,1,1,3,4,4742
4,4,0,1,1,4,5,4742
5,5,1,2,2,6,8,4742
6,6,1,0,3,6,9,4742
7,7,0,0,3,6,9,4742
0,0,1,0,1,0,1,4743
1,1,0,0,1,0,1,4743
0,0,1,0,1,0,1,4744
1,1,0,0,1,0,1,4744
0,0,1,0,1,0,1,4745
1,1,0,0,1,0,1,4745
0,0,1,0,1,0,1,4746
1,1,0,1,1,1,2,4746
2,2,0,0,1,1,2,4746
0,0,1,0,1,0,1,4747
1,1,2,0,3,0,3,4747
2,2,1,0,4,0,4,4747
3,3,3,0,7,0,7,4747
4,4,1,1,8,1,9,4747
5,5,0,1,8,2,10,4747
6,6,1,2,9,4,13,4747
7,7,2,0,11,4,15,4747
8,8,1,0,12,4,16,4747
9,9,2,0,14,4,18,4747
10,10,2,1,16,5,21,4747
11,11,0,0,16,5,21,4747
0,0,1,0,1,0,1,4748
1,1,1,0,2,0,2,4748
2,2,1,0,3,0,3,4748
3,3,1,0,4,0,4,4748
4,4,0,1,4,1,5,4748
5,5,1,3,5,4,9,4748
6,6,3,2,8,6,14,4748
7,7,3,3,11,9,20,4748
8,8,3,0,14,9,23,4748
9,9,1,0,15,9,24,4748
10,10,0,0,15,9,24,4748
0,0,1,0,1,0,1,4749
1,1,1,0,2,0,2,4749
2,2,0,1,2,1,3,4749
3,3,0,3,2,4,6,4749
4,4,0,1,2,5,7,4749
5,5,0,0,2,5,7,4749
0,0,1,0,1,0,1,4750
1,1,0,0,1,0,1,4750
0,0,1,0,1,0,1,4751
1,1,0,0,1,0,1,4751
0,0,1,0,1,0,1,4752
1,1,0,0,1,0,1,4752
0,0,1,0,1,0,1,4753
1,1,0,0,1,0,1,4753
0,0,1,0,1,0,1,4754
1,1,1,0,2,0,2,4754
2,2,1,0,3,0,3,4754
3,3,1,1,4,1,5,4754
4,4,1,1,5,2,7,4754
5,5,1,0,6,2,8,4754
6,6,2,0,8,2,10,4754
7,7,1,0,9,2,11,4754
8,8,0,0,9,2,11,4754
0,0,1,0,1,0,1,4755
1,1,1,1,2,1,3,4755
2,2,1,0,3,1,4,4755
3,3,0,0,3,1,4,4755
0,0,1,0,1,0,1,4756
1,1,1,0,2,0,2,4756
2,2,2,0,4,0,4,4756
3,3,1,1,5,1,6,4756
4,4,0,1,5,2,7,4756
5,5,0,2,5,4,9,4756
6,6,0,1,5,5,10,4756
7,7,1,1,6,6,12,4756
8,8,0,1,6,7,13,4756
9,9,0,1,6,8,14,4756
10,10,0,0,6,8,14,4756
0,0,1,0,1,0,1,4757
1,1,1,0,2,0,2,4757
2,2,2,1,4,1,5,4757
3,3,1,1,5,2,7,4757
4,4,4,1,9,3,12,4757
5,5,2,1,11,4,15,4757
6,6,5,1,16,5,21,4757
7,7,2,3,18,8,26,4757
8,8,3,1,21,9,30,4757
9,9,2,3,23,12,35,4757
10,10,1,1,24,13,37,4757
11,11,0,0,24,13,37,4757
0,0,1,0,1,0,1,4758
1,1,1,0,2,0,2,4758
2,2,0,0,2,0,2,4758
0,0,1,0,1,0,1,4759
1,1,1,0,2,0,2,4759
2,2,1,0,3,0,3,4759
3,3,0,1,3,1,4,4759
4,4,0,0,3,1,4,4759
0,0,1,0,1,0,1,4760
1,1,0,1,1,1,2,4760
2,2,1,0,2,1,3,4760
3,3,0,0,2,1,3,4760
0,0,1,0,1,0,1,4761
1,1,0,0,1,0,1,4761
0,0,1,0,1,0,1,4762
1,1,1,0,2,0,2,4762
2,2,1,0,3,0,3,4762
3,3,0,0,3,0,3,4762
0,0,1,0,1,0,1,4763
1,1,0,0,1,0,1,4763
0,0,1,0,1,0,1,4764
1,1,1,0,2,0,2,4764
2,2,0,0,2,0,2,4764
0,0,1,0,1,0,1,4765
1,1,1,0,2,0,2,4765
2,2,2,0,4,0,4,4765
3,3,1,0,5,0,5,4765
4,4,1,1,6,1,7,4765
5,5,1,0,7,1,8,4765
6,6,0,0,7,1,8,4765
0,0,1,0,1,0,1,4766
1,1,0,0,1,0,1,4766
0,0,1,0,1,0,1,4767
1,1,0,0,1,0,1,4767
0,0,1,0,1,0,1,4768
1,1,3,0,4,0,4,4768
2,2,2,0,6,0,6,4768
3,3,3,0,9,0,9,4768
4,4,1,0,10,0,10,4768
5,5,0,0,10,0,10,4768
0,0,1,0,1,0,1,4769
1,1,0,0,1,0,1,4769
0,0,1,0,1,0,1,4770
1,1,0,0,1,0,1,4770
0,0,1,0,1,0,1,4771
1,1,1,0,2,0,2,4771
2,2,0,0,2,0,2,4771
0,0,1,0,1,0,1,4772
1,1,0,0,1,0,1,4772
0,0,1,0,1,0,1,4773
1,1,1,0,2,0,2,4773
2,2,0,1,2,1,3,4773
3,3,0,0,2,1,3,4773
0,0,1,0,1,0,1,4774
1,1,1,0,2,0,2,4774
2,2,1,1,3,1,4,4774
3,3,2,2,5,3,8,4774
4,4,2,1,7,4,11,4774
5,5,0,1,7,5,12,4774
6,6,0,1,7,6,13,4774
7,7,0,2,7,8,15,4774
8,8,0,0,7,8,15,4774
0,0,1,0,1,0,1,4775
1,1,1,0,2,0,2,4775
2,2,1,0,3,0,3,4775
3,3,0,1,3,1,4,4775
4,4,0,1,3,2,5,4775
5,5,0,2,3,4,7,4775
6,6,0,0,3,4,7,4775
0,0,1,0,1,0,1,4776
1,1,0,0,1,0,1,4776
0,0,1,0,1,0,1,4777
1,1,0,0,1,0,1,4777
0,0,1,0,1,0,1,4778
1,1,0,0,1,0,1,4778
0,0,1,0,1,0,1,4779
1,1,1,0,2,0,2,4779
2,2,0,0,2,0,2,4779
0,0,1,0,1,0,1,4780
1,1,2,1,3,1,4,4780
2,2,1,1,4,2,6,4780
3,3,0,0,4,2,6,4780
0,0,1,0,1,0,1,4781
1,1,0,0,1,0,1,4781
0,0,1,0,1,0,1,4782
1,1,2,0,3,0,3,4782
2,2,2,0,5,0,5,4782
3,3,0,0,5,0,5,4782
0,0,1,0,1,0,1,4783
1,1,2,0,3,0,3,4783
2,2,4,0,7,0,7,4783
3,3,5,1,12,1,13,4783
4,4,6,1,18,2,20,4783
5,5,4,1,22,3,25,4783
6,6,3,1,25,4,29,4783
7,7,2,1,27,5,32,4783
8,8,1,1,28,6,34,4783
9,9,2,0,30,6,36,4783
10,10,3,0,33,6,39,4783
11,11,0,0,33,6,39,4783
0,0,1,0,1,0,1,4784
1,1,2,1,3,1,4,4784
2,2,1,1,4,2,6,4784
3,3,0,1,4,3,7,4784
4,4,1,0,5,3,8,4784
5,5,2,0,7,3,10,4784
6,6,2,1,9,4,13,4784
7,7,3,0,12,4,16,4784
8,8,1,1,13,5,18,4784
9,9,3,1,16,6,22,4784
10,10,3,0,19,6,25,4784
11,11,2,1,21,7,28,4784
12,12,1,3,22,10,32,4784
13,13,0,2,22,12,34,4784
14,14,0,1,22,13,35,4784
15,15,2,0,24,13,37,4784
16,16,2,1,26,14,40,4784
17,17,4,2,30,16,46,4784
18,18,1,1,31,17,48,4784
19,19,0,1,31,18,49,4784
20,20,0,0,31,18,49,4784
0,0,1,0,1,0,1,4785
1,1,2,0,3,0,3,4785
2,2,0,0,3,0,3,4785
0,0,1,0,1,0,1,4786
1,1,1,0,2,0,2,4786
2,2,1,0,3,0,3,4786
3,3,0,0,3,0,3,4786
0,0,1,0,1,0,1,4787
1,1,0,1,1,1,2,4787
2,2,1,2,2,3,5,4787
3,3,2,4,4,7,11,4787
4,4,1,4,5,11,16,4787
5,5,3,5,8,16,24,4787
6,6,3,4,11,20,31,4787
7,7,7,2,18,22,40,4787
8,8,6,2,24,24,48,4787
9,9,5,1,29,25,54,4787
10,10,5,1,34,26,60,4787
11,11,9,2,43,28,71,4787
12,12,2,5,45,33,78,4787
13,13,0,4,45,37,82,4787
14,14,2,2,47,39,86,4787
15,15,2,1,49,40,89,4787
16,16,1,1,50,41,91,4787
17,17,2,0,52,41,93,4787
18,18,0,0,52,41,93,4787
0,0,1,0,1,0,1,4788
1,1,2,0,3,0,3,4788
2,2,0,2,3,2,5,4788
3,3,0,0,3,2,5,4788
0,0,1,0,1,0,1,4789
1,1,0,0,1,0,1,4789
0,0,1,0,1,0,1,4790
1,1,1,0,2,0,2,4790
2,2,0,0,2,0,2,4790
0,0,1,0,1,0,1,4791
1,1,0,0,1,0,1,4791
0,0,1,0,1,0,1,4792
1,1,0,0,1,0,1,4792
0,0,1,0,1,0,1,4793
1,1,1,0,2,0,2,4793
2,2,0,0,2,0,2,4793
0,0,1,0,1,0,1,4794
1,1,1,0,2,0,2,4794
2,2,1,0,3,0,3,4794
3,3,2,0,5,0,5,4794
4,4,0,2,5,2,7,4794
5,5,1,1,6,3,9,4794
6,6,0,1,6,4,10,4794
7,7,0,0,6,4,10,4794
0,0,1,0,1,0,1,4795
1,1,2,0,3,0,3,4795
2,2,0,0,3,0,3,4795
0,0,1,0,1,0,1,4796
1,1,1,0,2,0,2,4796
2,2,0,0,2,0,2,4796
0,0,1,0,1,0,1,4797
1,1,2,1,3,1,4,4797
2,2,2,4,5,5,10,4797
3,3,0,4,5,9,14,4797
4,4,1,5,6,14,20,4797
5,5,2,3,8,17,25,4797
6,6,0,1,8,18,26,4797
7,7,0,1,8,19,27,4797
8,8,0,1,8,20,28,4797
9,9,0,1,8,21,29,4797
10,10,1,0,9,21,30,4797
11,11,2,1,11,22,33,4797
12,12,0,2,11,24,35,4797
13,13,1,1,12,25,37,4797
14,14,1,4,13,29,42,4797
15,15,3,3,16,32,48,4797
16,16,1,2,17,34,51,4797
17,17,0,1,17,35,52,4797
18,18,0,0,17,35,52,4797
0,0,1,0,1,0,1,4798
1,1,0,0,1,0,1,4798
0,0,1,0,1,0,1,4799
1,1,0,0,1,0,1,4799
0,0,1,0,1,0,1,4800
1,1,0,0,1,0,1,4800
0,0,1,0,1,0,1,4801
1,1,2,0,3,0,3,4801
2,2,1,0,4,0,4,4801
3,3,0,1,4,1,5,4801
4,4,0,0,4,1,5,4801
0,0,1,0,1,0,1,4802
1,1,2,0,3,0,3,4802
2,2,1,1,4,1,5,4802
3,3,0,1,4,2,6,4802
4,4,0,1,4,3,7,4802
5,5,1,2,5,5,10,4802
6,6,1,1,6,6,12,4802
7,7,0,1,6,7,13,4802
8,8,0,2,6,9,15,4802
9,9,0,5,6,14,20,4802
10,10,2,1,8,15,23,4802
11,11,0,1,8,16,24,4802
12,12,0,1,8,17,25,4802
13,13,0,2,8,19,27,4802
14,14,0,1,8,20,28,4802
15,15,0,0,8,20,28,4802
0,0,1,0,1,0,1,4803
1,1,1,0,2,0,2,4803
2,2,0,1,2,1,3,4803
3,3,0,0,2,1,3,4803
0,0,1,0,1,0,1,4804
1,1,0,0,1,0,1,4804
0,0,1,0,1,0,1,4805
1,1,0,0,1,0,1,4805
0,0,1,0,1,0,1,4806
1,1,0,0,1,0,1,4806
0,0,1,0,1,0,1,4807
1,1,2,0,3,0,3,4807
2,2,1,2,4,2,6,4807
3,3,1,1,5,3,8,4807
4,4,1,1,6,4,10,4807
5,5,1,3,7,7,14,4807
6,6,0,4,7,11,18,4807
7,7,1,3,8,14,22,4807
8,8,1,1,9,15,24,4807
9,9,1,1,10,16,26,4807
10,10,1,0,11,16,27,4807
11,11,0,0,11,16,27,4807
0,0,1,0,1,0,1,4808
1,1,0,0,1,0,1,4808
0,0,1,0,1,0,1,4809
1,1,1,0,2,0,2,4809
2,2,2,1,4,1,5,4809
3,3,1,3,5,4,9,4809
4,4,0,1,5,5,10,4809
5,5,0,0,5,5,10,4809
0,0,1,0,1,0,1,4810
1,1,0,0,1,0,1,4810
0,0,1,0,1,0,1,4811
1,1,2,0,3,0,3,4811
2,2,2,0,5,0,5,4811
3,3,4,0,9,0,9,4811
4,4,2,2,11,2,13,4811
5,5,1,1,12,3,15,4811
6,6,0,0,12,3,15,4811
0,0,1,0,1,0,1,4812
1,1,0,0,1,0,1,4812
0,0,1,0,1,0,1,4813
1,1,0,0,1,0,1,4813
0,0,1,0,1,0,1,4814
1,1,0,0,1,0,1,4814
0,0,1,0,1,0,1,4815
1,1,0,1,1,1,2,4815
2,2,0,0,1,1,2,4815
0,0,1,0,1,0,1,4816
1,1,1,0,2,0,2,4816
2,2,0,0,2,0,2,4816
0,0,1,0,1,0,1,4817
1,1,1,0,2,0,2,4817
2,2,1,0,3,0,3,4817
3,3,0,0,3,0,3,4817
0,0,1,0,1,0,1,4818
1,1,0,0,1,0,1,4818
0,0,1,0,1,0,1,4819
1,1,1,0,2,0,2,4819
2,2,1,0,3,0,3,4819
3,3,0,0,3,0,3,4819
0,0,1,0,1,0,1,4820
1,1,0,1,1,1,2,4820
2,2,1,1,2,2,4,4820
3,3,3,3,5,5,10,4820
4,4,5,1,10,6,16,4820
5,5,5,2,15,8,23,4820
6,6,3,0,18,8,26,4820
7,7,3,0,21,8,29,4820
8,8,3,1,24,9,33,4820
9,9,1,2,25,11,36,4820
10,10,1,3,26,14,40,4820
11,11,3,3,29,17,46,4820
12,12,1,1,30,18,48,4820
13,13,1,1,31,19,50,4820
14,14,1,1,32,20,52,4820
15,15,0,1,32,21,53,4820
16,16,0,0,32,21,53,4820
0,0,1,0,1,0,1,4821
1,1,1,0,2,0,2,4821
2,2,0,0,2,0,2,4821
0,0,1,0,1,0,1,4822
1,1,1,0,2,0,2,4822
2,2,0,0,2,0,2,4822
0,0,1,0,1,0,1,4823
1,1,0,0,1,0,1,4823
0,0,1,0,1,0,1,4824
1,1,0,0,1,0,1,4824
0,0,1,0,1,0,1,4825
1,1,0,0,1,0,1,4825
0,0,1,0,1,0,1,4826
1,1,0,0,1,0,1,4826
0,0,1,0,1,0,1,4827
1,1,0,0,1,0,1,4827
0,0,1,0,1,0,1,4828
1,1,1,1,2,1,3,4828
2,2,2,0,4,1,5,4828
3,3,1,0,5,1,6,4828
4,4,3,0,8,1,9,4828
5,5,3,0,11,1,12,4828
6,6,0,0,11,1,12,4828
0,0,1,0,1,0,1,4829
1,1,0,0,1,0,1,4829
0,0,1,0,1,0,1,4830
1,1,1,0,2,0,2,4830
2,2,1,0,3,0,3,4830
3,3,2,0,5,0,5,4830
4,4,1,0,6,0,6,4830
5,5,0,0,6,0,6,4830
0,0,1,0,1,0,1,4831
1,1,1,0,2,0,2,4831
2,2,1,0,3,0,3,4831
3,3,1,0,4,0,4,4831
4,4,1,0,5,0,5,4831
5,5,1,0,6,0,6,4831
6,6,1,0,7,0,7,4831
7,7,0,0,7,0,7,4831
0,0,1,0,1,0,1,4832
1,1,1,0,2,0,2,4832
2,2,0,0,2,0,2,4832
0,0,1,0,1,0,1,4833
1,1,2,0,3,0,3,4833
2,2,0,0,3,0,3,4833
0,0,1,0,1,0,1,4834
1,1,1,0,2,0,2,4834
2,2,0,0,2,0,2,4834
0,0,1,0,1,0,1,4835
1,1,0,0,1,0,1,4835
0,0,1,0,1,0,1,4836
1,1,0,0,1,0,1,4836
0,0,1,0,1,0,1,4837
1,1,1,0,2,0,2,4837
2,2,0,0,2,0,2,4837
0,0,1,0,1,0,1,4838
1,1,0,0,1,0,1,4838
0,0,1,0,1,0,1,4839
1,1,0,1,1,1,2,4839
2,2,0,0,1,1,2,4839
0,0,1,0,1,0,1,4840
1,1,1,0,2,0,2,4840
2,2,0,0,2,0,2,4840
0,0,1,0,1,0,1,4841
1,1,2,0,3,0,3,4841
2,2,1,0,4,0,4,4841
3,3,0,1,4,1,5,4841
4,4,0,2,4,3,7,4841
5,5,0,2,4,5,9,4841
6,6,0,1,4,6,10,4841
7,7,0,0,4,6,10,4841
0,0,1,0,1,0,1,4842
1,1,0,0,1,0,1,4842
0,0,1,0,1,0,1,4843
1,1,0,0,1,0,1,4843
0,0,1,0,1,0,1,4844
1,1,0,0,1,0,1,4844
0,0,1,0,1,0,1,4845
1,1,0,0,1,0,1,4845
0,0,1,0,1,0,1,4846
1,1,0,0,1,0,1,4846
0,0,1,0,1,0,1,4847
1,1,0,0,1,0,1,4847
0,0,1,0,1,0,1,4848
1,1,0,1,1,1,2,4848
2,2,0,1,1,2,3,4848
3,3,0,0,1,2,3,4848
0,0,1,0,1,0,1,4849
1,1,0,0,1,0,1,4849
0,0,1,0,1,0,1,4850
1,1,0,0,1,0,1,4850
0,0,1,0,1,0,1,4851
1,1,2,2,3,2,5,4851
2,2,0,2,3,4,7,4851
3,3,0,2,3,6,9,4851
4,4,1,2,4,8,12,4851
5,5,1,0,5,8,13,4851
6,6,0,1,5,9,14,4851
7,7,1,0,6,9,15,4851
8,8,1,0,7,9,16,4851
9,9,2,0,9,9,18,4851
10,10,0,0,9,9,18,4851
0,0,1,0,1,0,1,4852
1,1,1,0,2,0,2,4852
2,2,2,0,4,0,4,4852
3,3,2,0,6,0,6,4852
4,4,0,1,6,1,7,4852
5,5,0,0,6,1,7,4852
0,0,1,0,1,0,1,4853
1,1,1,0,2,0,2,4853
2,2,0,0,2,0,2,4853
0,0,1,0,1,0,1,4854
1,1,1,1,2,1,3,4854
2,2,3,1,5,2,7,4854
3,3,3,1,8,3,11,4854
4,4,0,0,8,3,11,4854
0,0,1,0,1,0,1,4855
1,1,1,0,2,0,2,4855
2,2,1,0,3,0,3,4855
3,3,2,0,5,0,5,4855
4,4,1,0,6,0,6,4855
5,5,2,0,8,0,8,4855
6,6,1,0,9,0,9,4855
7,7,0,0,9,0,9,4855
0,0,1,0,1,0,1,4856
1,1,0,0,1,0,1,4856
0,0,1,0,1,0,1,4857
1,1,0,0,1,0,1,4857
0,0,1,0,1,0,1,4858
1,1,1,0,2,0,2,4858
2,2,0,0,2,0,2,4858
0,0,1,0,1,0,1,4859
1,1,1,0,2,0,2,4859
2,2,1,0,3,0,3,4859
3,3,0,0,3,0,3,4859
0,0,1,0,1,0,1,4860
1,1,2,1,3,1,4,4860
2,2,3,1,6,2,8,4860
3,3,3,0,9,2,11,4860
4,4,3,0,12,2,14,4860
5,5,2,0,14,2,16,4860
6,6,3,0,17,2,19,4860
7,7,1,1,18,3,21,4860
8,8,2,1,20,4,24,4860
9,9,0,0,20,4,24,4860
0,0,1,0,1,0,1,4861
1,1,0,0,1,0,1,4861
0,0,1,0,1,0,1,4862
1,1,5,0,6,0,6,4862
2,2,1,0,7,0,7,4862
3,3,0,0,7,0,7,4862
0,0,1,0,1,0,1,4863
1,1,1,0,2,0,2,4863
2,2,0,0,2,0,2,4863
0,0,1,0,1,0,1,4864
1,1,1,0,2,0,2,4864
2,2,2,1,4,1,5,4864
3,3,3,1,7,2,9,4864
4,4,4,1,11,3,14,4864
5,5,6,2,17,5,22,4864
6,6,2,1,19,6,25,4864
7,7,2,0,21,6,27,4864
8,8,0,0,21,6,27,4864
0,0,1,0,1,0,1,4865
1,1,1,0,2,0,2,4865
2,2,0,0,2,0,2,4865
0,0,1,0,1,0,1,4866
1,1,2,1,3,1,4,4866
2,2,3,0,6,1,7,4866
3,3,1,0,7,1,8,4866
4,4,2,0,9,1,10,4866
5,5,2,1,11,2,13,4866
6,6,3,0,14,2,16,4866
7,7,3,2,17,4,21,4866
8,8,4,1,21,5,26,4866
9,9,0,2,21,7,28,4866
10,10,0,1,21,8,29,4866
11,11,0,0,21,8,29,4866
0,0,1,0,1,0,1,4867
1,1,1,0,2,0,2,4867
2,2,2,0,4,0,4,4867
3,3,1,1,5,1,6,4867
4,4,0,1,5,2,7,4867
5,5,0,0,5,2,7,4867
0,0,1,0,1,0,1,4868
1,1,0,1,1,1,2,4868
2,2,1,0,2,1,3,4868
3,3,1,1,3,2,5,4868
4,4,0,0,3,2,5,4868
0,0,1,0,1,0,1,4869
1,1,0,0,1,0,1,4869
0,0,1,0,1,0,1,4870
1,1,0,0,1,0,1,4870
0,0,1,0,1,0,1,4871
1,1,0,0,1,0,1,4871
0,0,1,0,1,0,1,4872
1,1,0,1,1,1,2,4872
2,2,0,1,1,2,3,4872
3,3,1,0,2,2,4,4872
4,4,0,0,2,2,4,4872
0,0,1,0,1,0,1,4873
1,1,2,0,3,0,3,4873
2,2,0,0,3,0,3,4873
0,0,1,0,1,0,1,4874
1,1,2,0,3,0,3,4874
2,2,0,1,3,1,4,4874
3,3,0,3,3,4,7,4874
4,4,0,3,3,7,10,4874
5,5,1,1,4,8,12,4874
6,6,0,0,4,8,12,4874
0,0,1,0,1,0,1,4875
1,1,2,0,3,0,3,4875
2,2,5,0,8,0,8,4875
3,3,3,1,11,1,12,4875
4,4,1,2,12,3,15,4875
5,5,0,2,12,5,17,4875
6,6,1,1,13,6,19,4875
7,7,0,0,13,6,19,4875
0,0,1,0,1,0,1,4876
1,1,1,0,2,0,2,4876
2,2,1,0,3,0,3,4876
3,3,1,0,4,0,4,4876
4,4,0,0,4,0,4,4876
0,0,1,0,1,0,1,4877
1,1,0,0,1,0,1,4877
0,0,1,0,1,0,1,4878
1,1,2,0,3,0,3,4878
2,2,1,0,4,0,4,4878
3,3,1,1,5,1,6,4878
4,4,3,0,8,1,9,4878
5,5,2,0,10,1,11,4878
6,6,2,0,12,1,13,4878
7,7,0,1,12,2,14,4878
8,8,0,0,12,2,14,4878
0,0,1,0,1,0,1,4879
1,1,0,0,1,0,1,4879
0,0,1,0,1,0,1,4880
1,1,1,0,2,0,2,4880
2,2,2,0,4,0,4,4880
3,3,2,0,6,0,6,4880
4,4,0,1,6,1,7,4880
5,5,0,0,6,1,7,4880
0,0,1,0,1,0,1,4881
1,1,1,0,2,0,2,4881
2,2,1,0,3,0,3,4881
3,3,1,0,4,0,4,4881
4,4,1,0,5,0,5,4881
5,5,0,0,5,0,5,4881
0,0,1,0,1,0,1,4882
1,1,1,1,2,1,3,4882
2,2,0,1,2,2,4,4882
3,3,1,2,3,4,7,4882
4,4,1,0,4,4,8,4882
5,5,0,0,4,4,8,4882
0,0,1,0,1,0,1,4883
1,1,0,1,1,1,2,4883
2,2,1,1,2,2,4,4883
3,3,0,1,2,3,5,4883
4,4,1,0,3,3,6,4883
5,5,0,0,3,3,6,4883
0,0,1,0,1,0,1,4884
1,1,0,0,1,0,1,4884
0,0,1,0,1,0,1,4885
1,1,0,0,1,0,1,4885
0,0,1,0,1,0,1,4886
1,1,1,0,2,0,2,4886
2,2,0,1,2,1,3,4886
3,3,0,0,2,1,3,4886
0,0,1,0,1,0,1,4887
1,1,2,0,3,0,3,4887
2,2,1,0,4,0,4,4887
3,3,0,0,4,0,4,4887
0,0,1,0,1,0,1,4888
1,1,0,0,1,0,1,4888
0,0,1,0,1,0,1,4889
1,1,0,0,1,0,1,4889
0,0,1,0,1,0,1,4890
1,1,1,0,2,0,2,4890
2,2,2,0,4,0,4,4890
3,3,1,0,5,0,5,4890
4,4,0,0,5,0,5,4890
0,0,1,0,1,0,1,4891
1,1,4,0,5,0,5,4891
2,2,1,0,6,0,6,4891
3,3,0,1,6,1,7,4891
4,4,0,0,6,1,7,4891
0,0,1,0,1,0,1,4892
1,1,1,0,2,0,2,4892
2,2,1,0,3,0,3,4892
3,3,0,0,3,0,3,4892
0,0,1,0,1,0,1,4893
1,1,2,0,3,0,3,4893
2,2,2,2,5,2,7,4893
3,3,1,1,6,3,9,4893
4,4,3,1,9,4,13,4893
5,5,1,2,10,6,16,4893
6,6,1,4,11,10,21,4893
7,7,2,1,13,11,24,4893
8,8,2,0,15,11,26,4893
9,9,0,0,15,11,26,4893
0,0,1,0,1,0,1,4894
1,1,3,0,4,0,4,4894
2,2,2,0,6,0,6,4894
3,3,2,0,8,0,8,4894
4,4,1,0,9,0,9,4894
5,5,0,0,9,0,9,4894
0,0,1,0,1,0,1,4895
1,1,1,0,2,0,2,4895
2,2,1,0,3,0,3,4895
3,3,1,1,4,1,5,4895
4,4,1,1,5,2,7,4895
5,5,2,0,7,2,9,4895
6,6,1,0,8,2,10,4895
7,7,1,0,9,2,11,4895
8,8,3,1,12,3,15,4895
9,9,0,0,12,3,15,4895
0,0,1,0,1,0,1,4896
1,1,2,1,3,1,4,4896
2,2,1,3,4,4,8,4896
3,3,0,0,4,4,8,4896
0,0,1,0,1,0,1,4897
1,1,0,0,1,0,1,4897
0,0,1,0,1,0,1,4898
1,1,2,1,3,1,4,4898
2,2,3,0,6,1,7,4898
3,3,2,2,8,3,11,4898
4,4,2,0,10,3,13,4898
5,5,0,0,10,3,13,4898
0,0,1,0,1,0,1,4899
1,1,0,0,1,0,1,4899
0,0,1,0,1,0,1,4900
1,1,0,0,1,0,1,4900
0,0,1,0,1,0,1,4901
1,1,0,1,1,1,2,4901
2,2,0,0,1,1,2,4901
0,0,1,0,1,0,1,4902
1,1,0,0,1,0,1,4902
0,0,1,0,1,0,1,4903
1,1,2,0,3,0,3,4903
2,2,5,2,8,2,10,4903
3,3,5,3,13,5,18,4903
4,4,4,4,17,9,26,4903
5,5,6,2,23,11,34,4903
6,6,3,3,26,14,40,4903
7,7,4,2,30,16,46,4903
8,8,1,4,31,20,51,4903
9,9,2,4,33,24,57,4903
10,10,5,5,38,29,67,4903
11,11,5,7,43,36,79,4903
12,12,5,7,48,43,91,4903
13,13,5,7,53,50,103,4903
14,14,4,7,57,57,114,4903
15,15,7,5,64,62,126,4903
16,16,5,7,69,69,138,4903
17,17,2,5,71,74,145,4903
18,18,2,7,73,81,154,4903
19,19,4,4,77,85,162,4903
20,20,2,2,79,87,166,4903
21,21,2,0,81,87,168,4903
22,22,2,1,83,88,171,4903
23,23,1,1,84,89,173,4903
24,24,0,0,84,89,173,4903
0,0,1,0,1,0,1,4904
1,1,1,0,2,0,2,4904
2,2,1,0,3,0,3,4904
3,3,0,0,3,0,3,4904
0,0,1,0,1,0,1,4905
1,1,0,0,1,0,1,4905
0,0,1,0,1,0,1,4906
1,1,1,1,2,1,3,4906
2,2,3,0,5,1,6,4906
3,3,4,2,9,3,12,4906
4,4,2,5,11,8,19,4906
5,5,1,5,12,13,25,4906
6,6,2,1,14,14,28,4906
7,7,3,0,17,14,31,4906
8,8,0,0,17,14,31,4906
0,0,1,0,1,0,1,4907
1,1,0,0,1,0,1,4907
0,0,1,0,1,0,1,4908
1,1,0,0,1,0,1,4908
0,0,1,0,1,0,1,4909
1,1,1,0,2,0,2,4909
2,2,0,1,2,1,3,4909
3,3,0,0,2,1,3,4909
0,0,1,0,1,0,1,4910
1,1,1,0,2,0,2,4910
2,2,2,0,4,0,4,4910
3,3,3,1,7,1,8,4910
4,4,2,1,9,2,11,4910
5,5,1,1,10,3,13,4910
6,6,1,0,11,3,14,4910
7,7,1,0,12,3,15,4910
8,8,2,0,14,3,17,4910
9,9,2,0,16,3,19,4910
10,10,2,0,18,3,21,4910
11,11,1,0,19,3,22,4910
12,12,0,0,19,3,22,4910
0,0,1,0,1,0,1,4911
1,1,0,0,1,0,1,4911
0,0,1,0,1,0,1,4912
1,1,0,0,1,0,1,4912
0,0,1,0,1,0,1,4913
1,1,1,0,2,0,2,4913
2,2,0,1,2,1,3,4913
3,3,1,1,3,2,5,4913
4,4,1,0,4,2,6,4913
5,5,1,1,5,3,8,4913
6,6,1,0,6,3,9,4913
7,7,1,0,7,3,10,4913
8,8,0,0,7,3,10,4913
0,0,1,0,1,0,1,4914
1,1,0,1,1,1,2,4914
2,2,1,3,2,4,6,4914
3,3,2,4,4,8,12,4914
4,4,2,2,6,10,16,4914
5,5,3,4,9,14,23,4914
6,6,3,6,12,20,32,4914
7,7,2,8,14,28,42,4914
8,8,5,6,19,34,53,4914
9,9,9,5,28,39,67,4914
10,10,5,4,33,43,76,4914
11,11,2,6,35,49,84,4914
12,12,3,8,38,57,95,4914
13,13,6,6,44,63,107,4914
14,14,4,3,48,66,114,4914
15,15,6,2,54,68,122,4914
16,16,4,2,58,70,128,4914
17,17,4,1,62,71,133,4914
18,18,5,0,67,71,138,4914
19,19,2,0,69,71,140,4914
20,20,0,0,69,71,140,4914
0,0,1,0,1,0,1,4915
1,1,0,0,1,0,1,4915
0,0,1,0,1,0,1,4916
1,1,0,1,1,1,2,4916
2,2,0,1,1,2,3,4916
3,3,0,1,1,3,4,4916
4,4,2,0,3,3,6,4916
5,5,1,0,4,3,7,4916
6,6,0,0,4,3,7,4916
0,0,1,0,1,0,1,4917
1,1,0,0,1,0,1,4917
0,0,1,0,1,0,1,4918
1,1,0,0,1,0,1,4918
0,0,1,0,1,0,1,4919
1,1,0,0,1,0,1,4919
0,0,1,0,1,0,1,4920
1,1,0,0,1,0,1,4920
0,0,1,0,1,0,1,4921
1,1,1,1,2,1,3,4921
2,2,3,0,5,1,6,4921
3,3,1,0,6,1,7,4921
4,4,1,0,7,1,8,4921
5,5,2,0,9,1,10,4921
6,6,3,0,12,1,13,4921
7,7,2,2,14,3,17,4921
8,8,1,1,15,4,19,4921
9,9,0,1,15,5,20,4921
10,10,0,0,15,5,20,4921
0,0,1,0,1,0,1,4922
1,1,1,0,2,0,2,4922
2,2,0,0,2,0,2,4922
0,0,1,0,1,0,1,4923
1,1,1,0,2,0,2,4923
2,2,0,0,2,0,2,4923
0,0,1,0,1,0,1,4924
1,1,2,1,3,1,4,4924
2,2,1,3,4,4,8,4924
3,3,1,4,5,8,13,4924
4,4,3,2,8,10,18,4924
5,5,3,2,11,12,23,4924
6,6,1,2,12,14,26,4924
7,7,1,3,13,17,30,4924
8,8,1,3,14,20,34,4924
9,9,3,2,17,22,39,4924
10,10,4,5,21,27,48,4924
11,11,4,6,25,33,58,4924
12,12,5,6,30,39,69,4924
13,13,0,12,30,51,81,4924
14,14,1,13,31,64,95,4924
15,15,3,6,34,70,104,4924
16,16,3,2,37,72,109,4924
17,17,2,3,39,75,114,4924
18,18,2,2,41,77,118,4924
19,19,1,1,42,78,120,4924
20,20,2,0,44,78,122,4924
21,21,3,0,47,78,125,4924
22,22,0,0,47,78,125,4924
0,0,1,0,1,0,1,4925
1,1,1,0,2,0,2,4925
2,2,0,0,2,0,2,4925
0,0,1,0,1,0,1,4926
1,1,1,0,2,0,2,4926
2,2,2,0,4,0,4,4926
3,3,1,0,5,0,5,4926
4,4,1,0,6,0,6,4926
5,5,1,0,7,0,7,4926
6,6,2,2,9,2,11,4926
7,7,3,1,12,3,15,4926
8,8,2,0,14,3,17,4926
9,9,0,0,14,3,17,4926
0,0,1,0,1,0,1,4927
1,1,0,0,1,0,1,4927
0,0,1,0,1,0,1,4928
1,1,3,0,4,0,4,4928
2,2,0,0,4,0,4,4928
0,0,1,0,1,0,1,4929
1,1,0,0,1,0,1,4929
0,0,1,0,1,0,1,4930
1,1,0,0,1,0,1,4930
0,0,1,0,1,0,1,4931
1,1,1,0,2,0,2,4931
2,2,1,0,3,0,3,4931
3,3,1,2,4,2,6,4931
4,4,0,3,4,5,9,4931
5,5,0,2,4,7,11,4931
6,6,1,0,5,7,12,4931
7,7,1,1,6,8,14,4931
8,8,0,0,6,8,14,4931
0,0,1,0,1,0,1,4932
1,1,0,0,1,0,1,4932
0,0,1,0,1,0,1,4933
1,1,1,0,2,0,2,4933
2,2,0,0,2,0,2,4933
0,0,1,0,1,0,1,4934
1,1,2,0,3,0,3,4934
2,2,0,1,3,1,4,4934
3,3,1,1,4,2,6,4934
4,4,1,2,5,4,9,4934
5,5,1,1,6,5,11,4934
6,6,1,1,7,6,13,4934
7,7,0,2,7,8,15,4934
8,8,0,2,7,10,17,4934
9,9,1,3,8,13,21,4934
10,10,1,3,9,16,25,4934
11,11,0,0,9,16,25,4934
0,0,1,0,1,0,1,4935
1,1,0,0,1,0,1,4935
0,0,1,0,1,0,1,4936
1,1,1,0,2,0,2,4936
2,2,1,1,3,1,4,4936
3,3,3,1,6,2,8,4936
4,4,2,2,8,4,12,4936
5,5,5,4,13,8,21,4936
6,6,8,5,21,13,34,4936
7,7,7,5,28,18,46,4936
8,8,6,5,34,23,57,4936
9,9,7,8,41,31,72,4936
10,10,6,3,47,34,81,4936
11,11,2,0,49,34,83,4936
12,12,3,1,52,35,87,4936
13,13,2,1,54,36,90,4936
14,14,1,2,55,38,93,4936
15,15,1,1,56,39,95,4936
16,16,2,0,58,39,97,4936
17,17,1,0,59,39,98,4936
18,18,0,0,59,39,98,4936
0,0,1,0,1,0,1,4937
1,1,2,1,3,1,4,4937
2,2,4,0,7,1,8,4937
3,3,2,1,9,2,11,4937
4,4,2,3,11,5,16,4937
5,5,3,0,14,5,19,4937
6,6,1,1,15,6,21,4937
7,7,0,1,15,7,22,4937
8,8,0,1,15,8,23,4937
9,9,0,0,15,8,23,4937
0,0,1,0,1,0,1,4938
1,1,1,0,2,0,2,4938
2,2,0,0,2,0,2,4938
0,0,1,0,1,0,1,4939
1,1,1,0,2,0,2,4939
2,2,2,0,4,0,4,4939
3,3,2,0,6,0,6,4939
4,4,0,0,6,0,6,4939
0,0,1,0,1,0,1,4940
1,1,1,0,2,0,2,4940
2,2,2,0,4,0,4,4940
3,3,1,1,5,1,6,4940
4,4,1,0,6,1,7,4940
5,5,0,0,6,1,7,4940
0,0,1,0,1,0,1,4941
1,1,0,0,1,0,1,4941
0,0,1,0,1,0,1,4942
1,1,2,0,3,0,3,4942
2,2,1,1,4,1,5,4942
3,3,1,2,5,3,8,4942
4,4,1,1,6,4,10,4942
5,5,0,1,6,5,11,4942
6,6,1,1,7,6,13,4942
7,7,1,2,8,8,16,4942
8,8,1,0,9,8,17,4942
9,9,2,0,11,8,19,4942
10,10,1,0,12,8,20,4942
11,11,0,0,12,8,20,4942
0,0,1,0,1,0,1,4943
1,1,1,0,2,0,2,4943
2,2,0,0,2,0,2,4943
0,0,1,0,1,0,1,4944
1,1,0,1,1,1,2,4944
2,2,0,0,1,1,2,4944
0,0,1,0,1,0,1,4945
1,1,0,1,1,1,2,4945
2,2,0,0,1,1,2,4945
0,0,1,0,1,0,1,4946
1,1,2,2,3,2,5,4946
2,2,0,3,3,5,8,4946
3,3,1,2,4,7,11,4946
4,4,1,1,5,8,13,4946
5,5,0,3,5,11,16,4946
6,6,0,3,5,14,19,4946
7,7,0,0,5,14,19,4946
0,0,1,0,1,0,1,4947
1,1,0,0,1,0,1,4947
0,0,1,0,1,0,1,4948
1,1,1,0,2,0,2,4948
2,2,1,0,3,0,3,4948
3,3,2,0,5,0,5,4948
4,4,4,0,9,0,9,4948
5,5,3,1,12,1,13,4948
6,6,2,1,14,2,16,4948
7,7,1,2,15,4,19,4948
8,8,0,2,15,6,21,4948
9,9,0,5,15,11,26,4948
10,10,0,3,15,14,29,4948
11,11,0,3,15,17,32,4948
12,12,1,1,16,18,34,4948
13,13,0,0,16,18,34,4948
0,0,1,0,1,0,1,4949
1,1,1,0,2,0,2,4949
2,2,1,0,3,0,3,4949
3,3,1,0,4,0,4,4949
4,4,1,0,5,0,5,4949
5,5,0,0,5,0,5,4949
0,0,1,0,1,0,1,4950
1,1,0,0,1,0,1,4950
0,0,1,0,1,0,1,4951
1,1,0,0,1,0,1,4951
0,0,1,0,1,0,1,4952
1,1,0,0,1,0,1,4952
0,0,1,0,1,0,1,4953
1,1,1,0,2,0,2,4953
2,2,2,0,4,0,4,4953
3,3,3,0,7,0,7,4953
4,4,1,0,8,0,8,4953
5,5,1,0,9,0,9,4953
6,6,0,0,9,0,9,4953
0,0,1,0,1,0,1,4954
1,1,0,0,1,0,1,4954
0,0,1,0,1,0,1,4955
1,1,1,0,2,0,2,4955
2,2,0,0,2,0,2,4955
0,0,1,0,1,0,1,4956
1,1,1,0,2,0,2,4956
2,2,1,0,3,0,3,4956
3,3,0,0,3,0,3,4956
0,0,1,0,1,0,1,4957
1,1,0,0,1,0,1,4957
0,0,1,0,1,0,1,4958
1,1,1,0,2,0,2,4958
2,2,1,0,3,0,3,4958
3,3,0,0,3,0,3,4958
0,0,1,0,1,0,1,4959
1,1,0,1,1,1,2,4959
2,2,0,3,1,4,5,4959
3,3,0,3,1,7,8,4959
4,4,0,1,1,8,9,4959
5,5,0,0,1,8,9,4959
0,0,1,0,1,0,1,4960
1,1,1,0,2,0,2,4960
2,2,0,0,2,0,2,4960
0,0,1,0,1,0,1,4961
1,1,1,0,2,0,2,4961
2,2,0,0,2,0,2,4961
0,0,1,0,1,0,1,4962
1,1,0,1,1,1,2,4962
2,2,0,0,1,1,2,4962
0,0,1,0,1,0,1,4963
1,1,0,0,1,0,1,4963
0,0,1,0,1,0,1,4964
1,1,1,0,2,0,2,4964
2,2,0,1,2,1,3,4964
3,3,0,0,2,1,3,4964
0,0,1,0,1,0,1,4965
1,1,0,0,1,0,1,4965
0,0,1,0,1,0,1,4966
1,1,1,0,2,0,2,4966
2,2,0,0,2,0,2,4966
0,0,1,0,1,0,1,4967
1,1,1,0,2,0,2,4967
2,2,0,0,2,0,2,4967
0,0,1,0,1,0,1,4968
1,1,0,0,1,0,1,4968
0,0,1,0,1,0,1,4969
1,1,0,0,1,0,1,4969
0,0,1,0,1,0,1,4970
1,1,0,0,1,0,1,4970
0,0,1,0,1,0,1,4971
1,1,0,0,1,0,1,4971
0,0,1,0,1,0,1,4972
1,1,0,0,1,0,1,4972
0,0,1,0,1,0,1,4973
1,1,1,0,2,0,2,4973
2,2,0,0,2,0,2,4973
0,0,1,0,1,0,1,4974
1,1,0,0,1,0,1,4974
0,0,1,0,1,0,1,4975
1,1,0,0,1,0,1,4975
0,0,1,0,1,0,1,4976
1,1,1,0,2,0,2,4976
2,2,0,0,2,0,2,4976
0,0,1,0,1,0,1,4977
1,1,0,0,1,0,1,4977
0,0,1,0,1,0,1,4978
1,1,1,1,2,1,3,4978
2,2,1,3,3,4,7,4978
3,3,0,1,3,5,8,4978
4,4,0,1,3,6,9,4978
5,5,0,3,3,9,12,4978
6,6,0,3,3,12,15,4978
7,7,0,3,3,15,18,4978
8,8,1,2,4,17,21,4978
9,9,2,1,6,18,24,4978
10,10,2,1,8,19,27,4978
11,11,2,0,10,19,29,4978
12,12,5,0,15,19,34,4978
13,13,5,0,20,19,39,4978
14,14,4,1,24,20,44,4978
15,15,2,1,26,21,47,4978
16,16,3,0,29,21,50,4978
17,17,1,1,30,22,52,4978
18,18,0,2,30,24,54,4978
19,19,0,0,30,24,54,4978
0,0,1,0,1,0,1,4979
1,1,0,0,1,0,1,4979
0,0,1,0,1,0,1,4980
1,1,1,0,2,0,2,4980
2,2,1,2,3,2,5,4980
3,3,0,3,3,5,8,4980
4,4,0,3,3,8,11,4980
5,5,1,1,4,9,13,4980
6,6,0,1,4,10,14,4980
7,7,1,0,5,10,15,4980
8,8,1,0,6,10,16,4980
9,9,1,0,7,10,17,4980
10,10,1,0,8,10,18,4980
11,11,1,0,9,10,19,4980
12,12,1,1,10,11,21,4980
13,13,2,2,12,13,25,4980
14,14,3,5,15,18,33,4980
15,15,2,7,17,25,42,4980
16,16,2,8,19,33,52,4980
17,17,5,9,24,42,66,4980
18,18,5,5,29,47,76,4980
19,19,5,5,34,52,86,4980
20,20,3,10,37,62,99,4980
21,21,2,8,39,70,109,4980
22,22,5,5,44,75,119,4980
23,23,6,2,50,77,127,4980
24,24,2,2,52,79,131,4980
25,25,2,5,54,84,138,4980
26,26,6,4,60,88,148,4980
27,27,5,6,65,94,159,4980
28,28,3,4,68,98,166,4980
29,29,2,1,70,99,169,4980
30,30,2,0,72,99,171,4980
31,31,2,0,74,99,173,4980
32,32,2,2,76,101,177,4980
33,33,1,1,77,102,179,4980
34,34,0,2,77,104,181,4980
35,35,0,1,77,105,182,4980
36,36,0,0,77,105,182,4980
0,0,1,0,1,0,1,4981
1,1,2,0,3,0,3,4981
2,2,2,1,5,1,6,4981
3,3,2,1,7,2,9,4981
4,4,1,1,8,3,11,4981
5,5,2,0,10,3,13,4981
6,6,0,0,10,3,13,4981
0,0,1,0,1,0,1,4982
1,1,1,0,2,0,2,4982
2,2,0,0,2,0,2,4982
0,0,1,0,1,0,1,4983
1,1,2,0,3,0,3,4983
2,2,0,0,3,0,3,4983
0,0,1,0,1,0,1,4984
1,1,1,2,2,2,4,4984
2,2,3,3,5,5,10,4984
3,3,1,0,6,5,11,4984
4,4,0,0,6,5,11,4984
0,0,1,0,1,0,1,4985
1,1,0,0,1,0,1,4985
0,0,1,0,1,0,1,4986
1,1,1,0,2,0,2,4986
2,2,1,0,3,0,3,4986
3,3,1,0,4,0,4,4986
4,4,0,1,4,1,5,4986
5,5,0,1,4,2,6,4986
6,6,0,1,4,3,7,4986
7,7,0,0,4,3,7,4986
0,0,1,0,1,0,1,4987
1,1,0,0,1,0,1,4987
0,0,1,0,1,0,1,4988
1,1,0,1,1,1,2,4988
2,2,0,0,1,1,2,4988
0,0,1,0,1,0,1,4989
1,1,0,0,1,0,1,4989
0,0,1,0,1,0,1,4990
1,1,1,0,2,0,2,4990
2,2,1,0,3,0,3,4990
3,3,0,0,3,0,3,4990
0,0,1,0,1,0,1,4991
1,1,3,0,4,0,4,4991
2,2,6,0,10,0,10,4991
3,3,3,0,13,0,13,4991
4,4,2,0,15,0,15,4991
5,5,0,0,15,0,15,4991
0,0,1,0,1,0,1,4992
1,1,1,0,2,0,2,4992
2,2,1,0,3,0,3,4992
3,3,1,0,4,0,4,4992
4,4,2,0,6,0,6,4992
5,5,1,0,7,0,7,4992
6,6,0,0,7,0,7,4992
0,0,1,0,1,0,1,4993
1,1,0,0,1,0,1,4993
0,0,1,0,1,0,1,4994
1,1,1,0,2,0,2,4994
2,2,2,1,4,1,5,4994
3,3,2,0,6,1,7,4994
4,4,1,1,7,2,9,4994
5,5,0,2,7,4,11,4994
6,6,0,2,7,6,13,4994
7,7,0,2,7,8,15,4994
8,8,1,1,8,9,17,4994
9,9,0,0,8,9,17,4994
0,0,1,0,1,0,1,4995
1,1,1,1,2,1,3,4995
2,2,0,0,2,1,3,4995
0,0,1,0,1,0,1,4996
1,1,0,0,1,0,1,4996
0,0,1,0,1,0,1,4997
1,1,0,0,1,0,1,4997
0,0,1,0,1,0,1,4998
1,1,3,0,4,0,4,4998
2,2,0,1,4,1,5,4998
3,3,0,0,4,1,5,4998
0,0,1,0,1,0,1,4999
1,1,0,0,1,0,1,4999
0,0,1,0,1,0,1,5000
1,1,0,0,1,0,1,5000
0,0,1,0,1,0,1,5001
1,1,0,0,1,0,1,5001
0,0,1,0,1,0,1,5002
1,1,0,0,1,0,1,5002
0,0,1,0,1,0,1,5003
1,1,1,0,2,0,2,5003
2,2,0,0,2,0,2,5003
0,0,1,0,1,0,1,5004
1,1,0,0,1,0,1,5004
0,0,1,0,1,0,1,5005
1,1,0,0,1,0,1,5005
0,0,1,0,1,0,1,5006
1,1,1,0,2,0,2,5006
2,2,0,0,2,0,2,5006
0,0,1,0,1,0,1,5007
1,1,1,0,2,0,2,5007
2,2,0,0,2,0,2,5007
0,0,1,0,1,0,1,5008
1,1,0,0,1,0,1,5008
0,0,1,0,1,0,1,5009
1,1,1,0,2,0,2,5009
2,2,2,0,4,0,4,5009
3,3,0,2,4,2,6,5009
4,4,0,3,4,5,9,5009
5,5,2,4,6,9,15,5009
6,6,3,1,9,10,19,5009
7,7,5,0,14,10,24,5009
8,8,6,2,20,12,32,5009
9,9,5,0,25,12,37,5009
10,10,1,2,26,14,40,5009
11,11,0,1,26,15,41,5009
12,12,0,0,26,15,41,5009
0,0,1,0,1,0,1,5010
1,1,1,0,2,0,2,5010
2,2,2,0,4,0,4,5010
3,3,3,2,7,2,9,5010
4,4,1,4,8,6,14,5010
5,5,3,1,11,7,18,5010
6,6,2,0,13,7,20,5010
7,7,2,0,15,7,22,5010
8,8,0,2,15,9,24,5010
9,9,0,2,15,11,26,5010
10,10,0,6,15,17,32,5010
11,11,1,7,16,24,40,5010
12,12,0,3,16,27,43,5010
13,13,1,2,17,29,46,5010
14,14,0,0,17,29,46,5010
0,0,1,0,1,0,1,5011
1,1,0,0,1,0,1,5011
0,0,1,0,1,0,1,5012
1,1,1,0,2,0,2,5012
2,2,2,0,4,0,4,5012
3,3,2,1,6,1,7,5012
4,4,3,1,9,2,11,5012
5,5,0,1,9,3,12,5012
6,6,0,0,9,3,12,5012
0,0,1,0,1,0,1,5013
1,1,0,1,1,1,2,5013
2,2,0,2,1,3,4,5013
3,3,0,1,1,4,5,5013
4,4,0,2,1,6,7,5013
5,5,0,0,1,6,7,5013
0,0,1,0,1,0,1,5014
1,1,1,0,2,0,2,5014
2,2,0,0,2,0,2,5014
0,0,1,0,1,0,1,5015
1,1,0,2,1,2,3,5015
2,2,0,3,1,5,6,5015
3,3,0,2,1,7,8,5015
4,4,0,0,1,7,8,5015
0,0,1,0,1,0,1,5016
1,1,0,0,1,0,1,5016
0,0,1,0,1,0,1,5017
1,1,1,0,2,0,2,5017
2,2,1,0,3,0,3,5017
3,3,0,0,3,0,3,5017
0,0,1,0,1,0,1,5018
1,1,0,0,1,0,1,5018
0,0,1,0,1,0,1,5019
1,1,0,0,1,0,1,5019
0,0,1,0,1,0,1,5020
1,1,0,1,1,1,2,5020
2,2,0,2,1,3,4,5020
3,3,1,1,2,4,6,5020
4,4,2,1,4,5,9,5020
5,5,1,0,5,5,10,5020
6,6,4,0,9,5,14,5020
7,7,2,0,11,5,16,5020
8,8,0,1,11,6,17,5020
9,9,0,2,11,8,19,5020
10,10,1,2,12,10,22,5020
11,11,3,0,15,10,25,5020
12,12,1,0,16,10,26,5020
13,13,0,0,16,10,26,5020
0,0,1,0,1,0,1,5021
1,1,0,0,1,0,1,5021
0,0,1,0,1,0,1,5022
1,1,3,0,4,0,4,5022
2,2,2,1,6,1,7,5022
3,3,3,0,9,1,10,5022
4,4,1,1,10,2,12,5022
5,5,0,0,10,2,12,5022
0,0,1,0,1,0,1,5023
1,1,1,0,2,0,2,5023
2,2,0,0,2,0,2,5023
0,0,1,0,1,0,1,5024
1,1,2,1,3,1,4,5024
2,2,0,2,3,3,6,5024
3,3,0,2,3,5,8,5024
4,4,1,4,4,9,13,5024
5,5,0,1,4,10,14,5024
6,6,0,2,4,12,16,5024
7,7,0,0,4,12,16,5024
0,0,1,0,1,0,1,5025
1,1,2,0,3,0,3,5025
2,2,0,1,3,1,4,5025
3,3,0,0,3,1,4,5025
0,0,1,0,1,0,1,5026
1,1,0,1,1,1,2,5026
2,2,0,0,1,1,2,5026
0,0,1,0,1,0,1,5027
1,1,0,0,1,0,1,5027
0,0,1,0,1,0,1,5028
1,1,1,0,2,0,2,5028
2,2,0,1,2,1,3,5028
3,3,0,0,2,1,3,5028
0,0,1,0,1,0,1,5029
1,1,0,0,1,0,1,5029
0,0,1,0,1,0,1,5030
1,1,0,0,1,0,1,5030
0,0,1,0,1,0,1,5031
1,1,1,1,2,1,3,5031
2,2,0,2,2,3,5,5031
3,3,0,2,2,5,7,5031
4,4,0,2,2,7,9,5031
5,5,0,2,2,9,11,5031
6,6,1,1,3,10,13,5031
7,7,1,1,4,11,15,5031
8,8,0,1,4,12,16,5031
9,9,0,1,4,13,17,5031
10,10,0,1,4,14,18,5031
11,11,0,1,4,15,19,5031
12,12,1,0,5,15,20,5031
13,13,0,0,5,15,20,5031
0,0,1,0,1,0,1,5032
1,1,0,0,1,0,1,5032
0,0,1,0,1,0,1,5033
1,1,2,0,3,0,3,5033
2,2,1,1,4,1,5,5033
3,3,1,3,5,4,9,5033
4,4,1,0,6,4,10,5033
5,5,1,0,7,4,11,5033
6,6,1,0,8,4,12,5033
7,7,1,1,9,5,14,5033
8,8,1,1,10,6,16,5033
9,9,1,0,11,6,17,5033
10,10,1,0,12,6,18,5033
11,11,0,0,12,6,18,5033
0,0,1,0,1,0,1,5034
1,1,2,0,3,0,3,5034
2,2,3,0,6,0,6,5034
3,3,3,0,9,0,9,5034
4,4,2,2,11,2,13,5034
5,5,0,3,11,5,16,5034
6,6,2,2,13,7,20,5034
7,7,2,1,15,8,23,5034
8,8,1,0,16,8,24,5034
9,9,1,0,17,8,25,5034
10,10,0,0,17,8,25,5034
0,0,1,0,1,0,1,5035
1,1,1,0,2,0,2,5035
2,2,0,0,2,0,2,5035
0,0,1,0,1,0,1,5036
1,1,0,1,1,1,2,5036
2,2,0,1,1,2,3,5036
3,3,0,1,1,3,4,5036
4,4,0,2,1,5,6,5036
5,5,0,2,1,7,8,5036
6,6,0,2,1,9,10,5036
7,7,0,1,1,10,11,5036
8,8,0,1,1,11,12,5036
9,9,0,1,1,12,13,5036
10,10,1,0,2,12,14,5036
11,11,1,0,3,12,15,5036
12,12,2,0,5,12,17,5036
13,13,0,1,5,13,18,5036
14,14,0,1,5,14,19,5036
15,15,2,0,7,14,21,5036
16,16,0,0,7,14,21,5036
0,0,1,0,1,0,1,5037
1,1,1,0,2,0,2,5037
2,2,0,0,2,0,2,5037
0,0,1,0,1,0,1,5038
1,1,0,0,1,0,1,5038
0,0,1,0,1,0,1,5039
1,1,1,0,2,0,2,5039
2,2,0,1,2,1,3,5039
3,3,0,1,2,2,4,5039
4,4,1,1,3,3,6,5039
5,5,1,2,4,5,9,5039
6,6,1,1,5,6,11,5039
7,7,2,0,7,6,13,5039
8,8,1,0,8,6,14,5039
9,9,0,0,8,6,14,5039
0,0,1,0,1,0,1,5040
1,1,0,1,1,1,2,5040
2,2,0,0,1,1,2,5040
0,0,1,0,1,0,1,5041
1,1,1,0,2,0,2,5041
2,2,0,0,2,0,2,5041
0,0,1,0,1,0,1,5042
1,1,1,0,2,0,2,5042
2,2,0,0,2,0,2,5042
0,0,1,0,1,0,1,5043
1,1,0,0,1,0,1,5043
0,0,1,0,1,0,1,5044
1,1,2,0,3,0,3,5044
2,2,2,0,5,0,5,5044
3,3,1,0,6,0,6,5044
4,4,1,0,7,0,7,5044
5,5,0,0,7,0,7,5044
0,0,1,0,1,0,1,5045
1,1,1,0,2,0,2,5045
2,2,2,0,4,0,4,5045
3,3,1,1,5,1,6,5045
4,4,0,1,5,2,7,5045
5,5,0,1,5,3,8,5045
6,6,0,1,5,4,9,5045
7,7,0,2,5,6,11,5045
8,8,0,0,5,6,11,5045
0,0,1,0,1,0,1,5046
1,1,0,0,1,0,1,5046
0,0,1,0,1,0,1,5047
1,1,1,1,2,1,3,5047
2,2,1,0,3,1,4,5047
3,3,0,1,3,2,5,5047
4,4,0,1,3,3,6,5047
5,5,1,1,4,4,8,5047
6,6,0,0,4,4,8,5047
0,0,1,0,1,0,1,5048
1,1,0,0,1,0,1,5048
0,0,1,0,1,0,1,5049
1,1,1,0,2,0,2,5049
2,2,2,0,4,0,4,5049
3,3,0,0,4,0,4,5049
0,0,1,0,1,0,1,5050
1,1,3,0,4,0,4,5050
2,2,3,0,7,0,7,5050
3,3,3,1,10,1,11,5050
4,4,2,0,12,1,13,5050
5,5,2,0,14,1,15,5050
6,6,2,1,16,2,18,5050
7,7,2,1,18,3,21,5050
8,8,0,2,18,5,23,5050
9,9,0,1,18,6,24,5050
10,10,0,0,18,6,24,5050
0,0,1,0,1,0,1,5051
1,1,0,0,1,0,1,5051
0,0,1,0,1,0,1,5052
1,1,0,0,1,0,1,5052
0,0,1,0,1,0,1,5053
1,1,4,1,5,1,6,5053
2,2,1,3,6,4,10,5053
3,3,0,4,6,8,14,5053
4,4,0,0,6,8,14,5053
0,0,1,0,1,0,1,5054
1,1,1,0,2,0,2,5054
2,2,1,0,3,0,3,5054
3,3,2,0,5,0,5,5054
4,4,1,0,6,0,6,5054
5,5,0,0,6,0,6,5054
0,0,1,0,1,0,1,5055
1,1,1,0,2,0,2,5055
2,2,1,1,3,1,4,5055
3,3,1,0,4,1,5,5055
4,4,0,0,4,1,5,5055
0,0,1,0,1,0,1,5056
1,1,0,0,1,0,1,5056
0,0,1,0,1,0,1,5057
1,1,4,1,5,1,6,5057
2,2,1,1,6,2,8,5057
3,3,1,2,7,4,11,5057
4,4,1,1,8,5,13,5057
5,5,1,4,9,9,18,5057
6,6,2,2,11,11,22,5057
7,7,2,2,13,13,26,5057
8,8,0,3,13,16,29,5057
9,9,1,2,14,18,32,5057
10,10,5,2,19,20,39,5057
11,11,1,0,20,20,40,5057
12,12,0,0,20,20,40,5057
0,0,1,0,1,0,1,5058
1,1,1,0,2,0,2,5058
2,2,0,0,2,0,2,5058
0,0,1,0,1,0,1,5059
1,1,0,0,1,0,1,5059
0,0,1,0,1,0,1,5060
1,1,3,0,4,0,4,5060
2,2,2,1,6,1,7,5060
3,3,3,1,9,2,11,5060
4,4,0,2,9,4,13,5060
5,5,0,2,9,6,15,5060
6,6,0,1,9,7,16,5060
7,7,0,0,9,7,16,5060
0,0,1,0,1,0,1,5061
1,1,1,0,2,0,2,5061
2,2,1,0,3,0,3,5061
3,3,0,1,3,1,4,5061
4,4,0,1,3,2,5,5061
5,5,0,2,3,4,7,5061
6,6,0,1,3,5,8,5061
7,7,0,1,3,6,9,5061
8,8,1,0,4,6,10,5061
9,9,1,0,5,6,11,5061
10,10,2,0,7,6,13,5061
11,11,0,0,7,6,13,5061
0,0,1,0,1,0,1,5062
1,1,2,0,3,0,3,5062
2,2,1,1,4,1,5,5062
3,3,1,2,5,3,8,5062
4,4,1,3,6,6,12,5062
5,5,1,4,7,10,17,5062
6,6,0,5,7,15,22,5062
7,7,1,3,8,18,26,5062
8,8,2,3,10,21,31,5062
9,9,1,1,11,22,33,5062
10,10,2,1,13,23,36,5062
11,11,0,0,13,23,36,5062
0,0,1,0,1,0,1,5063
1,1,0,1,1,1,2,5063
2,2,0,0,1,1,2,5063
0,0,1,0,1,0,1,5064
1,1,0,0,1,0,1,5064
0,0,1,0,1,0,1,5065
1,1,0,0,1,0,1,5065
0,0,1,0,1,0,1,5066
1,1,1,0,2,0,2,5066
2,2,1,0,3,0,3,5066
3,3,0,0,3,0,3,5066
0,0,1,0,1,0,1,5067
1,1,2,0,3,0,3,5067
2,2,0,0,3,0,3,5067
0,0,1,0,1,0,1,5068
1,1,0,0,1,0,1,5068
0,0,1,0,1,0,1,5069
1,1,0,0,1,0,1,5069
0,0,1,0,1,0,1,5070
1,1,1,0,2,0,2,5070
2,2,0,0,2,0,2,5070
0,0,1,0,1,0,1,5071
1,1,0,0,1,0,1,5071
0,0,1,0,1,0,1,5072
1,1,1,0,2,0,2,5072
2,2,1,0,3,0,3,5072
3,3,1,0,4,0,4,5072
4,4,3,0,7,0,7,5072
5,5,3,0,10,0,10,5072
6,6,2,1,12,1,13,5072
7,7,2,5,14,6,20,5072
8,8,2,5,16,11,27,5072
9,9,2,3,18,14,32,5072
10,10,1,1,19,15,34,5072
11,11,2,0,21,15,36,5072
12,12,1,0,22,15,37,5072
13,13,0,0,22,15,37,5072
0,0,1,0,1,0,1,5073
1,1,1,1,2,1,3,5073
2,2,0,0,2,1,3,5073
0,0,1,0,1,0,1,5074
1,1,2,0,3,0,3,5074
2,2,2,0,5,0,5,5074
3,3,0,0,5,0,5,5074
0,0,1,0,1,0,1,5075
1,1,0,0,1,0,1,5075
0,0,1,0,1,0,1,5076
1,1,2,0,3,0,3,5076
2,2,2,0,5,0,5,5076
3,3,2,0,7,0,7,5076
4,4,2,0,9,0,9,5076
5,5,3,0,12,0,12,5076
6,6,2,1,14,1,15,5076
7,7,3,0,17,1,18,5076
8,8,1,1,18,2,20,5076
9,9,0,0,18,2,20,5076
0,0,1,0,1,0,1,5077
1,1,2,1,3,1,4,5077
2,2,0,1,3,2,5,5077
3,3,0,0,3,2,5,5077
0,0,1,0,1,0,1,5078
1,1,0,0,1,0,1,5078
0,0,1,0,1,0,1,5079
1,1,0,0,1,0,1,5079
0,0,1,0,1,0,1,5080
1,1,0,0,1,0,1,5080
0,0,1,0,1,0,1,5081
1,1,0,1,1,1,2,5081
2,2,0,1,1,2,3,5081
3,3,0,0,1,2,3,5081
0,0,1,0,1,0,1,5082
1,1,2,0,3,0,3,5082
2,2,1,1,4,1,5,5082
3,3,1,0,5,1,6,5082
4,4,1,0,6,1,7,5082
5,5,0,0,6,1,7,5082
0,0,1,0,1,0,1,5083
1,1,1,0,2,0,2,5083
2,2,1,0,3,0,3,5083
3,3,1,0,4,0,4,5083
4,4,1,0,5,0,5,5083
5,5,4,0,9,0,9,5083
6,6,3,2,12,2,14,5083
7,7,2,3,14,5,19,5083
8,8,1,3,15,8,23,5083
9,9,0,0,15,8,23,5083
0,0,1,0,1,0,1,5084
1,1,0,0,1,0,1,5084
0,0,1,0,1,0,1,5085
1,1,1,0,2,0,2,5085
2,2,1,0,3,0,3,5085
3,3,0,0,3,0,3,5085
0,0,1,0,1,0,1,5086
1,1,1,0,2,0,2,5086
2,2,1,0,3,0,3,5086
3,3,0,0,3,0,3,5086
0,0,1,0,1,0,1,5087
1,1,0,0,1,0,1,5087
0,0,1,0,1,0,1,5088
1,1,0,0,1,0,1,5088
0,0,1,0,1,0,1,5089
1,1,1,0,2,0,2,5089
2,2,0,1,2,1,3,5089
3,3,0,0,2,1,3,5089
0,0,1,0,1,0,1,5090
1,1,0,1,1,1,2,5090
2,2,0,1,1,2,3,5090
3,3,0,2,1,4,5,5090
4,4,1,2,2,6,8,5090
5,5,2,1,4,7,11,5090
6,6,3,0,7,7,14,5090
7,7,1,0,8,7,15,5090
8,8,0,0,8,7,15,5090
0,0,1,0,1,0,1,5091
1,1,1,0,2,0,2,5091
2,2,0,0,2,0,2,5091
0,0,1,0,1,0,1,5092
1,1,1,0,2,0,2,5092
2,2,0,0,2,0,2,5092
0,0,1,0,1,0,1,5093
1,1,1,0,2,0,2,5093
2,2,0,1,2,1,3,5093
3,3,0,1,2,2,4,5093
4,4,0,1,2,3,5,5093
5,5,1,0,3,3,6,5093
6,6,1,0,4,3,7,5093
7,7,1,0,5,3,8,5093
8,8,1,0,6,3,9,5093
9,9,0,0,6,3,9,5093
0,0,1,0,1,0,1,5094
1,1,0,0,1,0,1,5094
0,0,1,0,1,0,1,5095
1,1,0,0,1,0,1,5095
0,0,1,0,1,0,1,5096
1,1,3,0,4,0,4,5096
2,2,1,2,5,2,7,5096
3,3,0,0,5,2,7,5096
0,0,1,0,1,0,1,5097
1,1,2,1,3,1,4,5097
2,2,3,0,6,1,7,5097
3,3,4,0,10,1,11,5097
4,4,2,1,12,2,14,5097
5,5,2,0,14,2,16,5097
6,6,1,0,15,2,17,5097
7,7,0,0,15,2,17,5097
0,0,1,0,1,0,1,5098
1,1,1,0,2,0,2,5098
2,2,0,0,2,0,2,5098
0,0,1,0,1,0,1,5099
1,1,0,0,1,0,1,5099
0,0,1,0,1,0,1,5100
1,1,0,0,1,0,1,5100
0,0,1,0,1,0,1,5101
1,1,0,0,1,0,1,5101
0,0,1,0,1,0,1,5102
1,1,0,0,1,0,1,5102
0,0,1,0,1,0,1,5103
1,1,0,0,1,0,1,5103
0,0,1,0,1,0,1,5104
1,1,1,0,2,0,2,5104
2,2,0,0,2,0,2,5104
0,0,1,0,1,0,1,5105
1,1,0,0,1,0,1,5105
0,0,1,0,1,0,1,5106
1,1,0,0,1,0,1,5106
0,0,1,0,1,0,1,5107
1,1,0,0,1,0,1,5107
0,0,1,0,1,0,1,5108
1,1,1,0,2,0,2,5108
2,2,0,0,2,0,2,5108
0,0,1,0,1,0,1,5109
1,1,0,0,1,0,1,5109
0,0,1,0,1,0,1,5110
1,1,1,0,2,0,2,5110
2,2,3,0,5,0,5,5110
3,3,3,0,8,0,8,5110
4,4,3,0,11,0,11,5110
5,5,1,2,12,2,14,5110
6,6,0,0,12,2,14,5110
0,0,1,0,1,0,1,5111
1,1,0,0,1,0,1,5111
0,0,1,0,1,0,1,5112
1,1,0,0,1,0,1,5112
0,0,1,0,1,0,1,5113
1,1,0,0,1,0,1,5113
0,0,1,0,1,0,1,5114
1,1,0,0,1,0,1,5114
0,0,1,0,1,0,1,5115
1,1,0,0,1,0,1,5115
0,0,1,0,1,0,1,5116
1,1,1,0,2,0,2,5116
2,2,2,0,4,0,4,5116
3,3,0,0,4,0,4,5116
0,0,1,0,1,0,1,5117
1,1,1,0,2,0,2,5117
2,2,0,0,2,0,2,5117
0,0,1,0,1,0,1,5118
1,1,2,1,3,1,4,5118
2,2,2,0,5,1,6,5118
3,3,4,0,9,1,10,5118
4,4,3,3,12,4,16,5118
5,5,1,4,13,8,21,5118
6,6,1,1,14,9,23,5118
7,7,2,0,16,9,25,5118
8,8,2,0,18,9,27,5118
9,9,0,0,18,9,27,5118
0,0,1,0,1,0,1,5119
1,1,0,1,1,1,2,5119
2,2,2,1,3,2,5,5119
3,3,1,3,4,5,9,5119
4,4,1,5,5,10,15,5119
5,5,2,5,7,15,22,5119
6,6,2,4,9,19,28,5119
7,7,0,5,9,24,33,5119
8,8,3,3,12,27,39,5119
9,9,3,2,15,29,44,5119
10,10,7,1,22,30,52,5119
11,11,1,2,23,32,55,5119
12,12,0,1,23,33,56,5119
13,13,0,0,23,33,56,5119
0,0,1,0,1,0,1,5120
1,1,1,0,2,0,2,5120
2,2,0,0,2,0,2,5120
0,0,1,0,1,0,1,5121
1,1,0,0,1,0,1,5121
0,0,1,0,1,0,1,5122
1,1,0,1,1,1,2,5122
2,2,0,0,1,1,2,5122
0,0,1,0,1,0,1,5123
1,1,2,0,3,0,3,5123
2,2,4,1,7,1,8,5123
3,3,4,0,11,1,12,5123
4,4,7,2,18,3,21,5123
5,5,6,2,24,5,29,5123
6,6,3,0,27,5,32,5123
7,7,2,0,29,5,34,5123
8,8,0,1,29,6,35,5123
9,9,0,1,29,7,36,5123
10,10,1,0,30,7,37,5123
11,11,0,1,30,8,38,5123
12,12,0,2,30,10,40,5123
13,13,0,2,30,12,42,5123
14,14,1,1,31,13,44,5123
15,15,1,1,32,14,46,5123
16,16,0,0,32,14,46,5123
0,0,1,0,1,0,1,5124
1,1,2,0,3,0,3,5124
2,2,2,0,5,0,5,5124
3,3,3,0,8,0,8,5124
4,4,2,0,10,0,10,5124
5,5,2,0,12,0,12,5124
6,6,2,1,14,1,15,5124
7,7,1,1,15,2,17,5124
8,8,2,1,17,3,20,5124
9,9,1,1,18,4,22,5124
10,10,0,0,18,4,22,5124
0,0,1,0,1,0,1,5125
1,1,4,0,5,0,5,5125
2,2,6,2,11,2,13,5125
3,3,4,4,15,6,21,5125
4,4,5,3,20,9,29,5125
5,5,4,6,24,15,39,5125
6,6,2,3,26,18,44,5125
7,7,2,1,28,19,47,5125
8,8,0,3,28,22,50,5125
9,9,0,4,28,26,54,5125
10,10,0,1,28,27,55,5125
11,11,0,1,28,28,56,5125
12,12,0,1,28,29,57,5125
13,13,1,1,29,30,59,5125
14,14,1,1,30,31,61,5125
15,15,5,1,35,32,67,5125
16,16,4,2,39,34,73,5125
17,17,3,6,42,40,82,5125
18,18,4,7,46,47,93,5125
19,19,5,6,51,53,104,5125
20,20,6,3,57,56,113,5125
21,21,8,3,65,59,124,5125
22,22,8,3,73,62,135,5125
23,23,3,5,76,67,143,5125
24,24,5,4,81,71,152,5125
25,25,2,4,83,75,158,5125
26,26,3,2,86,77,163,5125
27,27,2,2,88,79,167,5125
28,28,0,0,88,79,167,5125
0,0,1,0,1,0,1,5126
1,1,0,0,1,0,1,5126
0,0,1,0,1,0,1,5127
1,1,2,0,3,0,3,5127
2,2,0,0,3,0,3,5127
0,0,1,0,1,0,1,5128
1,1,2,0,3,0,3,5128
2,2,3,0,6,0,6,5128
3,3,0,1,6,1,7,5128
4,4,0,2,6,3,9,5128
5,5,1,2,7,5,12,5128
6,6,0,1,7,6,13,5128
7,7,0,0,7,6,13,5128
0,0,1,0,1,0,1,5129
1,1,1,0,2,0,2,5129
2,2,0,0,2,0,2,5129
0,0,1,0,1,0,1,5130
1,1,1,0,2,0,2,5130
2,2,0,0,2,0,2,5130
0,0,1,0,1,0,1,5131
1,1,2,0,3,0,3,5131
2,2,4,0,7,0,7,5131
3,3,1,0,8,0,8,5131
4,4,1,0,9,0,9,5131
5,5,2,0,11,0,11,5131
6,6,2,0,13,0,13,5131
7,7,0,0,13,0,13,5131
0,0,1,0,1,0,1,5132
1,1,0,0,1,0,1,5132
0,0,1,0,1,0,1,5133
1,1,0,0,1,0,1,5133
0,0,1,0,1,0,1,5134
1,1,1,0,2,0,2,5134
2,2,0,0,2,0,2,5134
0,0,1,0,1,0,1,5135
1,1,1,0,2,0,2,5135
2,2,0,0,2,0,2,5135
0,0,1,0,1,0,1,5136
1,1,1,1,2,1,3,5136
2,2,0,1,2,2,4,5136
3,3,0,0,2,2,4,5136
0,0,1,0,1,0,1,5137
1,1,0,0,1,0,1,5137
0,0,1,0,1,0,1,5138
1,1,0,0,1,0,1,5138
0,0,1,0,1,0,1,5139
1,1,0,0,1,0,1,5139
0,0,1,0,1,0,1,5140
1,1,0,0,1,0,1,5140
0,0,1,0,1,0,1,5141
1,1,2,0,3,0,3,5141
2,2,3,0,6,0,6,5141
3,3,1,0,7,0,7,5141
4,4,1,0,8,0,8,5141
5,5,0,0,8,0,8,5141
0,0,1,0,1,0,1,5142
1,1,3,0,4,0,4,5142
2,2,0,0,4,0,4,5142
0,0,1,0,1,0,1,5143
1,1,0,0,1,0,1,5143
0,0,1,0,1,0,1,5144
1,1,0,1,1,1,2,5144
2,2,0,1,1,2,3,5144
3,3,0,0,1,2,3,5144
0,0,1,0,1,0,1,5145
1,1,1,0,2,0,2,5145
2,2,0,1,2,1,3,5145
3,3,0,0,2,1,3,5145
0,0,1,0,1,0,1,5146
1,1,0,0,1,0,1,5146
0,0,1,0,1,0,1,5147
1,1,0,2,1,2,3,5147
2,2,1,3,2,5,7,5147
3,3,2,4,4,9,13,5147
4,4,1,5,5,14,19,5147
5,5,0,1,5,15,20,5147
6,6,0,0,5,15,20,5147
0,0,1,0,1,0,1,5148
1,1,0,0,1,0,1,5148
0,0,1,0,1,0,1,5149
1,1,2,2,3,2,5,5149
2,2,1,0,4,2,6,5149
3,3,1,0,5,2,7,5149
4,4,1,0,6,2,8,5149
5,5,1,0,7,2,9,5149
6,6,1,0,8,2,10,5149
7,7,0,0,8,2,10,5149
0,0,1,0,1,0,1,5150
1,1,0,0,1,0,1,5150
0,0,1,0,1,0,1,5151
1,1,0,0,1,0,1,5151
0,0,1,0,1,0,1,5152
1,1,0,0,1,0,1,5152
0,0,1,0,1,0,1,5153
1,1,1,0,2,0,2,5153
2,2,3,0,5,0,5,5153
3,3,3,2,8,2,10,5153
4,4,5,1,13,3,16,5153
5,5,3,2,16,5,21,5153
6,6,2,2,18,7,25,5153
7,7,2,2,20,9,29,5153
8,8,1,1,21,10,31,5153
9,9,1,0,22,10,32,5153
10,10,2,0,24,10,34,5153
11,11,1,0,25,10,35,5153
12,12,1,1,26,11,37,5153
13,13,2,0,28,11,39,5153
14,14,1,0,29,11,40,5153
15,15,1,0,30,11,41,5153
16,16,2,0,32,11,43,5153
17,17,0,0,32,11,43,5153
0,0,1,0,1,0,1,5154
1,1,0,0,1,0,1,5154
0,0,1,0,1,0,1,5155
1,1,2,0,3,0,3,5155
2,2,2,0,5,0,5,5155
3,3,1,0,6,0,6,5155
4,4,2,0,8,0,8,5155
5,5,0,1,8,1,9,5155
6,6,0,0,8,1,9,5155
0,0,1,0,1,0,1,5156
1,1,2,0,3,0,3,5156
2,2,2,0,5,0,5,5156
3,3,2,0,7,0,7,5156
4,4,2,1,9,1,10,5156
5,5,1,2,10,3,13,5156
6,6,1,1,11,4,15,5156
7,7,1,1,12,5,17,5156
8,8,0,2,12,7,19,5156
9,9,0,1,12,8,20,5156
10,10,0,0,12,8,20,5156
0,0,1,0,1,0,1,5157
1,1,0,0,1,0,1,5157
0,0,1,0,1,0,1,5158
1,1,0,0,1,0,1,5158
0,0,1,0,1,0,1,5159
1,1,1,0,2,0,2,5159
2,2,2,0,4,0,4,5159
3,3,2,0,6,0,6,5159
4,4,0,0,6,0,6,5159
0,0,1,0,1,0,1,5160
1,1,0,0,1,0,1,5160
0,0,1,0,1,0,1,5161
1,1,1,0,2,0,2,5161
2,2,0,0,2,0,2,5161
0,0,1,0,1,0,1,5162
1,1,1,1,2,1,3,5162
2,2,0,3,2,4,6,5162
3,3,0,3,2,7,9,5162
4,4,0,2,2,9,11,5162
5,5,0,0,2,9,11,5162
0,0,1,0,1,0,1,5163
1,1,2,0,3,0,3,5163
2,2,2,1,5,1,6,5163
3,3,4,1,9,2,11,5163
4,4,1,2,10,4,14,5163
5,5,1,0,11,4,15,5163
6,6,0,0,11,4,15,5163
0,0,1,0,1,0,1,5164
1,1,0,1,1,1,2,5164
2,2,0,0,1,1,2,5164
0,0,1,0,1,0,1,5165
1,1,1,0,2,0,2,5165
2,2,0,0,2,0,2,5165
0,0,1,0,1,0,1,5166
1,1,0,0,1,0,1,5166
0,0,1,0,1,0,1,5167
1,1,5,0,6,0,6,5167
2,2,4,0,10,0,10,5167
3,3,1,0,11,0,11,5167
4,4,0,0,11,0,11,5167
0,0,1,0,1,0,1,5168
1,1,0,1,1,1,2,5168
2,2,0,1,1,2,3,5168
3,3,0,1,1,3,4,5168
4,4,1,2,2,5,7,5168
5,5,2,1,4,6,10,5168
6,6,2,1,6,7,13,5168
7,7,0,0,6,7,13,5168
0,0,1,0,1,0,1,5169
1,1,0,0,1,0,1,5169
0,0,1,0,1,0,1,5170
1,1,0,0,1,0,1,5170
0,0,1,0,1,0,1,5171
1,1,1,2,2,2,4,5171
2,2,2,4,4,6,10,5171
3,3,3,2,7,8,15,5171
4,4,2,1,9,9,18,5171
5,5,0,1,9,10,19,5171
6,6,0,1,9,11,20,5171
7,7,0,1,9,12,21,5171
8,8,0,0,9,12,21,5171
0,0,1,0,1,0,1,5172
1,1,1,0,2,0,2,5172
2,2,2,0,4,0,4,5172
3,3,1,0,5,0,5,5172
4,4,3,0,8,0,8,5172
5,5,0,0,8,0,8,5172
0,0,1,0,1,0,1,5173
1,1,0,0,1,0,1,5173
0,0,1,0,1,0,1,5174
1,1,1,0,2,0,2,5174
2,2,1,0,3,0,3,5174
3,3,0,0,3,0,3,5174
0,0,1,0,1,0,1,5175
1,1,1,0,2,0,2,5175
2,2,1,0,3,0,3,5175
3,3,0,0,3,0,3,5175
0,0,1,0,1,0,1,5176
1,1,2,0,3,0,3,5176
2,2,1,0,4,0,4,5176
3,3,1,0,5,0,5,5176
4,4,2,0,7,0,7,5176
5,5,2,0,9,0,9,5176
6,6,3,1,12,1,13,5176
7,7,2,1,14,2,16,5176
8,8,0,2,14,4,18,5176
9,9,0,0,14,4,18,5176
0,0,1,0,1,0,1,5177
1,1,0,0,1,0,1,5177
0,0,1,0,1,0,1,5178
1,1,0,0,1,0,1,5178
0,0,1,0,1,0,1,5179
1,1,0,0,1,0,1,5179
0,0,1,0,1,0,1,5180
1,1,2,0,3,0,3,5180
2,2,2,0,5,0,5,5180
3,3,3,1,8,1,9,5180
4,4,1,0,9,1,10,5180
5,5,1,0,10,1,11,5180
6,6,0,0,10,1,11,5180
0,0,1,0,1,0,1,5181
1,1,0,0,1,0,1,5181
0,0,1,0,1,0,1,5182
1,1,0,1,1,1,2,5182
2,2,0,0,1,1,2,5182
0,0,1,0,1,0,1,5183
1,1,0,0,1,0,1,5183
0,0,1,0,1,0,1,5184
1,1,1,0,2,0,2,5184
2,2,0,0,2,0,2,5184
0,0,1,0,1,0,1,5185
1,1,0,0,1,0,1,5185
0,0,1,0,1,0,1,5186
1,1,0,0,1,0,1,5186
0,0,1,0,1,0,1,5187
1,1,0,0,1,0,1,5187
0,0,1,0,1,0,1,5188
1,1,1,0,2,0,2,5188
2,2,0,0,2,0,2,5188
0,0,1,0,1,0,1,5189
1,1,0,0,1,0,1,5189
0,0,1,0,1,0,1,5190
1,1,3,0,4,0,4,5190
2,2,1,0,5,0,5,5190
3,3,2,0,7,0,7,5190
4,4,1,0,8,0,8,5190
5,5,0,0,8,0,8,5190
0,0,1,0,1,0,1,5191
1,1,0,0,1,0,1,5191
0,0,1,0,1,0,1,5192
1,1,0,0,1,0,1,5192
0,0,1,0,1,0,1,5193
1,1,1,0,2,0,2,5193
2,2,2,0,4,0,4,5193
3,3,5,0,9,0,9,5193
4,4,3,0,12,0,12,5193
5,5,3,0,15,0,15,5193
6,6,2,1,17,1,18,5193
7,7,0,1,17,2,19,5193
8,8,0,0,17,2,19,5193
0,0,1,0,1,0,1,5194
1,1,2,0,3,0,3,5194
2,2,1,1,4,1,5,5194
3,3,1,1,5,2,7,5194
4,4,0,1,5,3,8,5194
5,5,0,1,5,4,9,5194
6,6,0,2,5,6,11,5194
7,7,0,0,5,6,11,5194
0,0,1,0,1,0,1,5195
1,1,1,1,2,1,3,5195
2,2,1,0,3,1,4,5195
3,3,1,0,4,1,5,5195
4,4,1,0,5,1,6,5195
5,5,0,0,5,1,6,5195
0,0,1,0,1,0,1,5196
1,1,2,0,3,0,3,5196
2,2,1,0,4,0,4,5196
3,3,0,0,4,0,4,5196
0,0,1,0,1,0,1,5197
1,1,2,1,3,1,4,5197
2,2,2,0,5,1,6,5197
3,3,2,1,7,2,9,5197
4,4,1,1,8,3,11,5197
5,5,2,1,10,4,14,5197
6,6,1,0,11,4,15,5197
7,7,1,0,12,4,16,5197
8,8,1,0,13,4,17,5197
9,9,0,0,13,4,17,5197
0,0,1,0,1,0,1,5198
1,1,3,0,4,0,4,5198
2,2,1,0,5,0,5,5198
3,3,0,0,5,0,5,5198
0,0,1,0,1,0,1,5199
1,1,0,0,1,0,1,5199
0,0,1,0,1,0,1,5200
1,1,0,0,1,0,1,5200
0,0,1,0,1,0,1,5201
1,1,0,0,1,0,1,5201
0,0,1,0,1,0,1,5202
1,1,2,1,3,1,4,5202
2,2,2,0,5,1,6,5202
3,3,0,0,5,1,6,5202
0,0,1,0,1,0,1,5203
1,1,1,0,2,0,2,5203
2,2,1,0,3,0,3,5203
3,3,1,0,4,0,4,5203
4,4,1,0,5,0,5,5203
5,5,0,0,5,0,5,5203
0,0,1,0,1,0,1,5204
1,1,0,0,1,0,1,5204
0,0,1,0,1,0,1,5205
1,1,0,1,1,1,2,5205
2,2,0,0,1,1,2,5205
0,0,1,0,1,0,1,5206
1,1,0,0,1,0,1,5206
0,0,1,0,1,0,1,5207
1,1,0,0,1,0,1,5207
0,0,1,0,1,0,1,5208
1,1,1,1,2,1,3,5208
2,2,2,4,4,5,9,5208
3,3,1,4,5,9,14,5208
4,4,0,1,5,10,15,5208
5,5,0,1,5,11,16,5208
6,6,0,1,5,12,17,5208
7,7,0,0,5,12,17,5208
0,0,1,0,1,0,1,5209
1,1,0,0,1,0,1,5209
0,0,1,0,1,0,1,5210
1,1,1,0,2,0,2,5210
2,2,0,0,2,0,2,5210
0,0,1,0,1,0,1,5211
1,1,0,0,1,0,1,5211
0,0,1,0,1,0,1,5212
1,1,1,0,2,0,2,5212
2,2,0,0,2,0,2,5212
0,0,1,0,1,0,1,5213
1,1,0,0,1,0,1,5213
0,0,1,0,1,0,1,5214
1,1,2,0,3,0,3,5214
2,2,1,0,4,0,4,5214
3,3,0,0,4,0,4,5214
0,0,1,0,1,0,1,5215
1,1,0,0,1,0,1,5215
0,0,1,0,1,0,1,5216
1,1,0,0,1,0,1,5216
0,0,1,0,1,0,1,5217
1,1,2,0,3,0,3,5217
2,2,3,1,6,1,7,5217
3,3,1,3,7,4,11,5217
4,4,1,3,8,7,15,5217
5,5,2,5,10,12,22,5217
6,6,4,3,14,15,29,5217
7,7,5,3,19,18,37,5217
8,8,3,0,22,18,40,5217
9,9,1,0,23,18,41,5217
10,10,1,0,24,18,42,5217
11,11,0,0,24,18,42,5217
0,0,1,0,1,0,1,5218
1,1,1,1,2,1,3,5218
2,2,0,0,2,1,3,5218
0,0,1,0,1,0,1,5219
1,1,1,0,2,0,2,5219
2,2,1,0,3,0,3,5219
3,3,0,0,3,0,3,5219
0,0,1,0,1,0,1,5220
1,1,0,1,1,1,2,5220
2,2,0,2,1,3,4,5220
3,3,1,1,2,4,6,5220
4,4,0,2,2,6,8,5220
5,5,1,1,3,7,10,5220
6,6,0,1,3,8,11,5220
7,7,0,2,3,10,13,5220
8,8,0,0,3,10,13,5220
0,0,1,0,1,0,1,5221
1,1,1,0,2,0,2,5221
2,2,3,0,5,0,5,5221
3,3,1,0,6,0,6,5221
4,4,0,0,6,0,6,5221
0,0,1,0,1,0,1,5222
1,1,1,1,2,1,3,5222
2,2,2,0,4,1,5,5222
3,3,4,1,8,2,10,5222
4,4,5,1,13,3,16,5222
5,5,7,0,20,3,23,5222
6,6,4,0,24,3,27,5222
7,7,0,0,24,3,27,5222
0,0,1,0,1,0,1,5223
1,1,1,0,2,0,2,5223
2,2,1,0,3,0,3,5223
3,3,0,1,3,1,4,5223
4,4,0,0,3,1,4,5223
0,0,1,0,1,0,1,5224
1,1,0,0,1,0,1,5224
0,0,1,0,1,0,1,5225
1,1,1,0,2,0,2,5225
2,2,0,1,2,1,3,5225
3,3,0,0,2,1,3,5225
0,0,1,0,1,0,1,5226
1,1,2,0,3,0,3,5226
2,2,1,0,4,0,4,5226
3,3,4,0,8,0,8,5226
4,4,1,1,9,1,10,5226
5,5,0,1,9,2,11,5226
6,6,0,2,9,4,13,5226
7,7,0,2,9,6,15,5226
8,8,0,1,9,7,16,5226
9,9,0,2,9,9,18,5226
10,10,0,3,9,12,21,5226
11,11,1,3,10,15,25,5226
12,12,2,2,12,17,29,5226
13,13,2,1,14,18,32,5226
14,14,1,1,15,19,34,5226
15,15,1,1,16,20,36,5226
16,16,3,0,19,20,39,5226
17,17,0,0,19,20,39,5226
0,0,1,0,1,0,1,5227
1,1,0,0,1,0,1,5227
0,0,1,0,1,0,1,5228
1,1,0,0,1,0,1,5228
0,0,1,0,1,0,1,5229
1,1,0,0,1,0,1,5229
0,0,1,0,1,0,1,5230
1,1,2,1,3,1,4,5230
2,2,1,0,4,1,5,5230
3,3,1,0,5,1,6,5230
4,4,1,0,6,1,7,5230
5,5,1,0,7,1,8,5230
6,6,0,0,7,1,8,5230
0,0,1,0,1,0,1,5231
1,1,1,0,2,0,2,5231
2,2,0,0,2,0,2,5231
0,0,1,0,1,0,1,5232
1,1,0,0,1,0,1,5232
0,0,1,0,1,0,1,5233
1,1,0,0,1,0,1,5233
0,0,1,0,1,0,1,5234
1,1,0,0,1,0,1,5234
0,0,1,0,1,0,1,5235
1,1,0,1,1,1,2,5235
2,2,0,2,1,3,4,5235
3,3,1,1,2,4,6,5235
4,4,1,0,3,4,7,5235
5,5,0,0,3,4,7,5235
0,0,1,0,1,0,1,5236
1,1,1,0,2,0,2,5236
2,2,2,0,4,0,4,5236
3,3,2,0,6,0,6,5236
4,4,3,0,9,0,9,5236
5,5,3,0,12,0,12,5236
6,6,3,2,15,2,17,5236
7,7,2,1,17,3,20,5236
8,8,0,4,17,7,24,5236
9,9,0,1,17,8,25,5236
10,10,0,2,17,10,27,5236
11,11,1,3,18,13,31,5236
12,12,0,2,18,15,33,5236
13,13,1,2,19,17,36,5236
14,14,0,2,19,19,38,5236
15,15,0,1,19,20,39,5236
16,16,1,1,20,21,41,5236
17,17,0,0,20,21,41,5236
0,0,1,0,1,0,1,5237
1,1,0,1,1,1,2,5237
2,2,0,0,1,1,2,5237
0,0,1,0,1,0,1,5238
1,1,2,0,3,0,3,5238
2,2,3,0,6,0,6,5238
3,3,0,1,6,1,7,5238
4,4,0,1,6,2,8,5238
5,5,0,0,6,2,8,5238
0,0,1,0,1,0,1,5239
1,1,4,0,5,0,5,5239
2,2,3,1,8,1,9,5239
3,3,1,2,9,3,12,5239
4,4,4,4,13,7,20,5239
5,5,1,2,14,9,23,5239
6,6,0,1,14,10,24,5239
7,7,0,1,14,11,25,5239
8,8,0,0,14,11,25,5239
0,0,1,0,1,0,1,5240
1,1,0,1,1,1,2,5240
2,2,0,0,1,1,2,5240
0,0,1,0,1,0,1,5241
1,1,0,0,1,0,1,5241
0,0,1,0,1,0,1,5242
1,1,1,0,2,0,2,5242
2,2,0,0,2,0,2,5242
0,0,1,0,1,0,1,5243
1,1,2,0,3,0,3,5243
2,2,0,0,3,0,3,5243
0,0,1,0,1,0,1,5244
1,1,1,0,2,0,2,5244
2,2,0,0,2,0,2,5244
0,0,1,0,1,0,1,5245
1,1,4,1,5,1,6,5245
2,2,7,0,12,1,13,5245
3,3,5,1,17,2,19,5245
4,4,1,4,18,6,24,5245
5,5,1,4,19,10,29,5245
6,6,1,2,20,12,32,5245
7,7,1,2,21,14,35,5245
8,8,1,1,22,15,37,5245
9,9,1,0,23,15,38,5245
10,10,0,0,23,15,38,5245
0,0,1,0,1,0,1,5246
1,1,1,0,2,0,2,5246
2,2,2,0,4,0,4,5246
3,3,1,0,5,0,5,5246
4,4,0,1,5,1,6,5246
5,5,0,0,5,1,6,5246
0,0,1,0,1,0,1,5247
1,1,0,1,1,1,2,5247
2,2,0,0,1,1,2,5247
0,0,1,0,1,0,1,5248
1,1,0,0,1,0,1,5248
0,0,1,0,1,0,1,5249
1,1,0,1,1,1,2,5249
2,2,0,0,1,1,2,5249
0,0,1,0,1,0,1,5250
1,1,0,0,1,0,1,5250
0,0,1,0,1,0,1,5251
1,1,3,0,4,0,4,5251
2,2,2,0,6,0,6,5251
3,3,0,1,6,1,7,5251
4,4,0,0,6,1,7,5251
0,0,1,0,1,0,1,5252
1,1,0,0,1,0,1,5252
0,0,1,0,1,0,1,5253
1,1,1,1,2,1,3,5253
2,2,1,0,3,1,4,5253
3,3,0,1,3,2,5,5253
4,4,0,0,3,2,5,5253
0,0,1,0,1,0,1,5254
1,1,0,0,1,0,1,5254
0,0,1,0,1,0,1,5255
1,1,1,1,2,1,3,5255
2,2,2,0,4,1,5,5255
3,3,0,0,4,1,5,5255
0,0,1,0,1,0,1,5256
1,1,1,0,2,0,2,5256
2,2,1,0,3,0,3,5256
3,3,0,0,3,0,3,5256
0,0,1,0,1,0,1,5257
1,1,1,0,2,0,2,5257
2,2,1,0,3,0,3,5257
3,3,1,0,4,0,4,5257
4,4,0,0,4,0,4,5257
0,0,1,0,1,0,1,5258
1,1,2,0,3,0,3,5258
2,2,1,1,4,1,5,5258
3,3,2,3,6,4,10,5258
4,4,6,4,12,8,20,5258
5,5,3,8,15,16,31,5258
6,6,2,5,17,21,38,5258
7,7,4,7,21,28,49,5258
8,8,4,6,25,34,59,5258
9,9,3,3,28,37,65,5258
10,10,3,1,31,38,69,5258
11,11,2,2,33,40,73,5258
12,12,2,1,35,41,76,5258
13,13,1,2,36,43,79,5258
14,14,2,2,38,45,83,5258
15,15,1,2,39,47,86,5258
16,16,0,0,39,47,86,5258
0,0,1,0,1,0,1,5259
1,1,0,0,1,0,1,5259
0,0,1,0,1,0,1,5260
1,1,1,0,2,0,2,5260
2,2,1,0,3,0,3,5260
3,3,0,0,3,0,3,5260
0,0,1,0,1,0,1,5261
1,1,1,0,2,0,2,5261
2,2,0,0,2,0,2,5261
0,0,1,0,1,0,1,5262
1,1,2,0,3,0,3,5262
2,2,2,1,5,1,6,5262
3,3,0,2,5,3,8,5262
4,4,1,3,6,6,12,5262
5,5,2,0,8,6,14,5262
6,6,1,0,9,6,15,5262
7,7,0,0,9,6,15,5262
0,0,1,0,1,0,1,5263
1,1,0,0,1,0,1,5263
0,0,1,0,1,0,1,5264
1,1,2,1,3,1,4,5264
2,2,1,2,4,3,7,5264
3,3,0,4,4,7,11,5264
4,4,1,2,5,9,14,5264
5,5,3,2,8,11,19,5264
6,6,1,5,9,16,25,5264
7,7,2,1,11,17,28,5264
8,8,3,3,14,20,34,5264
9,9,4,3,18,23,41,5264
10,10,3,0,21,23,44,5264
11,11,4,3,25,26,51,5264
12,12,3,5,28,31,59,5264
13,13,3,4,31,35,66,5264
14,14,2,2,33,37,70,5264
15,15,1,4,34,41,75,5264
16,16,2,0,36,41,77,5264
17,17,0,0,36,41,77,5264
0,0,1,0,1,0,1,5265
1,1,1,0,2,0,2,5265
2,2,0,0,2,0,2,5265
0,0,1,0,1,0,1,5266
1,1,4,1,5,1,6,5266
2,2,2,1,7,2,9,5266
3,3,4,2,11,4,15,5266
4,4,2,4,13,8,21,5266
5,5,1,7,14,15,29,5266
6,6,3,9,17,24,41,5266
7,7,3,9,20,33,53,5266
8,8,3,6,23,39,62,5266
9,9,3,9,26,48,74,5266
10,10,4,5,30,53,83,5266
11,11,3,3,33,56,89,5266
12,12,5,2,38,58,96,5266
13,13,4,2,42,60,102,5266
14,14,0,4,42,64,106,5266
15,15,0,0,42,64,106,5266
0,0,1,0,1,0,1,5267
1,1,1,0,2,0,2,5267
2,2,0,0,2,0,2,5267
0,0,1,0,1,0,1,5268
1,1,0,0,1,0,1,5268
0,0,1,0,1,0,1,5269
1,1,1,0,2,0,2,5269
2,2,3,0,5,0,5,5269
3,3,2,0,7,0,7,5269
4,4,1,1,8,1,9,5269
5,5,0,0,8,1,9,5269
0,0,1,0,1,0,1,5270
1,1,0,0,1,0,1,5270
0,0,1,0,1,0,1,5271
1,1,1,0,2,0,2,5271
2,2,0,0,2,0,2,5271
0,0,1,0,1,0,1,5272
1,1,1,0,2,0,2,5272
2,2,3,1,5,1,6,5272
3,3,4,2,9,3,12,5272
4,4,2,4,11,7,18,5272
5,5,4,5,15,12,27,5272
6,6,4,4,19,16,35,5272
7,7,4,3,23,19,42,5272
8,8,3,2,26,21,47,5272
9,9,2,3,28,24,52,5272
10,10,1,2,29,26,55,5272
11,11,0,1,29,27,56,5272
12,12,1,1,30,28,58,5272
13,13,0,1,30,29,59,5272
14,14,0,0,30,29,59,5272
0,0,1,0,1,0,1,5273
1,1,0,0,1,0,1,5273
0,0,1,0,1,0,1,5274
1,1,0,1,1,1,2,5274
2,2,0,0,1,1,2,5274
0,0,1,0,1,0,1,5275
1,1,1,1,2,1,3,5275
2,2,0,1,2,2,4,5275
3,3,1,2,3,4,7,5275
4,4,0,0,3,4,7,5275
0,0,1,0,1,0,1,5276
1,1,0,0,1,0,1,5276
0,0,1,0,1,0,1,5277
1,1,1,0,2,0,2,5277
2,2,1,0,3,0,3,5277
3,3,0,0,3,0,3,5277
0,0,1,0,1,0,1,5278
1,1,0,0,1,0,1,5278
0,0,1,0,1,0,1,5279
1,1,0,0,1,0,1,5279
0,0,1,0,1,0,1,5280
1,1,1,0,2,0,2,5280
2,2,0,0,2,0,2,5280
0,0,1,0,1,0,1,5281
1,1,1,0,2,0,2,5281
2,2,0,0,2,0,2,5281
0,0,1,0,1,0,1,5282
1,1,2,0,3,0,3,5282
2,2,1,1,4,1,5,5282
3,3,0,1,4,2,6,5282
4,4,0,0,4,2,6,5282
0,0,1,0,1,0,1,5283
1,1,1,0,2,0,2,5283
2,2,0,0,2,0,2,5283
0,0,1,0,1,0,1,5284
1,1,1,0,2,0,2,5284
2,2,0,0,2,0,2,5284
0,0,1,0,1,0,1,5285
1,1,0,0,1,0,1,5285
0,0,1,0,1,0,1,5286
1,1,1,0,2,0,2,5286
2,2,1,0,3,0,3,5286
3,3,1,0,4,0,4,5286
4,4,1,0,5,0,5,5286
5,5,0,0,5,0,5,5286
0,0,1,0,1,0,1,5287
1,1,2,0,3,0,3,5287
2,2,3,1,6,1,7,5287
3,3,2,0,8,1,9,5287
4,4,4,0,12,1,13,5287
5,5,1,0,13,1,14,5287
6,6,1,0,14,1,15,5287
7,7,0,0,14,1,15,5287
0,0,1,0,1,0,1,5288
1,1,0,0,1,0,1,5288
0,0,1,0,1,0,1,5289
1,1,1,1,2,1,3,5289
2,2,1,0,3,1,4,5289
3,3,0,0,3,1,4,5289
0,0,1,0,1,0,1,5290
1,1,0,0,1,0,1,5290
0,0,1,0,1,0,1,5291
1,1,1,0,2,0,2,5291
2,2,1,0,3,0,3,5291
3,3,1,0,4,0,4,5291
4,4,1,0,5,0,5,5291
5,5,2,0,7,0,7,5291
6,6,0,0,7,0,7,5291
0,0,1,0,1,0,1,5292
1,1,0,1,1,1,2,5292
2,2,0,2,1,3,4,5292
3,3,1,2,2,5,7,5292
4,4,1,2,3,7,10,5292
5,5,1,2,4,9,13,5292
6,6,1,2,5,11,16,5292
7,7,2,0,7,11,18,5292
8,8,0,0,7,11,18,5292
0,0,1,0,1,0,1,5293
1,1,3,0,4,0,4,5293
2,2,1,0,5,0,5,5293
3,3,0,0,5,0,5,5293
0,0,1,0,1,0,1,5294
1,1,1,0,2,0,2,5294
2,2,2,0,4,0,4,5294
3,3,2,2,6,2,8,5294
4,4,1,1,7,3,10,5294
5,5,0,0,7,3,10,5294
0,0,1,0,1,0,1,5295
1,1,0,0,1,0,1,5295
0,0,1,0,1,0,1,5296
1,1,2,0,3,0,3,5296
2,2,3,0,6,0,6,5296
3,3,0,0,6,0,6,5296
0,0,1,0,1,0,1,5297
1,1,0,0,1,0,1,5297
0,0,1,0,1,0,1,5298
1,1,0,0,1,0,1,5298
0,0,1,0,1,0,1,5299
1,1,1,1,2,1,3,5299
2,2,0,0,2,1,3,5299
0,0,1,0,1,0,1,5300
1,1,0,0,1,0,1,5300
0,0,1,0,1,0,1,5301
1,1,1,0,2,0,2,5301
2,2,0,0,2,0,2,5301
0,0,1,0,1,0,1,5302
1,1,0,0,1,0,1,5302
0,0,1,0,1,0,1,5303
1,1,1,0,2,0,2,5303
2,2,1,0,3,0,3,5303
3,3,1,0,4,0,4,5303
4,4,1,0,5,0,5,5303
5,5,0,0,5,0,5,5303
0,0,1,0,1,0,1,5304
1,1,1,0,2,0,2,5304
2,2,2,0,4,0,4,5304
3,3,1,0,5,0,5,5304
4,4,0,0,5,0,5,5304
0,0,1,0,1,0,1,5305
1,1,0,0,1,0,1,5305
0,0,1,0,1,0,1,5306
1,1,1,1,2,1,3,5306
2,2,0,1,2,2,4,5306
3,3,0,1,2,3,5,5306
4,4,1,1,3,4,7,5306
5,5,0,1,3,5,8,5306
6,6,1,1,4,6,10,5306
7,7,0,3,4,9,13,5306
8,8,1,1,5,10,15,5306
9,9,1,0,6,10,16,5306
10,10,1,0,7,10,17,5306
11,11,0,1,7,11,18,5306
12,12,0,3,7,14,21,5306
13,13,1,3,8,17,25,5306
14,14,0,3,8,20,28,5306
15,15,0,0,8,20,28,5306
0,0,1,0,1,0,1,5307
1,1,1,1,2,1,3,5307
2,2,1,0,3,1,4,5307
3,3,1,0,4,1,5,5307
4,4,0,0,4,1,5,5307
0,0,1,0,1,0,1,5308
1,1,1,0,2,0,2,5308
2,2,1,0,3,0,3,5308
3,3,1,0,4,0,4,5308
4,4,0,0,4,0,4,5308
0,0,1,0,1,0,1,5309
1,1,1,1,2,1,3,5309
2,2,0,3,2,4,6,5309
3,3,0,1,2,5,7,5309
4,4,0,2,2,7,9,5309
5,5,0,1,2,8,10,5309
6,6,0,1,2,9,11,5309
7,7,1,3,3,12,15,5309
8,8,1,1,4,13,17,5309
9,9,0,0,4,13,17,5309
0,0,1,0,1,0,1,5310
1,1,0,0,1,0,1,5310
0,0,1,0,1,0,1,5311
1,1,2,0,3,0,3,5311
2,2,1,1,4,1,5,5311
3,3,2,2,6,3,9,5311
4,4,0,2,6,5,11,5311
5,5,0,3,6,8,14,5311
6,6,0,3,6,11,17,5311
7,7,0,3,6,14,20,5311
8,8,1,6,7,20,27,5311
9,9,2,6,9,26,35,5311
10,10,3,0,12,26,38,5311
11,11,1,1,13,27,40,5311
12,12,1,2,14,29,43,5311
13,13,0,2,14,31,45,5311
14,14,0,1,14,32,46,5311
15,15,0,0,14,32,46,5311
0,0,1,0,1,0,1,5312
1,1,1,0,2,0,2,5312
2,2,1,0,3,0,3,5312
3,3,0,0,3,0,3,5312
0,0,1,0,1,0,1,5313
1,1,0,0,1,0,1,5313
0,0,1,0,1,0,1,5314
1,1,0,0,1,0,1,5314
0,0,1,0,1,0,1,5315
1,1,0,1,1,1,2,5315
2,2,0,0,1,1,2,5315
0,0,1,0,1,0,1,5316
1,1,0,1,1,1,2,5316
2,2,0,0,1,1,2,5316
0,0,1,0,1,0,1,5317
1,1,1,1,2,1,3,5317
2,2,0,2,2,3,5,5317
3,3,0,1,2,4,6,5317
4,4,0,0,2,4,6,5317
0,0,1,0,1,0,1,5318
1,1,0,0,1,0,1,5318
0,0,1,0,1,0,1,5319
1,1,0,0,1,0,1,5319
0,0,1,0,1,0,1,5320
1,1,2,0,3,0,3,5320
2,2,3,0,6,0,6,5320
3,3,0,0,6,0,6,5320
0,0,1,0,1,0,1,5321
1,1,3,0,4,0,4,5321
2,2,5,1,9,1,10,5321
3,3,6,3,15,4,19,5321
4,4,3,2,18,6,24,5321
5,5,6,3,24,9,33,5321
6,6,6,4,30,13,43,5321
7,7,5,3,35,16,51,5321
8,8,2,1,37,17,54,5321
9,9,1,1,38,18,56,5321
10,10,1,2,39,20,59,5321
11,11,0,3,39,23,62,5321
12,12,0,2,39,25,64,5321
13,13,1,1,40,26,66,5321
14,14,1,1,41,27,68,5321
15,15,3,2,44,29,73,5321
16,16,3,3,47,32,79,5321
17,17,4,2,51,34,85,5321
18,18,4,0,55,34,89,5321
19,19,0,1,55,35,90,5321
20,20,1,0,56,35,91,5321
21,21,0,0,56,35,91,5321
0,0,1,0,1,0,1,5322
1,1,0,0,1,0,1,5322
0,0,1,0,1,0,1,5323
1,1,1,0,2,0,2,5323
2,2,1,0,3,0,3,5323
3,3,0,0,3,0,3,5323
0,0,1,0,1,0,1,5324
1,1,3,0,4,0,4,5324
2,2,2,0,6,0,6,5324
3,3,0,1,6,1,7,5324
4,4,1,0,7,1,8,5324
5,5,0,0,7,1,8,5324
0,0,1,0,1,0,1,5325
1,1,0,0,1,0,1,5325
0,0,1,0,1,0,1,5326
1,1,1,1,2,1,3,5326
2,2,0,1,2,2,4,5326
3,3,0,1,2,3,5,5326
4,4,0,1,2,4,6,5326
5,5,0,1,2,5,7,5326
6,6,0,2,2,7,9,5326
7,7,0,0,2,7,9,5326
0,0,1,0,1,0,1,5327
1,1,0,0,1,0,1,5327
0,0,1,0,1,0,1,5328
1,1,1,1,2,1,3,5328
2,2,1,1,3,2,5,5328
3,3,2,0,5,2,7,5328
4,4,0,1,5,3,8,5328
5,5,0,0,5,3,8,5328
0,0,1,0,1,0,1,5329
1,1,0,0,1,0,1,5329
0,0,1,0,1,0,1,5330
1,1,1,1,2,1,3,5330
2,2,0,1,2,2,4,5330
3,3,0,2,2,4,6,5330
4,4,1,1,3,5,8,5330
5,5,0,1,3,6,9,5330
6,6,0,2,3,8,11,5330
7,7,0,1,3,9,12,5330
8,8,0,0,3,9,12,5330
0,0,1,0,1,0,1,5331
1,1,1,1,2,1,3,5331
2,2,1,1,3,2,5,5331
3,3,1,1,4,3,7,5331
4,4,0,0,4,3,7,5331
0,0,1,0,1,0,1,5332
1,1,0,1,1,1,2,5332
2,2,0,0,1,1,2,5332
0,0,1,0,1,0,1,5333
1,1,2,0,3,0,3,5333
2,2,3,0,6,0,6,5333
3,3,1,0,7,0,7,5333
4,4,1,0,8,0,8,5333
5,5,0,0,8,0,8,5333
0,0,1,0,1,0,1,5334
1,1,0,0,1,0,1,5334
0,0,1,0,1,0,1,5335
1,1,0,1,1,1,2,5335
2,2,0,0,1,1,2,5335
0,0,1,0,1,0,1,5336
1,1,0,0,1,0,1,5336
0,0,1,0,1,0,1,5337
1,1,0,0,1,0,1,5337
0,0,1,0,1,0,1,5338
1,1,0,0,1,0,1,5338
0,0,1,0,1,0,1,5339
1,1,1,0,2,0,2,5339
2,2,0,0,2,0,2,5339
0,0,1,0,1,0,1,5340
1,1,0,0,1,0,1,5340
0,0,1,0,1,0,1,5341
1,1,0,0,1,0,1,5341
0,0,1,0,1,0,1,5342
1,1,1,0,2,0,2,5342
2,2,0,0,2,0,2,5342
0,0,1,0,1,0,1,5343
1,1,0,0,1,0,1,5343
0,0,1,0,1,0,1,5344
1,1,3,0,4,0,4,5344
2,2,1,1,5,1,6,5344
3,3,2,0,7,1,8,5344
4,4,1,1,8,2,10,5344
5,5,2,0,10,2,12,5344
6,6,4,1,14,3,17,5344
7,7,4,0,18,3,21,5344
8,8,2,1,20,4,24,5344
9,9,3,1,23,5,28,5344
10,10,4,1,27,6,33,5344
11,11,5,0,32,6,38,5344
12,12,2,0,34,6,40,5344
13,13,2,0,36,6,42,5344
14,14,2,0,38,6,44,5344
15,15,0,0,38,6,44,5344
0,0,1,0,1,0,1,5345
1,1,1,1,2,1,3,5345
2,2,1,1,3,2,5,5345
3,3,1,0,4,2,6,5345
4,4,0,0,4,2,6,5345
0,0,1,0,1,0,1,5346
1,1,1,0,2,0,2,5346
2,2,0,0,2,0,2,5346
0,0,1,0,1,0,1,5347
1,1,1,0,2,0,2,5347
2,2,0,1,2,1,3,5347
3,3,0,1,2,2,4,5347
4,4,0,0,2,2,4,5347
0,0,1,0,1,0,1,5348
1,1,0,0,1,0,1,5348
0,0,1,0,1,0,1,5349
1,1,0,0,1,0,1,5349
0,0,1,0,1,0,1,5350
1,1,1,0,2,0,2,5350
2,2,1,0,3,0,3,5350
3,3,1,0,4,0,4,5350
4,4,0,2,4,2,6,5350
5,5,1,1,5,3,8,5350
6,6,1,0,6,3,9,5350
7,7,0,2,6,5,11,5350
8,8,0,1,6,6,12,5350
9,9,1,0,7,6,13,5350
10,10,3,0,10,6,16,5350
11,11,1,0,11,6,17,5350
12,12,0,1,11,7,18,5350
13,13,0,0,11,7,18,5350
0,0,1,0,1,0,1,5351
1,1,0,0,1,0,1,5351
0,0,1,0,1,0,1,5352
1,1,1,0,2,0,2,5352
2,2,0,1,2,1,3,5352
3,3,1,0,3,1,4,5352
4,4,1,0,4,1,5,5352
5,5,1,0,5,1,6,5352
6,6,0,1,5,2,7,5352
7,7,0,0,5,2,7,5352
0,0,1,0,1,0,1,5353
1,1,2,0,3,0,3,5353
2,2,1,0,4,0,4,5353
3,3,1,0,5,0,5,5353
4,4,0,0,5,0,5,5353
0,0,1,0,1,0,1,5354
1,1,1,0,2,0,2,5354
2,2,0,0,2,0,2,5354
0,0,1,0,1,0,1,5355
1,1,1,0,2,0,2,5355
2,2,3,0,5,0,5,5355
3,3,4,1,9,1,10,5355
4,4,5,1,14,2,16,5355
5,5,2,0,16,2,18,5355
6,6,2,0,18,2,20,5355
7,7,3,1,21,3,24,5355
8,8,3,3,24,6,30,5355
9,9,4,2,28,8,36,5355
10,10,3,2,31,10,41,5355
11,11,3,4,34,14,48,5355
12,12,3,5,37,19,56,5355
13,13,1,2,38,21,59,5355
14,14,1,3,39,24,63,5355
15,15,1,4,40,28,68,5355
16,16,1,1,41,29,70,5355
17,17,2,0,43,29,72,5355
18,18,2,0,45,29,74,5355
19,19,2,0,47,29,76,5355
20,20,1,0,48,29,77,5355
21,21,3,0,51,29,80,5355
22,22,3,0,54,29,83,5355
23,23,3,2,57,31,88,5355
24,24,1,1,58,32,90,5355
25,25,1,0,59,32,91,5355
26,26,0,0,59,32,91,5355
0,0,1,0,1,0,1,5356
1,1,2,0,3,0,3,5356
2,2,1,0,4,0,4,5356
3,3,0,0,4,0,4,5356
0,0,1,0,1,0,1,5357
1,1,0,0,1,0,1,5357
0,0,1,0,1,0,1,5358
1,1,1,1,2,1,3,5358
2,2,0,1,2,2,4,5358
3,3,0,3,2,5,7,5358
4,4,1,2,3,7,10,5358
5,5,2,3,5,10,15,5358
6,6,3,3,8,13,21,5358
7,7,1,2,9,15,24,5358
8,8,1,2,10,17,27,5358
9,9,1,4,11,21,32,5358
10,10,1,2,12,23,35,5358
11,11,2,2,14,25,39,5358
12,12,1,6,15,31,46,5358
13,13,0,3,15,34,49,5358
14,14,0,1,15,35,50,5358
15,15,0,0,15,35,50,5358
0,0,1,0,1,0,1,5359
1,1,1,0,2,0,2,5359
2,2,1,0,3,0,3,5359
3,3,0,0,3,0,3,5359
0,0,1,0,1,0,1,5360
1,1,1,0,2,0,2,5360
2,2,0,0,2,0,2,5360
0,0,1,0,1,0,1,5361
1,1,1,0,2,0,2,5361
2,2,0,1,2,1,3,5361
3,3,0,1,2,2,4,5361
4,4,0,0,2,2,4,5361
0,0,1,0,1,0,1,5362
1,1,0,0,1,0,1,5362
0,0,1,0,1,0,1,5363
1,1,1,0,2,0,2,5363
2,2,1,0,3,0,3,5363
3,3,1,0,4,0,4,5363
4,4,2,0,6,0,6,5363
5,5,2,0,8,0,8,5363
6,6,1,0,9,0,9,5363
7,7,1,0,10,0,10,5363
8,8,1,0,11,0,11,5363
9,9,0,0,11,0,11,5363
0,0,1,0,1,0,1,5364
1,1,1,0,2,0,2,5364
2,2,1,1,3,1,4,5364
3,3,1,2,4,3,7,5364
4,4,1,1,5,4,9,5364
5,5,0,0,5,4,9,5364
0,0,1,0,1,0,1,5365
1,1,0,0,1,0,1,5365
0,0,1,0,1,0,1,5366
1,1,3,0,4,0,4,5366
2,2,2,2,6,2,8,5366
3,3,0,1,6,3,9,5366
4,4,0,0,6,3,9,5366
0,0,1,0,1,0,1,5367
1,1,1,0,2,0,2,5367
2,2,1,0,3,0,3,5367
3,3,0,0,3,0,3,5367
0,0,1,0,1,0,1,5368
1,1,1,0,2,0,2,5368
2,2,3,0,5,0,5,5368
3,3,2,0,7,0,7,5368
4,4,2,0,9,0,9,5368
5,5,2,0,11,0,11,5368
6,6,1,0,12,0,12,5368
7,7,3,0,15,0,15,5368
8,8,3,0,18,0,18,5368
9,9,1,0,19,0,19,5368
10,10,0,0,19,0,19,5368
0,0,1,0,1,0,1,5369
1,1,0,0,1,0,1,5369
0,0,1,0,1,0,1,5370
1,1,1,0,2,0,2,5370
2,2,0,0,2,0,2,5370
0,0,1,0,1,0,1,5371
1,1,0,0,1,0,1,5371
0,0,1,0,1,0,1,5372
1,1,1,0,2,0,2,5372
2,2,0,0,2,0,2,5372
0,0,1,0,1,0,1,5373
1,1,0,0,1,0,1,5373
0,0,1,0,1,0,1,5374
1,1,1,2,2,2,4,5374
2,2,1,2,3,4,7,5374
3,3,0,2,3,6,9,5374
4,4,2,1,5,7,12,5374
5,5,1,1,6,8,14,5374
6,6,0,2,6,10,16,5374
7,7,0,1,6,11,17,5374
8,8,0,1,6,12,18,5374
9,9,0,1,6,13,19,5374
10,10,1,0,7,13,20,5374
11,11,0,0,7,13,20,5374
0,0,1,0,1,0,1,5375
1,1,1,0,2,0,2,5375
2,2,0,0,2,0,2,5375
0,0,1,0,1,0,1,5376
1,1,3,1,4,1,5,5376
2,2,3,1,7,2,9,5376
3,3,3,0,10,2,12,5376
4,4,0,0,10,2,12,5376
0,0,1,0,1,0,1,5377
1,1,0,0,1,0,1,5377
0,0,1,0,1,0,1,5378
1,1,0,1,1,1,2,5378
2,2,0,1,1,2,3,5378
3,3,0,0,1,2,3,5378
0,0,1,0,1,0,1,5379
1,1,0,1,1,1,2,5379
2,2,0,1,1,2,3,5379
3,3,0,1,1,3,4,5379
4,4,0,1,1,4,5,5379
5,5,1,1,2,5,7,5379
6,6,1,0,3,5,8,5379
7,7,1,0,4,5,9,5379
8,8,0,0,4,5,9,5379
0,0,1,0,1,0,1,5380
1,1,0,0,1,0,1,5380
0,0,1,0,1,0,1,5381
1,1,0,0,1,0,1,5381
0,0,1,0,1,0,1,5382
1,1,1,0,2,0,2,5382
2,2,0,0,2,0,2,5382
0,0,1,0,1,0,1,5383
1,1,0,0,1,0,1,5383
0,0,1,0,1,0,1,5384
1,1,2,0,3,0,3,5384
2,2,2,3,5,3,8,5384
3,3,0,3,5,6,11,5384
4,4,1,2,6,8,14,5384
5,5,1,3,7,11,18,5384
6,6,0,4,7,15,22,5384
7,7,0,2,7,17,24,5384
8,8,1,1,8,18,26,5384
9,9,2,1,10,19,29,5384
10,10,3,0,13,19,32,5384
11,11,2,0,15,19,34,5384
12,12,4,1,19,20,39,5384
13,13,3,2,22,22,44,5384
14,14,3,2,25,24,49,5384
15,15,0,3,25,27,52,5384
16,16,1,0,26,27,53,5384
17,17,1,0,27,27,54,5384
18,18,0,0,27,27,54,5384
0,0,1,0,1,0,1,5385
1,1,1,0,2,0,2,5385
2,2,0,0,2,0,2,5385
0,0,1,0,1,0,1,5386
1,1,0,0,1,0,1,5386
0,0,1,0,1,0,1,5387
1,1,0,1,1,1,2,5387
2,2,0,0,1,1,2,5387
0,0,1,0,1,0,1,5388
1,1,1,0,2,0,2,5388
2,2,0,0,2,0,2,5388
0,0,1,0,1,0,1,5389
1,1,1,0,2,0,2,5389
2,2,0,0,2,0,2,5389
0,0,1,0,1,0,1,5390
1,1,1,0,2,0,2,5390
2,2,0,1,2,1,3,5390
3,3,0,2,2,3,5,5390
4,4,0,0,2,3,5,5390
0,0,1,0,1,0,1,5391
1,1,0,2,1,2,3,5391
2,2,0,2,1,4,5,5391
3,3,0,3,1,7,8,5391
4,4,1,3,2,10,12,5391
5,5,2,2,4,12,16,5391
6,6,4,1,8,13,21,5391
7,7,4,1,12,14,26,5391
8,8,1,1,13,15,28,5391
9,9,1,2,14,17,31,5391
10,10,2,0,16,17,33,5391
11,11,1,0,17,17,34,5391
12,12,1,0,18,17,35,5391
13,13,0,0,18,17,35,5391
0,0,1,0,1,0,1,5392
1,1,1,0,2,0,2,5392
2,2,0,0,2,0,2,5392
0,0,1,0,1,0,1,5393
1,1,0,1,1,1,2,5393
2,2,0,0,1,1,2,5393
0,0,1,0,1,0,1,5394
1,1,1,0,2,0,2,5394
2,2,0,1,2,1,3,5394
3,3,0,1,2,2,4,5394
4,4,0,2,2,4,6,5394
5,5,1,0,3,4,7,5394
6,6,1,0,4,4,8,5394
7,7,0,1,4,5,9,5394
8,8,0,0,4,5,9,5394
0,0,1,0,1,0,1,5395
1,1,0,0,1,0,1,5395
0,0,1,0,1,0,1,5396
1,1,1,0,2,0,2,5396
2,2,1,0,3,0,3,5396
3,3,2,0,5,0,5,5396
4,4,2,1,7,1,8,5396
5,5,1,2,8,3,11,5396
6,6,1,0,9,3,12,5396
7,7,0,0,9,3,12,5396
0,0,1,0,1,0,1,5397
1,1,0,0,1,0,1,5397
0,0,1,0,1,0,1,5398
1,1,2,0,3,0,3,5398
2,2,2,0,5,0,5,5398
3,3,0,0,5,0,5,5398
0,0,1,0,1,0,1,5399
1,1,0,0,1,0,1,5399
0,0,1,0,1,0,1,5400
1,1,1,0,2,0,2,5400
2,2,0,0,2,0,2,5400
0,0,1,0,1,0,1,5401
1,1,0,0,1,0,1,5401
0,0,1,0,1,0,1,5402
1,1,0,0,1,0,1,5402
0,0,1,0,1,0,1,5403
1,1,3,1,4,1,5,5403
2,2,1,0,5,1,6,5403
3,3,0,1,5,2,7,5403
4,4,0,1,5,3,8,5403
5,5,0,3,5,6,11,5403
6,6,1,1,6,7,13,5403
7,7,1,0,7,7,14,5403
8,8,0,0,7,7,14,5403
0,0,1,0,1,0,1,5404
1,1,0,0,1,0,1,5404
0,0,1,0,1,0,1,5405
1,1,1,0,2,0,2,5405
2,2,0,0,2,0,2,5405
0,0,1,0,1,0,1,5406
1,1,0,0,1,0,1,5406
0,0,1,0,1,0,1,5407
1,1,0,0,1,0,1,5407
0,0,1,0,1,0,1,5408
1,1,1,0,2,0,2,5408
2,2,1,0,3,0,3,5408
3,3,0,0,3,0,3,5408
0,0,1,0,1,0,1,5409
1,1,0,1,1,1,2,5409
2,2,0,0,1,1,2,5409
0,0,1,0,1,0,1,5410
1,1,0,0,1,0,1,5410
0,0,1,0,1,0,1,5411
1,1,0,0,1,0,1,5411
0,0,1,0,1,0,1,5412
1,1,0,1,1,1,2,5412
2,2,0,1,1,2,3,5412
3,3,0,1,1,3,4,5412
4,4,1,4,2,7,9,5412
5,5,2,3,4,10,14,5412
6,6,1,0,5,10,15,5412
7,7,1,0,6,10,16,5412
8,8,1,0,7,10,17,5412
9,9,0,0,7,10,17,5412
0,0,1,0,1,0,1,5413
1,1,1,0,2,0,2,5413
2,2,0,0,2,0,2,5413
0,0,1,0,1,0,1,5414
1,1,1,0,2,0,2,5414
2,2,0,0,2,0,2,5414
0,0,1,0,1,0,1,5415
1,1,1,0,2,0,2,5415
2,2,0,0,2,0,2,5415
0,0,1,0,1,0,1,5416
1,1,0,0,1,0,1,5416
0,0,1,0,1,0,1,5417
1,1,0,0,1,0,1,5417
0,0,1,0,1,0,1,5418
1,1,0,0,1,0,1,5418
0,0,1,0,1,0,1,5419
1,1,1,0,2,0,2,5419
2,2,1,0,3,0,3,5419
3,3,1,2,4,2,6,5419
4,4,1,4,5,6,11,5419
5,5,3,5,8,11,19,5419
6,6,3,5,11,16,27,5419
7,7,6,3,17,19,36,5419
8,8,4,6,21,25,46,5419
9,9,4,3,25,28,53,5419
10,10,4,3,29,31,60,5419
11,11,3,2,32,33,65,5419
12,12,5,4,37,37,74,5419
13,13,5,3,42,40,82,5419
14,14,0,3,42,43,85,5419
15,15,0,0,42,43,85,5419
0,0,1,0,1,0,1,5420
1,1,0,0,1,0,1,5420
0,0,1,0,1,0,1,5421
1,1,2,0,3,0,3,5421
2,2,2,0,5,0,5,5421
3,3,2,1,7,1,8,5421
4,4,3,1,10,2,12,5421
5,5,1,3,11,5,16,5421
6,6,0,1,11,6,17,5421
7,7,0,1,11,7,18,5421
8,8,0,0,11,7,18,5421
0,0,1,0,1,0,1,5422
1,1,1,0,2,0,2,5422
2,2,0,1,2,1,3,5422
3,3,0,0,2,1,3,5422
0,0,1,0,1,0,1,5423
1,1,0,0,1,0,1,5423
0,0,1,0,1,0,1,5424
1,1,0,0,1,0,1,5424
0,0,1,0,1,0,1,5425
1,1,0,0,1,0,1,5425
0,0,1,0,1,0,1,5426
1,1,1,0,2,0,2,5426
2,2,0,0,2,0,2,5426
0,0,1,0,1,0,1,5427
1,1,1,0,2,0,2,5427
2,2,1,0,3,0,3,5427
3,3,1,0,4,0,4,5427
4,4,0,0,4,0,4,5427
0,0,1,0,1,0,1,5428
1,1,1,1,2,1,3,5428
2,2,1,1,3,2,5,5428
3,3,1,2,4,4,8,5428
4,4,1,2,5,6,11,5428
5,5,1,0,6,6,12,5428
6,6,1,0,7,6,13,5428
7,7,0,0,7,6,13,5428
0,0,1,0,1,0,1,5429
1,1,1,0,2,0,2,5429
2,2,0,0,2,0,2,5429
0,0,1,0,1,0,1,5430
1,1,1,0,2,0,2,5430
2,2,0,0,2,0,2,5430
0,0,1,0,1,0,1,5431
1,1,0,0,1,0,1,5431
0,0,1,0,1,0,1,5432
1,1,2,0,3,0,3,5432
2,2,2,0,5,0,5,5432
3,3,4,0,9,0,9,5432
4,4,5,0,14,0,14,5432
5,5,4,2,18,2,20,5432
6,6,1,1,19,3,22,5432
7,7,0,0,19,3,22,5432
0,0,1,0,1,0,1,5433
1,1,0,1,1,1,2,5433
2,2,0,0,1,1,2,5433
0,0,1,0,1,0,1,5434
1,1,1,0,2,0,2,5434
2,2,2,0,4,0,4,5434
3,3,1,1,5,1,6,5434
4,4,1,0,6,1,7,5434
5,5,0,1,6,2,8,5434
6,6,0,1,6,3,9,5434
7,7,0,0,6,3,9,5434
0,0,1,0,1,0,1,5435
1,1,1,0,2,0,2,5435
2,2,1,0,3,0,3,5435
3,3,0,1,3,1,4,5435
4,4,0,1,3,2,5,5435
5,5,0,0,3,2,5,5435
0,0,1,0,1,0,1,5436
1,1,0,0,1,0,1,5436
0,0,1,0,1,0,1,5437
1,1,0,0,1,0,1,5437
0,0,1,0,1,0,1,5438
1,1,0,0,1,0,1,5438
0,0,1,0,1,0,1,5439
1,1,0,0,1,0,1,5439
0,0,1,0,1,0,1,5440
1,1,0,0,1,0,1,5440
0,0,1,0,1,0,1,5441
1,1,0,0,1,0,1,5441
0,0,1,0,1,0,1,5442
1,1,2,0,3,0,3,5442
2,2,2,1,5,1,6,5442
3,3,0,0,5,1,6,5442
0,0,1,0,1,0,1,5443
1,1,0,0,1,0,1,5443
0,0,1,0,1,0,1,5444
1,1,1,0,2,0,2,5444
2,2,0,0,2,0,2,5444
0,0,1,0,1,0,1,5445
1,1,1,0,2,0,2,5445
2,2,2,0,4,0,4,5445
3,3,3,0,7,0,7,5445
4,4,3,0,10,0,10,5445
5,5,1,2,11,2,13,5445
6,6,0,2,11,4,15,5445
7,7,0,4,11,8,19,5445
8,8,2,2,13,10,23,5445
9,9,3,2,16,12,28,5445
10,10,2,1,18,13,31,5445
11,11,0,1,18,14,32,5445
12,12,0,1,18,15,33,5445
13,13,0,0,18,15,33,5445
0,0,1,0,1,0,1,5446
1,1,0,0,1,0,1,5446
0,0,1,0,1,0,1,5447
1,1,2,0,3,0,3,5447
2,2,0,0,3,0,3,5447
0,0,1,0,1,0,1,5448
1,1,0,0,1,0,1,5448
0,0,1,0,1,0,1,5449
1,1,0,1,1,1,2,5449
2,2,0,2,1,3,4,5449
3,3,0,3,1,6,7,5449
4,4,0,1,1,7,8,5449
5,5,0,0,1,7,8,5449
0,0,1,0,1,0,1,5450
1,1,0,1,1,1,2,5450
2,2,0,0,1,1,2,5450
0,0,1,0,1,0,1,5451
1,1,2,0,3,0,3,5451
2,2,0,2,3,2,5,5451
3,3,2,0,5,2,7,5451
4,4,4,0,9,2,11,5451
5,5,4,2,13,4,17,5451
6,6,1,1,14,5,19,5451
7,7,2,3,16,8,24,5451
8,8,4,2,20,10,30,5451
9,9,1,4,21,14,35,5451
10,10,0,1,21,15,36,5451
11,11,1,0,22,15,37,5451
12,12,0,2,22,17,39,5451
13,13,0,3,22,20,42,5451
14,14,1,2,23,22,45,5451
15,15,2,1,25,23,48,5451
16,16,1,0,26,23,49,5451
17,17,1,1,27,24,51,5451
18,18,0,1,27,25,52,5451
19,19,0,0,27,25,52,5451
0,0,1,0,1,0,1,5452
1,1,1,0,2,0,2,5452
2,2,0,0,2,0,2,5452
0,0,1,0,1,0,1,5453
1,1,0,1,1,1,2,5453
2,2,0,0,1,1,2,5453
0,0,1,0,1,0,1,5454
1,1,1,1,2,1,3,5454
2,2,3,1,5,2,7,5454
3,3,3,3,8,5,13,5454
4,4,3,3,11,8,19,5454
5,5,0,1,11,9,20,5454
6,6,0,1,11,10,21,5454
7,7,0,2,11,12,23,5454
8,8,0,4,11,16,27,5454
9,9,1,5,12,21,33,5454
10,10,3,1,15,22,37,5454
11,11,5,0,20,22,42,5454
12,12,4,2,24,24,48,5454
13,13,1,3,25,27,52,5454
14,14,5,1,30,28,58,5454
15,15,3,0,33,28,61,5454
16,16,2,0,35,28,63,5454
17,17,0,0,35,28,63,5454
0,0,1,0,1,0,1,5455
1,1,2,0,3,0,3,5455
2,2,1,1,4,1,5,5455
3,3,1,1,5,2,7,5455
4,4,0,0,5,2,7,5455
0,0,1,0,1,0,1,5456
1,1,2,0,3,0,3,5456
2,2,2,0,5,0,5,5456
3,3,4,0,9,0,9,5456
4,4,2,1,11,1,12,5456
5,5,1,1,12,2,14,5456
6,6,0,5,12,7,19,5456
7,7,2,4,14,11,25,5456
8,8,3,8,17,19,36,5456
9,9,2,4,19,23,42,5456
10,10,0,3,19,26,45,5456
11,11,1,0,20,26,46,5456
12,12,0,0,20,26,46,5456
0,0,1,0,1,0,1,5457
1,1,0,1,1,1,2,5457
2,2,0,1,1,2,3,5457
3,3,0,1,1,3,4,5457
4,4,0,0,1,3,4,5457
0,0,1,0,1,0,1,5458
1,1,2,0,3,0,3,5458
2,2,1,0,4,0,4,5458
3,3,0,0,4,0,4,5458
0,0,1,0,1,0,1,5459
1,1,1,0,2,0,2,5459
2,2,0,0,2,0,2,5459
0,0,1,0,1,0,1,5460
1,1,0,1,1,1,2,5460
2,2,0,0,1,1,2,5460
0,0,1,0,1,0,1,5461
1,1,1,0,2,0,2,5461
2,2,0,0,2,0,2,5461
0,0,1,0,1,0,1,5462
1,1,2,0,3,0,3,5462
2,2,0,0,3,0,3,5462
0,0,1,0,1,0,1,5463
1,1,1,0,2,0,2,5463
2,2,1,0,3,0,3,5463
3,3,0,0,3,0,3,5463
0,0,1,0,1,0,1,5464
1,1,0,0,1,0,1,5464
0,0,1,0,1,0,1,5465
1,1,0,1,1,1,2,5465
2,2,0,4,1,5,6,5465
3,3,1,1,2,6,8,5465
4,4,1,1,3,7,10,5465
5,5,2,1,5,8,13,5465
6,6,3,1,8,9,17,5465
7,7,3,1,11,10,21,5465
8,8,0,3,11,13,24,5465
9,9,0,6,11,19,30,5465
10,10,0,6,11,25,36,5465
11,11,0,7,11,32,43,5465
12,12,1,5,12,37,49,5465
13,13,4,2,16,39,55,5465
14,14,6,2,22,41,63,5465
15,15,5,4,27,45,72,5465
16,16,4,3,31,48,79,5465
17,17,9,2,40,50,90,5465
18,18,5,2,45,52,97,5465
19,19,2,4,47,56,103,5465
20,20,2,4,49,60,109,5465
21,21,1,3,50,63,113,5465
22,22,1,5,51,68,119,5465
23,23,2,2,53,70,123,5465
24,24,2,1,55,71,126,5465
25,25,2,0,57,71,128,5465
26,26,1,0,58,71,129,5465
27,27,0,0,58,71,129,5465
0,0,1,0,1,0,1,5466
1,1,0,0,1,0,1,5466
0,0,1,0,1,0,1,5467
1,1,2,0,3,0,3,5467
2,2,1,0,4,0,4,5467
3,3,0,0,4,0,4,5467
0,0,1,0,1,0,1,5468
1,1,4,1,5,1,6,5468
2,2,5,1,10,2,12,5468
3,3,1,3,11,5,16,5468
4,4,1,0,12,5,17,5468
5,5,4,0,16,5,21,5468
6,6,5,0,21,5,26,5468
7,7,2,0,23,5,28,5468
8,8,2,0,25,5,30,5468
9,9,0,0,25,5,30,5468
0,0,1,0,1,0,1,5469
1,1,1,0,2,0,2,5469
2,2,0,1,2,1,3,5469
3,3,1,1,3,2,5,5469
4,4,1,0,4,2,6,5469
5,5,1,0,5,2,7,5469
6,6,2,0,7,2,9,5469
7,7,1,0,8,2,10,5469
8,8,0,0,8,2,10,5469
0,0,1,0,1,0,1,5470
1,1,0,0,1,0,1,5470
0,0,1,0,1,0,1,5471
1,1,2,0,3,0,3,5471
2,2,1,0,4,0,4,5471
3,3,1,0,5,0,5,5471
4,4,1,0,6,0,6,5471
5,5,1,0,7,0,7,5471
6,6,0,0,7,0,7,5471
0,0,1,0,1,0,1,5472
1,1,2,0,3,0,3,5472
2,2,1,1,4,1,5,5472
3,3,1,1,5,2,7,5472
4,4,0,0,5,2,7,5472
0,0,1,0,1,0,1,5473
1,1,2,0,3,0,3,5473
2,2,0,0,3,0,3,5473
0,0,1,0,1,0,1,5474
1,1,1,0,2,0,2,5474
2,2,0,1,2,1,3,5474
3,3,0,0,2,1,3,5474
0,0,1,0,1,0,1,5475
1,1,0,0,1,0,1,5475
0,0,1,0,1,0,1,5476
1,1,3,0,4,0,4,5476
2,2,2,1,6,1,7,5476
3,3,1,1,7,2,9,5476
4,4,2,0,9,2,11,5476
5,5,3,0,12,2,14,5476
6,6,2,0,14,2,16,5476
7,7,1,2,15,4,19,5476
8,8,0,2,15,6,21,5476
9,9,1,2,16,8,24,5476
10,10,1,1,17,9,26,5476
11,11,0,0,17,9,26,5476
0,0,1,0,1,0,1,5477
1,1,0,0,1,0,1,5477
0,0,1,0,1,0,1,5478
1,1,0,0,1,0,1,5478
0,0,1,0,1,0,1,5479
1,1,1,0,2,0,2,5479
2,2,1,0,3,0,3,5479
3,3,0,1,3,1,4,5479
4,4,0,2,3,3,6,5479
5,5,0,2,3,5,8,5479
6,6,1,1,4,6,10,5479
7,7,2,3,6,9,15,5479
8,8,3,2,9,11,20,5479
9,9,4,1,13,12,25,5479
10,10,1,0,14,12,26,5479
11,11,0,0,14,12,26,5479
0,0,1,0,1,0,1,5480
1,1,0,0,1,0,1,5480
0,0,1,0,1,0,1,5481
1,1,0,0,1,0,1,5481
0,0,1,0,1,0,1,5482
1,1,2,0,3,0,3,5482
2,2,0,0,3,0,3,5482
0,0,1,0,1,0,1,5483
1,1,1,1,2,1,3,5483
2,2,2,0,4,1,5,5483
3,3,3,0,7,1,8,5483
4,4,2,1,9,2,11,5483
5,5,0,0,9,2,11,5483
0,0,1,0,1,0,1,5484
1,1,0,0,1,0,1,5484
0,0,1,0,1,0,1,5485
1,1,2,0,3,0,3,5485
2,2,0,1,3,1,4,5485
3,3,1,1,4,2,6,5485
4,4,0,0,4,2,6,5485
0,0,1,0,1,0,1,5486
1,1,0,1,1,1,2,5486
2,2,0,1,1,2,3,5486
3,3,1,0,2,2,4,5486
4,4,0,0,2,2,4,5486
0,0,1,0,1,0,1,5487
1,1,2,0,3,0,3,5487
2,2,0,0,3,0,3,5487
0,0,1,0,1,0,1,5488
1,1,0,0,1,0,1,5488
0,0,1,0,1,0,1,5489
1,1,0,0,1,0,1,5489
0,0,1,0,1,0,1,5490
1,1,1,0,2,0,2,5490
2,2,0,0,2,0,2,5490
0,0,1,0,1,0,1,5491
1,1,0,1,1,1,2,5491
2,2,1,1,2,2,4,5491
3,3,3,2,5,4,9,5491
4,4,3,1,8,5,13,5491
5,5,0,2,8,7,15,5491
6,6,0,0,8,7,15,5491
0,0,1,0,1,0,1,5492
1,1,0,0,1,0,1,5492
0,0,1,0,1,0,1,5493
1,1,1,0,2,0,2,5493
2,2,1,0,3,0,3,5493
3,3,0,0,3,0,3,5493
0,0,1,0,1,0,1,5494
1,1,1,0,2,0,2,5494
2,2,1,0,3,0,3,5494
3,3,0,0,3,0,3,5494
0,0,1,0,1,0,1,5495
1,1,0,0,1,0,1,5495
0,0,1,0,1,0,1,5496
1,1,0,0,1,0,1,5496
0,0,1,0,1,0,1,5497
1,1,2,0,3,0,3,5497
2,2,0,1,3,1,4,5497
3,3,0,1,3,2,5,5497
4,4,1,0,4,2,6,5497
5,5,2,0,6,2,8,5497
6,6,2,0,8,2,10,5497
7,7,1,0,9,2,11,5497
8,8,0,0,9,2,11,5497
0,0,1,0,1,0,1,5498
1,1,0,0,1,0,1,5498
0,0,1,0,1,0,1,5499
1,1,1,1,2,1,3,5499
2,2,2,1,4,2,6,5499
3,3,1,3,5,5,10,5499
4,4,1,2,6,7,13,5499
5,5,1,1,7,8,15,5499
6,6,0,0,7,8,15,5499
0,0,1,0,1,0,1,5500
1,1,1,1,2,1,3,5500
2,2,0,1,2,2,4,5500
3,3,0,3,2,5,7,5500
4,4,0,3,2,8,10,5500
5,5,2,3,4,11,15,5500
6,6,0,2,4,13,17,5500
7,7,0,3,4,16,20,5500
8,8,0,2,4,18,22,5500
9,9,0,2,4,20,24,5500
10,10,0,0,4,20,24,5500
0,0,1,0,1,0,1,5501
1,1,0,0,1,0,1,5501
0,0,1,0,1,0,1,5502
1,1,2,0,3,0,3,5502
2,2,3,0,6,0,6,5502
3,3,4,2,10,2,12,5502
4,4,3,0,13,2,15,5502
5,5,1,0,14,2,16,5502
6,6,0,0,14,2,16,5502
0,0,1,0,1,0,1,5503
1,1,0,0,1,0,1,5503
0,0,1,0,1,0,1,5504
1,1,0,0,1,0,1,5504
0,0,1,0,1,0,1,5505
1,1,1,0,2,0,2,5505
2,2,1,0,3,0,3,5505
3,3,1,0,4,0,4,5505
4,4,1,0,5,0,5,5505
5,5,0,0,5,0,5,5505
0,0,1,0,1,0,1,5506
1,1,0,0,1,0,1,5506
0,0,1,0,1,0,1,5507
1,1,0,0,1,0,1,5507
0,0,1,0,1,0,1,5508
1,1,0,0,1,0,1,5508
0,0,1,0,1,0,1,5509
1,1,0,0,1,0,1,5509
0,0,1,0,1,0,1,5510
1,1,1,0,2,0,2,5510
2,2,0,0,2,0,2,5510
0,0,1,0,1,0,1,5511
1,1,1,0,2,0,2,5511
2,2,0,0,2,0,2,5511
0,0,1,0,1,0,1,5512
1,1,0,0,1,0,1,5512
0,0,1,0,1,0,1,5513
1,1,0,0,1,0,1,5513
0,0,1,0,1,0,1,5514
1,1,0,0,1,0,1,5514
0,0,1,0,1,0,1,5515
1,1,0,0,1,0,1,5515
0,0,1,0,1,0,1,5516
1,1,0,0,1,0,1,5516
0,0,1,0,1,0,1,5517
1,1,1,1,2,1,3,5517
2,2,1,1,3,2,5,5517
3,3,0,1,3,3,6,5517
4,4,0,1,3,4,7,5517
5,5,0,1,3,5,8,5517
6,6,0,0,3,5,8,5517
0,0,1,0,1,0,1,5518
1,1,0,0,1,0,1,5518
0,0,1,0,1,0,1,5519
1,1,1,0,2,0,2,5519
2,2,4,0,6,0,6,5519
3,3,5,0,11,0,11,5519
4,4,5,0,16,0,16,5519
5,5,2,0,18,0,18,5519
6,6,1,0,19,0,19,5519
7,7,1,1,20,1,21,5519
8,8,1,0,21,1,22,5519
9,9,1,0,22,1,23,5519
10,10,1,1,23,2,25,5519
11,11,0,1,23,3,26,5519
12,12,0,1,23,4,27,5519
13,13,0,3,23,7,30,5519
14,14,1,2,24,9,33,5519
15,15,0,2,24,11,35,5519
16,16,0,2,24,13,37,5519
17,17,1,2,25,15,40,5519
18,18,1,3,26,18,44,5519
19,19,1,2,27,20,47,5519
20,20,2,2,29,22,51,5519
21,21,1,2,30,24,54,5519
22,22,2,1,32,25,57,5519
23,23,3,0,35,25,60,5519
24,24,3,1,38,26,64,5519
25,25,2,2,40,28,68,5519
26,26,0,0,40,28,68,5519
0,0,1,0,1,0,1,5520
1,1,2,0,3,0,3,5520
2,2,1,0,4,0,4,5520
3,3,0,0,4,0,4,5520
0,0,1,0,1,0,1,5521
1,1,3,0,4,0,4,5521
2,2,0,0,4,0,4,5521
0,0,1,0,1,0,1,5522
1,1,2,0,3,0,3,5522
2,2,3,1,6,1,7,5522
3,3,1,2,7,3,10,5522
4,4,5,1,12,4,16,5522
5,5,2,0,14,4,18,5522
6,6,2,1,16,5,21,5522
7,7,1,1,17,6,23,5522
8,8,2,1,19,7,26,5522
9,9,2,0,21,7,28,5522
10,10,0,0,21,7,28,5522
0,0,1,0,1,0,1,5523
1,1,1,0,2,0,2,5523
2,2,1,0,3,0,3,5523
3,3,0,0,3,0,3,5523
0,0,1,0,1,0,1,5524
1,1,0,2,1,2,3,5524
2,2,0,1,1,3,4,5524
3,3,0,0,1,3,4,5524
0,0,1,0,1,0,1,5525
1,1,0,0,1,0,1,5525
0,0,1,0,1,0,1,5526
1,1,0,0,1,0,1,5526
0,0,1,0,1,0,1,5527
1,1,0,0,1,0,1,5527
0,0,1,0,1,0,1,5528
1,1,0,0,1,0,1,5528
0,0,1,0,1,0,1,5529
1,1,1,0,2,0,2,5529
2,2,2,0,4,0,4,5529
3,3,1,2,5,2,7,5529
4,4,1,1,6,3,9,5529
5,5,1,0,7,3,10,5529
6,6,1,0,8,3,11,5529
7,7,2,0,10,3,13,5529
8,8,1,0,11,3,14,5529
9,9,0,0,11,3,14,5529
0,0,1,0,1,0,1,5530
1,1,0,0,1,0,1,5530
0,0,1,0,1,0,1,5531
1,1,0,0,1,0,1,5531
0,0,1,0,1,0,1,5532
1,1,0,0,1,0,1,5532
0,0,1,0,1,0,1,5533
1,1,0,0,1,0,1,5533
0,0,1,0,1,0,1,5534
1,1,0,0,1,0,1,5534
0,0,1,0,1,0,1,5535
1,1,0,0,1,0,1,5535
0,0,1,0,1,0,1,5536
1,1,0,0,1,0,1,5536
0,0,1,0,1,0,1,5537
1,1,3,0,4,0,4,5537
2,2,3,0,7,0,7,5537
3,3,3,0,10,0,10,5537
4,4,2,0,12,0,12,5537
5,5,3,0,15,0,15,5537
6,6,0,2,15,2,17,5537
7,7,0,3,15,5,20,5537
8,8,1,2,16,7,23,5537
9,9,0,1,16,8,24,5537
10,10,1,2,17,10,27,5537
11,11,2,2,19,12,31,5537
12,12,1,1,20,13,33,5537
13,13,0,2,20,15,35,5537
14,14,0,1,20,16,36,5537
15,15,0,1,20,17,37,5537
16,16,0,0,20,17,37,5537
0,0,1,0,1,0,1,5538
1,1,0,0,1,0,1,5538
0,0,1,0,1,0,1,5539
1,1,1,0,2,0,2,5539
2,2,0,0,2,0,2,5539
0,0,1,0,1,0,1,5540
1,1,1,0,2,0,2,5540
2,2,0,0,2,0,2,5540
0,0,1,0,1,0,1,5541
1,1,0,0,1,0,1,5541
0,0,1,0,1,0,1,5542
1,1,1,0,2,0,2,5542
2,2,1,0,3,0,3,5542
3,3,2,0,5,0,5,5542
4,4,0,0,5,0,5,5542
0,0,1,0,1,0,1,5543
1,1,3,1,4,1,5,5543
2,2,1,1,5,2,7,5543
3,3,0,1,5,3,8,5543
4,4,0,1,5,4,9,5543
5,5,0,0,5,4,9,5543
0,0,1,0,1,0,1,5544
1,1,0,1,1,1,2,5544
2,2,0,1,1,2,3,5544
3,3,0,2,1,4,5,5544
4,4,0,2,1,6,7,5544
5,5,0,2,1,8,9,5544
6,6,0,3,1,11,12,5544
7,7,1,2,2,13,15,5544
8,8,1,2,3,15,18,5544
9,9,1,3,4,18,22,5544
10,10,0,0,4,18,22,5544
0,0,1,0,1,0,1,5545
1,1,0,0,1,0,1,5545
0,0,1,0,1,0,1,5546
1,1,0,1,1,1,2,5546
2,2,0,0,1,1,2,5546
0,0,1,0,1,0,1,5547
1,1,0,0,1,0,1,5547
0,0,1,0,1,0,1,5548
1,1,0,0,1,0,1,5548
0,0,1,0,1,0,1,5549
1,1,0,0,1,0,1,5549
0,0,1,0,1,0,1,5550
1,1,1,0,2,0,2,5550
2,2,2,0,4,0,4,5550
3,3,3,0,7,0,7,5550
4,4,4,1,11,1,12,5550
5,5,2,1,13,2,15,5550
6,6,0,2,13,4,17,5550
7,7,0,3,13,7,20,5550
8,8,0,1,13,8,21,5550
9,9,1,3,14,11,25,5550
10,10,0,4,14,15,29,5550
11,11,0,2,14,17,31,5550
12,12,0,0,14,17,31,5550
0,0,1,0,1,0,1,5551
1,1,0,0,1,0,1,5551
0,0,1,0,1,0,1,5552
1,1,0,0,1,0,1,5552
0,0,1,0,1,0,1,5553
1,1,2,0,3,0,3,5553
2,2,1,0,4,0,4,5553
3,3,2,0,6,0,6,5553
4,4,1,3,7,3,10,5553
5,5,3,5,10,8,18,5553
6,6,1,6,11,14,25,5553
7,7,0,4,11,18,29,5553
8,8,0,1,11,19,30,5553
9,9,0,0,11,19,30,5553
0,0,1,0,1,0,1,5554
1,1,0,0,1,0,1,5554
0,0,1,0,1,0,1,5555
1,1,0,0,1,0,1,5555
0,0,1,0,1,0,1,5556
1,1,0,1,1,1,2,5556
2,2,0,0,1,1,2,5556
0,0,1,0,1,0,1,5557
1,1,1,0,2,0,2,5557
2,2,0,0,2,0,2,5557
0,0,1,0,1,0,1,5558
1,1,1,0,2,0,2,5558
2,2,1,0,3,0,3,5558
3,3,0,0,3,0,3,5558
0,0,1,0,1,0,1,5559
1,1,0,0,1,0,1,5559
0,0,1,0,1,0,1,5560
1,1,0,0,1,0,1,5560
0,0,1,0,1,0,1,5561
1,1,0,0,1,0,1,5561
0,0,1,0,1,0,1,5562
1,1,1,0,2,0,2,5562
2,2,0,0,2,0,2,5562
0,0,1,0,1,0,1,5563
1,1,1,0,2,0,2,5563
2,2,1,0,3,0,3,5563
3,3,1,0,4,0,4,5563
4,4,2,0,6,0,6,5563
5,5,0,0,6,0,6,5563
0,0,1,0,1,0,1,5564
1,1,2,0,3,0,3,5564
2,2,0,0,3,0,3,5564
0,0,1,0,1,0,1,5565
1,1,1,1,2,1,3,5565
2,2,0,1,2,2,4,5565
3,3,0,2,2,4,6,5565
4,4,0,1,2,5,7,5565
5,5,0,2,2,7,9,5565
6,6,0,1,2,8,10,5565
7,7,0,1,2,9,11,5565
8,8,0,0,2,9,11,5565
0,0,1,0,1,0,1,5566
1,1,2,0,3,0,3,5566
2,2,3,0,6,0,6,5566
3,3,2,1,8,1,9,5566
4,4,3,2,11,3,14,5566
5,5,2,2,13,5,18,5566
6,6,1,2,14,7,21,5566
7,7,0,1,14,8,22,5566
8,8,0,1,14,9,23,5566
9,9,0,0,14,9,23,5566
0,0,1,0,1,0,1,5567
1,1,2,0,3,0,3,5567
2,2,0,0,3,0,3,5567
0,0,1,0,1,0,1,5568
1,1,0,0,1,0,1,5568
0,0,1,0,1,0,1,5569
1,1,1,0,2,0,2,5569
2,2,0,0,2,0,2,5569
0,0,1,0,1,0,1,5570
1,1,0,0,1,0,1,5570
0,0,1,0,1,0,1,5571
1,1,1,1,2,1,3,5571
2,2,1,0,3,1,4,5571
3,3,0,0,3,1,4,5571
0,0,1,0,1,0,1,5572
1,1,1,0,2,0,2,5572
2,2,1,0,3,0,3,5572
3,3,0,1,3,1,4,5572
4,4,1,1,4,2,6,5572
5,5,0,0,4,2,6,5572
0,0,1,0,1,0,1,5573
1,1,0,0,1,0,1,5573
0,0,1,0,1,0,1,5574
1,1,1,0,2,0,2,5574
2,2,1,1,3,1,4,5574
3,3,0,0,3,1,4,5574
0,0,1,0,1,0,1,5575
1,1,1,0,2,0,2,5575
2,2,0,0,2,0,2,5575
0,0,1,0,1,0,1,5576
1,1,0,0,1,0,1,5576
0,0,1,0,1,0,1,5577
1,1,0,0,1,0,1,5577
0,0,1,0,1,0,1,5578
1,1,1,0,2,0,2,5578
2,2,0,0,2,0,2,5578
0,0,1,0,1,0,1,5579
1,1,0,0,1,0,1,5579
0,0,1,0,1,0,1,5580
1,1,1,1,2,1,3,5580
2,2,3,0,5,1,6,5580
3,3,3,2,8,3,11,5580
4,4,2,4,10,7,17,5580
5,5,1,2,11,9,20,5580
6,6,1,1,12,10,22,5580
7,7,0,0,12,10,22,5580
0,0,1,0,1,0,1,5581
1,1,2,0,3,0,3,5581
2,2,2,1,5,1,6,5581
3,3,0,0,5,1,6,5581
0,0,1,0,1,0,1,5582
1,1,0,1,1,1,2,5582
2,2,0,0,1,1,2,5582
0,0,1,0,1,0,1,5583
1,1,0,0,1,0,1,5583
0,0,1,0,1,0,1,5584
1,1,0,1,1,1,2,5584
2,2,1,1,2,2,4,5584
3,3,0,1,2,3,5,5584
4,4,0,0,2,3,5,5584
0,0,1,0,1,0,1,5585
1,1,2,0,3,0,3,5585
2,2,0,0,3,0,3,5585
0,0,1,0,1,0,1,5586
1,1,0,0,1,0,1,5586
0,0,1,0,1,0,1,5587
1,1,0,0,1,0,1,5587
0,0,1,0,1,0,1,5588
1,1,0,1,1,1,2,5588
2,2,1,1,2,2,4,5588
3,3,0,1,2,3,5,5588
4,4,0,0,2,3,5,5588
0,0,1,0,1,0,1,5589
1,1,0,0,1,0,1,5589
0,0,1,0,1,0,1,5590
1,1,0,0,1,0,1,5590
0,0,1,0,1,0,1,5591
1,1,0,0,1,0,1,5591
0,0,1,0,1,0,1,5592
1,1,1,0,2,0,2,5592
2,2,1,1,3,1,4,5592
3,3,1,1,4,2,6,5592
4,4,2,0,6,2,8,5592
5,5,1,1,7,3,10,5592
6,6,0,0,7,3,10,5592
0,0,1,0,1,0,1,5593
1,1,0,0,1,0,1,5593
0,0,1,0,1,0,1,5594
1,1,0,0,1,0,1,5594
0,0,1,0,1,0,1,5595
1,1,0,0,1,0,1,5595
0,0,1,0,1,0,1,5596
1,1,0,0,1,0,1,5596
0,0,1,0,1,0,1,5597
1,1,0,0,1,0,1,5597
0,0,1,0,1,0,1,5598
1,1,0,0,1,0,1,5598
0,0,1,0,1,0,1,5599
1,1,0,0,1,0,1,5599
0,0,1,0,1,0,1,5600
1,1,1,1,2,1,3,5600
2,2,1,1,3,2,5,5600
3,3,1,1,4,3,7,5600
4,4,0,0,4,3,7,5600
0,0,1,0,1,0,1,5601
1,1,1,0,2,0,2,5601
2,2,3,0,5,0,5,5601
3,3,2,1,7,1,8,5601
4,4,1,1,8,2,10,5601
5,5,2,0,10,2,12,5601
6,6,2,2,12,4,16,5601
7,7,4,2,16,6,22,5601
8,8,2,2,18,8,26,5601
9,9,3,5,21,13,34,5601
10,10,0,4,21,17,38,5601
11,11,1,2,22,19,41,5601
12,12,2,1,24,20,44,5601
13,13,0,1,24,21,45,5601
14,14,0,1,24,22,46,5601
15,15,0,4,24,26,50,5601
16,16,0,2,24,28,52,5601
17,17,1,1,25,29,54,5601
18,18,1,0,26,29,55,5601
19,19,1,0,27,29,56,5601
20,20,1,0,28,29,57,5601
21,21,1,1,29,30,59,5601
22,22,1,2,30,32,62,5601
23,23,0,1,30,33,63,5601
24,24,0,1,30,34,64,5601
25,25,0,0,30,34,64,5601
0,0,1,0,1,0,1,5602
1,1,2,0,3,0,3,5602
2,2,1,0,4,0,4,5602
3,3,2,0,6,0,6,5602
4,4,2,1,8,1,9,5602
5,5,2,2,10,3,13,5602
6,6,4,0,14,3,17,5602
7,7,6,1,20,4,24,5602
8,8,4,2,24,6,30,5602
9,9,6,2,30,8,38,5602
10,10,2,2,32,10,42,5602
11,11,1,2,33,12,45,5602
12,12,2,3,35,15,50,5602
13,13,1,4,36,19,55,5602
14,14,0,3,36,22,58,5602
15,15,0,2,36,24,60,5602
16,16,2,1,38,25,63,5602
17,17,1,2,39,27,66,5602
18,18,2,1,41,28,69,5602
19,19,2,1,43,29,72,5602
20,20,3,2,46,31,77,5602
21,21,1,1,47,32,79,5602
22,22,0,0,47,32,79,5602
0,0,1,0,1,0,1,5603
1,1,2,1,3,1,4,5603
2,2,2,0,5,1,6,5603
3,3,3,0,8,1,9,5603
4,4,1,0,9,1,10,5603
5,5,1,0,10,1,11,5603
6,6,1,0,11,1,12,5603
7,7,1,0,12,1,13,5603
8,8,1,0,13,1,14,5603
9,9,1,1,14,2,16,5603
10,10,0,0,14,2,16,5603
0,0,1,0,1,0,1,5604
1,1,1,0,2,0,2,5604
2,2,0,0,2,0,2,5604
0,0,1,0,1,0,1,5605
1,1,1,0,2,0,2,5605
2,2,1,1,3,1,4,5605
3,3,0,0,3,1,4,5605
0,0,1,0,1,0,1,5606
1,1,1,1,2,1,3,5606
2,2,0,1,2,2,4,5606
3,3,0,1,2,3,5,5606
4,4,0,0,2,3,5,5606
0,0,1,0,1,0,1,5607
1,1,0,0,1,0,1,5607
0,0,1,0,1,0,1,5608
1,1,1,1,2,1,3,5608
2,2,0,2,2,3,5,5608
3,3,0,2,2,5,7,5608
4,4,0,2,2,7,9,5608
5,5,2,1,4,8,12,5608
6,6,2,1,6,9,15,5608
7,7,2,0,8,9,17,5608
8,8,1,0,9,9,18,5608
9,9,0,1,9,10,19,5608
10,10,0,1,9,11,20,5608
11,11,0,1,9,12,21,5608
12,12,0,0,9,12,21,5608
0,0,1,0,1,0,1,5609
1,1,1,0,2,0,2,5609
2,2,0,0,2,0,2,5609
0,0,1,0,1,0,1,5610
1,1,1,1,2,1,3,5610
2,2,1,1,3,2,5,5610
3,3,1,2,4,4,8,5610
4,4,3,1,7,5,12,5610
5,5,1,0,8,5,13,5610
6,6,0,1,8,6,14,5610
7,7,0,1,8,7,15,5610
8,8,0,1,8,8,16,5610
9,9,0,1,8,9,17,5610
10,10,0,0,8,9,17,5610
0,0,1,0,1,0,1,5611
1,1,0,1,1,1,2,5611
2,2,0,1,1,2,3,5611
3,3,0,1,1,3,4,5611
4,4,0,0,1,3,4,5611
0,0,1,0,1,0,1,5612
1,1,0,1,1,1,2,5612
2,2,0,0,1,1,2,5612
0,0,1,0,1,0,1,5613
1,1,1,0,2,0,2,5613
2,2,2,0,4,0,4,5613
3,3,1,1,5,1,6,5613
4,4,2,1,7,2,9,5613
5,5,0,0,7,2,9,5613
0,0,1,0,1,0,1,5614
1,1,1,0,2,0,2,5614
2,2,1,0,3,0,3,5614
3,3,1,0,4,0,4,5614
4,4,1,0,5,0,5,5614
5,5,0,0,5,0,5,5614
0,0,1,0,1,0,1,5615
1,1,3,0,4,0,4,5615
2,2,0,1,4,1,5,5615
3,3,0,0,4,1,5,5615
0,0,1,0,1,0,1,5616
1,1,3,0,4,0,4,5616
2,2,1,1,5,1,6,5616
3,3,0,1,5,2,7,5616
4,4,0,1,5,3,8,5616
5,5,0,1,5,4,9,5616
6,6,0,2,5,6,11,5616
7,7,1,1,6,7,13,5616
8,8,2,1,8,8,16,5616
9,9,1,0,9,8,17,5616
10,10,2,0,11,8,19,5616
11,11,2,0,13,8,21,5616
12,12,1,0,14,8,22,5616
13,13,0,0,14,8,22,5616
0,0,1,0,1,0,1,5617
1,1,1,0,2,0,2,5617
2,2,0,0,2,0,2,5617
0,0,1,0,1,0,1,5618
1,1,0,0,1,0,1,5618
0,0,1,0,1,0,1,5619
1,1,1,0,2,0,2,5619
2,2,0,1,2,1,3,5619
3,3,0,0,2,1,3,5619
0,0,1,0,1,0,1,5620
1,1,1,0,2,0,2,5620
2,2,0,0,2,0,2,5620
0,0,1,0,1,0,1,5621
1,1,0,0,1,0,1,5621
0,0,1,0,1,0,1,5622
1,1,0,0,1,0,1,5622
0,0,1,0,1,0,1,5623
1,1,0,0,1,0,1,5623
0,0,1,0,1,0,1,5624
1,1,0,0,1,0,1,5624
0,0,1,0,1,0,1,5625
1,1,0,0,1,0,1,5625
0,0,1,0,1,0,1,5626
1,1,0,0,1,0,1,5626
0,0,1,0,1,0,1,5627
1,1,0,0,1,0,1,5627
0,0,1,0,1,0,1,5628
1,1,0,1,1,1,2,5628
2,2,0,0,1,1,2,5628
0,0,1,0,1,0,1,5629
1,1,0,0,1,0,1,5629
0,0,1,0,1,0,1,5630
1,1,0,0,1,0,1,5630
0,0,1,0,1,0,1,5631
1,1,0,0,1,0,1,5631
0,0,1,0,1,0,1,5632
1,1,0,0,1,0,1,5632
0,0,1,0,1,0,1,5633
1,1,1,0,2,0,2,5633
2,2,1,2,3,2,5,5633
3,3,0,3,3,5,8,5633
4,4,1,3,4,8,12,5633
5,5,2,2,6,10,16,5633
6,6,1,2,7,12,19,5633
7,7,1,1,8,13,21,5633
8,8,0,1,8,14,22,5633
9,9,0,1,8,15,23,5633
10,10,0,2,8,17,25,5633
11,11,0,0,8,17,25,5633
0,0,1,0,1,0,1,5634
1,1,1,0,2,0,2,5634
2,2,0,0,2,0,2,5634
0,0,1,0,1,0,1,5635
1,1,1,0,2,0,2,5635
2,2,0,0,2,0,2,5635
0,0,1,0,1,0,1,5636
1,1,1,0,2,0,2,5636
2,2,0,0,2,0,2,5636
0,0,1,0,1,0,1,5637
1,1,1,0,2,0,2,5637
2,2,0,0,2,0,2,5637
0,0,1,0,1,0,1,5638
1,1,0,0,1,0,1,5638
0,0,1,0,1,0,1,5639
1,1,0,0,1,0,1,5639
0,0,1,0,1,0,1,5640
1,1,1,0,2,0,2,5640
2,2,1,0,3,0,3,5640
3,3,0,1,3,1,4,5640
4,4,1,0,4,1,5,5640
5,5,1,0,5,1,6,5640
6,6,0,1,5,2,7,5640
7,7,0,0,5,2,7,5640
0,0,1,0,1,0,1,5641
1,1,0,1,1,1,2,5641
2,2,0,1,1,2,3,5641
3,3,1,1,2,3,5,5641
4,4,0,0,2,3,5,5641
0,0,1,0,1,0,1,5642
1,1,0,1,1,1,2,5642
2,2,0,1,1,2,3,5642
3,3,0,0,1,2,3,5642
0,0,1,0,1,0,1,5643
1,1,1,0,2,0,2,5643
2,2,0,2,2,2,4,5643
3,3,1,0,3,2,5,5643
4,4,0,0,3,2,5,5643
0,0,1,0,1,0,1,5644
1,1,0,0,1,0,1,5644
0,0,1,0,1,0,1,5645
1,1,0,0,1,0,1,5645
0,0,1,0,1,0,1,5646
1,1,1,0,2,0,2,5646
2,2,4,1,6,1,7,5646
3,3,3,0,9,1,10,5646
4,4,1,0,10,1,11,5646
5,5,2,0,12,1,13,5646
6,6,0,0,12,1,13,5646
0,0,1,0,1,0,1,5647
1,1,1,0,2,0,2,5647
2,2,1,0,3,0,3,5647
3,3,0,1,3,1,4,5647
4,4,0,0,3,1,4,5647
0,0,1,0,1,0,1,5648
1,1,0,1,1,1,2,5648
2,2,0,0,1,1,2,5648
0,0,1,0,1,0,1,5649
1,1,0,1,1,1,2,5649
2,2,0,2,1,3,4,5649
3,3,0,1,1,4,5,5649
4,4,0,2,1,6,7,5649
5,5,0,2,1,8,9,5649
6,6,1,2,2,10,12,5649
7,7,2,4,4,14,18,5649
8,8,1,0,5,14,19,5649
9,9,2,0,7,14,21,5649
10,10,2,0,9,14,23,5649
11,11,1,0,10,14,24,5649
12,12,0,0,10,14,24,5649
0,0,1,0,1,0,1,5650
1,1,1,0,2,0,2,5650
2,2,1,0,3,0,3,5650
3,3,0,0,3,0,3,5650
0,0,1,0,1,0,1,5651
1,1,2,1,3,1,4,5651
2,2,1,2,4,3,7,5651
3,3,0,2,4,5,9,5651
4,4,0,1,4,6,10,5651
5,5,1,2,5,8,13,5651
6,6,0,0,5,8,13,5651
0,0,1,0,1,0,1,5652
1,1,0,0,1,0,1,5652
0,0,1,0,1,0,1,5653
1,1,0,0,1,0,1,5653
0,0,1,0,1,0,1,5654
1,1,2,0,3,0,3,5654
2,2,2,0,5,0,5,5654
3,3,1,1,6,1,7,5654
4,4,0,0,6,1,7,5654
0,0,1,0,1,0,1,5655
1,1,0,0,1,0,1,5655
0,0,1,0,1,0,1,5656
1,1,0,0,1,0,1,5656
0,0,1,0,1,0,1,5657
1,1,1,0,2,0,2,5657
2,2,1,0,3,0,3,5657
3,3,2,0,5,0,5,5657
4,4,1,1,6,1,7,5657
5,5,1,1,7,2,9,5657
6,6,0,1,7,3,10,5657
7,7,0,1,7,4,11,5657
8,8,0,1,7,5,12,5657
9,9,1,0,8,5,13,5657
10,10,1,0,9,5,14,5657
11,11,0,0,9,5,14,5657
0,0,1,0,1,0,1,5658
1,1,1,0,2,0,2,5658
2,2,1,0,3,0,3,5658
3,3,2,0,5,0,5,5658
4,4,0,1,5,1,6,5658
5,5,1,0,6,1,7,5658
6,6,1,0,7,1,8,5658
7,7,2,0,9,1,10,5658
8,8,1,0,10,1,11,5658
9,9,2,0,12,1,13,5658
10,10,0,1,12,2,14,5658
11,11,0,1,12,3,15,5658
12,12,0,0,12,3,15,5658
0,0,1,0,1,0,1,5659
1,1,1,1,2,1,3,5659
2,2,0,0,2,1,3,5659
0,0,1,0,1,0,1,5660
1,1,0,0,1,0,1,5660
0,0,1,0,1,0,1,5661
1,1,2,0,3,0,3,5661
2,2,2,0,5,0,5,5661
3,3,2,0,7,0,7,5661
4,4,0,0,7,0,7,5661
0,0,1,0,1,0,1,5662
1,1,1,0,2,0,2,5662
2,2,1,0,3,0,3,5662
3,3,1,0,4,0,4,5662
4,4,0,0,4,0,4,5662
0,0,1,0,1,0,1,5663
1,1,0,0,1,0,1,5663
0,0,1,0,1,0,1,5664
1,1,1,0,2,0,2,5664
2,2,0,0,2,0,2,5664
0,0,1,0,1,0,1,5665
1,1,1,1,2,1,3,5665
2,2,0,1,2,2,4,5665
3,3,0,4,2,6,8,5665
4,4,1,2,3,8,11,5665
5,5,2,1,5,9,14,5665
6,6,2,1,7,10,17,5665
7,7,0,0,7,10,17,5665
0,0,1,0,1,0,1,5666
1,1,1,2,2,2,4,5666
2,2,1,1,3,3,6,5666
3,3,0,2,3,5,8,5666
4,4,1,2,4,7,11,5666
5,5,2,1,6,8,14,5666
6,6,2,1,8,9,17,5666
7,7,5,3,13,12,25,5666
8,8,3,3,16,15,31,5666
9,9,2,2,18,17,35,5666
10,10,0,2,18,19,37,5666
11,11,0,2,18,21,39,5666
12,12,1,2,19,23,42,5666
13,13,2,2,21,25,46,5666
14,14,3,2,24,27,51,5666
15,15,1,1,25,28,53,5666
16,16,1,3,26,31,57,5666
17,17,2,0,28,31,59,5666
18,18,0,1,28,32,60,5666
19,19,0,0,28,32,60,5666
0,0,1,0,1,0,1,5667
1,1,0,0,1,0,1,5667
0,0,1,0,1,0,1,5668
1,1,1,0,2,0,2,5668
2,2,1,0,3,0,3,5668
3,3,1,0,4,0,4,5668
4,4,1,0,5,0,5,5668
5,5,0,0,5,0,5,5668
0,0,1,0,1,0,1,5669
1,1,1,0,2,0,2,5669
2,2,0,0,2,0,2,5669
0,0,1,0,1,0,1,5670
1,1,0,1,1,1,2,5670
2,2,1,2,2,3,5,5670
3,3,2,3,4,6,10,5670
4,4,2,3,6,9,15,5670
5,5,5,0,11,9,20,5670
6,6,4,2,15,11,26,5670
7,7,5,3,20,14,34,5670
8,8,5,4,25,18,43,5670
9,9,4,5,29,23,52,5670
10,10,3,5,32,28,60,5670
11,11,3,4,35,32,67,5670
12,12,2,2,37,34,71,5670
13,13,2,2,39,36,75,5670
14,14,0,2,39,38,77,5670
15,15,0,4,39,42,81,5670
16,16,0,2,39,44,83,5670
17,17,0,3,39,47,86,5670
18,18,0,2,39,49,88,5670
19,19,0,2,39,51,90,5670
20,20,0,2,39,53,92,5670
21,21,1,2,40,55,95,5670
22,22,0,1,40,56,96,5670
23,23,0,2,40,58,98,5670
24,24,0,0,40,58,98,5670
0,0,1,0,1,0,1,5671
1,1,1,0,2,0,2,5671
2,2,2,0,4,0,4,5671
3,3,1,0,5,0,5,5671
4,4,1,0,6,0,6,5671
5,5,0,1,6,1,7,5671
6,6,1,0,7,1,8,5671
7,7,0,1,7,2,9,5671
8,8,0,0,7,2,9,5671
0,0,1,0,1,0,1,5672
1,1,1,1,2,1,3,5672
2,2,0,0,2,1,3,5672
0,0,1,0,1,0,1,5673
1,1,0,0,1,0,1,5673
0,0,1,0,1,0,1,5674
1,1,0,0,1,0,1,5674
0,0,1,0,1,0,1,5675
1,1,0,0,1,0,1,5675
0,0,1,0,1,0,1,5676
1,1,0,0,1,0,1,5676
0,0,1,0,1,0,1,5677
1,1,1,0,2,0,2,5677
2,2,1,0,3,0,3,5677
3,3,0,0,3,0,3,5677
0,0,1,0,1,0,1,5678
1,1,0,0,1,0,1,5678
0,0,1,0,1,0,1,5679
1,1,1,0,2,0,2,5679
2,2,0,0,2,0,2,5679
0,0,1,0,1,0,1,5680
1,1,1,0,2,0,2,5680
2,2,1,0,3,0,3,5680
3,3,0,0,3,0,3,5680
0,0,1,0,1,0,1,5681
1,1,0,0,1,0,1,5681
0,0,1,0,1,0,1,5682
1,1,1,0,2,0,2,5682
2,2,0,0,2,0,2,5682
0,0,1,0,1,0,1,5683
1,1,1,0,2,0,2,5683
2,2,1,0,3,0,3,5683
3,3,0,0,3,0,3,5683
0,0,1,0,1,0,1,5684
1,1,0,0,1,0,1,5684
0,0,1,0,1,0,1,5685
1,1,2,0,3,0,3,5685
2,2,0,1,3,1,4,5685
3,3,1,0,4,1,5,5685
4,4,0,0,4,1,5,5685
0,0,1,0,1,0,1,5686
1,1,0,0,1,0,1,5686
0,0,1,0,1,0,1,5687
1,1,0,1,1,1,2,5687
2,2,0,0,1,1,2,5687
0,0,1,0,1,0,1,5688
1,1,1,1,2,1,3,5688
2,2,1,0,3,1,4,5688
3,3,1,0,4,1,5,5688
4,4,1,0,5,1,6,5688
5,5,0,0,5,1,6,5688
0,0,1,0,1,0,1,5689
1,1,1,1,2,1,3,5689
2,2,2,0,4,1,5,5689
3,3,2,1,6,2,8,5689
4,4,0,1,6,3,9,5689
5,5,0,1,6,4,10,5689
6,6,0,1,6,5,11,5689
7,7,0,0,6,5,11,5689
0,0,1,0,1,0,1,5690
1,1,0,1,1,1,2,5690
2,2,0,0,1,1,2,5690
0,0,1,0,1,0,1,5691
1,1,1,1,2,1,3,5691
2,2,2,2,4,3,7,5691
3,3,0,2,4,5,9,5691
4,4,1,1,5,6,11,5691
5,5,2,2,7,8,15,5691
6,6,2,1,9,9,18,5691
7,7,1,1,10,10,20,5691
8,8,0,0,10,10,20,5691
0,0,1,0,1,0,1,5692
1,1,1,0,2,0,2,5692
2,2,0,0,2,0,2,5692
0,0,1,0,1,0,1,5693
1,1,2,0,3,0,3,5693
2,2,2,0,5,0,5,5693
3,3,0,0,5,0,5,5693
0,0,1,0,1,0,1,5694
1,1,1,0,2,0,2,5694
2,2,1,0,3,0,3,5694
3,3,0,0,3,0,3,5694
0,0,1,0,1,0,1,5695
1,1,0,1,1,1,2,5695
2,2,0,0,1,1,2,5695
0,0,1,0,1,0,1,5696
1,1,0,0,1,0,1,5696
0,0,1,0,1,0,1,5697
1,1,1,0,2,0,2,5697
2,2,1,1,3,1,4,5697
3,3,1,2,4,3,7,5697
4,4,1,4,5,7,12,5697
5,5,1,2,6,9,15,5697
6,6,0,3,6,12,18,5697
7,7,0,1,6,13,19,5697
8,8,1,1,7,14,21,5697
9,9,0,1,7,15,22,5697
10,10,0,0,7,15,22,5697
0,0,1,0,1,0,1,5698
1,1,1,0,2,0,2,5698
2,2,1,0,3,0,3,5698
3,3,1,0,4,0,4,5698
4,4,0,0,4,0,4,5698
0,0,1,0,1,0,1,5699
1,1,1,0,2,0,2,5699
2,2,0,0,2,0,2,5699
0,0,1,0,1,0,1,5700
1,1,0,0,1,0,1,5700
0,0,1,0,1,0,1,5701
1,1,0,0,1,0,1,5701
0,0,1,0,1,0,1,5702
1,1,2,0,3,0,3,5702
2,2,2,0,5,0,5,5702
3,3,2,0,7,0,7,5702
4,4,0,0,7,0,7,5702
0,0,1,0,1,0,1,5703
1,1,2,0,3,0,3,5703
2,2,3,0,6,0,6,5703
3,3,3,0,9,0,9,5703
4,4,2,1,11,1,12,5703
5,5,2,2,13,3,16,5703
6,6,1,1,14,4,18,5703
7,7,2,1,16,5,21,5703
8,8,2,1,18,6,24,5703
9,9,3,1,21,7,28,5703
10,10,4,0,25,7,32,5703
11,11,1,1,26,8,34,5703
12,12,2,1,28,9,37,5703
13,13,1,0,29,9,38,5703
14,14,0,0,29,9,38,5703
0,0,1,0,1,0,1,5704
1,1,0,0,1,0,1,5704
0,0,1,0,1,0,1,5705
1,1,1,1,2,1,3,5705
2,2,0,0,2,1,3,5705
0,0,1,0,1,0,1,5706
1,1,0,0,1,0,1,5706
0,0,1,0,1,0,1,5707
1,1,0,0,1,0,1,5707
0,0,1,0,1,0,1,5708
1,1,0,0,1,0,1,5708
0,0,1,0,1,0,1,5709
1,1,1,0,2,0,2,5709
2,2,0,0,2,0,2,5709
0,0,1,0,1,0,1,5710
1,1,0,0,1,0,1,5710
0,0,1,0,1,0,1,5711
1,1,0,0,1,0,1,5711
0,0,1,0,1,0,1,5712
1,1,2,0,3,0,3,5712
2,2,1,0,4,0,4,5712
3,3,1,0,5,0,5,5712
4,4,0,0,5,0,5,5712
0,0,1,0,1,0,1,5713
1,1,2,0,3,0,3,5713
2,2,1,0,4,0,4,5713
3,3,1,0,5,0,5,5713
4,4,0,0,5,0,5,5713
0,0,1,0,1,0,1,5714
1,1,2,0,3,0,3,5714
2,2,2,0,5,0,5,5714
3,3,1,0,6,0,6,5714
4,4,2,0,8,0,8,5714
5,5,0,1,8,1,9,5714
6,6,0,1,8,2,10,5714
7,7,0,0,8,2,10,5714
0,0,1,0,1,0,1,5715
1,1,0,0,1,0,1,5715
0,0,1,0,1,0,1,5716
1,1,1,0,2,0,2,5716
2,2,4,0,6,0,6,5716
3,3,1,0,7,0,7,5716
4,4,1,0,8,0,8,5716
5,5,0,0,8,0,8,5716
0,0,1,0,1,0,1,5717
1,1,2,0,3,0,3,5717
2,2,1,1,4,1,5,5717
3,3,2,0,6,1,7,5717
4,4,0,1,6,2,8,5717
5,5,0,0,6,2,8,5717
0,0,1,0,1,0,1,5718
1,1,0,0,1,0,1,5718
0,0,1,0,1,0,1,5719
1,1,0,0,1,0,1,5719
0,0,1,0,1,0,1,5720
1,1,0,0,1,0,1,5720
0,0,1,0,1,0,1,5721
1,1,1,0,2,0,2,5721
2,2,1,0,3,0,3,5721
3,3,0,0,3,0,3,5721
0,0,1,0,1,0,1,5722
1,1,0,0,1,0,1,5722
0,0,1,0,1,0,1,5723
1,1,1,0,2,0,2,5723
2,2,1,0,3,0,3,5723
3,3,2,0,5,0,5,5723
4,4,0,1,5,1,6,5723
5,5,0,2,5,3,8,5723
6,6,1,0,6,3,9,5723
7,7,1,0,7,3,10,5723
8,8,1,1,8,4,12,5723
9,9,1,2,9,6,15,5723
10,10,1,0,10,6,16,5723
11,11,2,0,12,6,18,5723
12,12,1,0,13,6,19,5723
13,13,0,0,13,6,19,5723
0,0,1,0,1,0,1,5724
1,1,1,0,2,0,2,5724
2,2,0,0,2,0,2,5724
0,0,1,0,1,0,1,5725
1,1,1,0,2,0,2,5725
2,2,1,0,3,0,3,5725
3,3,0,0,3,0,3,5725
0,0,1,0,1,0,1,5726
1,1,1,0,2,0,2,5726
2,2,0,0,2,0,2,5726
0,0,1,0,1,0,1,5727
1,1,0,0,1,0,1,5727
0,0,1,0,1,0,1,5728
1,1,1,0,2,0,2,5728
2,2,1,0,3,0,3,5728
3,3,1,1,4,1,5,5728
4,4,1,1,5,2,7,5728
5,5,1,0,6,2,8,5728
6,6,0,0,6,2,8,5728
0,0,1,0,1,0,1,5729
1,1,0,1,1,1,2,5729
2,2,1,1,2,2,4,5729
3,3,0,1,2,3,5,5729
4,4,0,1,2,4,6,5729
5,5,0,2,2,6,8,5729
6,6,0,1,2,7,9,5729
7,7,0,0,2,7,9,5729
0,0,1,0,1,0,1,5730
1,1,0,1,1,1,2,5730
2,2,0,1,1,2,3,5730
3,3,0,0,1,2,3,5730
0,0,1,0,1,0,1,5731
1,1,3,0,4,0,4,5731
2,2,2,1,6,1,7,5731
3,3,1,0,7,1,8,5731
4,4,0,1,7,2,9,5731
5,5,0,2,7,4,11,5731
6,6,0,0,7,4,11,5731
0,0,1,0,1,0,1,5732
1,1,0,0,1,0,1,5732
0,0,1,0,1,0,1,5733
1,1,0,0,1,0,1,5733
0,0,1,0,1,0,1,5734
1,1,2,0,3,0,3,5734
2,2,0,0,3,0,3,5734
0,0,1,0,1,0,1,5735
1,1,2,0,3,0,3,5735
2,2,2,1,5,1,6,5735
3,3,0,0,5,1,6,5735
0,0,1,0,1,0,1,5736
1,1,2,0,3,0,3,5736
2,2,1,0,4,0,4,5736
3,3,0,0,4,0,4,5736
0,0,1,0,1,0,1,5737
1,1,2,0,3,0,3,5737
2,2,3,2,6,2,8,5737
3,3,3,2,9,4,13,5737
4,4,0,2,9,6,15,5737
5,5,0,0,9,6,15,5737
0,0,1,0,1,0,1,5738
1,1,1,0,2,0,2,5738
2,2,0,0,2,0,2,5738
0,0,1,0,1,0,1,5739
1,1,0,1,1,1,2,5739
2,2,0,0,1,1,2,5739
0,0,1,0,1,0,1,5740
1,1,1,0,2,0,2,5740
2,2,0,1,2,1,3,5740
3,3,0,1,2,2,4,5740
4,4,0,1,2,3,5,5740
5,5,0,0,2,3,5,5740
0,0,1,0,1,0,1,5741
1,1,0,0,1,0,1,5741
0,0,1,0,1,0,1,5742
1,1,1,0,2,0,2,5742
2,2,1,0,3,0,3,5742
3,3,0,0,3,0,3,5742
0,0,1,0,1,0,1,5743
1,1,1,0,2,0,2,5743
2,2,0,0,2,0,2,5743
0,0,1,0,1,0,1,5744
1,1,1,0,2,0,2,5744
2,2,0,0,2,0,2,5744
0,0,1,0,1,0,1,5745
1,1,0,0,1,0,1,5745
0,0,1,0,1,0,1,5746
1,1,0,0,1,0,1,5746
0,0,1,0,1,0,1,5747
1,1,1,1,2,1,3,5747
2,2,0,3,2,4,6,5747
3,3,1,2,3,6,9,5747
4,4,1,2,4,8,12,5747
5,5,0,1,4,9,13,5747
6,6,0,0,4,9,13,5747
0,0,1,0,1,0,1,5748
1,1,0,0,1,0,1,5748
0,0,1,0,1,0,1,5749
1,1,1,0,2,0,2,5749
2,2,0,1,2,1,3,5749
3,3,0,0,2,1,3,5749
0,0,1,0,1,0,1,5750
1,1,1,0,2,0,2,5750
2,2,1,0,3,0,3,5750
3,3,0,0,3,0,3,5750
0,0,1,0,1,0,1,5751
1,1,0,0,1,0,1,5751
0,0,1,0,1,0,1,5752
1,1,0,1,1,1,2,5752
2,2,0,0,1,1,2,5752
0,0,1,0,1,0,1,5753
1,1,0,0,1,0,1,5753
0,0,1,0,1,0,1,5754
1,1,0,1,1,1,2,5754
2,2,0,0,1,1,2,5754
0,0,1,0,1,0,1,5755
1,1,1,0,2,0,2,5755
2,2,0,1,2,1,3,5755
3,3,1,1,3,2,5,5755
4,4,1,1,4,3,7,5755
5,5,3,0,7,3,10,5755
6,6,2,1,9,4,13,5755
7,7,1,0,10,4,14,5755
8,8,0,0,10,4,14,5755
0,0,1,0,1,0,1,5756
1,1,0,1,1,1,2,5756
2,2,0,1,1,2,3,5756
3,3,0,0,1,2,3,5756
0,0,1,0,1,0,1,5757
1,1,3,0,4,0,4,5757
2,2,2,0,6,0,6,5757
3,3,0,0,6,0,6,5757
0,0,1,0,1,0,1,5758
1,1,1,0,2,0,2,5758
2,2,0,1,2,1,3,5758
3,3,0,1,2,2,4,5758
4,4,0,0,2,2,4,5758
0,0,1,0,1,0,1,5759
1,1,0,0,1,0,1,5759
0,0,1,0,1,0,1,5760
1,1,0,0,1,0,1,5760
0,0,1,0,1,0,1,5761
1,1,0,0,1,0,1,5761
0,0,1,0,1,0,1,5762
1,1,0,0,1,0,1,5762
0,0,1,0,1,0,1,5763
1,1,0,0,1,0,1,5763
0,0,1,0,1,0,1,5764
1,1,2,0,3,0,3,5764
2,2,2,0,5,0,5,5764
3,3,2,1,7,1,8,5764
4,4,1,1,8,2,10,5764
5,5,0,3,8,5,13,5764
6,6,0,3,8,8,16,5764
7,7,0,1,8,9,17,5764
8,8,0,0,8,9,17,5764
0,0,1,0,1,0,1,5765
1,1,0,0,1,0,1,5765
0,0,1,0,1,0,1,5766
1,1,0,0,1,0,1,5766
0,0,1,0,1,0,1,5767
1,1,0,0,1,0,1,5767
0,0,1,0,1,0,1,5768
1,1,0,0,1,0,1,5768
0,0,1,0,1,0,1,5769
1,1,0,1,1,1,2,5769
2,2,0,1,1,2,3,5769
3,3,1,1,2,3,5,5769
4,4,0,0,2,3,5,5769
0,0,1,0,1,0,1,5770
1,1,0,1,1,1,2,5770
2,2,0,1,1,2,3,5770
3,3,1,0,2,2,4,5770
4,4,1,0,3,2,5,5770
5,5,1,0,4,2,6,5770
6,6,0,0,4,2,6,5770
0,0,1,0,1,0,1,5771
1,1,2,0,3,0,3,5771
2,2,2,0,5,0,5,5771
3,3,3,3,8,3,11,5771
4,4,3,3,11,6,17,5771
5,5,5,5,16,11,27,5771
6,6,4,5,20,16,36,5771
7,7,2,2,22,18,40,5771
8,8,0,0,22,18,40,5771
0,0,1,0,1,0,1,5772
1,1,2,0,3,0,3,5772
2,2,3,0,6,0,6,5772
3,3,1,0,7,0,7,5772
4,4,0,0,7,0,7,5772
0,0,1,0,1,0,1,5773
1,1,0,1,1,1,2,5773
2,2,1,1,2,2,4,5773
3,3,3,0,5,2,7,5773
4,4,3,0,8,2,10,5773
5,5,4,0,12,2,14,5773
6,6,2,0,14,2,16,5773
7,7,0,1,14,3,17,5773
8,8,1,1,15,4,19,5773
9,9,2,0,17,4,21,5773
10,10,0,3,17,7,24,5773
11,11,1,2,18,9,27,5773
12,12,2,4,20,13,33,5773
13,13,1,4,21,17,38,5773
14,14,0,3,21,20,41,5773
15,15,3,5,24,25,49,5773
16,16,3,4,27,29,56,5773
17,17,3,3,30,32,62,5773
18,18,3,6,33,38,71,5773
19,19,5,5,38,43,81,5773
20,20,6,2,44,45,89,5773
21,21,5,2,49,47,96,5773
22,22,5,3,54,50,104,5773
23,23,3,2,57,52,109,5773
24,24,2,2,59,54,113,5773
25,25,0,3,59,57,116,5773
26,26,0,2,59,59,118,5773
27,27,0,0,59,59,118,5773
0,0,1,0,1,0,1,5774
1,1,1,0,2,0,2,5774
2,2,0,0,2,0,2,5774
0,0,1,0,1,0,1,5775
1,1,0,0,1,0,1,5775
0,0,1,0,1,0,1,5776
1,1,1,0,2,0,2,5776
2,2,1,0,3,0,3,5776
3,3,1,0,4,0,4,5776
4,4,0,0,4,0,4,5776
0,0,1,0,1,0,1,5777
1,1,0,0,1,0,1,5777
0,0,1,0,1,0,1,5778
1,1,2,0,3,0,3,5778
2,2,2,0,5,0,5,5778
3,3,0,1,5,1,6,5778
4,4,0,0,5,1,6,5778
0,0,1,0,1,0,1,5779
1,1,0,0,1,0,1,5779
0,0,1,0,1,0,1,5780
1,1,0,0,1,0,1,5780
0,0,1,0,1,0,1,5781
1,1,1,0,2,0,2,5781
2,2,0,0,2,0,2,5781
0,0,1,0,1,0,1,5782
1,1,2,0,3,0,3,5782
2,2,2,0,5,0,5,5782
3,3,2,0,7,0,7,5782
4,4,0,2,7,2,9,5782
5,5,0,1,7,3,10,5782
6,6,0,1,7,4,11,5782
7,7,0,0,7,4,11,5782
0,0,1,0,1,0,1,5783
1,1,0,0,1,0,1,5783
0,0,1,0,1,0,1,5784
1,1,1,0,2,0,2,5784
2,2,0,0,2,0,2,5784
0,0,1,0,1,0,1,5785
1,1,0,0,1,0,1,5785
0,0,1,0,1,0,1,5786
1,1,2,0,3,0,3,5786
2,2,5,0,8,0,8,5786
3,3,3,0,11,0,11,5786
4,4,2,1,13,1,14,5786
5,5,1,1,14,2,16,5786
6,6,1,1,15,3,18,5786
7,7,1,1,16,4,20,5786
8,8,1,2,17,6,23,5786
9,9,0,3,17,9,26,5786
10,10,0,7,17,16,33,5786
11,11,2,4,19,20,39,5786
12,12,1,3,20,23,43,5786
13,13,1,1,21,24,45,5786
14,14,1,1,22,25,47,5786
15,15,1,0,23,25,48,5786
16,16,0,1,23,26,49,5786
17,17,0,0,23,26,49,5786
0,0,1,0,1,0,1,5787
1,1,0,0,1,0,1,5787
0,0,1,0,1,0,1,5788
1,1,0,1,1,1,2,5788
2,2,0,0,1,1,2,5788
0,0,1,0,1,0,1,5789
1,1,0,0,1,0,1,5789
0,0,1,0,1,0,1,5790
1,1,0,1,1,1,2,5790
2,2,0,2,1,3,4,5790
3,3,0,0,1,3,4,5790
0,0,1,0,1,0,1,5791
1,1,0,0,1,0,1,5791
0,0,1,0,1,0,1,5792
1,1,1,1,2,1,3,5792
2,2,1,0,3,1,4,5792
3,3,0,0,3,1,4,5792
0,0,1,0,1,0,1,5793
1,1,0,0,1,0,1,5793
0,0,1,0,1,0,1,5794
1,1,0,0,1,0,1,5794
0,0,1,0,1,0,1,5795
1,1,0,0,1,0,1,5795
0,0,1,0,1,0,1,5796
1,1,2,0,3,0,3,5796
2,2,2,0,5,0,5,5796
3,3,3,0,8,0,8,5796
4,4,3,0,11,0,11,5796
5,5,3,1,14,1,15,5796
6,6,0,5,14,6,20,5796
7,7,1,3,15,9,24,5796
8,8,3,7,18,16,34,5796
9,9,3,4,21,20,41,5796
10,10,3,2,24,22,46,5796
11,11,5,4,29,26,55,5796
12,12,3,6,32,32,64,5796
13,13,2,3,34,35,69,5796
14,14,2,0,36,35,71,5796
15,15,2,0,38,35,73,5796
16,16,1,1,39,36,75,5796
17,17,1,3,40,39,79,5796
18,18,1,2,41,41,82,5796
19,19,1,1,42,42,84,5796
20,20,0,1,42,43,85,5796
21,21,0,0,42,43,85,5796
0,0,1,0,1,0,1,5797
1,1,1,0,2,0,2,5797
2,2,0,0,2,0,2,5797
0,0,1,0,1,0,1,5798
1,1,0,0,1,0,1,5798
0,0,1,0,1,0,1,5799
1,1,1,0,2,0,2,5799
2,2,1,0,3,0,3,5799
3,3,0,0,3,0,3,5799
0,0,1,0,1,0,1,5800
1,1,2,0,3,0,3,5800
2,2,2,0,5,0,5,5800
3,3,0,0,5,0,5,5800
0,0,1,0,1,0,1,5801
1,1,0,0,1,0,1,5801
0,0,1,0,1,0,1,5802
1,1,0,1,1,1,2,5802
2,2,0,2,1,3,4,5802
3,3,0,1,1,4,5,5802
4,4,1,2,2,6,8,5802
5,5,0,5,2,11,13,5802
6,6,1,1,3,12,15,5802
7,7,1,1,4,13,17,5802
8,8,0,0,4,13,17,5802
0,0,1,0,1,0,1,5803
1,1,0,0,1,0,1,5803
0,0,1,0,1,0,1,5804
1,1,1,0,2,0,2,5804
2,2,1,0,3,0,3,5804
3,3,0,0,3,0,3,5804
0,0,1,0,1,0,1,5805
1,1,1,0,2,0,2,5805
2,2,0,0,2,0,2,5805
0,0,1,0,1,0,1,5806
1,1,0,0,1,0,1,5806
0,0,1,0,1,0,1,5807
1,1,1,0,2,0,2,5807
2,2,0,0,2,0,2,5807
0,0,1,0,1,0,1,5808
1,1,2,0,3,0,3,5808
2,2,1,0,4,0,4,5808
3,3,2,0,6,0,6,5808
4,4,1,1,7,1,8,5808
5,5,3,0,10,1,11,5808
6,6,1,0,11,1,12,5808
7,7,0,0,11,1,12,5808
0,0,1,0,1,0,1,5809
1,1,2,0,3,0,3,5809
2,2,0,3,3,3,6,5809
3,3,0,5,3,8,11,5809
4,4,2,0,5,8,13,5809
5,5,2,0,7,8,15,5809
6,6,2,0,9,8,17,5809
7,7,0,0,9,8,17,5809
0,0,1,0,1,0,1,5810
1,1,1,0,2,0,2,5810
2,2,0,1,2,1,3,5810
3,3,0,3,2,4,6,5810
4,4,1,1,3,5,8,5810
5,5,1,2,4,7,11,5810
6,6,1,1,5,8,13,5810
7,7,1,0,6,8,14,5810
8,8,0,0,6,8,14,5810
0,0,1,0,1,0,1,5811
1,1,3,0,4,0,4,5811
2,2,2,0,6,0,6,5811
3,3,1,1,7,1,8,5811
4,4,0,0,7,1,8,5811
0,0,1,0,1,0,1,5812
1,1,1,1,2,1,3,5812
2,2,0,0,2,1,3,5812
0,0,1,0,1,0,1,5813
1,1,0,1,1,1,2,5813
2,2,0,0,1,1,2,5813
0,0,1,0,1,0,1,5814
1,1,2,0,3,0,3,5814
2,2,2,0,5,0,5,5814
3,3,0,0,5,0,5,5814
0,0,1,0,1,0,1,5815
1,1,1,1,2,1,3,5815
2,2,1,1,3,2,5,5815
3,3,2,1,5,3,8,5815
4,4,2,1,7,4,11,5815
5,5,2,2,9,6,15,5815
6,6,3,1,12,7,19,5815
7,7,2,0,14,7,21,5815
8,8,0,0,14,7,21,5815
0,0,1,0,1,0,1,5816
1,1,3,0,4,0,4,5816
2,2,0,0,4,0,4,5816
0,0,1,0,1,0,1,5817
1,1,3,1,4,1,5,5817
2,2,3,1,7,2,9,5817
3,3,8,3,15,5,20,5817
4,4,1,2,16,7,23,5817
5,5,0,1,16,8,24,5817
6,6,1,1,17,9,26,5817
7,7,2,0,19,9,28,5817
8,8,2,1,21,10,31,5817
9,9,0,0,21,10,31,5817
0,0,1,0,1,0,1,5818
1,1,2,0,3,0,3,5818
2,2,2,1,5,1,6,5818
3,3,2,1,7,2,9,5818
4,4,0,2,7,4,11,5818
5,5,0,1,7,5,12,5818
6,6,0,0,7,5,12,5818
0,0,1,0,1,0,1,5819
1,1,0,1,1,1,2,5819
2,2,0,2,1,3,4,5819
3,3,0,0,1,3,4,5819
0,0,1,0,1,0,1,5820
1,1,0,1,1,1,2,5820
2,2,0,1,1,2,3,5820
3,3,0,0,1,2,3,5820
0,0,1,0,1,0,1,5821
1,1,0,1,1,1,2,5821
2,2,2,0,3,1,4,5821
3,3,0,1,3,2,5,5821
4,4,0,0,3,2,5,5821
0,0,1,0,1,0,1,5822
1,1,1,1,2,1,3,5822
2,2,0,1,2,2,4,5822
3,3,0,0,2,2,4,5822
0,0,1,0,1,0,1,5823
1,1,0,0,1,0,1,5823
0,0,1,0,1,0,1,5824
1,1,1,0,2,0,2,5824
2,2,3,0,5,0,5,5824
3,3,2,0,7,0,7,5824
4,4,4,0,11,0,11,5824
5,5,4,0,15,0,15,5824
6,6,4,1,19,1,20,5824
7,7,4,3,23,4,27,5824
8,8,2,2,25,6,31,5824
9,9,2,1,27,7,34,5824
10,10,4,1,31,8,39,5824
11,11,1,0,32,8,40,5824
12,12,1,0,33,8,41,5824
13,13,2,1,35,9,44,5824
14,14,2,2,37,11,48,5824
15,15,3,0,40,11,51,5824
16,16,1,0,41,11,52,5824
17,17,0,0,41,11,52,5824
0,0,1,0,1,0,1,5825
1,1,1,0,2,0,2,5825
2,2,0,0,2,0,2,5825
0,0,1,0,1,0,1,5826
1,1,0,1,1,1,2,5826
2,2,0,1,1,2,3,5826
3,3,1,1,2,3,5,5826
4,4,1,0,3,3,6,5826
5,5,1,0,4,3,7,5826
6,6,1,0,5,3,8,5826
7,7,1,0,6,3,9,5826
8,8,0,0,6,3,9,5826
0,0,1,0,1,0,1,5827
1,1,0,1,1,1,2,5827
2,2,0,0,1,1,2,5827
0,0,1,0,1,0,1,5828
1,1,1,0,2,0,2,5828
2,2,0,2,2,2,4,5828
3,3,1,3,3,5,8,5828
4,4,2,2,5,7,12,5828
5,5,1,0,6,7,13,5828
6,6,2,0,8,7,15,5828
7,7,2,1,10,8,18,5828
8,8,2,3,12,11,23,5828
9,9,2,1,14,12,26,5828
10,10,2,1,16,13,29,5828
11,11,2,0,18,13,31,5828
12,12,3,0,21,13,34,5828
13,13,2,1,23,14,37,5828
14,14,0,0,23,14,37,5828
0,0,1,0,1,0,1,5829
1,1,0,0,1,0,1,5829
0,0,1,0,1,0,1,5830
1,1,2,0,3,0,3,5830
2,2,0,0,3,0,3,5830
0,0,1,0,1,0,1,5831
1,1,3,0,4,0,4,5831
2,2,1,0,5,0,5,5831
3,3,2,0,7,0,7,5831
4,4,3,0,10,0,10,5831
5,5,2,1,12,1,13,5831
6,6,2,0,14,1,15,5831
7,7,1,0,15,1,16,5831
8,8,1,0,16,1,17,5831
9,9,0,1,16,2,18,5831
10,10,0,0,16,2,18,5831
0,0,1,0,1,0,1,5832
1,1,0,1,1,1,2,5832
2,2,0,1,1,2,3,5832
3,3,0,0,1,2,3,5832
0,0,1,0,1,0,1,5833
1,1,0,1,1,1,2,5833
2,2,0,3,1,4,5,5833
3,3,1,5,2,9,11,5833
4,4,1,7,3,16,19,5833
5,5,3,12,6,28,34,5833
6,6,5,12,11,40,51,5833
7,7,3,6,14,46,60,5833
8,8,3,7,17,53,70,5833
9,9,6,5,23,58,81,5833
10,10,11,2,34,60,94,5833
11,11,6,1,40,61,101,5833
12,12,6,0,46,61,107,5833
13,13,7,0,53,61,114,5833
14,14,3,0,56,61,117,5833
15,15,1,0,57,61,118,5833
16,16,1,0,58,61,119,5833
17,17,0,0,58,61,119,5833
0,0,1,0,1,0,1,5834
1,1,0,0,1,0,1,5834
0,0,1,0,1,0,1,5835
1,1,4,0,5,0,5,5835
2,2,3,1,8,1,9,5835
3,3,2,0,10,1,11,5835
4,4,2,0,12,1,13,5835
5,5,1,0,13,1,14,5835
6,6,0,0,13,1,14,5835
0,0,1,0,1,0,1,5836
1,1,0,1,1,1,2,5836
2,2,0,0,1,1,2,5836
0,0,1,0,1,0,1,5837
1,1,0,0,1,0,1,5837
0,0,1,0,1,0,1,5838
1,1,0,0,1,0,1,5838
0,0,1,0,1,0,1,5839
1,1,1,0,2,0,2,5839
2,2,0,0,2,0,2,5839
0,0,1,0,1,0,1,5840
1,1,0,2,1,2,3,5840
2,2,0,0,1,2,3,5840
0,0,1,0,1,0,1,5841
1,1,0,0,1,0,1,5841
0,0,1,0,1,0,1,5842
1,1,1,0,2,0,2,5842
2,2,0,0,2,0,2,5842
0,0,1,0,1,0,1,5843
1,1,1,0,2,0,2,5843
2,2,1,0,3,0,3,5843
3,3,1,1,4,1,5,5843
4,4,0,2,4,3,7,5843
5,5,0,1,4,4,8,5843
6,6,0,0,4,4,8,5843
0,0,1,0,1,0,1,5844
1,1,1,0,2,0,2,5844
2,2,0,0,2,0,2,5844
0,0,1,0,1,0,1,5845
1,1,0,0,1,0,1,5845
0,0,1,0,1,0,1,5846
1,1,1,0,2,0,2,5846
2,2,0,0,2,0,2,5846
0,0,1,0,1,0,1,5847
1,1,0,0,1,0,1,5847
0,0,1,0,1,0,1,5848
1,1,0,0,1,0,1,5848
0,0,1,0,1,0,1,5849
1,1,3,0,4,0,4,5849
2,2,1,1,5,1,6,5849
3,3,1,1,6,2,8,5849
4,4,2,0,8,2,10,5849
5,5,1,0,9,2,11,5849
6,6,1,0,10,2,12,5849
7,7,0,0,10,2,12,5849
0,0,1,0,1,0,1,5850
1,1,0,0,1,0,1,5850
0,0,1,0,1,0,1,5851
1,1,1,0,2,0,2,5851
2,2,1,0,3,0,3,5851
3,3,0,0,3,0,3,5851
0,0,1,0,1,0,1,5852
1,1,1,0,2,0,2,5852
2,2,0,0,2,0,2,5852
0,0,1,0,1,0,1,5853
1,1,0,0,1,0,1,5853
0,0,1,0,1,0,1,5854
1,1,1,0,2,0,2,5854
2,2,3,0,5,0,5,5854
3,3,1,0,6,0,6,5854
4,4,0,1,6,1,7,5854
5,5,0,1,6,2,8,5854
6,6,0,1,6,3,9,5854
7,7,0,0,6,3,9,5854
0,0,1,0,1,0,1,5855
1,1,0,1,1,1,2,5855
2,2,0,0,1,1,2,5855
0,0,1,0,1,0,1,5856
1,1,0,0,1,0,1,5856
0,0,1,0,1,0,1,5857
1,1,1,0,2,0,2,5857
2,2,0,0,2,0,2,5857
0,0,1,0,1,0,1,5858
1,1,0,0,1,0,1,5858
0,0,1,0,1,0,1,5859
1,1,0,1,1,1,2,5859
2,2,0,0,1,1,2,5859
0,0,1,0,1,0,1,5860
1,1,0,0,1,0,1,5860
0,0,1,0,1,0,1,5861
1,1,0,0,1,0,1,5861
0,0,1,0,1,0,1,5862
1,1,0,0,1,0,1,5862
0,0,1,0,1,0,1,5863
1,1,2,0,3,0,3,5863
2,2,1,0,4,0,4,5863
3,3,1,1,5,1,6,5863
4,4,0,0,5,1,6,5863
0,0,1,0,1,0,1,5864
1,1,0,0,1,0,1,5864
0,0,1,0,1,0,1,5865
1,1,1,0,2,0,2,5865
2,2,2,1,4,1,5,5865
3,3,2,2,6,3,9,5865
4,4,0,3,6,6,12,5865
5,5,1,2,7,8,15,5865
6,6,1,4,8,12,20,5865
7,7,2,3,10,15,25,5865
8,8,1,2,11,17,28,5865
9,9,1,2,12,19,31,5865
10,10,0,0,12,19,31,5865
0,0,1,0,1,0,1,5866
1,1,0,1,1,1,2,5866
2,2,1,0,2,1,3,5866
3,3,1,0,3,1,4,5866
4,4,0,0,3,1,4,5866
0,0,1,0,1,0,1,5867
1,1,0,0,1,0,1,5867
0,0,1,0,1,0,1,5868
1,1,1,1,2,1,3,5868
2,2,1,0,3,1,4,5868
3,3,2,0,5,1,6,5868
4,4,0,0,5,1,6,5868
0,0,1,0,1,0,1,5869
1,1,0,0,1,0,1,5869
0,0,1,0,1,0,1,5870
1,1,0,0,1,0,1,5870
0,0,1,0,1,0,1,5871
1,1,0,0,1,0,1,5871
0,0,1,0,1,0,1,5872
1,1,0,0,1,0,1,5872
0,0,1,0,1,0,1,5873
1,1,0,0,1,0,1,5873
0,0,1,0,1,0,1,5874
1,1,0,0,1,0,1,5874
0,0,1,0,1,0,1,5875
1,1,0,0,1,0,1,5875
0,0,1,0,1,0,1,5876
1,1,2,0,3,0,3,5876
2,2,2,1,5,1,6,5876
3,3,2,0,7,1,8,5876
4,4,0,1,7,2,9,5876
5,5,0,1,7,3,10,5876
6,6,0,0,7,3,10,5876
0,0,1,0,1,0,1,5877
1,1,0,0,1,0,1,5877
0,0,1,0,1,0,1,5878
1,1,0,0,1,0,1,5878
0,0,1,0,1,0,1,5879
1,1,0,0,1,0,1,5879
0,0,1,0,1,0,1,5880
1,1,1,0,2,0,2,5880
2,2,0,0,2,0,2,5880
0,0,1,0,1,0,1,5881
1,1,0,0,1,0,1,5881
0,0,1,0,1,0,1,5882
1,1,1,1,2,1,3,5882
2,2,0,1,2,2,4,5882
3,3,0,1,2,3,5,5882
4,4,0,0,2,3,5,5882
0,0,1,0,1,0,1,5883
1,1,1,0,2,0,2,5883
2,2,0,0,2,0,2,5883
0,0,1,0,1,0,1,5884
1,1,0,1,1,1,2,5884
2,2,0,0,1,1,2,5884
0,0,1,0,1,0,1,5885
1,1,1,0,2,0,2,5885
2,2,2,1,4,1,5,5885
3,3,0,1,4,2,6,5885
4,4,0,2,4,4,8,5885
5,5,1,3,5,7,12,5885
6,6,1,1,6,8,14,5885
7,7,1,0,7,8,15,5885
8,8,0,0,7,8,15,5885
0,0,1,0,1,0,1,5886
1,1,1,0,2,0,2,5886
2,2,1,1,3,1,4,5886
3,3,0,0,3,1,4,5886
0,0,1,0,1,0,1,5887
1,1,1,0,2,0,2,5887
2,2,1,0,3,0,3,5887
3,3,1,0,4,0,4,5887
4,4,0,0,4,0,4,5887
0,0,1,0,1,0,1,5888
1,1,1,0,2,0,2,5888
2,2,0,0,2,0,2,5888
0,0,1,0,1,0,1,5889
1,1,1,0,2,0,2,5889
2,2,0,0,2,0,2,5889
0,0,1,0,1,0,1,5890
1,1,1,0,2,0,2,5890
2,2,0,0,2,0,2,5890
0,0,1,0,1,0,1,5891
1,1,0,0,1,0,1,5891
0,0,1,0,1,0,1,5892
1,1,2,0,3,0,3,5892
2,2,1,0,4,0,4,5892
3,3,0,0,4,0,4,5892
0,0,1,0,1,0,1,5893
1,1,0,0,1,0,1,5893
0,0,1,0,1,0,1,5894
1,1,3,1,4,1,5,5894
2,2,1,0,5,1,6,5894
3,3,1,0,6,1,7,5894
4,4,1,0,7,1,8,5894
5,5,0,0,7,1,8,5894
0,0,1,0,1,0,1,5895
1,1,1,0,2,0,2,5895
2,2,0,2,2,2,4,5895
3,3,0,3,2,5,7,5895
4,4,0,1,2,6,8,5895
5,5,0,1,2,7,9,5895
6,6,0,1,2,8,10,5895
7,7,0,1,2,9,11,5895
8,8,0,1,2,10,12,5895
9,9,1,1,3,11,14,5895
10,10,0,3,3,14,17,5895
11,11,1,2,4,16,20,5895
12,12,3,1,7,17,24,5895
13,13,6,2,13,19,32,5895
14,14,7,4,20,23,43,5895
15,15,7,5,27,28,55,5895
16,16,3,7,30,35,65,5895
17,17,2,8,32,43,75,5895
18,18,4,8,36,51,87,5895
19,19,5,7,41,58,99,5895
20,20,10,4,51,62,113,5895
21,21,10,7,61,69,130,5895
22,22,12,4,73,73,146,5895
23,23,11,7,84,80,164,5895
24,24,8,7,92,87,179,5895
25,25,8,2,100,89,189,5895
26,26,6,3,106,92,198,5895
27,27,9,4,115,96,211,5895
28,28,6,7,121,103,224,5895
29,29,1,8,122,111,233,5895
30,30,3,6,125,117,242,5895
31,31,2,12,127,129,256,5895
32,32,8,10,135,139,274,5895
33,33,15,11,150,150,300,5895
34,34,13,10,163,160,323,5895
35,35,14,8,177,168,345,5895
36,36,13,10,190,178,368,5895
37,37,13,7,203,185,388,5895
38,38,11,7,214,192,406,5895
39,39,4,5,218,197,415,5895
40,40,5,1,223,198,421,5895
41,41,2,2,225,200,425,5895
42,42,2,1,227,201,428,5895
43,43,0,0,227,201,428,5895
0,0,1,0,1,0,1,5896
1,1,0,0,1,0,1,5896
0,0,1,0,1,0,1,5897
1,1,2,0,3,0,3,5897
2,2,1,0,4,0,4,5897
3,3,0,0,4,0,4,5897
0,0,1,0,1,0,1,5898
1,1,0,0,1,0,1,5898
0,0,1,0,1,0,1,5899
1,1,1,0,2,0,2,5899
2,2,0,0,2,0,2,5899
0,0,1,0,1,0,1,5900
1,1,4,0,5,0,5,5900
2,2,1,0,6,0,6,5900
3,3,4,1,10,1,11,5900
4,4,5,1,15,2,17,5900
5,5,4,0,19,2,21,5900
6,6,0,1,19,3,22,5900
7,7,0,0,19,3,22,5900
0,0,1,0,1,0,1,5901
1,1,0,0,1,0,1,5901
0,0,1,0,1,0,1,5902
1,1,1,1,2,1,3,5902
2,2,1,1,3,2,5,5902
3,3,0,0,3,2,5,5902
0,0,1,0,1,0,1,5903
1,1,0,0,1,0,1,5903
0,0,1,0,1,0,1,5904
1,1,1,0,2,0,2,5904
2,2,0,0,2,0,2,5904
0,0,1,0,1,0,1,5905
1,1,0,0,1,0,1,5905
0,0,1,0,1,0,1,5906
1,1,1,0,2,0,2,5906
2,2,0,0,2,0,2,5906
0,0,1,0,1,0,1,5907
1,1,1,0,2,0,2,5907
2,2,1,0,3,0,3,5907
3,3,0,0,3,0,3,5907
0,0,1,0,1,0,1,5908
1,1,0,0,1,0,1,5908
0,0,1,0,1,0,1,5909
1,1,0,3,1,3,4,5909
2,2,1,1,2,4,6,5909
3,3,1,0,3,4,7,5909
4,4,2,0,5,4,9,5909
5,5,1,0,6,4,10,5909
6,6,0,0,6,4,10,5909
0,0,1,0,1,0,1,5910
1,1,0,0,1,0,1,5910
0,0,1,0,1,0,1,5911
1,1,0,0,1,0,1,5911
0,0,1,0,1,0,1,5912
1,1,0,0,1,0,1,5912
0,0,1,0,1,0,1,5913
1,1,1,0,2,0,2,5913
2,2,0,0,2,0,2,5913
0,0,1,0,1,0,1,5914
1,1,1,1,2,1,3,5914
2,2,2,1,4,2,6,5914
3,3,1,0,5,2,7,5914
4,4,0,0,5,2,7,5914
0,0,1,0,1,0,1,5915
1,1,0,1,1,1,2,5915
2,2,0,0,1,1,2,5915
0,0,1,0,1,0,1,5916
1,1,0,0,1,0,1,5916
0,0,1,0,1,0,1,5917
1,1,0,0,1,0,1,5917
0,0,1,0,1,0,1,5918
1,1,1,0,2,0,2,5918
2,2,0,2,2,2,4,5918
3,3,0,2,2,4,6,5918
4,4,1,0,3,4,7,5918
5,5,1,0,4,4,8,5918
6,6,1,0,5,4,9,5918
7,7,2,0,7,4,11,5918
8,8,1,0,8,4,12,5918
9,9,1,0,9,4,13,5918
10,10,0,0,9,4,13,5918
0,0,1,0,1,0,1,5919
1,1,0,0,1,0,1,5919
0,0,1,0,1,0,1,5920
1,1,0,0,1,0,1,5920
0,0,1,0,1,0,1,5921
1,1,1,0,2,0,2,5921
2,2,0,0,2,0,2,5921
0,0,1,0,1,0,1,5922
1,1,1,0,2,0,2,5922
2,2,0,0,2,0,2,5922
0,0,1,0,1,0,1,5923
1,1,1,0,2,0,2,5923
2,2,0,0,2,0,2,5923
0,0,1,0,1,0,1,5924
1,1,1,0,2,0,2,5924
2,2,0,0,2,0,2,5924
0,0,1,0,1,0,1,5925
1,1,0,0,1,0,1,5925
0,0,1,0,1,0,1,5926
1,1,0,0,1,0,1,5926
0,0,1,0,1,0,1,5927
1,1,2,0,3,0,3,5927
2,2,2,0,5,0,5,5927
3,3,1,1,6,1,7,5927
4,4,0,3,6,4,10,5927
5,5,1,0,7,4,11,5927
6,6,0,0,7,4,11,5927
0,0,1,0,1,0,1,5928
1,1,0,0,1,0,1,5928
0,0,1,0,1,0,1,5929
1,1,0,0,1,0,1,5929
0,0,1,0,1,0,1,5930
1,1,0,0,1,0,1,5930
0,0,1,0,1,0,1,5931
1,1,1,0,2,0,2,5931
2,2,0,0,2,0,2,5931
0,0,1,0,1,0,1,5932
1,1,0,1,1,1,2,5932
2,2,0,0,1,1,2,5932
0,0,1,0,1,0,1,5933
1,1,0,0,1,0,1,5933
0,0,1,0,1,0,1,5934
1,1,1,0,2,0,2,5934
2,2,2,1,4,1,5,5934
3,3,4,0,8,1,9,5934
4,4,7,0,15,1,16,5934
5,5,8,3,23,4,27,5934
6,6,5,7,28,11,39,5934
7,7,5,6,33,17,50,5934
8,8,4,5,37,22,59,5934
9,9,3,4,40,26,66,5934
10,10,2,4,42,30,72,5934
11,11,0,5,42,35,77,5934
12,12,3,2,45,37,82,5934
13,13,0,2,45,39,84,5934
14,14,0,2,45,41,86,5934
15,15,0,0,45,41,86,5934
0,0,1,0,1,0,1,5935
1,1,1,0,2,0,2,5935
2,2,0,0,2,0,2,5935
0,0,1,0,1,0,1,5936
1,1,0,0,1,0,1,5936
0,0,1,0,1,0,1,5937
1,1,1,0,2,0,2,5937
2,2,2,0,4,0,4,5937
3,3,2,0,6,0,6,5937
4,4,2,1,8,1,9,5937
5,5,0,1,8,2,10,5937
6,6,0,1,8,3,11,5937
7,7,0,0,8,3,11,5937
0,0,1,0,1,0,1,5938
1,1,0,0,1,0,1,5938
0,0,1,0,1,0,1,5939
1,1,0,0,1,0,1,5939
0,0,1,0,1,0,1,5940
1,1,0,0,1,0,1,5940
0,0,1,0,1,0,1,5941
1,1,1,1,2,1,3,5941
2,2,2,1,4,2,6,5941
3,3,4,0,8,2,10,5941
4,4,1,0,9,2,11,5941
5,5,2,1,11,3,14,5941
6,6,0,0,11,3,14,5941
0,0,1,0,1,0,1,5942
1,1,1,0,2,0,2,5942
2,2,1,0,3,0,3,5942
3,3,0,0,3,0,3,5942
0,0,1,0,1,0,1,5943
1,1,1,0,2,0,2,5943
2,2,1,0,3,0,3,5943
3,3,0,0,3,0,3,5943
0,0,1,0,1,0,1,5944
1,1,0,0,1,0,1,5944
0,0,1,0,1,0,1,5945
1,1,0,0,1,0,1,5945
0,0,1,0,1,0,1,5946
1,1,1,0,2,0,2,5946
2,2,0,0,2,0,2,5946
0,0,1,0,1,0,1,5947
1,1,0,0,1,0,1,5947
0,0,1,0,1,0,1,5948
1,1,1,0,2,0,2,5948
2,2,0,0,2,0,2,5948
0,0,1,0,1,0,1,5949
1,1,1,0,2,0,2,5949
2,2,3,1,5,1,6,5949
3,3,3,2,8,3,11,5949
4,4,1,2,9,5,14,5949
5,5,1,3,10,8,18,5949
6,6,1,4,11,12,23,5949
7,7,1,3,12,15,27,5949
8,8,0,0,12,15,27,5949
0,0,1,0,1,0,1,5950
1,1,0,0,1,0,1,5950
0,0,1,0,1,0,1,5951
1,1,0,0,1,0,1,5951
0,0,1,0,1,0,1,5952
1,1,1,0,2,0,2,5952
2,2,0,0,2,0,2,5952
0,0,1,0,1,0,1,5953
1,1,0,0,1,0,1,5953
0,0,1,0,1,0,1,5954
1,1,1,0,2,0,2,5954
2,2,1,0,3,0,3,5954
3,3,0,0,3,0,3,5954
0,0,1,0,1,0,1,5955
1,1,0,0,1,0,1,5955
0,0,1,0,1,0,1,5956
1,1,0,1,1,1,2,5956
2,2,0,0,1,1,2,5956
0,0,1,0,1,0,1,5957
1,1,1,0,2,0,2,5957
2,2,1,0,3,0,3,5957
3,3,0,0,3,0,3,5957
0,0,1,0,1,0,1,5958
1,1,0,1,1,1,2,5958
2,2,0,0,1,1,2,5958
0,0,1,0,1,0,1,5959
1,1,1,0,2,0,2,5959
2,2,0,0,2,0,2,5959
0,0,1,0,1,0,1,5960
1,1,1,0,2,0,2,5960
2,2,0,0,2,0,2,5960
0,0,1,0,1,0,1,5961
1,1,0,0,1,0,1,5961
0,0,1,0,1,0,1,5962
1,1,0,0,1,0,1,5962
0,0,1,0,1,0,1,5963
1,1,0,0,1,0,1,5963
0,0,1,0,1,0,1,5964
1,1,1,0,2,0,2,5964
2,2,1,1,3,1,4,5964
3,3,0,1,3,2,5,5964
4,4,0,0,3,2,5,5964
0,0,1,0,1,0,1,5965
1,1,0,0,1,0,1,5965
0,0,1,0,1,0,1,5966
1,1,1,0,2,0,2,5966
2,2,3,0,5,0,5,5966
3,3,3,0,8,0,8,5966
4,4,0,0,8,0,8,5966
0,0,1,0,1,0,1,5967
1,1,1,0,2,0,2,5967
2,2,1,1,3,1,4,5967
3,3,1,2,4,3,7,5967
4,4,2,2,6,5,11,5967
5,5,0,2,6,7,13,5967
6,6,0,2,6,9,15,5967
7,7,1,0,7,9,16,5967
8,8,0,0,7,9,16,5967
0,0,1,0,1,0,1,5968
1,1,1,0,2,0,2,5968
2,2,0,0,2,0,2,5968
0,0,1,0,1,0,1,5969
1,1,0,0,1,0,1,5969
0,0,1,0,1,0,1,5970
1,1,1,0,2,0,2,5970
2,2,0,0,2,0,2,5970
0,0,1,0,1,0,1,5971
1,1,1,0,2,0,2,5971
2,2,3,0,5,0,5,5971
3,3,1,0,6,0,6,5971
4,4,2,0,8,0,8,5971
5,5,2,0,10,0,10,5971
6,6,0,0,10,0,10,5971
0,0,1,0,1,0,1,5972
1,1,0,0,1,0,1,5972
0,0,1,0,1,0,1,5973
1,1,0,0,1,0,1,5973
0,0,1,0,1,0,1,5974
1,1,0,0,1,0,1,5974
0,0,1,0,1,0,1,5975
1,1,1,0,2,0,2,5975
2,2,0,0,2,0,2,5975
0,0,1,0,1,0,1,5976
1,1,0,0,1,0,1,5976
0,0,1,0,1,0,1,5977
1,1,0,0,1,0,1,5977
0,0,1,0,1,0,1,5978
1,1,0,0,1,0,1,5978
0,0,1,0,1,0,1,5979
1,1,3,0,4,0,4,5979
2,2,0,1,4,1,5,5979
3,3,0,0,4,1,5,5979
0,0,1,0,1,0,1,5980
1,1,2,0,3,0,3,5980
2,2,3,0,6,0,6,5980
3,3,2,0,8,0,8,5980
4,4,1,0,9,0,9,5980
5,5,1,0,10,0,10,5980
6,6,0,0,10,0,10,5980
0,0,1,0,1,0,1,5981
1,1,3,0,4,0,4,5981
2,2,0,1,4,1,5,5981
3,3,0,0,4,1,5,5981
0,0,1,0,1,0,1,5982
1,1,1,0,2,0,2,5982
2,2,0,0,2,0,2,5982
0,0,1,0,1,0,1,5983
1,1,1,0,2,0,2,5983
2,2,2,0,4,0,4,5983
3,3,2,0,6,0,6,5983
4,4,1,1,7,1,8,5983
5,5,0,0,7,1,8,5983
0,0,1,0,1,0,1,5984
1,1,0,0,1,0,1,5984
0,0,1,0,1,0,1,5985
1,1,0,0,1,0,1,5985
0,0,1,0,1,0,1,5986
1,1,0,0,1,0,1,5986
0,0,1,0,1,0,1,5987
1,1,1,0,2,0,2,5987
2,2,1,0,3,0,3,5987
3,3,1,0,4,0,4,5987
4,4,1,1,5,1,6,5987
5,5,0,2,5,3,8,5987
6,6,0,0,5,3,8,5987
0,0,1,0,1,0,1,5988
1,1,1,0,2,0,2,5988
2,2,0,0,2,0,2,5988
0,0,1,0,1,0,1,5989
1,1,0,0,1,0,1,5989
0,0,1,0,1,0,1,5990
1,1,1,0,2,0,2,5990
2,2,1,0,3,0,3,5990
3,3,1,0,4,0,4,5990
4,4,0,0,4,0,4,5990
0,0,1,0,1,0,1,5991
1,1,0,0,1,0,1,5991
0,0,1,0,1,0,1,5992
1,1,0,0,1,0,1,5992
0,0,1,0,1,0,1,5993
1,1,0,0,1,0,1,5993
0,0,1,0,1,0,1,5994
1,1,0,0,1,0,1,5994
0,0,1,0,1,0,1,5995
1,1,1,0,2,0,2,5995
2,2,1,1,3,1,4,5995
3,3,1,1,4,2,6,5995
4,4,0,0,4,2,6,5995
0,0,1,0,1,0,1,5996
1,1,1,0,2,0,2,5996
2,2,1,0,3,0,3,5996
3,3,0,0,3,0,3,5996
0,0,1,0,1,0,1,5997
1,1,1,0,2,0,2,5997
2,2,0,0,2,0,2,5997
0,0,1,0,1,0,1,5998
1,1,1,0,2,0,2,5998
2,2,0,0,2,0,2,5998
0,0,1,0,1,0,1,5999
1,1,1,0,2,0,2,5999
2,2,0,0,2,0,2,5999
0,0,1,0,1,0,1,6000
1,1,0,0,1,0,1,6000
0,0,1,0,1,0,1,6001
1,1,2,0,3,0,3,6001
2,2,4,1,7,1,8,6001
3,3,2,1,9,2,11,6001
4,4,1,3,10,5,15,6001
5,5,2,2,12,7,19,6001
6,6,1,0,13,7,20,6001
7,7,0,0,13,7,20,6001
0,0,1,0,1,0,1,6002
1,1,0,0,1,0,1,6002
0,0,1,0,1,0,1,6003
1,1,0,0,1,0,1,6003
0,0,1,0,1,0,1,6004
1,1,0,0,1,0,1,6004
0,0,1,0,1,0,1,6005
1,1,0,0,1,0,1,6005
0,0,1,0,1,0,1,6006
1,1,2,0,3,0,3,6006
2,2,1,0,4,0,4,6006
3,3,1,0,5,0,5,6006
4,4,1,1,6,1,7,6006
5,5,0,1,6,2,8,6006
6,6,0,0,6,2,8,6006
0,0,1,0,1,0,1,6007
1,1,0,0,1,0,1,6007
0,0,1,0,1,0,1,6008
1,1,1,0,2,0,2,6008
2,2,0,1,2,1,3,6008
3,3,0,2,2,3,5,6008
4,4,0,0,2,3,5,6008
0,0,1,0,1,0,1,6009
1,1,0,0,1,0,1,6009
0,0,1,0,1,0,1,6010
1,1,3,0,4,0,4,6010
2,2,1,1,5,1,6,6010
3,3,0,0,5,1,6,6010
0,0,1,0,1,0,1,6011
1,1,0,0,1,0,1,6011
0,0,1,0,1,0,1,6012
1,1,1,1,2,1,3,6012
2,2,1,0,3,1,4,6012
3,3,1,0,4,1,5,6012
4,4,0,0,4,1,5,6012
0,0,1,0,1,0,1,6013
1,1,4,0,5,0,5,6013
2,2,1,1,6,1,7,6013
3,3,1,0,7,1,8,6013
4,4,1,1,8,2,10,6013
5,5,1,3,9,5,14,6013
6,6,0,2,9,7,16,6013
7,7,0,1,9,8,17,6013
8,8,1,0,10,8,18,6013
9,9,0,0,10,8,18,6013
0,0,1,0,1,0,1,6014
1,1,1,0,2,0,2,6014
2,2,3,1,5,1,6,6014
3,3,3,0,8,1,9,6014
4,4,3,0,11,1,12,6014
5,5,4,1,15,2,17,6014
6,6,5,2,20,4,24,6014
7,7,5,2,25,6,31,6014
8,8,3,1,28,7,35,6014
9,9,3,1,31,8,39,6014
10,10,1,1,32,9,41,6014
11,11,2,1,34,10,44,6014
12,12,2,1,36,11,47,6014
13,13,2,2,38,13,51,6014
14,14,2,2,40,15,55,6014
15,15,0,2,40,17,57,6014
16,16,0,2,40,19,59,6014
17,17,0,1,40,20,60,6014
18,18,0,2,40,22,62,6014
19,19,0,2,40,24,64,6014
20,20,0,1,40,25,65,6014
21,21,0,0,40,25,65,6014
0,0,1,0,1,0,1,6015
1,1,0,1,1,1,2,6015
2,2,0,3,1,4,5,6015
3,3,1,2,2,6,8,6015
4,4,0,1,2,7,9,6015
5,5,1,2,3,9,12,6015
6,6,0,1,3,10,13,6015
7,7,0,1,3,11,14,6015
8,8,0,1,3,12,15,6015
9,9,0,1,3,13,16,6015
10,10,0,0,3,13,16,6015
0,0,1,0,1,0,1,6016
1,1,0,1,1,1,2,6016
2,2,0,1,1,2,3,6016
3,3,0,3,1,5,6,6016
4,4,0,1,1,6,7,6016
5,5,0,0,1,6,7,6016
0,0,1,0,1,0,1,6017
1,1,3,0,4,0,4,6017
2,2,0,0,4,0,4,6017
0,0,1,0,1,0,1,6018
1,1,0,0,1,0,1,6018
0,0,1,0,1,0,1,6019
1,1,0,0,1,0,1,6019
0,0,1,0,1,0,1,6020
1,1,3,1,4,1,5,6020
2,2,1,0,5,1,6,6020
3,3,0,0,5,1,6,6020
0,0,1,0,1,0,1,6021
1,1,2,0,3,0,3,6021
2,2,3,0,6,0,6,6021
3,3,3,2,9,2,11,6021
4,4,1,3,10,5,15,6021
5,5,1,1,11,6,17,6021
6,6,2,2,13,8,21,6021
7,7,0,2,13,10,23,6021
8,8,1,1,14,11,25,6021
9,9,1,0,15,11,26,6021
10,10,2,0,17,11,28,6021
11,11,2,1,19,12,31,6021
12,12,0,4,19,16,35,6021
13,13,1,4,20,20,40,6021
14,14,3,0,23,20,43,6021
15,15,3,0,26,20,46,6021
16,16,4,0,30,20,50,6021
17,17,3,1,33,21,54,6021
18,18,1,2,34,23,57,6021
19,19,2,1,36,24,60,6021
20,20,1,2,37,26,63,6021
21,21,1,1,38,27,65,6021
22,22,1,1,39,28,67,6021
23,23,0,1,39,29,68,6021
24,24,1,1,40,30,70,6021
25,25,3,1,43,31,74,6021
26,26,4,1,47,32,79,6021
27,27,3,4,50,36,86,6021
28,28,4,4,54,40,94,6021
29,29,5,0,59,40,99,6021
30,30,8,1,67,41,108,6021
31,31,3,5,70,46,116,6021
32,32,5,1,75,47,122,6021
33,33,4,3,79,50,129,6021
34,34,4,3,83,53,136,6021
35,35,3,2,86,55,141,6021
36,36,3,3,89,58,147,6021
37,37,4,5,93,63,156,6021
38,38,5,2,98,65,163,6021
39,39,5,4,103,69,172,6021
40,40,11,10,114,79,193,6021
41,41,12,12,126,91,217,6021
42,42,10,6,136,97,233,6021
43,43,3,6,139,103,242,6021
44,44,1,7,140,110,250,6021
45,45,1,7,141,117,258,6021
46,46,0,4,141,121,262,6021
47,47,0,2,141,123,264,6021
48,48,0,2,141,125,266,6021
49,49,0,2,141,127,268,6021
50,50,0,2,141,129,270,6021
51,51,0,1,141,130,271,6021
52,52,1,1,142,131,273,6021
53,53,1,0,143,131,274,6021
54,54,0,0,143,131,274,6021
0,0,1,0,1,0,1,6022
1,1,0,2,1,2,3,6022
2,2,0,2,1,4,5,6022
3,3,0,2,1,6,7,6022
4,4,1,1,2,7,9,6022
5,5,1,0,3,7,10,6022
6,6,0,0,3,7,10,6022
0,0,1,0,1,0,1,6023
1,1,3,0,4,0,4,6023
2,2,1,1,5,1,6,6023
3,3,0,2,5,3,8,6023
4,4,0,2,5,5,10,6023
5,5,0,1,5,6,11,6023
6,6,1,0,6,6,12,6023
7,7,1,0,7,6,13,6023
8,8,1,0,8,6,14,6023
9,9,1,0,9,6,15,6023
10,10,1,0,10,6,16,6023
11,11,1,1,11,7,18,6023
12,12,1,1,12,8,20,6023
13,13,0,0,12,8,20,6023
0,0,1,0,1,0,1,6024
1,1,2,0,3,0,3,6024
2,2,1,0,4,0,4,6024
3,3,0,1,4,1,5,6024
4,4,0,0,4,1,5,6024
0,0,1,0,1,0,1,6025
1,1,1,0,2,0,2,6025
2,2,0,0,2,0,2,6025
0,0,1,0,1,0,1,6026
1,1,1,0,2,0,2,6026
2,2,1,0,3,0,3,6026
3,3,0,0,3,0,3,6026
0,0,1,0,1,0,1,6027
1,1,2,1,3,1,4,6027
2,2,0,2,3,3,6,6027
3,3,0,0,3,3,6,6027
0,0,1,0,1,0,1,6028
1,1,1,0,2,0,2,6028
2,2,0,1,2,1,3,6028
3,3,0,0,2,1,3,6028
0,0,1,0,1,0,1,6029
1,1,1,0,2,0,2,6029
2,2,1,1,3,1,4,6029
3,3,3,0,6,1,7,6029
4,4,4,2,10,3,13,6029
5,5,3,0,13,3,16,6029
6,6,1,1,14,4,18,6029
7,7,1,0,15,4,19,6029
8,8,1,0,16,4,20,6029
9,9,0,0,16,4,20,6029
0,0,1,0,1,0,1,6030
1,1,0,0,1,0,1,6030
0,0,1,0,1,0,1,6031
1,1,1,0,2,0,2,6031
2,2,2,1,4,1,5,6031
3,3,1,1,5,2,7,6031
4,4,1,0,6,2,8,6031
5,5,1,0,7,2,9,6031
6,6,0,0,7,2,9,6031
0,0,1,0,1,0,1,6032
1,1,1,0,2,0,2,6032
2,2,0,0,2,0,2,6032
0,0,1,0,1,0,1,6033
1,1,2,1,3,1,4,6033
2,2,1,1,4,2,6,6033
3,3,1,4,5,6,11,6033
4,4,2,2,7,8,15,6033
5,5,0,0,7,8,15,6033
0,0,1,0,1,0,1,6034
1,1,1,0,2,0,2,6034
2,2,2,0,4,0,4,6034
3,3,1,0,5,0,5,6034
4,4,2,0,7,0,7,6034
5,5,0,0,7,0,7,6034
0,0,1,0,1,0,1,6035
1,1,1,0,2,0,2,6035
2,2,1,0,3,0,3,6035
3,3,1,0,4,0,4,6035
4,4,0,0,4,0,4,6035
0,0,1,0,1,0,1,6036
1,1,1,0,2,0,2,6036
2,2,1,0,3,0,3,6036
3,3,1,1,4,1,5,6036
4,4,1,1,5,2,7,6036
5,5,0,1,5,3,8,6036
6,6,0,0,5,3,8,6036
0,0,1,0,1,0,1,6037
1,1,1,1,2,1,3,6037
2,2,0,0,2,1,3,6037
0,0,1,0,1,0,1,6038
1,1,0,0,1,0,1,6038
0,0,1,0,1,0,1,6039
1,1,1,0,2,0,2,6039
2,2,1,0,3,0,3,6039
3,3,0,0,3,0,3,6039
0,0,1,0,1,0,1,6040
1,1,1,0,2,0,2,6040
2,2,3,0,5,0,5,6040
3,3,4,0,9,0,9,6040
4,4,2,3,11,3,14,6040
5,5,3,3,14,6,20,6040
6,6,2,1,16,7,23,6040
7,7,2,2,18,9,27,6040
8,8,0,0,18,9,27,6040
0,0,1,0,1,0,1,6041
1,1,0,0,1,0,1,6041
0,0,1,0,1,0,1,6042
1,1,2,0,3,0,3,6042
2,2,2,0,5,0,5,6042
3,3,1,1,6,1,7,6042
4,4,1,1,7,2,9,6042
5,5,3,0,10,2,12,6042
6,6,6,0,16,2,18,6042
7,7,2,0,18,2,20,6042
8,8,1,1,19,3,22,6042
9,9,2,1,21,4,25,6042
10,10,2,0,23,4,27,6042
11,11,3,2,26,6,32,6042
12,12,4,3,30,9,39,6042
13,13,5,2,35,11,46,6042
14,14,6,3,41,14,55,6042
15,15,5,2,46,16,62,6042
16,16,6,3,52,19,71,6042
17,17,6,5,58,24,82,6042
18,18,5,7,63,31,94,6042
19,19,3,9,66,40,106,6042
20,20,7,8,73,48,121,6042
21,21,8,6,81,54,135,6042
22,22,9,9,90,63,153,6042
23,23,9,10,99,73,172,6042
24,24,9,11,108,84,192,6042
25,25,10,7,118,91,209,6042
26,26,5,5,123,96,219,6042
27,27,6,6,129,102,231,6042
28,28,10,8,139,110,249,6042
29,29,8,7,147,117,264,6042
30,30,11,5,158,122,280,6042
31,31,8,6,166,128,294,6042
32,32,5,9,171,137,308,6042
33,33,11,10,182,147,329,6042
34,34,14,8,196,155,351,6042
35,35,9,6,205,161,366,6042
36,36,11,3,216,164,380,6042
37,37,14,4,230,168,398,6042
38,38,10,7,240,175,415,6042
39,39,10,5,250,180,430,6042
40,40,6,5,256,185,441,6042
41,41,4,8,260,193,453,6042
42,42,5,7,265,200,465,6042
43,43,9,3,274,203,477,6042
44,44,12,7,286,210,496,6042
45,45,8,7,294,217,511,6042
46,46,4,5,298,222,520,6042
47,47,4,7,302,229,531,6042
48,48,3,10,305,239,544,6042
49,49,3,5,308,244,552,6042
50,50,4,5,312,249,561,6042
51,51,2,1,314,250,564,6042
52,52,2,0,316,250,566,6042
53,53,1,0,317,250,567,6042
54,54,0,0,317,250,567,6042
0,0,1,0,1,0,1,6043
1,1,0,0,1,0,1,6043
0,0,1,0,1,0,1,6044
1,1,1,0,2,0,2,6044
2,2,0,0,2,0,2,6044
0,0,1,0,1,0,1,6045
1,1,0,0,1,0,1,6045
0,0,1,0,1,0,1,6046
1,1,2,0,3,0,3,6046
2,2,1,0,4,0,4,6046
3,3,1,0,5,0,5,6046
4,4,0,0,5,0,5,6046
0,0,1,0,1,0,1,6047
1,1,1,1,2,1,3,6047
2,2,1,1,3,2,5,6047
3,3,4,2,7,4,11,6047
4,4,3,2,10,6,16,6047
5,5,2,2,12,8,20,6047
6,6,3,3,15,11,26,6047
7,7,0,3,15,14,29,6047
8,8,1,4,16,18,34,6047
9,9,2,2,18,20,38,6047
10,10,2,3,20,23,43,6047
11,11,2,5,22,28,50,6047
12,12,0,4,22,32,54,6047
13,13,0,6,22,38,60,6047
14,14,0,4,22,42,64,6047
15,15,2,3,24,45,69,6047
16,16,2,2,26,47,73,6047
17,17,3,1,29,48,77,6047
18,18,2,1,31,49,80,6047
19,19,2,2,33,51,84,6047
20,20,2,0,35,51,86,6047
21,21,0,0,35,51,86,6047
0,0,1,0,1,0,1,6048
1,1,1,0,2,0,2,6048
2,2,1,0,3,0,3,6048
3,3,0,0,3,0,3,6048
0,0,1,0,1,0,1,6049
1,1,0,0,1,0,1,6049
0,0,1,0,1,0,1,6050
1,1,1,0,2,0,2,6050
2,2,1,0,3,0,3,6050
3,3,0,0,3,0,3,6050
0,0,1,0,1,0,1,6051
1,1,0,0,1,0,1,6051
0,0,1,0,1,0,1,6052
1,1,0,0,1,0,1,6052
0,0,1,0,1,0,1,6053
1,1,1,1,2,1,3,6053
2,2,2,0,4,1,5,6053
3,3,0,0,4,1,5,6053
0,0,1,0,1,0,1,6054
1,1,1,0,2,0,2,6054
2,2,1,0,3,0,3,6054
3,3,2,0,5,0,5,6054
4,4,3,0,8,0,8,6054
5,5,0,1,8,1,9,6054
6,6,0,1,8,2,10,6054
7,7,0,0,8,2,10,6054
0,0,1,0,1,0,1,6055
1,1,0,0,1,0,1,6055
0,0,1,0,1,0,1,6056
1,1,1,0,2,0,2,6056
2,2,1,0,3,0,3,6056
3,3,2,0,5,0,5,6056
4,4,2,1,7,1,8,6056
5,5,5,0,12,1,13,6056
6,6,4,1,16,2,18,6056
7,7,5,2,21,4,25,6056
8,8,3,2,24,6,30,6056
9,9,1,1,25,7,32,6056
10,10,0,1,25,8,33,6056
11,11,0,0,25,8,33,6056
0,0,1,0,1,0,1,6057
1,1,0,0,1,0,1,6057
0,0,1,0,1,0,1,6058
1,1,0,0,1,0,1,6058
0,0,1,0,1,0,1,6059
1,1,1,0,2,0,2,6059
2,2,2,0,4,0,4,6059
3,3,1,0,5,0,5,6059
4,4,0,0,5,0,5,6059
0,0,1,0,1,0,1,6060
1,1,1,0,2,0,2,6060
2,2,1,0,3,0,3,6060
3,3,1,0,4,0,4,6060
4,4,0,0,4,0,4,6060
0,0,1,0,1,0,1,6061
1,1,2,0,3,0,3,6061
2,2,2,0,5,0,5,6061
3,3,3,0,8,0,8,6061
4,4,2,0,10,0,10,6061
5,5,2,1,12,1,13,6061
6,6,2,0,14,1,15,6061
7,7,2,0,16,1,17,6061
8,8,2,0,18,1,19,6061
9,9,2,0,20,1,21,6061
10,10,0,0,20,1,21,6061
0,0,1,0,1,0,1,6062
1,1,0,2,1,2,3,6062
2,2,0,1,1,3,4,6062
3,3,0,2,1,5,6,6062
4,4,0,1,1,6,7,6062
5,5,0,1,1,7,8,6062
6,6,0,2,1,9,10,6062
7,7,1,1,2,10,12,6062
8,8,1,0,3,10,13,6062
9,9,0,0,3,10,13,6062
0,0,1,0,1,0,1,6063
1,1,0,1,1,1,2,6063
2,2,1,1,2,2,4,6063
3,3,1,2,3,4,7,6063
4,4,1,3,4,7,11,6063
5,5,0,1,4,8,12,6063
6,6,0,1,4,9,13,6063
7,7,0,2,4,11,15,6063
8,8,1,0,5,11,16,6063
9,9,1,0,6,11,17,6063
10,10,3,0,9,11,20,6063
11,11,2,0,11,11,22,6063
12,12,0,0,11,11,22,6063
0,0,1,0,1,0,1,6064
1,1,1,1,2,1,3,6064
2,2,0,0,2,1,3,6064
0,0,1,0,1,0,1,6065
1,1,0,0,1,0,1,6065
0,0,1,0,1,0,1,6066
1,1,0,0,1,0,1,6066
0,0,1,0,1,0,1,6067
1,1,1,1,2,1,3,6067
2,2,1,1,3,2,5,6067
3,3,0,2,3,4,7,6067
4,4,0,1,3,5,8,6067
5,5,0,0,3,5,8,6067
0,0,1,0,1,0,1,6068
1,1,0,0,1,0,1,6068
0,0,1,0,1,0,1,6069
1,1,1,0,2,0,2,6069
2,2,0,1,2,1,3,6069
3,3,0,0,2,1,3,6069
0,0,1,0,1,0,1,6070
1,1,1,0,2,0,2,6070
2,2,0,0,2,0,2,6070
0,0,1,0,1,0,1,6071
1,1,2,0,3,0,3,6071
2,2,1,0,4,0,4,6071
3,3,1,1,5,1,6,6071
4,4,0,1,5,2,7,6071
5,5,0,0,5,2,7,6071
0,0,1,0,1,0,1,6072
1,1,0,0,1,0,1,6072
0,0,1,0,1,0,1,6073
1,1,1,0,2,0,2,6073
2,2,1,0,3,0,3,6073
3,3,1,0,4,0,4,6073
4,4,1,0,5,0,5,6073
5,5,0,0,5,0,5,6073
0,0,1,0,1,0,1,6074
1,1,1,0,2,0,2,6074
2,2,1,0,3,0,3,6074
3,3,1,0,4,0,4,6074
4,4,2,0,6,0,6,6074
5,5,0,0,6,0,6,6074
0,0,1,0,1,0,1,6075
1,1,0,1,1,1,2,6075
2,2,0,0,1,1,2,6075
0,0,1,0,1,0,1,6076
1,1,1,0,2,0,2,6076
2,2,0,0,2,0,2,6076
0,0,1,0,1,0,1,6077
1,1,2,1,3,1,4,6077
2,2,1,1,4,2,6,6077
3,3,1,1,5,3,8,6077
4,4,1,1,6,4,10,6077
5,5,0,0,6,4,10,6077
0,0,1,0,1,0,1,6078
1,1,0,1,1,1,2,6078
2,2,0,1,1,2,3,6078
3,3,0,1,1,3,4,6078
4,4,0,2,1,5,6,6078
5,5,0,2,1,7,8,6078
6,6,1,2,2,9,11,6078
7,7,1,3,3,12,15,6078
8,8,0,4,3,16,19,6078
9,9,1,1,4,17,21,6078
10,10,1,1,5,18,23,6078
11,11,0,1,5,19,24,6078
12,12,0,1,5,20,25,6078
13,13,1,1,6,21,27,6078
14,14,3,2,9,23,32,6078
15,15,1,2,10,25,35,6078
16,16,4,0,14,25,39,6078
17,17,3,0,17,25,42,6078
18,18,2,0,19,25,44,6078
19,19,2,0,21,25,46,6078
20,20,0,0,21,25,46,6078
0,0,1,0,1,0,1,6079
1,1,0,0,1,0,1,6079
0,0,1,0,1,0,1,6080
1,1,1,1,2,1,3,6080
2,2,0,2,2,3,5,6080
3,3,1,0,3,3,6,6080
4,4,0,0,3,3,6,6080
0,0,1,0,1,0,1,6081
1,1,2,0,3,0,3,6081
2,2,0,0,3,0,3,6081
0,0,1,0,1,0,1,6082
1,1,2,1,3,1,4,6082
2,2,1,0,4,1,5,6082
3,3,2,0,6,1,7,6082
4,4,3,1,9,2,11,6082
5,5,2,0,11,2,13,6082
6,6,0,1,11,3,14,6082
7,7,0,0,11,3,14,6082
0,0,1,0,1,0,1,6083
1,1,1,0,2,0,2,6083
2,2,2,0,4,0,4,6083
3,3,2,0,6,0,6,6083
4,4,1,1,7,1,8,6083
5,5,1,1,8,2,10,6083
6,6,0,0,8,2,10,6083
0,0,1,0,1,0,1,6084
1,1,0,0,1,0,1,6084
0,0,1,0,1,0,1,6085
1,1,1,0,2,0,2,6085
2,2,1,1,3,1,4,6085
3,3,0,0,3,1,4,6085
0,0,1,0,1,0,1,6086
1,1,0,0,1,0,1,6086
0,0,1,0,1,0,1,6087
1,1,0,0,1,0,1,6087
0,0,1,0,1,0,1,6088
1,1,2,1,3,1,4,6088
2,2,0,0,3,1,4,6088
0,0,1,0,1,0,1,6089
1,1,0,0,1,0,1,6089
0,0,1,0,1,0,1,6090
1,1,1,0,2,0,2,6090
2,2,0,0,2,0,2,6090
0,0,1,0,1,0,1,6091
1,1,1,0,2,0,2,6091
2,2,1,0,3,0,3,6091
3,3,0,0,3,0,3,6091
0,0,1,0,1,0,1,6092
1,1,0,0,1,0,1,6092
0,0,1,0,1,0,1,6093
1,1,0,1,1,1,2,6093
2,2,0,2,1,3,4,6093
3,3,1,3,2,6,8,6093
4,4,4,0,6,6,12,6093
5,5,4,2,10,8,18,6093
6,6,2,2,12,10,22,6093
7,7,6,3,18,13,31,6093
8,8,5,4,23,17,40,6093
9,9,5,2,28,19,47,6093
10,10,5,4,33,23,56,6093
11,11,6,6,39,29,68,6093
12,12,8,0,47,29,76,6093
13,13,5,1,52,30,82,6093
14,14,2,1,54,31,85,6093
15,15,0,1,54,32,86,6093
16,16,1,0,55,32,87,6093
17,17,0,1,55,33,88,6093
18,18,0,0,55,33,88,6093
0,0,1,0,1,0,1,6094
1,1,1,1,2,1,3,6094
2,2,3,2,5,3,8,6094
3,3,7,1,12,4,16,6094
4,4,5,4,17,8,25,6094
5,5,3,4,20,12,32,6094
6,6,5,3,25,15,40,6094
7,7,2,2,27,17,44,6094
8,8,3,3,30,20,50,6094
9,9,4,1,34,21,55,6094
10,10,5,0,39,21,60,6094
11,11,1,0,40,21,61,6094
12,12,1,0,41,21,62,6094
13,13,1,0,42,21,63,6094
14,14,0,0,42,21,63,6094
0,0,1,0,1,0,1,6095
1,1,1,1,2,1,3,6095
2,2,1,2,3,3,6,6095
3,3,0,1,3,4,7,6095
4,4,0,2,3,6,9,6095
5,5,0,0,3,6,9,6095
0,0,1,0,1,0,1,6096
1,1,0,0,1,0,1,6096
0,0,1,0,1,0,1,6097
1,1,0,0,1,0,1,6097
0,0,1,0,1,0,1,6098
1,1,0,0,1,0,1,6098
0,0,1,0,1,0,1,6099
1,1,0,0,1,0,1,6099
0,0,1,0,1,0,1,6100
1,1,1,0,2,0,2,6100
2,2,0,2,2,2,4,6100
3,3,2,1,4,3,7,6100
4,4,2,1,6,4,10,6100
5,5,4,0,10,4,14,6100
6,6,7,0,17,4,21,6100
7,7,4,2,21,6,27,6100
8,8,6,1,27,7,34,6100
9,9,7,2,34,9,43,6100
10,10,3,3,37,12,49,6100
11,11,1,4,38,16,54,6100
12,12,1,5,39,21,60,6100
13,13,2,1,41,22,63,6100
14,14,2,0,43,22,65,6100
15,15,1,0,44,22,66,6100
16,16,2,1,46,23,69,6100
17,17,2,1,48,24,72,6100
18,18,0,0,48,24,72,6100
0,0,1,0,1,0,1,6101
1,1,1,0,2,0,2,6101
2,2,0,0,2,0,2,6101
0,0,1,0,1,0,1,6102
1,1,0,1,1,1,2,6102
2,2,1,0,2,1,3,6102
3,3,2,0,4,1,5,6102
4,4,1,1,5,2,7,6102
5,5,0,0,5,2,7,6102
0,0,1,0,1,0,1,6103
1,1,0,0,1,0,1,6103
0,0,1,0,1,0,1,6104
1,1,1,0,2,0,2,6104
2,2,0,0,2,0,2,6104
0,0,1,0,1,0,1,6105
1,1,1,0,2,0,2,6105
2,2,2,0,4,0,4,6105
3,3,2,0,6,0,6,6105
4,4,1,0,7,0,7,6105
5,5,2,0,9,0,9,6105
6,6,2,0,11,0,11,6105
7,7,0,0,11,0,11,6105
0,0,1,0,1,0,1,6106
1,1,1,0,2,0,2,6106
2,2,2,0,4,0,4,6106
3,3,2,1,6,1,7,6106
4,4,3,0,9,1,10,6106
5,5,1,0,10,1,11,6106
6,6,0,0,10,1,11,6106
0,0,1,0,1,0,1,6107
1,1,0,0,1,0,1,6107
0,0,1,0,1,0,1,6108
1,1,0,0,1,0,1,6108
0,0,1,0,1,0,1,6109
1,1,0,0,1,0,1,6109
0,0,1,0,1,0,1,6110
1,1,0,1,1,1,2,6110
2,2,0,0,1,1,2,6110
0,0,1,0,1,0,1,6111
1,1,2,0,3,0,3,6111
2,2,3,0,6,0,6,6111
3,3,7,1,13,1,14,6111
4,4,5,3,18,4,22,6111
5,5,2,2,20,6,26,6111
6,6,1,0,21,6,27,6111
7,7,0,0,21,6,27,6111
0,0,1,0,1,0,1,6112
1,1,1,0,2,0,2,6112
2,2,0,0,2,0,2,6112
0,0,1,0,1,0,1,6113
1,1,2,1,3,1,4,6113
2,2,1,2,4,3,7,6113
3,3,0,0,4,3,7,6113
0,0,1,0,1,0,1,6114
1,1,1,0,2,0,2,6114
2,2,2,0,4,0,4,6114
3,3,1,0,5,0,5,6114
4,4,2,0,7,0,7,6114
5,5,1,0,8,0,8,6114
6,6,2,0,10,0,10,6114
7,7,1,0,11,0,11,6114
8,8,0,1,11,1,12,6114
9,9,0,1,11,2,13,6114
10,10,0,0,11,2,13,6114
0,0,1,0,1,0,1,6115
1,1,2,0,3,0,3,6115
2,2,0,0,3,0,3,6115
0,0,1,0,1,0,1,6116
1,1,3,0,4,0,4,6116
2,2,4,0,8,0,8,6116
3,3,1,2,9,2,11,6116
4,4,1,1,10,3,13,6116
5,5,0,4,10,7,17,6116
6,6,0,2,10,9,19,6116
7,7,1,2,11,11,22,6116
8,8,0,1,11,12,23,6116
9,9,0,0,11,12,23,6116
0,0,1,0,1,0,1,6117
1,1,1,0,2,0,2,6117
2,2,0,0,2,0,2,6117
0,0,1,0,1,0,1,6118
1,1,1,0,2,0,2,6118
2,2,2,0,4,0,4,6118
3,3,3,0,7,0,7,6118
4,4,3,1,10,1,11,6118
5,5,1,2,11,3,14,6118
6,6,1,2,12,5,17,6118
7,7,0,3,12,8,20,6118
8,8,5,1,17,9,26,6118
9,9,5,3,22,12,34,6118
10,10,3,2,25,14,39,6118
11,11,3,5,28,19,47,6118
12,12,3,7,31,26,57,6118
13,13,6,3,37,29,66,6118
14,14,6,3,43,32,75,6118
15,15,3,6,46,38,84,6118
16,16,4,5,50,43,93,6118
17,17,2,4,52,47,99,6118
18,18,6,6,58,53,111,6118
19,19,4,1,62,54,116,6118
20,20,5,1,67,55,122,6118
21,21,4,4,71,59,130,6118
22,22,3,0,74,59,133,6118
23,23,3,1,77,60,137,6118
24,24,4,1,81,61,142,6118
25,25,3,0,84,61,145,6118
26,26,4,2,88,63,151,6118
27,27,8,3,96,66,162,6118
28,28,8,2,104,68,172,6118
29,29,8,3,112,71,183,6118
30,30,5,2,117,73,190,6118
31,31,2,2,119,75,194,6118
32,32,2,1,121,76,197,6118
33,33,3,1,124,77,201,6118
34,34,3,1,127,78,205,6118
35,35,3,0,130,78,208,6118
36,36,2,1,132,79,211,6118
37,37,1,3,133,82,215,6118
38,38,1,4,134,86,220,6118
39,39,3,4,137,90,227,6118
40,40,5,3,142,93,235,6118
41,41,6,1,148,94,242,6118
42,42,7,1,155,95,250,6118
43,43,2,2,157,97,254,6118
44,44,2,5,159,102,261,6118
45,45,3,4,162,106,268,6118
46,46,3,4,165,110,275,6118
47,47,5,1,170,111,281,6118
48,48,8,4,178,115,293,6118
49,49,10,3,188,118,306,6118
50,50,9,8,197,126,323,6118
51,51,6,5,203,131,334,6118
52,52,11,4,214,135,349,6118
53,53,9,8,223,143,366,6118
54,54,5,9,228,152,380,6118
55,55,5,7,233,159,392,6118
56,56,6,9,239,168,407,6118
57,57,7,8,246,176,422,6118
58,58,7,4,253,180,433,6118
59,59,4,4,257,184,441,6118
60,60,3,1,260,185,445,6118
61,61,3,1,263,186,449,6118
62,62,3,3,266,189,455,6118
63,63,2,4,268,193,461,6118
64,64,2,1,270,194,464,6118
65,65,1,1,271,195,466,6118
66,66,1,1,272,196,468,6118
67,67,0,2,272,198,470,6118
68,68,0,1,272,199,471,6118
69,69,1,0,273,199,472,6118
70,70,0,1,273,200,473,6118
71,71,0,0,273,200,473,6118
0,0,1,0,1,0,1,6119
1,1,1,0,2,0,2,6119
2,2,2,0,4,0,4,6119
3,3,4,0,8,0,8,6119
4,4,1,1,9,1,10,6119
5,5,0,1,9,2,11,6119
6,6,0,0,9,2,11,6119
0,0,1,0,1,0,1,6120
1,1,0,0,1,0,1,6120
0,0,1,0,1,0,1,6121
1,1,1,0,2,0,2,6121
2,2,1,0,3,0,3,6121
3,3,0,0,3,0,3,6121
0,0,1,0,1,0,1,6122
1,1,1,0,2,0,2,6122
2,2,2,1,4,1,5,6122
3,3,2,0,6,1,7,6122
4,4,3,0,9,1,10,6122
5,5,1,0,10,1,11,6122
6,6,1,0,11,1,12,6122
7,7,2,0,13,1,14,6122
8,8,1,1,14,2,16,6122
9,9,1,0,15,2,17,6122
10,10,0,0,15,2,17,6122
0,0,1,0,1,0,1,6123
1,1,2,0,3,0,3,6123
2,2,2,0,5,0,5,6123
3,3,2,0,7,0,7,6123
4,4,4,0,11,0,11,6123
5,5,2,1,13,1,14,6123
6,6,0,0,13,1,14,6123
0,0,1,0,1,0,1,6124
1,1,0,0,1,0,1,6124
0,0,1,0,1,0,1,6125
1,1,0,0,1,0,1,6125
0,0,1,0,1,0,1,6126
1,1,1,0,2,0,2,6126
2,2,0,0,2,0,2,6126
0,0,1,0,1,0,1,6127
1,1,0,0,1,0,1,6127
0,0,1,0,1,0,1,6128
1,1,0,0,1,0,1,6128
0,0,1,0,1,0,1,6129
1,1,0,1,1,1,2,6129
2,2,0,0,1,1,2,6129
0,0,1,0,1,0,1,6130
1,1,1,1,2,1,3,6130
2,2,2,1,4,2,6,6130
3,3,4,0,8,2,10,6130
4,4,4,2,12,4,16,6130
5,5,5,2,17,6,23,6130
6,6,6,3,23,9,32,6130
7,7,2,4,25,13,38,6130
8,8,2,0,27,13,40,6130
9,9,0,0,27,13,40,6130
0,0,1,0,1,0,1,6131
1,1,1,0,2,0,2,6131
2,2,0,0,2,0,2,6131
0,0,1,0,1,0,1,6132
1,1,2,0,3,0,3,6132
2,2,4,0,7,0,7,6132
3,3,4,0,11,0,11,6132
4,4,4,1,15,1,16,6132
5,5,2,2,17,3,20,6132
6,6,0,2,17,5,22,6132
7,7,0,1,17,6,23,6132
8,8,0,0,17,6,23,6132
0,0,1,0,1,0,1,6133
1,1,1,0,2,0,2,6133
2,2,0,0,2,0,2,6133
0,0,1,0,1,0,1,6134
1,1,1,0,2,0,2,6134
2,2,2,1,4,1,5,6134
3,3,1,2,5,3,8,6134
4,4,1,5,6,8,14,6134
5,5,4,4,10,12,22,6134
6,6,5,8,15,20,35,6134
7,7,3,7,18,27,45,6134
8,8,3,11,21,38,59,6134
9,9,7,8,28,46,74,6134
10,10,5,10,33,56,89,6134
11,11,6,13,39,69,108,6134
12,12,4,9,43,78,121,6134
13,13,2,6,45,84,129,6134
14,14,6,5,51,89,140,6134
15,15,7,8,58,97,155,6134
16,16,3,6,61,103,164,6134
17,17,6,7,67,110,177,6134
18,18,7,5,74,115,189,6134
19,19,6,6,80,121,201,6134
20,20,5,8,85,129,214,6134
21,21,7,2,92,131,223,6134
22,22,5,2,97,133,230,6134
23,23,6,2,103,135,238,6134
24,24,4,0,107,135,242,6134
25,25,1,4,108,139,247,6134
26,26,1,1,109,140,249,6134
27,27,0,0,109,140,249,6134
0,0,1,0,1,0,1,6135
1,1,0,1,1,1,2,6135
2,2,0,0,1,1,2,6135
0,0,1,0,1,0,1,6136
1,1,1,0,2,0,2,6136
2,2,0,1,2,1,3,6136
3,3,0,1,2,2,4,6136
4,4,0,0,2,2,4,6136
0,0,1,0,1,0,1,6137
1,1,0,0,1,0,1,6137
0,0,1,0,1,0,1,6138
1,1,1,0,2,0,2,6138
2,2,5,0,7,0,7,6138
3,3,1,0,8,0,8,6138
4,4,1,0,9,0,9,6138
5,5,1,1,10,1,11,6138
6,6,0,1,10,2,12,6138
7,7,0,0,10,2,12,6138
0,0,1,0,1,0,1,6139
1,1,1,0,2,0,2,6139
2,2,0,0,2,0,2,6139
0,0,1,0,1,0,1,6140
1,1,0,0,1,0,1,6140
0,0,1,0,1,0,1,6141
1,1,0,0,1,0,1,6141
0,0,1,0,1,0,1,6142
1,1,1,0,2,0,2,6142
2,2,0,0,2,0,2,6142
0,0,1,0,1,0,1,6143
1,1,0,0,1,0,1,6143
0,0,1,0,1,0,1,6144
1,1,0,0,1,0,1,6144
0,0,1,0,1,0,1,6145
1,1,1,1,2,1,3,6145
2,2,0,1,2,2,4,6145
3,3,1,0,3,2,5,6145
4,4,0,0,3,2,5,6145
0,0,1,0,1,0,1,6146
1,1,2,0,3,0,3,6146
2,2,1,0,4,0,4,6146
3,3,0,0,4,0,4,6146
0,0,1,0,1,0,1,6147
1,1,0,0,1,0,1,6147
0,0,1,0,1,0,1,6148
1,1,1,0,2,0,2,6148
2,2,0,0,2,0,2,6148
0,0,1,0,1,0,1,6149
1,1,1,0,2,0,2,6149
2,2,3,0,5,0,5,6149
3,3,0,1,5,1,6,6149
4,4,2,3,7,4,11,6149
5,5,1,2,8,6,14,6149
6,6,3,2,11,8,19,6149
7,7,2,2,13,10,23,6149
8,8,0,1,13,11,24,6149
9,9,0,1,13,12,25,6149
10,10,0,1,13,13,26,6149
11,11,0,1,13,14,27,6149
12,12,0,0,13,14,27,6149
0,0,1,0,1,0,1,6150
1,1,0,0,1,0,1,6150
0,0,1,0,1,0,1,6151
1,1,0,0,1,0,1,6151
0,0,1,0,1,0,1,6152
1,1,1,1,2,1,3,6152
2,2,2,1,4,2,6,6152
3,3,2,0,6,2,8,6152
4,4,3,0,9,2,11,6152
5,5,3,1,12,3,15,6152
6,6,2,1,14,4,18,6152
7,7,0,1,14,5,19,6152
8,8,0,0,14,5,19,6152
0,0,1,0,1,0,1,6153
1,1,1,0,2,0,2,6153
2,2,0,0,2,0,2,6153
0,0,1,0,1,0,1,6154
1,1,0,0,1,0,1,6154
0,0,1,0,1,0,1,6155
1,1,0,0,1,0,1,6155
0,0,1,0,1,0,1,6156
1,1,0,0,1,0,1,6156
0,0,1,0,1,0,1,6157
1,1,0,0,1,0,1,6157
0,0,1,0,1,0,1,6158
1,1,2,1,3,1,4,6158
2,2,1,0,4,1,5,6158
3,3,1,0,5,1,6,6158
4,4,0,0,5,1,6,6158
0,0,1,0,1,0,1,6159
1,1,0,1,1,1,2,6159
2,2,0,3,1,4,5,6159
3,3,1,3,2,7,9,6159
4,4,0,3,2,10,12,6159
5,5,0,1,2,11,13,6159
6,6,0,0,2,11,13,6159
0,0,1,0,1,0,1,6160
1,1,2,0,3,0,3,6160
2,2,1,1,4,1,5,6160
3,3,1,0,5,1,6,6160
4,4,0,0,5,1,6,6160
0,0,1,0,1,0,1,6161
1,1,0,0,1,0,1,6161
0,0,1,0,1,0,1,6162
1,1,0,1,1,1,2,6162
2,2,0,0,1,1,2,6162
0,0,1,0,1,0,1,6163
1,1,3,0,4,0,4,6163
2,2,2,0,6,0,6,6163
3,3,0,1,6,1,7,6163
4,4,0,0,6,1,7,6163
0,0,1,0,1,0,1,6164
1,1,0,0,1,0,1,6164
0,0,1,0,1,0,1,6165
1,1,2,0,3,0,3,6165
2,2,0,1,3,1,4,6165
3,3,0,1,3,2,5,6165
4,4,0,1,3,3,6,6165
5,5,0,0,3,3,6,6165
0,0,1,0,1,0,1,6166
1,1,0,0,1,0,1,6166
0,0,1,0,1,0,1,6167
1,1,0,0,1,0,1,6167
0,0,1,0,1,0,1,6168
1,1,1,0,2,0,2,6168
2,2,0,0,2,0,2,6168
0,0,1,0,1,0,1,6169
1,1,0,0,1,0,1,6169
0,0,1,0,1,0,1,6170
1,1,1,1,2,1,3,6170
2,2,1,1,3,2,5,6170
3,3,2,0,5,2,7,6170
4,4,3,0,8,2,10,6170
5,5,4,0,12,2,14,6170
6,6,5,1,17,3,20,6170
7,7,2,2,19,5,24,6170
8,8,1,2,20,7,27,6170
9,9,1,1,21,8,29,6170
10,10,1,1,22,9,31,6170
11,11,0,0,22,9,31,6170
0,0,1,0,1,0,1,6171
1,1,1,0,2,0,2,6171
2,2,0,0,2,0,2,6171
0,0,1,0,1,0,1,6172
1,1,1,1,2,1,3,6172
2,2,1,0,3,1,4,6172
3,3,1,1,4,2,6,6172
4,4,0,1,4,3,7,6172
5,5,0,1,4,4,8,6172
6,6,1,0,5,4,9,6172
7,7,1,1,6,5,11,6172
8,8,2,1,8,6,14,6172
9,9,1,2,9,8,17,6172
10,10,1,2,10,10,20,6172
11,11,4,1,14,11,25,6172
12,12,3,3,17,14,31,6172
13,13,2,6,19,20,39,6172
14,14,2,4,21,24,45,6172
15,15,2,4,23,28,51,6172
16,16,5,3,28,31,59,6172
17,17,6,4,34,35,69,6172
18,18,4,3,38,38,76,6172
19,19,2,2,40,40,80,6172
20,20,2,2,42,42,84,6172
21,21,2,2,44,44,88,6172
22,22,2,2,46,46,92,6172
23,23,1,3,47,49,96,6172
24,24,1,4,48,53,101,6172
25,25,3,4,51,57,108,6172
26,26,3,4,54,61,115,6172
27,27,2,5,56,66,122,6172
28,28,3,6,59,72,131,6172
29,29,4,0,63,72,135,6172
30,30,1,2,64,74,138,6172
31,31,1,1,65,75,140,6172
32,32,0,1,65,76,141,6172
33,33,1,1,66,77,143,6172
34,34,1,1,67,78,145,6172
35,35,2,1,69,79,148,6172
36,36,1,1,70,80,150,6172
37,37,3,0,73,80,153,6172
38,38,2,1,75,81,156,6172
39,39,1,2,76,83,159,6172
40,40,3,2,79,85,164,6172
41,41,3,0,82,85,167,6172
42,42,0,0,82,85,167,6172
0,0,1,0,1,0,1,6173
1,1,0,0,1,0,1,6173
0,0,1,0,1,0,1,6174
1,1,0,1,1,1,2,6174
2,2,1,0,2,1,3,6174
3,3,2,0,4,1,5,6174
4,4,1,0,5,1,6,6174
5,5,1,0,6,1,7,6174
6,6,0,0,6,1,7,6174
0,0,1,0,1,0,1,6175
1,1,0,0,1,0,1,6175
0,0,1,0,1,0,1,6176
1,1,1,1,2,1,3,6176
2,2,0,0,2,1,3,6176
0,0,1,0,1,0,1,6177
1,1,1,0,2,0,2,6177
2,2,1,0,3,0,3,6177
3,3,1,0,4,0,4,6177
4,4,0,0,4,0,4,6177
0,0,1,0,1,0,1,6178
1,1,0,1,1,1,2,6178
2,2,0,1,1,2,3,6178
3,3,0,1,1,3,4,6178
4,4,0,0,1,3,4,6178
0,0,1,0,1,0,1,6179
1,1,1,0,2,0,2,6179
2,2,1,0,3,0,3,6179
3,3,2,0,5,0,5,6179
4,4,0,0,5,0,5,6179
0,0,1,0,1,0,1,6180
1,1,2,0,3,0,3,6180
2,2,2,0,5,0,5,6180
3,3,1,0,6,0,6,6180
4,4,2,0,8,0,8,6180
5,5,2,0,10,0,10,6180
6,6,1,0,11,0,11,6180
7,7,2,1,13,1,14,6180
8,8,0,0,13,1,14,6180
0,0,1,0,1,0,1,6181
1,1,0,0,1,0,1,6181
0,0,1,0,1,0,1,6182
1,1,3,0,4,0,4,6182
2,2,1,1,5,1,6,6182
3,3,1,0,6,1,7,6182
4,4,0,0,6,1,7,6182
0,0,1,0,1,0,1,6183
1,1,0,0,1,0,1,6183
0,0,1,0,1,0,1,6184
1,1,0,0,1,0,1,6184
0,0,1,0,1,0,1,6185
1,1,0,0,1,0,1,6185
0,0,1,0,1,0,1,6186
1,1,0,1,1,1,2,6186
2,2,0,1,1,2,3,6186
3,3,0,0,1,2,3,6186
0,0,1,0,1,0,1,6187
1,1,0,0,1,0,1,6187
0,0,1,0,1,0,1,6188
1,1,1,0,2,0,2,6188
2,2,1,0,3,0,3,6188
3,3,2,0,5,0,5,6188
4,4,0,1,5,1,6,6188
5,5,1,4,6,5,11,6188
6,6,1,2,7,7,14,6188
7,7,3,3,10,10,20,6188
8,8,4,2,14,12,26,6188
9,9,2,0,16,12,28,6188
10,10,1,0,17,12,29,6188
11,11,0,0,17,12,29,6188
0,0,1,0,1,0,1,6189
1,1,1,0,2,0,2,6189
2,2,0,0,2,0,2,6189
0,0,1,0,1,0,1,6190
1,1,0,0,1,0,1,6190
0,0,1,0,1,0,1,6191
1,1,0,0,1,0,1,6191
0,0,1,0,1,0,1,6192
1,1,1,0,2,0,2,6192
2,2,0,0,2,0,2,6192
0,0,1,0,1,0,1,6193
1,1,2,0,3,0,3,6193
2,2,1,0,4,0,4,6193
3,3,0,0,4,0,4,6193
0,0,1,0,1,0,1,6194
1,1,1,0,2,0,2,6194
2,2,1,0,3,0,3,6194
3,3,0,0,3,0,3,6194
0,0,1,0,1,0,1,6195
1,1,0,1,1,1,2,6195
2,2,0,2,1,3,4,6195
3,3,0,0,1,3,4,6195
0,0,1,0,1,0,1,6196
1,1,0,0,1,0,1,6196
0,0,1,0,1,0,1,6197
1,1,0,1,1,1,2,6197
2,2,0,0,1,1,2,6197
0,0,1,0,1,0,1,6198
1,1,3,0,4,0,4,6198
2,2,1,1,5,1,6,6198
3,3,0,0,5,1,6,6198
0,0,1,0,1,0,1,6199
1,1,0,0,1,0,1,6199
0,0,1,0,1,0,1,6200
1,1,0,0,1,0,1,6200
0,0,1,0,1,0,1,6201
1,1,0,0,1,0,1,6201
0,0,1,0,1,0,1,6202
1,1,2,0,3,0,3,6202
2,2,2,0,5,0,5,6202
3,3,2,2,7,2,9,6202
4,4,0,0,7,2,9,6202
0,0,1,0,1,0,1,6203
1,1,1,0,2,0,2,6203
2,2,1,0,3,0,3,6203
3,3,1,0,4,0,4,6203
4,4,1,0,5,0,5,6203
5,5,1,1,6,1,7,6203
6,6,2,3,8,4,12,6203
7,7,0,2,8,6,14,6203
8,8,0,4,8,10,18,6203
9,9,0,2,8,12,20,6203
10,10,0,2,8,14,22,6203
11,11,0,1,8,15,23,6203
12,12,0,0,8,15,23,6203
0,0,1,0,1,0,1,6204
1,1,1,0,2,0,2,6204
2,2,1,0,3,0,3,6204
3,3,0,0,3,0,3,6204
0,0,1,0,1,0,1,6205
1,1,0,0,1,0,1,6205
0,0,1,0,1,0,1,6206
1,1,0,0,1,0,1,6206
0,0,1,0,1,0,1,6207
1,1,0,0,1,0,1,6207
0,0,1,0,1,0,1,6208
1,1,0,0,1,0,1,6208
0,0,1,0,1,0,1,6209
1,1,0,0,1,0,1,6209
0,0,1,0,1,0,1,6210
1,1,1,0,2,0,2,6210
2,2,0,0,2,0,2,6210
0,0,1,0,1,0,1,6211
1,1,0,1,1,1,2,6211
2,2,0,0,1,1,2,6211
0,0,1,0,1,0,1,6212
1,1,1,0,2,0,2,6212
2,2,0,0,2,0,2,6212
0,0,1,0,1,0,1,6213
1,1,0,0,1,0,1,6213
0,0,1,0,1,0,1,6214
1,1,1,0,2,0,2,6214
2,2,1,0,3,0,3,6214
3,3,1,0,4,0,4,6214
4,4,1,0,5,0,5,6214
5,5,0,0,5,0,5,6214
0,0,1,0,1,0,1,6215
1,1,1,1,2,1,3,6215
2,2,1,1,3,2,5,6215
3,3,0,0,3,2,5,6215
0,0,1,0,1,0,1,6216
1,1,0,0,1,0,1,6216
0,0,1,0,1,0,1,6217
1,1,0,0,1,0,1,6217
0,0,1,0,1,0,1,6218
1,1,2,0,3,0,3,6218
2,2,2,0,5,0,5,6218
3,3,0,0,5,0,5,6218
0,0,1,0,1,0,1,6219
1,1,1,0,2,0,2,6219
2,2,0,0,2,0,2,6219
0,0,1,0,1,0,1,6220
1,1,0,1,1,1,2,6220
2,2,0,1,1,2,3,6220
3,3,0,0,1,2,3,6220
0,0,1,0,1,0,1,6221
1,1,1,0,2,0,2,6221
2,2,1,0,3,0,3,6221
3,3,1,0,4,0,4,6221
4,4,0,0,4,0,4,6221
0,0,1,0,1,0,1,6222
1,1,0,1,1,1,2,6222
2,2,0,2,1,3,4,6222
3,3,0,4,1,7,8,6222
4,4,0,0,1,7,8,6222
0,0,1,0,1,0,1,6223
1,1,1,0,2,0,2,6223
2,2,0,0,2,0,2,6223
0,0,1,0,1,0,1,6224
1,1,1,0,2,0,2,6224
2,2,1,0,3,0,3,6224
3,3,0,0,3,0,3,6224
0,0,1,0,1,0,1,6225
1,1,1,0,2,0,2,6225
2,2,1,1,3,1,4,6225
3,3,0,0,3,1,4,6225
0,0,1,0,1,0,1,6226
1,1,1,0,2,0,2,6226
2,2,0,0,2,0,2,6226
0,0,1,0,1,0,1,6227
1,1,2,0,3,0,3,6227
2,2,2,3,5,3,8,6227
3,3,4,4,9,7,16,6227
4,4,5,3,14,10,24,6227
5,5,4,2,18,12,30,6227
6,6,4,3,22,15,37,6227
7,7,5,3,27,18,45,6227
8,8,4,5,31,23,54,6227
9,9,5,6,36,29,65,6227
10,10,5,3,41,32,73,6227
11,11,1,6,42,38,80,6227
12,12,1,2,43,40,83,6227
13,13,0,5,43,45,88,6227
14,14,2,5,45,50,95,6227
15,15,1,8,46,58,104,6227
16,16,2,8,48,66,114,6227
17,17,0,8,48,74,122,6227
18,18,1,7,49,81,130,6227
19,19,3,4,52,85,137,6227
20,20,2,1,54,86,140,6227
21,21,1,0,55,86,141,6227
22,22,0,0,55,86,141,6227
0,0,1,0,1,0,1,6228
1,1,0,0,1,0,1,6228
0,0,1,0,1,0,1,6229
1,1,0,0,1,0,1,6229
0,0,1,0,1,0,1,6230
1,1,0,1,1,1,2,6230
2,2,0,1,1,2,3,6230
3,3,0,3,1,5,6,6230
4,4,0,3,1,8,9,6230
5,5,0,0,1,8,9,6230
0,0,1,0,1,0,1,6231
1,1,2,0,3,0,3,6231
2,2,0,0,3,0,3,6231
0,0,1,0,1,0,1,6232
1,1,0,0,1,0,1,6232
0,0,1,0,1,0,1,6233
1,1,2,0,3,0,3,6233
2,2,2,0,5,0,5,6233
3,3,3,0,8,0,8,6233
4,4,1,1,9,1,10,6233
5,5,2,2,11,3,14,6233
6,6,3,3,14,6,20,6233
7,7,1,1,15,7,22,6233
8,8,1,1,16,8,24,6233
9,9,3,1,19,9,28,6233
10,10,2,0,21,9,30,6233
11,11,1,0,22,9,31,6233
12,12,0,0,22,9,31,6233
0,0,1,0,1,0,1,6234
1,1,1,1,2,1,3,6234
2,2,2,3,4,4,8,6234
3,3,2,1,6,5,11,6234
4,4,1,0,7,5,12,6234
5,5,1,1,8,6,14,6234
6,6,2,1,10,7,17,6234
7,7,0,0,10,7,17,6234
0,0,1,0,1,0,1,6235
1,1,3,0,4,0,4,6235
2,2,3,1,7,1,8,6235
3,3,4,1,11,2,13,6235
4,4,4,1,15,3,18,6235
5,5,4,2,19,5,24,6235
6,6,2,5,21,10,31,6235
7,7,5,9,26,19,45,6235
8,8,9,16,35,35,70,6235
9,9,6,16,41,51,92,6235
10,10,9,15,50,66,116,6235
11,11,7,8,57,74,131,6235
12,12,5,7,62,81,143,6235
13,13,4,6,66,87,153,6235
14,14,6,5,72,92,164,6235
15,15,4,6,76,98,174,6235
16,16,7,2,83,100,183,6235
17,17,4,4,87,104,191,6235
18,18,3,7,90,111,201,6235
19,19,2,6,92,117,209,6235
20,20,0,6,92,123,215,6235
21,21,2,8,94,131,225,6235
22,22,5,8,99,139,238,6235
23,23,6,3,105,142,247,6235
24,24,5,1,110,143,253,6235
25,25,2,1,112,144,256,6235
26,26,2,0,114,144,258,6235
27,27,1,1,115,145,260,6235
28,28,0,1,115,146,261,6235
29,29,0,1,115,147,262,6235
30,30,0,1,115,148,263,6235
31,31,0,0,115,148,263,6235
0,0,1,0,1,0,1,6236
1,1,0,0,1,0,1,6236
0,0,1,0,1,0,1,6237
1,1,0,1,1,1,2,6237
2,2,0,0,1,1,2,6237
0,0,1,0,1,0,1,6238
1,1,0,1,1,1,2,6238
2,2,0,0,1,1,2,6238
0,0,1,0,1,0,1,6239
1,1,1,0,2,0,2,6239
2,2,0,0,2,0,2,6239
0,0,1,0,1,0,1,6240
1,1,1,0,2,0,2,6240
2,2,1,1,3,1,4,6240
3,3,1,3,4,4,8,6240
4,4,2,4,6,8,14,6240
5,5,1,2,7,10,17,6240
6,6,3,1,10,11,21,6240
7,7,2,1,12,12,24,6240
8,8,0,0,12,12,24,6240
0,0,1,0,1,0,1,6241
1,1,1,1,2,1,3,6241
2,2,0,0,2,1,3,6241
0,0,1,0,1,0,1,6242
1,1,0,0,1,0,1,6242
0,0,1,0,1,0,1,6243
1,1,1,0,2,0,2,6243
2,2,0,0,2,0,2,6243
0,0,1,0,1,0,1,6244
1,1,1,0,2,0,2,6244
2,2,0,0,2,0,2,6244
0,0,1,0,1,0,1,6245
1,1,1,0,2,0,2,6245
2,2,1,0,3,0,3,6245
3,3,0,0,3,0,3,6245
0,0,1,0,1,0,1,6246
1,1,1,0,2,0,2,6246
2,2,1,1,3,1,4,6246
3,3,0,1,3,2,5,6246
4,4,0,2,3,4,7,6246
5,5,0,0,3,4,7,6246
0,0,1,0,1,0,1,6247
1,1,0,0,1,0,1,6247
0,0,1,0,1,0,1,6248
1,1,2,0,3,0,3,6248
2,2,1,0,4,0,4,6248
3,3,1,0,5,0,5,6248
4,4,0,0,5,0,5,6248
0,0,1,0,1,0,1,6249
1,1,2,0,3,0,3,6249
2,2,1,0,4,0,4,6249
3,3,0,1,4,1,5,6249
4,4,1,0,5,1,6,6249
5,5,3,0,8,1,9,6249
6,6,4,1,12,2,14,6249
7,7,3,1,15,3,18,6249
8,8,3,3,18,6,24,6249
9,9,5,3,23,9,32,6249
10,10,1,0,24,9,33,6249
11,11,1,0,25,9,34,6249
12,12,1,0,26,9,35,6249
13,13,1,0,27,9,36,6249
14,14,2,0,29,9,38,6249
15,15,0,1,29,10,39,6249
16,16,0,2,29,12,41,6249
17,17,0,2,29,14,43,6249
18,18,0,4,29,18,47,6249
19,19,2,1,31,19,50,6249
20,20,0,0,31,19,50,6249
0,0,1,0,1,0,1,6250
1,1,1,0,2,0,2,6250
2,2,1,0,3,0,3,6250
3,3,2,0,5,0,5,6250
4,4,3,1,8,1,9,6250
5,5,3,1,11,2,13,6250
6,6,2,0,13,2,15,6250
7,7,0,0,13,2,15,6250
0,0,1,0,1,0,1,6251
1,1,2,0,3,0,3,6251
2,2,2,1,5,1,6,6251
3,3,1,0,6,1,7,6251
4,4,2,0,8,1,9,6251
5,5,4,0,12,1,13,6251
6,6,1,2,13,3,16,6251
7,7,0,1,13,4,17,6251
8,8,0,1,13,5,18,6251
9,9,0,1,13,6,19,6251
10,10,0,0,13,6,19,6251
0,0,1,0,1,0,1,6252
1,1,1,0,2,0,2,6252
2,2,1,0,3,0,3,6252
3,3,0,0,3,0,3,6252
0,0,1,0,1,0,1,6253
1,1,1,0,2,0,2,6253
2,2,0,0,2,0,2,6253
0,0,1,0,1,0,1,6254
1,1,1,0,2,0,2,6254
2,2,1,0,3,0,3,6254
3,3,1,0,4,0,4,6254
4,4,0,0,4,0,4,6254
0,0,1,0,1,0,1,6255
1,1,0,0,1,0,1,6255
0,0,1,0,1,0,1,6256
1,1,0,0,1,0,1,6256
0,0,1,0,1,0,1,6257
1,1,0,0,1,0,1,6257
0,0,1,0,1,0,1,6258
1,1,1,1,2,1,3,6258
2,2,1,0,3,1,4,6258
3,3,0,0,3,1,4,6258
0,0,1,0,1,0,1,6259
1,1,1,0,2,0,2,6259
2,2,1,0,3,0,3,6259
3,3,1,1,4,1,5,6259
4,4,1,0,5,1,6,6259
5,5,0,0,5,1,6,6259
0,0,1,0,1,0,1,6260
1,1,0,0,1,0,1,6260
0,0,1,0,1,0,1,6261
1,1,0,2,1,2,3,6261
2,2,0,1,1,3,4,6261
3,3,0,0,1,3,4,6261
0,0,1,0,1,0,1,6262
1,1,2,0,3,0,3,6262
2,2,0,0,3,0,3,6262
0,0,1,0,1,0,1,6263
1,1,2,0,3,0,3,6263
2,2,0,0,3,0,3,6263
0,0,1,0,1,0,1,6264
1,1,0,0,1,0,1,6264
0,0,1,0,1,0,1,6265
1,1,1,0,2,0,2,6265
2,2,0,0,2,0,2,6265
0,0,1,0,1,0,1,6266
1,1,0,0,1,0,1,6266
0,0,1,0,1,0,1,6267
1,1,2,0,3,0,3,6267
2,2,0,1,3,1,4,6267
3,3,0,0,3,1,4,6267
0,0,1,0,1,0,1,6268
1,1,0,0,1,0,1,6268
0,0,1,0,1,0,1,6269
1,1,0,0,1,0,1,6269
0,0,1,0,1,0,1,6270
1,1,0,0,1,0,1,6270
0,0,1,0,1,0,1,6271
1,1,1,0,2,0,2,6271
2,2,1,0,3,0,3,6271
3,3,1,0,4,0,4,6271
4,4,0,0,4,0,4,6271
0,0,1,0,1,0,1,6272
1,1,0,0,1,0,1,6272
0,0,1,0,1,0,1,6273
1,1,0,0,1,0,1,6273
0,0,1,0,1,0,1,6274
1,1,0,0,1,0,1,6274
0,0,1,0,1,0,1,6275
1,1,0,0,1,0,1,6275
0,0,1,0,1,0,1,6276
1,1,2,0,3,0,3,6276
2,2,0,0,3,0,3,6276
0,0,1,0,1,0,1,6277
1,1,0,1,1,1,2,6277
2,2,0,0,1,1,2,6277
0,0,1,0,1,0,1,6278
1,1,1,1,2,1,3,6278
2,2,2,0,4,1,5,6278
3,3,4,1,8,2,10,6278
4,4,0,0,8,2,10,6278
0,0,1,0,1,0,1,6279
1,1,0,1,1,1,2,6279
2,2,0,0,1,1,2,6279
0,0,1,0,1,0,1,6280
1,1,0,0,1,0,1,6280
0,0,1,0,1,0,1,6281
1,1,1,0,2,0,2,6281
2,2,0,0,2,0,2,6281
0,0,1,0,1,0,1,6282
1,1,0,0,1,0,1,6282
0,0,1,0,1,0,1,6283
1,1,1,0,2,0,2,6283
2,2,1,0,3,0,3,6283
3,3,2,0,5,0,5,6283
4,4,0,0,5,0,5,6283
0,0,1,0,1,0,1,6284
1,1,1,0,2,0,2,6284
2,2,2,0,4,0,4,6284
3,3,2,0,6,0,6,6284
4,4,1,1,7,1,8,6284
5,5,0,0,7,1,8,6284
0,0,1,0,1,0,1,6285
1,1,0,0,1,0,1,6285
0,0,1,0,1,0,1,6286
1,1,0,0,1,0,1,6286
0,0,1,0,1,0,1,6287
1,1,0,0,1,0,1,6287
0,0,1,0,1,0,1,6288
1,1,0,0,1,0,1,6288
0,0,1,0,1,0,1,6289
1,1,0,0,1,0,1,6289
0,0,1,0,1,0,1,6290
1,1,2,0,3,0,3,6290
2,2,1,0,4,0,4,6290
3,3,1,0,5,0,5,6290
4,4,0,0,5,0,5,6290
0,0,1,0,1,0,1,6291
1,1,1,0,2,0,2,6291
2,2,1,0,3,0,3,6291
3,3,1,0,4,0,4,6291
4,4,1,0,5,0,5,6291
5,5,2,0,7,0,7,6291
6,6,1,1,8,1,9,6291
7,7,1,2,9,3,12,6291
8,8,0,3,9,6,15,6291
9,9,0,1,9,7,16,6291
10,10,0,1,9,8,17,6291
11,11,0,0,9,8,17,6291
0,0,1,0,1,0,1,6292
1,1,1,1,2,1,3,6292
2,2,1,1,3,2,5,6292
3,3,1,0,4,2,6,6292
4,4,2,0,6,2,8,6292
5,5,1,2,7,4,11,6292
6,6,1,0,8,4,12,6292
7,7,0,0,8,4,12,6292
0,0,1,0,1,0,1,6293
1,1,2,0,3,0,3,6293
2,2,1,0,4,0,4,6293
3,3,2,1,6,1,7,6293
4,4,1,0,7,1,8,6293
5,5,0,0,7,1,8,6293
0,0,1,0,1,0,1,6294
1,1,1,0,2,0,2,6294
2,2,2,0,4,0,4,6294
3,3,0,0,4,0,4,6294
0,0,1,0,1,0,1,6295
1,1,1,0,2,0,2,6295
2,2,2,0,4,0,4,6295
3,3,2,0,6,0,6,6295
4,4,3,0,9,0,9,6295
5,5,2,1,11,1,12,6295
6,6,0,0,11,1,12,6295
0,0,1,0,1,0,1,6296
1,1,0,1,1,1,2,6296
2,2,0,0,1,1,2,6296
0,0,1,0,1,0,1,6297
1,1,0,0,1,0,1,6297
0,0,1,0,1,0,1,6298
1,1,1,1,2,1,3,6298
2,2,1,1,3,2,5,6298
3,3,0,0,3,2,5,6298
0,0,1,0,1,0,1,6299
1,1,0,1,1,1,2,6299
2,2,0,1,1,2,3,6299
3,3,0,2,1,4,5,6299
4,4,2,1,3,5,8,6299
5,5,4,1,7,6,13,6299
6,6,0,0,7,6,13,6299
0,0,1,0,1,0,1,6300
1,1,2,1,3,1,4,6300
2,2,1,0,4,1,5,6300
3,3,0,0,4,1,5,6300
0,0,1,0,1,0,1,6301
1,1,1,0,2,0,2,6301
2,2,2,0,4,0,4,6301
3,3,0,0,4,0,4,6301
0,0,1,0,1,0,1,6302
1,1,1,1,2,1,3,6302
2,2,1,0,3,1,4,6302
3,3,0,0,3,1,4,6302
0,0,1,0,1,0,1,6303
1,1,0,0,1,0,1,6303
0,0,1,0,1,0,1,6304
1,1,1,0,2,0,2,6304
2,2,1,0,3,0,3,6304
3,3,0,1,3,1,4,6304
4,4,1,0,4,1,5,6304
5,5,0,0,4,1,5,6304
0,0,1,0,1,0,1,6305
1,1,0,0,1,0,1,6305
0,0,1,0,1,0,1,6306
1,1,1,0,2,0,2,6306
2,2,2,1,4,1,5,6306
3,3,1,0,5,1,6,6306
4,4,0,0,5,1,6,6306
0,0,1,0,1,0,1,6307
1,1,0,0,1,0,1,6307
0,0,1,0,1,0,1,6308
1,1,0,0,1,0,1,6308
0,0,1,0,1,0,1,6309
1,1,1,0,2,0,2,6309
2,2,1,0,3,0,3,6309
3,3,1,0,4,0,4,6309
4,4,0,1,4,1,5,6309
5,5,0,2,4,3,7,6309
6,6,2,0,6,3,9,6309
7,7,2,0,8,3,11,6309
8,8,1,1,9,4,13,6309
9,9,1,0,10,4,14,6309
10,10,2,1,12,5,17,6309
11,11,1,0,13,5,18,6309
12,12,1,0,14,5,19,6309
13,13,1,0,15,5,20,6309
14,14,3,0,18,5,23,6309
15,15,2,1,20,6,26,6309
16,16,2,0,22,6,28,6309
17,17,1,0,23,6,29,6309
18,18,0,0,23,6,29,6309
0,0,1,0,1,0,1,6310
1,1,0,0,1,0,1,6310
0,0,1,0,1,0,1,6311
1,1,1,0,2,0,2,6311
2,2,0,0,2,0,2,6311
0,0,1,0,1,0,1,6312
1,1,0,0,1,0,1,6312
0,0,1,0,1,0,1,6313
1,1,0,0,1,0,1,6313
0,0,1,0,1,0,1,6314
1,1,2,0,3,0,3,6314
2,2,1,0,4,0,4,6314
3,3,1,0,5,0,5,6314
4,4,0,0,5,0,5,6314
0,0,1,0,1,0,1,6315
1,1,0,2,1,2,3,6315
2,2,1,3,2,5,7,6315
3,3,1,1,3,6,9,6315
4,4,2,1,5,7,12,6315
5,5,0,2,5,9,14,6315
6,6,0,3,5,12,17,6315
7,7,1,1,6,13,19,6315
8,8,2,0,8,13,21,6315
9,9,1,0,9,13,22,6315
10,10,0,0,9,13,22,6315
0,0,1,0,1,0,1,6316
1,1,1,0,2,0,2,6316
2,2,2,2,4,2,6,6316
3,3,3,2,7,4,11,6316
4,4,6,1,13,5,18,6316
5,5,4,2,17,7,24,6316
6,6,6,3,23,10,33,6316
7,7,4,2,27,12,39,6316
8,8,5,3,32,15,47,6316
9,9,4,1,36,16,52,6316
10,10,1,3,37,19,56,6316
11,11,0,3,37,22,59,6316
12,12,0,2,37,24,61,6316
13,13,1,2,38,26,64,6316
14,14,2,3,40,29,69,6316
15,15,0,0,40,29,69,6316
0,0,1,0,1,0,1,6317
1,1,1,0,2,0,2,6317
2,2,0,0,2,0,2,6317
0,0,1,0,1,0,1,6318
1,1,0,0,1,0,1,6318
0,0,1,0,1,0,1,6319
1,1,4,1,5,1,6,6319
2,2,2,2,7,3,10,6319
3,3,3,2,10,5,15,6319
4,4,7,2,17,7,24,6319
5,5,3,1,20,8,28,6319
6,6,3,1,23,9,32,6319
7,7,3,2,26,11,37,6319
8,8,4,2,30,13,43,6319
9,9,4,1,34,14,48,6319
10,10,0,1,34,15,49,6319
11,11,0,0,34,15,49,6319
0,0,1,0,1,0,1,6320
1,1,0,0,1,0,1,6320
0,0,1,0,1,0,1,6321
1,1,1,0,2,0,2,6321
2,2,0,0,2,0,2,6321
0,0,1,0,1,0,1,6322
1,1,2,0,3,0,3,6322
2,2,2,0,5,0,5,6322
3,3,1,0,6,0,6,6322
4,4,2,1,8,1,9,6322
5,5,1,1,9,2,11,6322
6,6,0,1,9,3,12,6322
7,7,0,0,9,3,12,6322
0,0,1,0,1,0,1,6323
1,1,1,0,2,0,2,6323
2,2,0,0,2,0,2,6323
0,0,1,0,1,0,1,6324
1,1,2,1,3,1,4,6324
2,2,1,2,4,3,7,6324
3,3,0,1,4,4,8,6324
4,4,0,3,4,7,11,6324
5,5,0,2,4,9,13,6324
6,6,0,2,4,11,15,6324
7,7,0,3,4,14,18,6324
8,8,0,3,4,17,21,6324
9,9,0,3,4,20,24,6324
10,10,0,1,4,21,25,6324
11,11,0,2,4,23,27,6324
12,12,0,3,4,26,30,6324
13,13,0,3,4,29,33,6324
14,14,0,2,4,31,35,6324
15,15,2,0,6,31,37,6324
16,16,2,1,8,32,40,6324
17,17,1,0,9,32,41,6324
18,18,0,0,9,32,41,6324
0,0,1,0,1,0,1,6325
1,1,0,0,1,0,1,6325
0,0,1,0,1,0,1,6326
1,1,0,0,1,0,1,6326
0,0,1,0,1,0,1,6327
1,1,1,0,2,0,2,6327
2,2,1,0,3,0,3,6327
3,3,0,1,3,1,4,6327
4,4,0,0,3,1,4,6327
0,0,1,0,1,0,1,6328
1,1,1,1,2,1,3,6328
2,2,1,1,3,2,5,6328
3,3,3,0,6,2,8,6328
4,4,4,0,10,2,12,6328
5,5,3,0,13,2,15,6328
6,6,3,1,16,3,19,6328
7,7,3,1,19,4,23,6328
8,8,2,0,21,4,25,6328
9,9,3,0,24,4,28,6328
10,10,2,1,26,5,31,6328
11,11,1,0,27,5,32,6328
12,12,1,1,28,6,34,6328
13,13,1,2,29,8,37,6328
14,14,0,0,29,8,37,6328
0,0,1,0,1,0,1,6329
1,1,0,0,1,0,1,6329
0,0,1,0,1,0,1,6330
1,1,0,0,1,0,1,6330
0,0,1,0,1,0,1,6331
1,1,0,0,1,0,1,6331
0,0,1,0,1,0,1,6332
1,1,1,0,2,0,2,6332
2,2,0,0,2,0,2,6332
0,0,1,0,1,0,1,6333
1,1,1,0,2,0,2,6333
2,2,0,0,2,0,2,6333
0,0,1,0,1,0,1,6334
1,1,2,0,3,0,3,6334
2,2,0,0,3,0,3,6334
0,0,1,0,1,0,1,6335
1,1,0,0,1,0,1,6335
0,0,1,0,1,0,1,6336
1,1,2,0,3,0,3,6336
2,2,0,0,3,0,3,6336
0,0,1,0,1,0,1,6337
1,1,2,0,3,0,3,6337
2,2,2,0,5,0,5,6337
3,3,2,1,7,1,8,6337
4,4,1,1,8,2,10,6337
5,5,1,2,9,4,13,6337
6,6,0,1,9,5,14,6337
7,7,0,1,9,6,15,6337
8,8,1,0,10,6,16,6337
9,9,0,0,10,6,16,6337
0,0,1,0,1,0,1,6338
1,1,1,0,2,0,2,6338
2,2,1,0,3,0,3,6338
3,3,0,0,3,0,3,6338
0,0,1,0,1,0,1,6339
1,1,2,0,3,0,3,6339
2,2,0,0,3,0,3,6339
0,0,1,0,1,0,1,6340
1,1,1,0,2,0,2,6340
2,2,0,0,2,0,2,6340
0,0,1,0,1,0,1,6341
1,1,0,0,1,0,1,6341
0,0,1,0,1,0,1,6342
1,1,1,0,2,0,2,6342
2,2,3,0,5,0,5,6342
3,3,2,1,7,1,8,6342
4,4,2,5,9,6,15,6342
5,5,2,5,11,11,22,6342
6,6,2,3,13,14,27,6342
7,7,2,2,15,16,31,6342
8,8,4,1,19,17,36,6342
9,9,6,3,25,20,45,6342
10,10,6,4,31,24,55,6342
11,11,7,5,38,29,67,6342
12,12,6,1,44,30,74,6342
13,13,1,2,45,32,77,6342
14,14,3,1,48,33,81,6342
15,15,0,1,48,34,82,6342
16,16,2,0,50,34,84,6342
17,17,1,1,51,35,86,6342
18,18,2,1,53,36,89,6342
19,19,2,0,55,36,91,6342
20,20,0,0,55,36,91,6342
0,0,1,0,1,0,1,6343
1,1,0,0,1,0,1,6343
0,0,1,0,1,0,1,6344
1,1,0,0,1,0,1,6344
0,0,1,0,1,0,1,6345
1,1,0,0,1,0,1,6345
0,0,1,0,1,0,1,6346
1,1,1,0,2,0,2,6346
2,2,0,2,2,2,4,6346
3,3,1,1,3,3,6,6346
4,4,1,0,4,3,7,6346
5,5,0,0,4,3,7,6346
0,0,1,0,1,0,1,6347
1,1,2,1,3,1,4,6347
2,2,0,2,3,3,6,6347
3,3,0,1,3,4,7,6347
4,4,1,0,4,4,8,6347
5,5,1,0,5,4,9,6347
6,6,0,1,5,5,10,6347
7,7,0,2,5,7,12,6347
8,8,0,2,5,9,14,6347
9,9,0,1,5,10,15,6347
10,10,0,1,5,11,16,6347
11,11,0,2,5,13,18,6347
12,12,1,2,6,15,21,6347
13,13,0,2,6,17,23,6347
14,14,0,2,6,19,25,6347
15,15,1,3,7,22,29,6347
16,16,3,1,10,23,33,6347
17,17,0,1,10,24,34,6347
18,18,1,2,11,26,37,6347
19,19,0,0,11,26,37,6347
0,0,1,0,1,0,1,6348
1,1,1,0,2,0,2,6348
2,2,0,0,2,0,2,6348
0,0,1,0,1,0,1,6349
1,1,1,0,2,0,2,6349
2,2,1,0,3,0,3,6349
3,3,2,0,5,0,5,6349
4,4,0,1,5,1,6,6349
5,5,0,1,5,2,7,6349
6,6,2,1,7,3,10,6349
7,7,1,1,8,4,12,6349
8,8,0,1,8,5,13,6349
9,9,0,0,8,5,13,6349
0,0,1,0,1,0,1,6350
1,1,0,0,1,0,1,6350
0,0,1,0,1,0,1,6351
1,1,1,0,2,0,2,6351
2,2,1,0,3,0,3,6351
3,3,2,0,5,0,5,6351
4,4,2,1,7,1,8,6351
5,5,1,0,8,1,9,6351
6,6,2,0,10,1,11,6351
7,7,1,0,11,1,12,6351
8,8,2,0,13,1,14,6351
9,9,4,0,17,1,18,6351
10,10,3,0,20,1,21,6351
11,11,1,0,21,1,22,6351
12,12,1,0,22,1,23,6351
13,13,3,0,25,1,26,6351
14,14,1,1,26,2,28,6351
15,15,1,0,27,2,29,6351
16,16,1,1,28,3,31,6351
17,17,1,0,29,3,32,6351
18,18,0,0,29,3,32,6351
0,0,1,0,1,0,1,6352
1,1,0,0,1,0,1,6352
0,0,1,0,1,0,1,6353
1,1,1,0,2,0,2,6353
2,2,2,0,4,0,4,6353
3,3,2,0,6,0,6,6353
4,4,1,0,7,0,7,6353
5,5,2,0,9,0,9,6353
6,6,4,1,13,1,14,6353
7,7,3,1,16,2,18,6353
8,8,3,2,19,4,23,6353
9,9,3,1,22,5,27,6353
10,10,4,0,26,5,31,6353
11,11,0,1,26,6,32,6353
12,12,0,0,26,6,32,6353
0,0,1,0,1,0,1,6354
1,1,0,1,1,1,2,6354
2,2,0,1,1,2,3,6354
3,3,0,0,1,2,3,6354
0,0,1,0,1,0,1,6355
1,1,0,0,1,0,1,6355
0,0,1,0,1,0,1,6356
1,1,0,0,1,0,1,6356
0,0,1,0,1,0,1,6357
1,1,4,0,5,0,5,6357
2,2,3,5,8,5,13,6357
3,3,0,7,8,12,20,6357
4,4,2,6,10,18,28,6357
5,5,5,9,15,27,42,6357
6,6,6,6,21,33,54,6357
7,7,5,5,26,38,64,6357
8,8,4,6,30,44,74,6357
9,9,1,7,31,51,82,6357
10,10,0,5,31,56,87,6357
11,11,0,6,31,62,93,6357
12,12,1,4,32,66,98,6357
13,13,2,3,34,69,103,6357
14,14,1,3,35,72,107,6357
15,15,2,0,37,72,109,6357
16,16,1,0,38,72,110,6357
17,17,0,0,38,72,110,6357
0,0,1,0,1,0,1,6358
1,1,0,0,1,0,1,6358
0,0,1,0,1,0,1,6359
1,1,2,0,3,0,3,6359
2,2,2,2,5,2,7,6359
3,3,2,2,7,4,11,6359
4,4,1,3,8,7,15,6359
5,5,0,2,8,9,17,6359
6,6,0,1,8,10,18,6359
7,7,0,1,8,11,19,6359
8,8,0,0,8,11,19,6359
0,0,1,0,1,0,1,6360
1,1,0,0,1,0,1,6360
0,0,1,0,1,0,1,6361
1,1,0,0,1,0,1,6361
0,0,1,0,1,0,1,6362
1,1,0,0,1,0,1,6362
0,0,1,0,1,0,1,6363
1,1,1,0,2,0,2,6363
2,2,0,0,2,0,2,6363
0,0,1,0,1,0,1,6364
1,1,1,0,2,0,2,6364
2,2,0,0,2,0,2,6364
0,0,1,0,1,0,1,6365
1,1,1,0,2,0,2,6365
2,2,1,0,3,0,3,6365
3,3,1,1,4,1,5,6365
4,4,0,2,4,3,7,6365
5,5,1,2,5,5,10,6365
6,6,2,1,7,6,13,6365
7,7,3,3,10,9,19,6365
8,8,5,4,15,13,28,6365
9,9,7,2,22,15,37,6365
10,10,3,4,25,19,44,6365
11,11,4,3,29,22,51,6365
12,12,2,2,31,24,55,6365
13,13,0,2,31,26,57,6365
14,14,0,2,31,28,59,6365
15,15,2,1,33,29,62,6365
16,16,2,2,35,31,66,6365
17,17,0,3,35,34,69,6365
18,18,0,1,35,35,70,6365
19,19,0,1,35,36,71,6365
20,20,1,0,36,36,72,6365
21,21,1,0,37,36,73,6365
22,22,0,0,37,36,73,6365
0,0,1,0,1,0,1,6366
1,1,2,0,3,0,3,6366
2,2,3,0,6,0,6,6366
3,3,5,0,11,0,11,6366
4,4,2,0,13,0,13,6366
5,5,1,0,14,0,14,6366
6,6,0,0,14,0,14,6366
0,0,1,0,1,0,1,6367
1,1,0,0,1,0,1,6367
0,0,1,0,1,0,1,6368
1,1,0,0,1,0,1,6368
0,0,1,0,1,0,1,6369
1,1,0,0,1,0,1,6369
0,0,1,0,1,0,1,6370
1,1,1,0,2,0,2,6370
2,2,1,0,3,0,3,6370
3,3,0,0,3,0,3,6370
0,0,1,0,1,0,1,6371
1,1,1,0,2,0,2,6371
2,2,0,1,2,1,3,6371
3,3,0,3,2,4,6,6371
4,4,1,3,3,7,10,6371
5,5,1,1,4,8,12,6371
6,6,0,0,4,8,12,6371
0,0,1,0,1,0,1,6372
1,1,0,0,1,0,1,6372
0,0,1,0,1,0,1,6373
1,1,1,0,2,0,2,6373
2,2,1,0,3,0,3,6373
3,3,1,0,4,0,4,6373
4,4,2,0,6,0,6,6373
5,5,4,0,10,0,10,6373
6,6,2,0,12,0,12,6373
7,7,1,0,13,0,13,6373
8,8,0,0,13,0,13,6373
0,0,1,0,1,0,1,6374
1,1,0,0,1,0,1,6374
0,0,1,0,1,0,1,6375
1,1,1,0,2,0,2,6375
2,2,1,0,3,0,3,6375
3,3,0,0,3,0,3,6375
0,0,1,0,1,0,1,6376
1,1,1,0,2,0,2,6376
2,2,0,0,2,0,2,6376
0,0,1,0,1,0,1,6377
1,1,2,0,3,0,3,6377
2,2,2,1,5,1,6,6377
3,3,3,1,8,2,10,6377
4,4,1,1,9,3,12,6377
5,5,2,1,11,4,15,6377
6,6,1,1,12,5,17,6377
7,7,3,0,15,5,20,6377
8,8,4,0,19,5,24,6377
9,9,3,1,22,6,28,6377
10,10,1,1,23,7,30,6377
11,11,1,1,24,8,32,6377
12,12,2,0,26,8,34,6377
13,13,0,0,26,8,34,6377
0,0,1,0,1,0,1,6378
1,1,1,0,2,0,2,6378
2,2,0,0,2,0,2,6378
0,0,1,0,1,0,1,6379
1,1,0,0,1,0,1,6379
0,0,1,0,1,0,1,6380
1,1,0,0,1,0,1,6380
0,0,1,0,1,0,1,6381
1,1,0,0,1,0,1,6381
0,0,1,0,1,0,1,6382
1,1,0,1,1,1,2,6382
2,2,0,0,1,1,2,6382
0,0,1,0,1,0,1,6383
1,1,0,0,1,0,1,6383
0,0,1,0,1,0,1,6384
1,1,1,1,2,1,3,6384
2,2,0,1,2,2,4,6384
3,3,0,1,2,3,5,6384
4,4,2,0,4,3,7,6384
5,5,2,0,6,3,9,6384
6,6,3,0,9,3,12,6384
7,7,3,0,12,3,15,6384
8,8,0,1,12,4,16,6384
9,9,0,0,12,4,16,6384
0,0,1,0,1,0,1,6385
1,1,1,0,2,0,2,6385
2,2,1,1,3,1,4,6385
3,3,1,1,4,2,6,6385
4,4,0,1,4,3,7,6385
5,5,0,2,4,5,9,6385
6,6,0,1,4,6,10,6385
7,7,0,2,4,8,12,6385
8,8,0,1,4,9,13,6385
9,9,1,1,5,10,15,6385
10,10,1,1,6,11,17,6385
11,11,0,0,6,11,17,6385
0,0,1,0,1,0,1,6386
1,1,3,1,4,1,5,6386
2,2,2,2,6,3,9,6386
3,3,1,2,7,5,12,6386
4,4,0,0,7,5,12,6386
0,0,1,0,1,0,1,6387
1,1,0,0,1,0,1,6387
0,0,1,0,1,0,1,6388
1,1,1,0,2,0,2,6388
2,2,0,1,2,1,3,6388
3,3,0,0,2,1,3,6388
0,0,1,0,1,0,1,6389
1,1,0,0,1,0,1,6389
0,0,1,0,1,0,1,6390
1,1,2,0,3,0,3,6390
2,2,1,0,4,0,4,6390
3,3,1,0,5,0,5,6390
4,4,1,0,6,0,6,6390
5,5,0,2,6,2,8,6390
6,6,0,2,6,4,10,6390
7,7,0,2,6,6,12,6390
8,8,0,5,6,11,17,6390
9,9,1,5,7,16,23,6390
10,10,2,5,9,21,30,6390
11,11,1,4,10,25,35,6390
12,12,3,1,13,26,39,6390
13,13,4,0,17,26,43,6390
14,14,3,1,20,27,47,6390
15,15,2,3,22,30,52,6390
16,16,1,2,23,32,55,6390
17,17,1,1,24,33,57,6390
18,18,1,1,25,34,59,6390
19,19,1,0,26,34,60,6390
20,20,1,1,27,35,62,6390
21,21,1,1,28,36,64,6390
22,22,0,1,28,37,65,6390
23,23,0,3,28,40,68,6390
24,24,0,5,28,45,73,6390
25,25,2,6,30,51,81,6390
26,26,3,5,33,56,89,6390
27,27,0,5,33,61,94,6390
28,28,0,4,33,65,98,6390
29,29,0,1,33,66,99,6390
30,30,0,1,33,67,100,6390
31,31,0,1,33,68,101,6390
32,32,0,1,33,69,102,6390
33,33,0,0,33,69,102,6390
0,0,1,0,1,0,1,6391
1,1,0,0,1,0,1,6391
0,0,1,0,1,0,1,6392
1,1,1,0,2,0,2,6392
2,2,0,0,2,0,2,6392
0,0,1,0,1,0,1,6393
1,1,0,1,1,1,2,6393
2,2,0,0,1,1,2,6393
0,0,1,0,1,0,1,6394
1,1,0,0,1,0,1,6394
0,0,1,0,1,0,1,6395
1,1,0,0,1,0,1,6395
0,0,1,0,1,0,1,6396
1,1,1,0,2,0,2,6396
2,2,0,0,2,0,2,6396
0,0,1,0,1,0,1,6397
1,1,0,0,1,0,1,6397
0,0,1,0,1,0,1,6398
1,1,0,0,1,0,1,6398
0,0,1,0,1,0,1,6399
1,1,2,0,3,0,3,6399
2,2,1,0,4,0,4,6399
3,3,0,1,4,1,5,6399
4,4,0,0,4,1,5,6399
0,0,1,0,1,0,1,6400
1,1,0,0,1,0,1,6400
0,0,1,0,1,0,1,6401
1,1,0,0,1,0,1,6401
0,0,1,0,1,0,1,6402
1,1,1,0,2,0,2,6402
2,2,1,0,3,0,3,6402
3,3,0,0,3,0,3,6402
0,0,1,0,1,0,1,6403
1,1,2,0,3,0,3,6403
2,2,0,0,3,0,3,6403
0,0,1,0,1,0,1,6404
1,1,0,0,1,0,1,6404
0,0,1,0,1,0,1,6405
1,1,0,0,1,0,1,6405
0,0,1,0,1,0,1,6406
1,1,2,0,3,0,3,6406
2,2,2,3,5,3,8,6406
3,3,2,0,7,3,10,6406
4,4,1,1,8,4,12,6406
5,5,1,0,9,4,13,6406
6,6,0,0,9,4,13,6406
0,0,1,0,1,0,1,6407
1,1,0,0,1,0,1,6407
0,0,1,0,1,0,1,6408
1,1,0,0,1,0,1,6408
0,0,1,0,1,0,1,6409
1,1,1,0,2,0,2,6409
2,2,1,0,3,0,3,6409
3,3,0,0,3,0,3,6409
0,0,1,0,1,0,1,6410
1,1,3,0,4,0,4,6410
2,2,4,0,8,0,8,6410
3,3,4,0,12,0,12,6410
4,4,2,0,14,0,14,6410
5,5,0,0,14,0,14,6410
0,0,1,0,1,0,1,6411
1,1,2,0,3,0,3,6411
2,2,2,0,5,0,5,6411
3,3,0,2,5,2,7,6411
4,4,0,2,5,4,9,6411
5,5,1,2,6,6,12,6411
6,6,2,2,8,8,16,6411
7,7,4,4,12,12,24,6411
8,8,4,8,16,20,36,6411
9,9,6,11,22,31,53,6411
10,10,4,12,26,43,69,6411
11,11,3,7,29,50,79,6411
12,12,5,5,34,55,89,6411
13,13,5,3,39,58,97,6411
14,14,0,1,39,59,98,6411
15,15,0,1,39,60,99,6411
16,16,0,0,39,60,99,6411
0,0,1,0,1,0,1,6412
1,1,1,1,2,1,3,6412
2,2,1,1,3,2,5,6412
3,3,1,0,4,2,6,6412
4,4,2,0,6,2,8,6412
5,5,2,1,8,3,11,6412
6,6,1,0,9,3,12,6412
7,7,1,0,10,3,13,6412
8,8,1,0,11,3,14,6412
9,9,0,0,11,3,14,6412
0,0,1,0,1,0,1,6413
1,1,1,1,2,1,3,6413
2,2,1,0,3,1,4,6413
3,3,0,1,3,2,5,6413
4,4,0,0,3,2,5,6413
0,0,1,0,1,0,1,6414
1,1,1,1,2,1,3,6414
2,2,0,1,2,2,4,6414
3,3,0,0,2,2,4,6414
0,0,1,0,1,0,1,6415
1,1,3,0,4,0,4,6415
2,2,2,1,6,1,7,6415
3,3,6,3,12,4,16,6415
4,4,3,9,15,13,28,6415
5,5,4,12,19,25,44,6415
6,6,5,10,24,35,59,6415
7,7,4,12,28,47,75,6415
8,8,8,8,36,55,91,6415
9,9,6,9,42,64,106,6415
10,10,5,7,47,71,118,6415
11,11,4,8,51,79,130,6415
12,12,4,8,55,87,142,6415
13,13,2,5,57,92,149,6415
14,14,0,5,57,97,154,6415
15,15,1,3,58,100,158,6415
16,16,0,4,58,104,162,6415
17,17,0,2,58,106,164,6415
18,18,0,0,58,106,164,6415
0,0,1,0,1,0,1,6416
1,1,0,0,1,0,1,6416
0,0,1,0,1,0,1,6417
1,1,0,0,1,0,1,6417
0,0,1,0,1,0,1,6418
1,1,0,0,1,0,1,6418
0,0,1,0,1,0,1,6419
1,1,1,0,2,0,2,6419
2,2,0,0,2,0,2,6419
0,0,1,0,1,0,1,6420
1,1,0,1,1,1,2,6420
2,2,0,1,1,2,3,6420
3,3,0,0,1,2,3,6420
0,0,1,0,1,0,1,6421
1,1,1,0,2,0,2,6421
2,2,0,0,2,0,2,6421
0,0,1,0,1,0,1,6422
1,1,0,0,1,0,1,6422
0,0,1,0,1,0,1,6423
1,1,0,0,1,0,1,6423
0,0,1,0,1,0,1,6424
1,1,1,0,2,0,2,6424
2,2,0,2,2,2,4,6424
3,3,0,0,2,2,4,6424
0,0,1,0,1,0,1,6425
1,1,1,0,2,0,2,6425
2,2,0,0,2,0,2,6425
0,0,1,0,1,0,1,6426
1,1,2,0,3,0,3,6426
2,2,1,1,4,1,5,6426
3,3,1,1,5,2,7,6426
4,4,0,0,5,2,7,6426
0,0,1,0,1,0,1,6427
1,1,0,0,1,0,1,6427
0,0,1,0,1,0,1,6428
1,1,1,0,2,0,2,6428
2,2,1,0,3,0,3,6428
3,3,0,0,3,0,3,6428
0,0,1,0,1,0,1,6429
1,1,0,0,1,0,1,6429
0,0,1,0,1,0,1,6430
1,1,1,0,2,0,2,6430
2,2,0,0,2,0,2,6430
0,0,1,0,1,0,1,6431
1,1,0,0,1,0,1,6431
0,0,1,0,1,0,1,6432
1,1,0,0,1,0,1,6432
0,0,1,0,1,0,1,6433
1,1,2,0,3,0,3,6433
2,2,4,0,7,0,7,6433
3,3,4,0,11,0,11,6433
4,4,3,0,14,0,14,6433
5,5,3,0,17,0,17,6433
6,6,2,0,19,0,19,6433
7,7,1,0,20,0,20,6433
8,8,2,0,22,0,22,6433
9,9,1,0,23,0,23,6433
10,10,0,0,23,0,23,6433
0,0,1,0,1,0,1,6434
1,1,0,0,1,0,1,6434
0,0,1,0,1,0,1,6435
1,1,0,1,1,1,2,6435
2,2,2,2,3,3,6,6435
3,3,3,2,6,5,11,6435
4,4,2,1,8,6,14,6435
5,5,1,2,9,8,17,6435
6,6,0,0,9,8,17,6435
0,0,1,0,1,0,1,6436
1,1,1,0,2,0,2,6436
2,2,0,0,2,0,2,6436
0,0,1,0,1,0,1,6437
1,1,0,0,1,0,1,6437
0,0,1,0,1,0,1,6438
1,1,1,0,2,0,2,6438
2,2,0,1,2,1,3,6438
3,3,1,0,3,1,4,6438
4,4,0,0,3,1,4,6438
0,0,1,0,1,0,1,6439
1,1,0,1,1,1,2,6439
2,2,0,3,1,4,5,6439
3,3,0,2,1,6,7,6439
4,4,0,3,1,9,10,6439
5,5,0,2,1,11,12,6439
6,6,0,0,1,11,12,6439
0,0,1,0,1,0,1,6440
1,1,0,0,1,0,1,6440
0,0,1,0,1,0,1,6441
1,1,0,1,1,1,2,6441
2,2,0,1,1,2,3,6441
3,3,0,1,1,3,4,6441
4,4,0,0,1,3,4,6441
0,0,1,0,1,0,1,6442
1,1,1,0,2,0,2,6442
2,2,1,0,3,0,3,6442
3,3,3,0,6,0,6,6442
4,4,1,0,7,0,7,6442
5,5,0,0,7,0,7,6442
0,0,1,0,1,0,1,6443
1,1,1,0,2,0,2,6443
2,2,3,1,5,1,6,6443
3,3,1,2,6,3,9,6443
4,4,2,1,8,4,12,6443
5,5,2,2,10,6,16,6443
6,6,2,0,12,6,18,6443
7,7,3,0,15,6,21,6443
8,8,0,0,15,6,21,6443
0,0,1,0,1,0,1,6444
1,1,1,0,2,0,2,6444
2,2,2,0,4,0,4,6444
3,3,0,0,4,0,4,6444
0,0,1,0,1,0,1,6445
1,1,0,0,1,0,1,6445
0,0,1,0,1,0,1,6446
1,1,1,0,2,0,2,6446
2,2,1,1,3,1,4,6446
3,3,1,1,4,2,6,6446
4,4,1,2,5,4,9,6446
5,5,0,0,5,4,9,6446
0,0,1,0,1,0,1,6447
1,1,0,1,1,1,2,6447
2,2,0,0,1,1,2,6447
0,0,1,0,1,0,1,6448
1,1,1,0,2,0,2,6448
2,2,0,2,2,2,4,6448
3,3,0,1,2,3,5,6448
4,4,0,1,2,4,6,6448
5,5,0,0,2,4,6,6448
0,0,1,0,1,0,1,6449
1,1,0,0,1,0,1,6449
0,0,1,0,1,0,1,6450
1,1,2,0,3,0,3,6450
2,2,0,0,3,0,3,6450
0,0,1,0,1,0,1,6451
1,1,0,0,1,0,1,6451
0,0,1,0,1,0,1,6452
1,1,1,1,2,1,3,6452
2,2,0,2,2,3,5,6452
3,3,0,3,2,6,8,6452
4,4,0,6,2,12,14,6452
5,5,2,4,4,16,20,6452
6,6,2,5,6,21,27,6452
7,7,0,4,6,25,31,6452
8,8,1,1,7,26,33,6452
9,9,1,0,8,26,34,6452
10,10,0,1,8,27,35,6452
11,11,0,0,8,27,35,6452
0,0,1,0,1,0,1,6453
1,1,1,1,2,1,3,6453
2,2,0,3,2,4,6,6453
3,3,1,3,3,7,10,6453
4,4,1,3,4,10,14,6453
5,5,3,1,7,11,18,6453
6,6,0,1,7,12,19,6453
7,7,0,0,7,12,19,6453
0,0,1,0,1,0,1,6454
1,1,1,0,2,0,2,6454
2,2,0,0,2,0,2,6454
0,0,1,0,1,0,1,6455
1,1,0,0,1,0,1,6455
0,0,1,0,1,0,1,6456
1,1,0,1,1,1,2,6456
2,2,0,0,1,1,2,6456
0,0,1,0,1,0,1,6457
1,1,2,0,3,0,3,6457
2,2,0,0,3,0,3,6457
0,0,1,0,1,0,1,6458
1,1,1,0,2,0,2,6458
2,2,0,0,2,0,2,6458
0,0,1,0,1,0,1,6459
1,1,0,0,1,0,1,6459
0,0,1,0,1,0,1,6460
1,1,1,0,2,0,2,6460
2,2,2,0,4,0,4,6460
3,3,4,1,8,1,9,6460
4,4,1,2,9,3,12,6460
5,5,1,2,10,5,15,6460
6,6,1,1,11,6,17,6460
7,7,1,0,12,6,18,6460
8,8,2,1,14,7,21,6460
9,9,0,1,14,8,22,6460
10,10,0,1,14,9,23,6460
11,11,0,0,14,9,23,6460
0,0,1,0,1,0,1,6461
1,1,2,0,3,0,3,6461
2,2,3,0,6,0,6,6461
3,3,4,0,10,0,10,6461
4,4,4,0,14,0,14,6461
5,5,2,0,16,0,16,6461
6,6,2,0,18,0,18,6461
7,7,2,1,20,1,21,6461
8,8,3,1,23,2,25,6461
9,9,5,1,28,3,31,6461
10,10,1,2,29,5,34,6461
11,11,4,0,33,5,38,6461
12,12,4,0,37,5,42,6461
13,13,2,0,39,5,44,6461
14,14,1,0,40,5,45,6461
15,15,0,0,40,5,45,6461
0,0,1,0,1,0,1,6462
1,1,1,0,2,0,2,6462
2,2,0,0,2,0,2,6462
0,0,1,0,1,0,1,6463
1,1,0,0,1,0,1,6463
0,0,1,0,1,0,1,6464
1,1,1,1,2,1,3,6464
2,2,0,1,2,2,4,6464
3,3,0,2,2,4,6,6464
4,4,0,4,2,8,10,6464
5,5,2,2,4,10,14,6464
6,6,0,3,4,13,17,6464
7,7,0,3,4,16,20,6464
8,8,0,1,4,17,21,6464
9,9,0,2,4,19,23,6464
10,10,0,1,4,20,24,6464
11,11,0,1,4,21,25,6464
12,12,0,0,4,21,25,6464
0,0,1,0,1,0,1,6465
1,1,0,0,1,0,1,6465
0,0,1,0,1,0,1,6466
1,1,0,0,1,0,1,6466
0,0,1,0,1,0,1,6467
1,1,0,1,1,1,2,6467
2,2,0,0,1,1,2,6467
0,0,1,0,1,0,1,6468
1,1,0,0,1,0,1,6468
0,0,1,0,1,0,1,6469
1,1,1,0,2,0,2,6469
2,2,1,0,3,0,3,6469
3,3,1,0,4,0,4,6469
4,4,1,0,5,0,5,6469
5,5,0,0,5,0,5,6469
0,0,1,0,1,0,1,6470
1,1,0,0,1,0,1,6470
0,0,1,0,1,0,1,6471
1,1,1,0,2,0,2,6471
2,2,1,0,3,0,3,6471
3,3,3,0,6,0,6,6471
4,4,0,0,6,0,6,6471
0,0,1,0,1,0,1,6472
1,1,0,0,1,0,1,6472
0,0,1,0,1,0,1,6473
1,1,1,0,2,0,2,6473
2,2,0,0,2,0,2,6473
0,0,1,0,1,0,1,6474
1,1,0,0,1,0,1,6474
0,0,1,0,1,0,1,6475
1,1,1,0,2,0,2,6475
2,2,2,0,4,0,4,6475
3,3,3,0,7,0,7,6475
4,4,3,0,10,0,10,6475
5,5,4,0,14,0,14,6475
6,6,2,0,16,0,16,6475
7,7,2,1,18,1,19,6475
8,8,2,0,20,1,21,6475
9,9,0,1,20,2,22,6475
10,10,0,0,20,2,22,6475
0,0,1,0,1,0,1,6476
1,1,0,0,1,0,1,6476
0,0,1,0,1,0,1,6477
1,1,0,1,1,1,2,6477
2,2,0,0,1,1,2,6477
0,0,1,0,1,0,1,6478
1,1,0,0,1,0,1,6478
0,0,1,0,1,0,1,6479
1,1,0,0,1,0,1,6479
0,0,1,0,1,0,1,6480
1,1,1,0,2,0,2,6480
2,2,1,0,3,0,3,6480
3,3,0,1,3,1,4,6480
4,4,0,0,3,1,4,6480
0,0,1,0,1,0,1,6481
1,1,0,0,1,0,1,6481
0,0,1,0,1,0,1,6482
1,1,3,0,4,0,4,6482
2,2,2,1,6,1,7,6482
3,3,1,2,7,3,10,6482
4,4,3,3,10,6,16,6482
5,5,0,1,10,7,17,6482
6,6,0,1,10,8,18,6482
7,7,0,0,10,8,18,6482
0,0,1,0,1,0,1,6483
1,1,0,1,1,1,2,6483
2,2,0,0,1,1,2,6483
0,0,1,0,1,0,1,6484
1,1,1,2,2,2,4,6484
2,2,1,2,3,4,7,6484
3,3,0,1,3,5,8,6484
4,4,0,1,3,6,9,6484
5,5,0,0,3,6,9,6484
0,0,1,0,1,0,1,6485
1,1,2,0,3,0,3,6485
2,2,2,1,5,1,6,6485
3,3,0,1,5,2,7,6485
4,4,0,0,5,2,7,6485
0,0,1,0,1,0,1,6486
1,1,3,1,4,1,5,6486
2,2,0,3,4,4,8,6486
3,3,1,1,5,5,10,6486
4,4,1,0,6,5,11,6486
5,5,1,1,7,6,13,6486
6,6,2,2,9,8,17,6486
7,7,0,1,9,9,18,6486
8,8,1,0,10,9,19,6486
9,9,0,0,10,9,19,6486
0,0,1,0,1,0,1,6487
1,1,0,0,1,0,1,6487
0,0,1,0,1,0,1,6488
1,1,1,0,2,0,2,6488
2,2,1,0,3,0,3,6488
3,3,1,1,4,1,5,6488
4,4,1,0,5,1,6,6488
5,5,1,0,6,1,7,6488
6,6,0,1,6,2,8,6488
7,7,0,0,6,2,8,6488
0,0,1,0,1,0,1,6489
1,1,2,0,3,0,3,6489
2,2,1,3,4,3,7,6489
3,3,1,6,5,9,14,6489
4,4,1,4,6,13,19,6489
5,5,1,3,7,16,23,6489
6,6,1,2,8,18,26,6489
7,7,1,1,9,19,28,6489
8,8,0,1,9,20,29,6489
9,9,0,0,9,20,29,6489
0,0,1,0,1,0,1,6490
1,1,0,0,1,0,1,6490
0,0,1,0,1,0,1,6491
1,1,2,0,3,0,3,6491
2,2,2,1,5,1,6,6491
3,3,2,3,7,4,11,6491
4,4,2,4,9,8,17,6491
5,5,4,1,13,9,22,6491
6,6,2,1,15,10,25,6491
7,7,1,1,16,11,27,6491
8,8,1,1,17,12,29,6491
9,9,2,3,19,15,34,6491
10,10,1,3,20,18,38,6491
11,11,1,4,21,22,43,6491
12,12,0,2,21,24,45,6491
13,13,0,2,21,26,47,6491
14,14,0,4,21,30,51,6491
15,15,0,3,21,33,54,6491
16,16,0,2,21,35,56,6491
17,17,0,1,21,36,57,6491
18,18,0,1,21,37,58,6491
19,19,0,1,21,38,59,6491
20,20,0,0,21,38,59,6491
0,0,1,0,1,0,1,6492
1,1,0,0,1,0,1,6492
0,0,1,0,1,0,1,6493
1,1,1,0,2,0,2,6493
2,2,0,0,2,0,2,6493
0,0,1,0,1,0,1,6494
1,1,2,0,3,0,3,6494
2,2,1,0,4,0,4,6494
3,3,1,0,5,0,5,6494
4,4,1,0,6,0,6,6494
5,5,1,0,7,0,7,6494
6,6,0,0,7,0,7,6494
0,0,1,0,1,0,1,6495
1,1,0,1,1,1,2,6495
2,2,0,1,1,2,3,6495
3,3,0,0,1,2,3,6495
0,0,1,0,1,0,1,6496
1,1,1,0,2,0,2,6496
2,2,2,0,4,0,4,6496
3,3,3,0,7,0,7,6496
4,4,2,2,9,2,11,6496
5,5,1,0,10,2,12,6496
6,6,3,0,13,2,15,6496
7,7,1,0,14,2,16,6496
8,8,0,0,14,2,16,6496
0,0,1,0,1,0,1,6497
1,1,0,0,1,0,1,6497
0,0,1,0,1,0,1,6498
1,1,1,0,2,0,2,6498
2,2,1,0,3,0,3,6498
3,3,0,0,3,0,3,6498
0,0,1,0,1,0,1,6499
1,1,2,0,3,0,3,6499
2,2,1,0,4,0,4,6499
3,3,0,0,4,0,4,6499
0,0,1,0,1,0,1,6500
1,1,1,0,2,0,2,6500
2,2,1,0,3,0,3,6500
3,3,0,0,3,0,3,6500
0,0,1,0,1,0,1,6501
1,1,1,0,2,0,2,6501
2,2,0,1,2,1,3,6501
3,3,0,0,2,1,3,6501
0,0,1,0,1,0,1,6502
1,1,1,0,2,0,2,6502
2,2,0,0,2,0,2,6502
0,0,1,0,1,0,1,6503
1,1,1,0,2,0,2,6503
2,2,0,0,2,0,2,6503
0,0,1,0,1,0,1,6504
1,1,0,0,1,0,1,6504
0,0,1,0,1,0,1,6505
1,1,0,0,1,0,1,6505
0,0,1,0,1,0,1,6506
1,1,0,0,1,0,1,6506
0,0,1,0,1,0,1,6507
1,1,1,0,2,0,2,6507
2,2,1,0,3,0,3,6507
3,3,0,0,3,0,3,6507
0,0,1,0,1,0,1,6508
1,1,2,1,3,1,4,6508
2,2,2,1,5,2,7,6508
3,3,2,2,7,4,11,6508
4,4,1,2,8,6,14,6508
5,5,2,6,10,12,22,6508
6,6,1,10,11,22,33,6508
7,7,6,4,17,26,43,6508
8,8,2,0,19,26,45,6508
9,9,1,0,20,26,46,6508
10,10,1,0,21,26,47,6508
11,11,1,0,22,26,48,6508
12,12,1,0,23,26,49,6508
13,13,1,0,24,26,50,6508
14,14,0,1,24,27,51,6508
15,15,1,2,25,29,54,6508
16,16,0,0,25,29,54,6508
0,0,1,0,1,0,1,6509
1,1,1,0,2,0,2,6509
2,2,2,0,4,0,4,6509
3,3,1,0,5,0,5,6509
4,4,1,0,6,0,6,6509
5,5,2,0,8,0,8,6509
6,6,2,0,10,0,10,6509
7,7,0,0,10,0,10,6509
0,0,1,0,1,0,1,6510
1,1,1,1,2,1,3,6510
2,2,1,3,3,4,7,6510
3,3,2,2,5,6,11,6510
4,4,2,2,7,8,15,6510
5,5,3,2,10,10,20,6510
6,6,1,5,11,15,26,6510
7,7,4,8,15,23,38,6510
8,8,6,3,21,26,47,6510
9,9,4,4,25,30,55,6510
10,10,1,3,26,33,59,6510
11,11,1,1,27,34,61,6510
12,12,1,0,28,34,62,6510
13,13,0,1,28,35,63,6510
14,14,0,0,28,35,63,6510
0,0,1,0,1,0,1,6511
1,1,1,0,2,0,2,6511
2,2,0,1,2,1,3,6511
3,3,0,0,2,1,3,6511
0,0,1,0,1,0,1,6512
1,1,1,0,2,0,2,6512
2,2,1,0,3,0,3,6512
3,3,0,0,3,0,3,6512
0,0,1,0,1,0,1,6513
1,1,1,0,2,0,2,6513
2,2,0,0,2,0,2,6513
0,0,1,0,1,0,1,6514
1,1,1,2,2,2,4,6514
2,2,2,1,4,3,7,6514
3,3,2,2,6,5,11,6514
4,4,1,2,7,7,14,6514
5,5,1,1,8,8,16,6514
6,6,2,2,10,10,20,6514
7,7,2,2,12,12,24,6514
8,8,1,4,13,16,29,6514
9,9,1,4,14,20,34,6514
10,10,3,3,17,23,40,6514
11,11,2,2,19,25,44,6514
12,12,0,0,19,25,44,6514
0,0,1,0,1,0,1,6515
1,1,0,0,1,0,1,6515
0,0,1,0,1,0,1,6516
1,1,2,0,3,0,3,6516
2,2,1,0,4,0,4,6516
3,3,0,1,4,1,5,6516
4,4,0,0,4,1,5,6516
0,0,1,0,1,0,1,6517
1,1,0,1,1,1,2,6517
2,2,0,0,1,1,2,6517
0,0,1,0,1,0,1,6518
1,1,1,0,2,0,2,6518
2,2,0,0,2,0,2,6518
0,0,1,0,1,0,1,6519
1,1,1,0,2,0,2,6519
2,2,2,0,4,0,4,6519
3,3,1,1,5,1,6,6519
4,4,1,2,6,3,9,6519
5,5,0,1,6,4,10,6519
6,6,2,0,8,4,12,6519
7,7,1,1,9,5,14,6519
8,8,1,1,10,6,16,6519
9,9,1,0,11,6,17,6519
10,10,1,0,12,6,18,6519
11,11,1,0,13,6,19,6519
12,12,1,0,14,6,20,6519
13,13,1,0,15,6,21,6519
14,14,0,0,15,6,21,6519
0,0,1,0,1,0,1,6520
1,1,1,0,2,0,2,6520
2,2,1,1,3,1,4,6520
3,3,0,0,3,1,4,6520
0,0,1,0,1,0,1,6521
1,1,1,0,2,0,2,6521
2,2,1,0,3,0,3,6521
3,3,1,0,4,0,4,6521
4,4,1,0,5,0,5,6521
5,5,0,0,5,0,5,6521
0,0,1,0,1,0,1,6522
1,1,1,0,2,0,2,6522
2,2,0,0,2,0,2,6522
0,0,1,0,1,0,1,6523
1,1,0,1,1,1,2,6523
2,2,0,1,1,2,3,6523
3,3,0,1,1,3,4,6523
4,4,0,1,1,4,5,6523
5,5,1,0,2,4,6,6523
6,6,0,0,2,4,6,6523
0,0,1,0,1,0,1,6524
1,1,0,0,1,0,1,6524
0,0,1,0,1,0,1,6525
1,1,1,0,2,0,2,6525
2,2,1,0,3,0,3,6525
3,3,0,0,3,0,3,6525
0,0,1,0,1,0,1,6526
1,1,0,0,1,0,1,6526
0,0,1,0,1,0,1,6527
1,1,1,1,2,1,3,6527
2,2,1,2,3,3,6,6527
3,3,3,0,6,3,9,6527
4,4,1,0,7,3,10,6527
5,5,0,0,7,3,10,6527
0,0,1,0,1,0,1,6528
1,1,1,1,2,1,3,6528
2,2,1,1,3,2,5,6528
3,3,2,0,5,2,7,6528
4,4,4,0,9,2,11,6528
5,5,1,0,10,2,12,6528
6,6,0,0,10,2,12,6528
0,0,1,0,1,0,1,6529
1,1,1,0,2,0,2,6529
2,2,2,0,4,0,4,6529
3,3,1,0,5,0,5,6529
4,4,1,0,6,0,6,6529
5,5,1,0,7,0,7,6529
6,6,2,0,9,0,9,6529
7,7,0,0,9,0,9,6529
0,0,1,0,1,0,1,6530
1,1,1,0,2,0,2,6530
2,2,1,0,3,0,3,6530
3,3,1,0,4,0,4,6530
4,4,2,0,6,0,6,6530
5,5,1,0,7,0,7,6530
6,6,0,0,7,0,7,6530
0,0,1,0,1,0,1,6531
1,1,1,0,2,0,2,6531
2,2,0,0,2,0,2,6531
0,0,1,0,1,0,1,6532
1,1,1,0,2,0,2,6532
2,2,0,0,2,0,2,6532
0,0,1,0,1,0,1,6533
1,1,1,0,2,0,2,6533
2,2,0,0,2,0,2,6533
0,0,1,0,1,0,1,6534
1,1,0,0,1,0,1,6534
0,0,1,0,1,0,1,6535
1,1,0,0,1,0,1,6535
0,0,1,0,1,0,1,6536
1,1,1,0,2,0,2,6536
2,2,0,1,2,1,3,6536
3,3,0,0,2,1,3,6536
0,0,1,0,1,0,1,6537
1,1,0,1,1,1,2,6537
2,2,0,0,1,1,2,6537
0,0,1,0,1,0,1,6538
1,1,3,0,4,0,4,6538
2,2,3,0,7,0,7,6538
3,3,2,0,9,0,9,6538
4,4,2,0,11,0,11,6538
5,5,1,1,12,1,13,6538
6,6,0,2,12,3,15,6538
7,7,0,1,12,4,16,6538
8,8,0,1,12,5,17,6538
9,9,0,1,12,6,18,6538
10,10,0,0,12,6,18,6538
0,0,1,0,1,0,1,6539
1,1,0,0,1,0,1,6539
0,0,1,0,1,0,1,6540
1,1,3,0,4,0,4,6540
2,2,3,0,7,0,7,6540
3,3,3,0,10,0,10,6540
4,4,1,0,11,0,11,6540
5,5,0,0,11,0,11,6540
0,0,1,0,1,0,1,6541
1,1,1,0,2,0,2,6541
2,2,0,1,2,1,3,6541
3,3,0,0,2,1,3,6541
0,0,1,0,1,0,1,6542
1,1,1,0,2,0,2,6542
2,2,0,1,2,1,3,6542
3,3,0,2,2,3,5,6542
4,4,0,1,2,4,6,6542
5,5,0,0,2,4,6,6542
0,0,1,0,1,0,1,6543
1,1,1,1,2,1,3,6543
2,2,1,2,3,3,6,6543
3,3,1,2,4,5,9,6543
4,4,1,3,5,8,13,6543
5,5,1,3,6,11,17,6543
6,6,1,1,7,12,19,6543
7,7,0,1,7,13,20,6543
8,8,0,0,7,13,20,6543
0,0,1,0,1,0,1,6544
1,1,2,0,3,0,3,6544
2,2,1,1,4,1,5,6544
3,3,0,0,4,1,5,6544
0,0,1,0,1,0,1,6545
1,1,1,0,2,0,2,6545
2,2,0,0,2,0,2,6545
0,0,1,0,1,0,1,6546
1,1,0,0,1,0,1,6546
0,0,1,0,1,0,1,6547
1,1,0,0,1,0,1,6547
0,0,1,0,1,0,1,6548
1,1,0,0,1,0,1,6548
0,0,1,0,1,0,1,6549
1,1,1,0,2,0,2,6549
2,2,1,0,3,0,3,6549
3,3,2,0,5,0,5,6549
4,4,2,1,7,1,8,6549
5,5,0,1,7,2,9,6549
6,6,0,0,7,2,9,6549
0,0,1,0,1,0,1,6550
1,1,0,0,1,0,1,6550
0,0,1,0,1,0,1,6551
1,1,1,1,2,1,3,6551
2,2,2,1,4,2,6,6551
3,3,4,1,8,3,11,6551
4,4,1,0,9,3,12,6551
5,5,1,0,10,3,13,6551
6,6,1,1,11,4,15,6551
7,7,0,0,11,4,15,6551
0,0,1,0,1,0,1,6552
1,1,1,0,2,0,2,6552
2,2,0,0,2,0,2,6552
0,0,1,0,1,0,1,6553
1,1,0,0,1,0,1,6553
0,0,1,0,1,0,1,6554
1,1,0,1,1,1,2,6554
2,2,0,0,1,1,2,6554
0,0,1,0,1,0,1,6555
1,1,1,1,2,1,3,6555
2,2,1,1,3,2,5,6555
3,3,0,3,3,5,8,6555
4,4,0,2,3,7,10,6555
5,5,1,2,4,9,13,6555
6,6,1,1,5,10,15,6555
7,7,1,3,6,13,19,6555
8,8,3,2,9,15,24,6555
9,9,5,3,14,18,32,6555
10,10,5,11,19,29,48,6555
11,11,4,9,23,38,61,6555
12,12,4,8,27,46,73,6555
13,13,8,7,35,53,88,6555
14,14,9,3,44,56,100,6555
15,15,5,1,49,57,106,6555
16,16,7,1,56,58,114,6555
17,17,2,1,58,59,117,6555
18,18,2,3,60,62,122,6555
19,19,3,1,63,63,126,6555
20,20,2,0,65,63,128,6555
21,21,0,0,65,63,128,6555
0,0,1,0,1,0,1,6556
1,1,0,0,1,0,1,6556
0,0,1,0,1,0,1,6557
1,1,0,0,1,0,1,6557
0,0,1,0,1,0,1,6558
1,1,0,1,1,1,2,6558
2,2,0,0,1,1,2,6558
0,0,1,0,1,0,1,6559
1,1,1,0,2,0,2,6559
2,2,0,0,2,0,2,6559
0,0,1,0,1,0,1,6560
1,1,1,0,2,0,2,6560
2,2,0,0,2,0,2,6560
0,0,1,0,1,0,1,6561
1,1,0,0,1,0,1,6561
0,0,1,0,1,0,1,6562
1,1,0,0,1,0,1,6562
0,0,1,0,1,0,1,6563
1,1,1,0,2,0,2,6563
2,2,0,0,2,0,2,6563
0,0,1,0,1,0,1,6564
1,1,0,0,1,0,1,6564
0,0,1,0,1,0,1,6565
1,1,0,1,1,1,2,6565
2,2,0,1,1,2,3,6565
3,3,0,0,1,2,3,6565
0,0,1,0,1,0,1,6566
1,1,0,0,1,0,1,6566
0,0,1,0,1,0,1,6567
1,1,0,1,1,1,2,6567
2,2,1,1,2,2,4,6567
3,3,0,0,2,2,4,6567
0,0,1,0,1,0,1,6568
1,1,3,0,4,0,4,6568
2,2,1,2,5,2,7,6568
3,3,1,2,6,4,10,6568
4,4,0,0,6,4,10,6568
0,0,1,0,1,0,1,6569
1,1,0,0,1,0,1,6569
0,0,1,0,1,0,1,6570
1,1,1,0,2,0,2,6570
2,2,0,0,2,0,2,6570
0,0,1,0,1,0,1,6571
1,1,1,0,2,0,2,6571
2,2,2,0,4,0,4,6571
3,3,0,0,4,0,4,6571
0,0,1,0,1,0,1,6572
1,1,0,0,1,0,1,6572
0,0,1,0,1,0,1,6573
1,1,2,1,3,1,4,6573
2,2,3,0,6,1,7,6573
3,3,2,0,8,1,9,6573
4,4,1,0,9,1,10,6573
5,5,0,0,9,1,10,6573
0,0,1,0,1,0,1,6574
1,1,1,1,2,1,3,6574
2,2,2,1,4,2,6,6574
3,3,1,1,5,3,8,6574
4,4,3,2,8,5,13,6574
5,5,2,2,10,7,17,6574
6,6,0,3,10,10,20,6574
7,7,0,2,10,12,22,6574
8,8,1,2,11,14,25,6574
9,9,0,4,11,18,29,6574
10,10,0,4,11,22,33,6574
11,11,0,1,11,23,34,6574
12,12,0,1,11,24,35,6574
13,13,0,0,11,24,35,6574
0,0,1,0,1,0,1,6575
1,1,2,0,3,0,3,6575
2,2,1,0,4,0,4,6575
3,3,1,0,5,0,5,6575
4,4,1,0,6,0,6,6575
5,5,2,0,8,0,8,6575
6,6,2,0,10,0,10,6575
7,7,2,0,12,0,12,6575
8,8,1,1,13,1,14,6575
9,9,0,1,13,2,15,6575
10,10,0,0,13,2,15,6575
0,0,1,0,1,0,1,6576
1,1,0,1,1,1,2,6576
2,2,0,2,1,3,4,6576
3,3,1,0,2,3,5,6576
4,4,0,0,2,3,5,6576
0,0,1,0,1,0,1,6577
1,1,1,0,2,0,2,6577
2,2,1,0,3,0,3,6577
3,3,1,1,4,1,5,6577
4,4,0,0,4,1,5,6577
0,0,1,0,1,0,1,6578
1,1,1,0,2,0,2,6578
2,2,0,0,2,0,2,6578
0,0,1,0,1,0,1,6579
1,1,1,1,2,1,3,6579
2,2,1,0,3,1,4,6579
3,3,1,0,4,1,5,6579
4,4,0,0,4,1,5,6579
0,0,1,0,1,0,1,6580
1,1,0,1,1,1,2,6580
2,2,0,0,1,1,2,6580
0,0,1,0,1,0,1,6581
1,1,2,0,3,0,3,6581
2,2,1,0,4,0,4,6581
3,3,0,0,4,0,4,6581
0,0,1,0,1,0,1,6582
1,1,1,1,2,1,3,6582
2,2,0,1,2,2,4,6582
3,3,0,0,2,2,4,6582
0,0,1,0,1,0,1,6583
1,1,0,0,1,0,1,6583
0,0,1,0,1,0,1,6584
1,1,0,0,1,0,1,6584
0,0,1,0,1,0,1,6585
1,1,0,0,1,0,1,6585
0,0,1,0,1,0,1,6586
1,1,3,0,4,0,4,6586
2,2,0,1,4,1,5,6586
3,3,0,1,4,2,6,6586
4,4,0,0,4,2,6,6586
0,0,1,0,1,0,1,6587
1,1,1,0,2,0,2,6587
2,2,0,0,2,0,2,6587
0,0,1,0,1,0,1,6588
1,1,2,0,3,0,3,6588
2,2,2,0,5,0,5,6588
3,3,2,0,7,0,7,6588
4,4,1,0,8,0,8,6588
5,5,1,0,9,0,9,6588
6,6,0,0,9,0,9,6588
0,0,1,0,1,0,1,6589
1,1,1,0,2,0,2,6589
2,2,4,1,6,1,7,6589
3,3,3,1,9,2,11,6589
4,4,4,0,13,2,15,6589
5,5,3,0,16,2,18,6589
6,6,0,1,16,3,19,6589
7,7,0,0,16,3,19,6589
0,0,1,0,1,0,1,6590
1,1,4,0,5,0,5,6590
2,2,1,0,6,0,6,6590
3,3,0,0,6,0,6,6590
0,0,1,0,1,0,1,6591
1,1,0,0,1,0,1,6591
0,0,1,0,1,0,1,6592
1,1,1,0,2,0,2,6592
2,2,2,0,4,0,4,6592
3,3,2,1,6,1,7,6592
4,4,2,2,8,3,11,6592
5,5,2,2,10,5,15,6592
6,6,3,0,13,5,18,6592
7,7,0,1,13,6,19,6592
8,8,0,1,13,7,20,6592
9,9,0,0,13,7,20,6592
0,0,1,0,1,0,1,6593
1,1,0,1,1,1,2,6593
2,2,0,0,1,1,2,6593
0,0,1,0,1,0,1,6594
1,1,0,0,1,0,1,6594
0,0,1,0,1,0,1,6595
1,1,0,1,1,1,2,6595
2,2,0,1,1,2,3,6595
3,3,0,0,1,2,3,6595
0,0,1,0,1,0,1,6596
1,1,0,0,1,0,1,6596
0,0,1,0,1,0,1,6597
1,1,1,1,2,1,3,6597
2,2,1,0,3,1,4,6597
3,3,2,0,5,1,6,6597
4,4,1,0,6,1,7,6597
5,5,0,0,6,1,7,6597
0,0,1,0,1,0,1,6598
1,1,1,0,2,0,2,6598
2,2,1,0,3,0,3,6598
3,3,2,0,5,0,5,6598
4,4,1,0,6,0,6,6598
5,5,0,0,6,0,6,6598
0,0,1,0,1,0,1,6599
1,1,0,1,1,1,2,6599
2,2,0,0,1,1,2,6599
0,0,1,0,1,0,1,6600
1,1,2,0,3,0,3,6600
2,2,2,0,5,0,5,6600
3,3,1,1,6,1,7,6600
4,4,0,0,6,1,7,6600
0,0,1,0,1,0,1,6601
1,1,2,0,3,0,3,6601
2,2,0,1,3,1,4,6601
3,3,0,1,3,2,5,6601
4,4,0,1,3,3,6,6601
5,5,0,0,3,3,6,6601
0,0,1,0,1,0,1,6602
1,1,1,0,2,0,2,6602
2,2,1,0,3,0,3,6602
3,3,0,0,3,0,3,6602
0,0,1,0,1,0,1,6603
1,1,0,0,1,0,1,6603
0,0,1,0,1,0,1,6604
1,1,0,0,1,0,1,6604
0,0,1,0,1,0,1,6605
1,1,2,0,3,0,3,6605
2,2,2,0,5,0,5,6605
3,3,1,0,6,0,6,6605
4,4,0,0,6,0,6,6605
0,0,1,0,1,0,1,6606
1,1,0,0,1,0,1,6606
0,0,1,0,1,0,1,6607
1,1,1,0,2,0,2,6607
2,2,0,0,2,0,2,6607
0,0,1,0,1,0,1,6608
1,1,0,0,1,0,1,6608
0,0,1,0,1,0,1,6609
1,1,1,1,2,1,3,6609
2,2,0,0,2,1,3,6609
0,0,1,0,1,0,1,6610
1,1,2,0,3,0,3,6610
2,2,1,0,4,0,4,6610
3,3,2,0,6,0,6,6610
4,4,3,0,9,0,9,6610
5,5,1,1,10,1,11,6610
6,6,0,0,10,1,11,6610
0,0,1,0,1,0,1,6611
1,1,1,0,2,0,2,6611
2,2,0,0,2,0,2,6611
0,0,1,0,1,0,1,6612
1,1,1,0,2,0,2,6612
2,2,1,0,3,0,3,6612
3,3,1,0,4,0,4,6612
4,4,0,2,4,2,6,6612
5,5,1,1,5,3,8,6612
6,6,0,0,5,3,8,6612
0,0,1,0,1,0,1,6613
1,1,0,0,1,0,1,6613
0,0,1,0,1,0,1,6614
1,1,1,0,2,0,2,6614
2,2,1,1,3,1,4,6614
3,3,0,0,3,1,4,6614
0,0,1,0,1,0,1,6615
1,1,1,1,2,1,3,6615
2,2,1,3,3,4,7,6615
3,3,1,2,4,6,10,6615
4,4,0,2,4,8,12,6615
5,5,0,2,4,10,14,6615
6,6,0,1,4,11,15,6615
7,7,0,1,4,12,16,6615
8,8,0,0,4,12,16,6615
0,0,1,0,1,0,1,6616
1,1,2,0,3,0,3,6616
2,2,2,0,5,0,5,6616
3,3,2,0,7,0,7,6616
4,4,4,0,11,0,11,6616
5,5,5,0,16,0,16,6616
6,6,3,1,19,1,20,6616
7,7,5,3,24,4,28,6616
8,8,5,5,29,9,38,6616
9,9,10,3,39,12,51,6616
10,10,12,4,51,16,67,6616
11,11,8,6,59,22,81,6616
12,12,13,3,72,25,97,6616
13,13,9,1,81,26,107,6616
14,14,5,2,86,28,114,6616
15,15,2,1,88,29,117,6616
16,16,2,3,90,32,122,6616
17,17,3,4,93,36,129,6616
18,18,3,3,96,39,135,6616
19,19,0,1,96,40,136,6616
20,20,0,2,96,42,138,6616
21,21,0,1,96,43,139,6616
22,22,0,1,96,44,140,6616
23,23,0,0,96,44,140,6616
0,0,1,0,1,0,1,6617
1,1,3,0,4,0,4,6617
2,2,0,1,4,1,5,6617
3,3,0,1,4,2,6,6617
4,4,1,1,5,3,8,6617
5,5,2,2,7,5,12,6617
6,6,2,3,9,8,17,6617
7,7,2,3,11,11,22,6617
8,8,1,4,12,15,27,6617
9,9,1,2,13,17,30,6617
10,10,2,3,15,20,35,6617
11,11,3,1,18,21,39,6617
12,12,4,1,22,22,44,6617
13,13,5,0,27,22,49,6617
14,14,7,1,34,23,57,6617
15,15,5,0,39,23,62,6617
16,16,8,2,47,25,72,6617
17,17,8,3,55,28,83,6617
18,18,8,2,63,30,93,6617
19,19,12,3,75,33,108,6617
20,20,5,2,80,35,115,6617
21,21,4,0,84,35,119,6617
22,22,3,2,87,37,124,6617
23,23,3,3,90,40,130,6617
24,24,2,1,92,41,133,6617
25,25,2,0,94,41,135,6617
26,26,2,0,96,41,137,6617
27,27,0,0,96,41,137,6617
0,0,1,0,1,0,1,6618
1,1,2,0,3,0,3,6618
2,2,4,0,7,0,7,6618
3,3,1,1,8,1,9,6618
4,4,1,3,9,4,13,6618
5,5,2,6,11,10,21,6618
6,6,4,4,15,14,29,6618
7,7,5,4,20,18,38,6618
8,8,4,3,24,21,45,6618
9,9,2,5,26,26,52,6618
10,10,3,4,29,30,59,6618
11,11,3,0,32,30,62,6618
12,12,0,0,32,30,62,6618
0,0,1,0,1,0,1,6619
1,1,0,0,1,0,1,6619
0,0,1,0,1,0,1,6620
1,1,0,1,1,1,2,6620
2,2,1,0,2,1,3,6620
3,3,1,0,3,1,4,6620
4,4,1,0,4,1,5,6620
5,5,1,0,5,1,6,6620
6,6,0,0,5,1,6,6620
0,0,1,0,1,0,1,6621
1,1,0,0,1,0,1,6621
0,0,1,0,1,0,1,6622
1,1,3,0,4,0,4,6622
2,2,1,0,5,0,5,6622
3,3,0,0,5,0,5,6622
0,0,1,0,1,0,1,6623
1,1,1,0,2,0,2,6623
2,2,0,0,2,0,2,6623
0,0,1,0,1,0,1,6624
1,1,0,0,1,0,1,6624
0,0,1,0,1,0,1,6625
1,1,0,0,1,0,1,6625
0,0,1,0,1,0,1,6626
1,1,1,0,2,0,2,6626
2,2,1,0,3,0,3,6626
3,3,0,0,3,0,3,6626
0,0,1,0,1,0,1,6627
1,1,1,0,2,0,2,6627
2,2,1,0,3,0,3,6627
3,3,2,1,5,1,6,6627
4,4,2,1,7,2,9,6627
5,5,2,3,9,5,14,6627
6,6,3,2,12,7,19,6627
7,7,4,1,16,8,24,6627
8,8,3,1,19,9,28,6627
9,9,1,3,20,12,32,6627
10,10,3,6,23,18,41,6627
11,11,2,3,25,21,46,6627
12,12,1,2,26,23,49,6627
13,13,2,1,28,24,52,6627
14,14,1,2,29,26,55,6627
15,15,2,2,31,28,59,6627
16,16,1,1,32,29,61,6627
17,17,0,0,32,29,61,6627
0,0,1,0,1,0,1,6628
1,1,0,1,1,1,2,6628
2,2,0,3,1,4,5,6628
3,3,1,2,2,6,8,6628
4,4,1,2,3,8,11,6628
5,5,1,4,4,12,16,6628
6,6,0,4,4,16,20,6628
7,7,1,4,5,20,25,6628
8,8,1,3,6,23,29,6628
9,9,0,4,6,27,33,6628
10,10,3,1,9,28,37,6628
11,11,2,2,11,30,41,6628
12,12,1,1,12,31,43,6628
13,13,1,0,13,31,44,6628
14,14,1,1,14,32,46,6628
15,15,2,1,16,33,49,6628
16,16,0,0,16,33,49,6628
0,0,1,0,1,0,1,6629
1,1,0,0,1,0,1,6629
0,0,1,0,1,0,1,6630
1,1,0,1,1,1,2,6630
2,2,0,1,1,2,3,6630
3,3,0,1,1,3,4,6630
4,4,0,0,1,3,4,6630
0,0,1,0,1,0,1,6631
1,1,0,0,1,0,1,6631
0,0,1,0,1,0,1,6632
1,1,0,0,1,0,1,6632
0,0,1,0,1,0,1,6633
1,1,0,0,1,0,1,6633
0,0,1,0,1,0,1,6634
1,1,0,0,1,0,1,6634
0,0,1,0,1,0,1,6635
1,1,0,0,1,0,1,6635
0,0,1,0,1,0,1,6636
1,1,0,0,1,0,1,6636
0,0,1,0,1,0,1,6637
1,1,0,0,1,0,1,6637
0,0,1,0,1,0,1,6638
1,1,4,0,5,0,5,6638
2,2,2,2,7,2,9,6638
3,3,0,1,7,3,10,6638
4,4,0,0,7,3,10,6638
0,0,1,0,1,0,1,6639
1,1,0,1,1,1,2,6639
2,2,1,2,2,3,5,6639
3,3,0,1,2,4,6,6639
4,4,0,1,2,5,7,6639
5,5,0,0,2,5,7,6639
0,0,1,0,1,0,1,6640
1,1,1,0,2,0,2,6640
2,2,1,0,3,0,3,6640
3,3,2,0,5,0,5,6640
4,4,1,0,6,0,6,6640
5,5,1,0,7,0,7,6640
6,6,0,0,7,0,7,6640
0,0,1,0,1,0,1,6641
1,1,1,0,2,0,2,6641
2,2,1,0,3,0,3,6641
3,3,0,1,3,1,4,6641
4,4,0,1,3,2,5,6641
5,5,0,0,3,2,5,6641
0,0,1,0,1,0,1,6642
1,1,1,0,2,0,2,6642
2,2,0,0,2,0,2,6642
0,0,1,0,1,0,1,6643
1,1,0,0,1,0,1,6643
0,0,1,0,1,0,1,6644
1,1,0,0,1,0,1,6644
0,0,1,0,1,0,1,6645
1,1,1,0,2,0,2,6645
2,2,0,1,2,1,3,6645
3,3,0,0,2,1,3,6645
0,0,1,0,1,0,1,6646
1,1,2,0,3,0,3,6646
2,2,1,0,4,0,4,6646
3,3,0,0,4,0,4,6646
0,0,1,0,1,0,1,6647
1,1,0,0,1,0,1,6647
0,0,1,0,1,0,1,6648
1,1,0,0,1,0,1,6648
0,0,1,0,1,0,1,6649
1,1,2,0,3,0,3,6649
2,2,0,1,3,1,4,6649
3,3,1,1,4,2,6,6649
4,4,0,1,4,3,7,6649
5,5,0,0,4,3,7,6649
0,0,1,0,1,0,1,6650
1,1,0,0,1,0,1,6650
0,0,1,0,1,0,1,6651
1,1,0,0,1,0,1,6651
0,0,1,0,1,0,1,6652
1,1,0,0,1,0,1,6652
0,0,1,0,1,0,1,6653
1,1,2,0,3,0,3,6653
2,2,1,0,4,0,4,6653
3,3,1,0,5,0,5,6653
4,4,0,0,5,0,5,6653
0,0,1,0,1,0,1,6654
1,1,0,0,1,0,1,6654
0,0,1,0,1,0,1,6655
1,1,0,1,1,1,2,6655
2,2,0,0,1,1,2,6655
0,0,1,0,1,0,1,6656
1,1,1,1,2,1,3,6656
2,2,1,0,3,1,4,6656
3,3,2,1,5,2,7,6656
4,4,1,2,6,4,10,6656
5,5,1,1,7,5,12,6656
6,6,1,3,8,8,16,6656
7,7,1,3,9,11,20,6656
8,8,0,2,9,13,22,6656
9,9,0,1,9,14,23,6656
10,10,0,1,9,15,24,6656
11,11,0,2,9,17,26,6656
12,12,1,1,10,18,28,6656
13,13,0,2,10,20,30,6656
14,14,0,2,10,22,32,6656
15,15,0,4,10,26,36,6656
16,16,3,2,13,28,41,6656
17,17,0,1,13,29,42,6656
18,18,0,0,13,29,42,6656
0,0,1,0,1,0,1,6657
1,1,0,0,1,0,1,6657
0,0,1,0,1,0,1,6658
1,1,1,0,2,0,2,6658
2,2,1,0,3,0,3,6658
3,3,2,1,5,1,6,6658
4,4,0,0,5,1,6,6658
0,0,1,0,1,0,1,6659
1,1,0,0,1,0,1,6659
0,0,1,0,1,0,1,6660
1,1,0,1,1,1,2,6660
2,2,0,0,1,1,2,6660
0,0,1,0,1,0,1,6661
1,1,0,0,1,0,1,6661
0,0,1,0,1,0,1,6662
1,1,0,0,1,0,1,6662
0,0,1,0,1,0,1,6663
1,1,0,0,1,0,1,6663
0,0,1,0,1,0,1,6664
1,1,0,0,1,0,1,6664
0,0,1,0,1,0,1,6665
1,1,1,0,2,0,2,6665
2,2,1,0,3,0,3,6665
3,3,0,0,3,0,3,6665
0,0,1,0,1,0,1,6666
1,1,0,0,1,0,1,6666
0,0,1,0,1,0,1,6667
1,1,0,0,1,0,1,6667
0,0,1,0,1,0,1,6668
1,1,1,0,2,0,2,6668
2,2,2,0,4,0,4,6668
3,3,0,1,4,1,5,6668
4,4,0,1,4,2,6,6668
5,5,0,1,4,3,7,6668
6,6,0,1,4,4,8,6668
7,7,0,0,4,4,8,6668
0,0,1,0,1,0,1,6669
1,1,1,0,2,0,2,6669
2,2,1,1,3,1,4,6669
3,3,0,1,3,2,5,6669
4,4,0,1,3,3,6,6669
5,5,1,0,4,3,7,6669
6,6,0,0,4,3,7,6669
0,0,1,0,1,0,1,6670
1,1,0,0,1,0,1,6670
0,0,1,0,1,0,1,6671
1,1,0,1,1,1,2,6671
2,2,0,1,1,2,3,6671
3,3,0,1,1,3,4,6671
4,4,0,1,1,4,5,6671
5,5,0,0,1,4,5,6671
0,0,1,0,1,0,1,6672
1,1,1,1,2,1,3,6672
2,2,0,1,2,2,4,6672
3,3,0,0,2,2,4,6672
0,0,1,0,1,0,1,6673
1,1,1,0,2,0,2,6673
2,2,1,0,3,0,3,6673
3,3,0,0,3,0,3,6673
0,0,1,0,1,0,1,6674
1,1,1,0,2,0,2,6674
2,2,0,1,2,1,3,6674
3,3,0,0,2,1,3,6674
0,0,1,0,1,0,1,6675
1,1,0,0,1,0,1,6675
0,0,1,0,1,0,1,6676
1,1,1,0,2,0,2,6676
2,2,0,0,2,0,2,6676
0,0,1,0,1,0,1,6677
1,1,0,0,1,0,1,6677
0,0,1,0,1,0,1,6678
1,1,0,0,1,0,1,6678
0,0,1,0,1,0,1,6679
1,1,1,0,2,0,2,6679
2,2,0,0,2,0,2,6679
0,0,1,0,1,0,1,6680
1,1,0,0,1,0,1,6680
0,0,1,0,1,0,1,6681
1,1,2,0,3,0,3,6681
2,2,2,0,5,0,5,6681
3,3,1,0,6,0,6,6681
4,4,0,0,6,0,6,6681
0,0,1,0,1,0,1,6682
1,1,1,0,2,0,2,6682
2,2,0,1,2,1,3,6682
3,3,1,1,3,2,5,6682
4,4,0,4,3,6,9,6682
5,5,0,1,3,7,10,6682
6,6,0,0,3,7,10,6682
0,0,1,0,1,0,1,6683
1,1,0,0,1,0,1,6683
0,0,1,0,1,0,1,6684
1,1,0,0,1,0,1,6684
0,0,1,0,1,0,1,6685
1,1,0,0,1,0,1,6685
0,0,1,0,1,0,1,6686
1,1,0,0,1,0,1,6686
0,0,1,0,1,0,1,6687
1,1,0,0,1,0,1,6687
0,0,1,0,1,0,1,6688
1,1,1,0,2,0,2,6688
2,2,1,0,3,0,3,6688
3,3,1,1,4,1,5,6688
4,4,0,0,4,1,5,6688
0,0,1,0,1,0,1,6689
1,1,0,0,1,0,1,6689
0,0,1,0,1,0,1,6690
1,1,0,0,1,0,1,6690
0,0,1,0,1,0,1,6691
1,1,0,0,1,0,1,6691
0,0,1,0,1,0,1,6692
1,1,2,1,3,1,4,6692
2,2,0,0,3,1,4,6692
0,0,1,0,1,0,1,6693
1,1,1,0,2,0,2,6693
2,2,1,0,3,0,3,6693
3,3,0,2,3,2,5,6693
4,4,0,0,3,2,5,6693
0,0,1,0,1,0,1,6694
1,1,0,1,1,1,2,6694
2,2,0,1,1,2,3,6694
3,3,1,0,2,2,4,6694
4,4,0,0,2,2,4,6694
0,0,1,0,1,0,1,6695
1,1,0,0,1,0,1,6695
0,0,1,0,1,0,1,6696
1,1,2,1,3,1,4,6696
2,2,2,0,5,1,6,6696
3,3,2,0,7,1,8,6696
4,4,0,0,7,1,8,6696
0,0,1,0,1,0,1,6697
1,1,0,0,1,0,1,6697
0,0,1,0,1,0,1,6698
1,1,0,0,1,0,1,6698
0,0,1,0,1,0,1,6699
1,1,1,1,2,1,3,6699
2,2,0,0,2,1,3,6699
0,0,1,0,1,0,1,6700
1,1,1,0,2,0,2,6700
2,2,0,3,2,3,5,6700
3,3,0,7,2,10,12,6700
4,4,1,7,3,17,20,6700
5,5,3,11,6,28,34,6700
6,6,2,5,8,33,41,6700
7,7,1,2,9,35,44,6700
8,8,1,1,10,36,46,6700
9,9,1,0,11,36,47,6700
10,10,0,0,11,36,47,6700
0,0,1,0,1,0,1,6701
1,1,0,0,1,0,1,6701
0,0,1,0,1,0,1,6702
1,1,0,1,1,1,2,6702
2,2,1,1,2,2,4,6702
3,3,1,0,3,2,5,6702
4,4,0,0,3,2,5,6702
0,0,1,0,1,0,1,6703
1,1,2,0,3,0,3,6703
2,2,3,1,6,1,7,6703
3,3,3,3,9,4,13,6703
4,4,1,4,10,8,18,6703
5,5,1,7,11,15,26,6703
6,6,3,3,14,18,32,6703
7,7,1,4,15,22,37,6703
8,8,3,2,18,24,42,6703
9,9,2,3,20,27,47,6703
10,10,2,5,22,32,54,6703
11,11,2,3,24,35,59,6703
12,12,1,2,25,37,62,6703
13,13,4,2,29,39,68,6703
14,14,4,1,33,40,73,6703
15,15,2,1,35,41,76,6703
16,16,2,2,37,43,80,6703
17,17,0,1,37,44,81,6703
18,18,0,0,37,44,81,6703
0,0,1,0,1,0,1,6704
1,1,0,0,1,0,1,6704
0,0,1,0,1,0,1,6705
1,1,0,0,1,0,1,6705
0,0,1,0,1,0,1,6706
1,1,0,0,1,0,1,6706
0,0,1,0,1,0,1,6707
1,1,0,0,1,0,1,6707
0,0,1,0,1,0,1,6708
1,1,1,1,2,1,3,6708
2,2,1,2,3,3,6,6708
3,3,0,1,3,4,7,6708
4,4,0,1,3,5,8,6708
5,5,0,1,3,6,9,6708
6,6,0,0,3,6,9,6708
0,0,1,0,1,0,1,6709
1,1,1,0,2,0,2,6709
2,2,2,0,4,0,4,6709
3,3,0,1,4,1,5,6709
4,4,0,0,4,1,5,6709
0,0,1,0,1,0,1,6710
1,1,0,0,1,0,1,6710
0,0,1,0,1,0,1,6711
1,1,0,0,1,0,1,6711
0,0,1,0,1,0,1,6712
1,1,0,1,1,1,2,6712
2,2,0,2,1,3,4,6712
3,3,0,2,1,5,6,6712
4,4,0,0,1,5,6,6712
0,0,1,0,1,0,1,6713
1,1,2,0,3,0,3,6713
2,2,0,0,3,0,3,6713
0,0,1,0,1,0,1,6714
1,1,0,0,1,0,1,6714
0,0,1,0,1,0,1,6715
1,1,1,0,2,0,2,6715
2,2,0,0,2,0,2,6715
0,0,1,0,1,0,1,6716
1,1,0,0,1,0,1,6716
0,0,1,0,1,0,1,6717
1,1,0,0,1,0,1,6717
0,0,1,0,1,0,1,6718
1,1,0,0,1,0,1,6718
0,0,1,0,1,0,1,6719
1,1,1,1,2,1,3,6719
2,2,0,2,2,3,5,6719
3,3,1,4,3,7,10,6719
4,4,1,2,4,9,13,6719
5,5,0,4,4,13,17,6719
6,6,0,0,4,13,17,6719
0,0,1,0,1,0,1,6720
1,1,0,0,1,0,1,6720
0,0,1,0,1,0,1,6721
1,1,0,0,1,0,1,6721
0,0,1,0,1,0,1,6722
1,1,2,0,3,0,3,6722
2,2,2,0,5,0,5,6722
3,3,3,0,8,0,8,6722
4,4,0,0,8,0,8,6722
0,0,1,0,1,0,1,6723
1,1,3,0,4,0,4,6723
2,2,1,0,5,0,5,6723
3,3,0,0,5,0,5,6723
0,0,1,0,1,0,1,6724
1,1,1,0,2,0,2,6724
2,2,1,0,3,0,3,6724
3,3,2,0,5,0,5,6724
4,4,2,1,7,1,8,6724
5,5,1,1,8,2,10,6724
6,6,0,1,8,3,11,6724
7,7,0,1,8,4,12,6724
8,8,0,0,8,4,12,6724
0,0,1,0,1,0,1,6725
1,1,2,0,3,0,3,6725
2,2,1,0,4,0,4,6725
3,3,2,0,6,0,6,6725
4,4,1,0,7,0,7,6725
5,5,3,0,10,0,10,6725
6,6,2,0,12,0,12,6725
7,7,3,0,15,0,15,6725
8,8,2,0,17,0,17,6725
9,9,0,1,17,1,18,6725
10,10,0,0,17,1,18,6725
0,0,1,0,1,0,1,6726
1,1,0,0,1,0,1,6726
0,0,1,0,1,0,1,6727
1,1,2,0,3,0,3,6727
2,2,1,1,4,1,5,6727
3,3,0,3,4,4,8,6727
4,4,1,2,5,6,11,6727
5,5,2,2,7,8,15,6727
6,6,5,1,12,9,21,6727
7,7,7,0,19,9,28,6727
8,8,1,2,20,11,31,6727
9,9,3,3,23,14,37,6727
10,10,2,4,25,18,43,6727
11,11,0,6,25,24,49,6727
12,12,2,6,27,30,57,6727
13,13,1,6,28,36,64,6727
14,14,1,5,29,41,70,6727
15,15,1,5,30,46,76,6727
16,16,2,7,32,53,85,6727
17,17,5,8,37,61,98,6727
18,18,4,5,41,66,107,6727
19,19,3,1,44,67,111,6727
20,20,5,0,49,67,116,6727
21,21,2,2,51,69,120,6727
22,22,4,1,55,70,125,6727
23,23,4,2,59,72,131,6727
24,24,5,2,64,74,138,6727
25,25,1,3,65,77,142,6727
26,26,3,2,68,79,147,6727
27,27,1,3,69,82,151,6727
28,28,1,1,70,83,153,6727
29,29,1,0,71,83,154,6727
30,30,0,0,71,83,154,6727
0,0,1,0,1,0,1,6728
1,1,1,0,2,0,2,6728
2,2,1,0,3,0,3,6728
3,3,1,0,4,0,4,6728
4,4,1,0,5,0,5,6728
5,5,0,0,5,0,5,6728
0,0,1,0,1,0,1,6729
1,1,1,0,2,0,2,6729
2,2,0,0,2,0,2,6729
0,0,1,0,1,0,1,6730
1,1,4,0,5,0,5,6730
2,2,0,0,5,0,5,6730
0,0,1,0,1,0,1,6731
1,1,2,0,3,0,3,6731
2,2,2,0,5,0,5,6731
3,3,0,1,5,1,6,6731
4,4,0,2,5,3,8,6731
5,5,1,0,6,3,9,6731
6,6,0,0,6,3,9,6731
0,0,1,0,1,0,1,6732
1,1,1,1,2,1,3,6732
2,2,0,2,2,3,5,6732
3,3,0,0,2,3,5,6732
0,0,1,0,1,0,1,6733
1,1,1,0,2,0,2,6733
2,2,1,0,3,0,3,6733
3,3,1,1,4,1,5,6733
4,4,1,0,5,1,6,6733
5,5,0,0,5,1,6,6733
0,0,1,0,1,0,1,6734
1,1,1,0,2,0,2,6734
2,2,1,0,3,0,3,6734
3,3,3,0,6,0,6,6734
4,4,7,0,13,0,13,6734
5,5,5,1,18,1,19,6734
6,6,4,3,22,4,26,6734
7,7,3,5,25,9,34,6734
8,8,3,6,28,15,43,6734
9,9,1,3,29,18,47,6734
10,10,3,2,32,20,52,6734
11,11,4,2,36,22,58,6734
12,12,2,3,38,25,63,6734
13,13,3,2,41,27,68,6734
14,14,0,1,41,28,69,6734
15,15,0,1,41,29,70,6734
16,16,0,1,41,30,71,6734
17,17,0,0,41,30,71,6734
0,0,1,0,1,0,1,6735
1,1,1,0,2,0,2,6735
2,2,0,0,2,0,2,6735
0,0,1,0,1,0,1,6736
1,1,0,0,1,0,1,6736
0,0,1,0,1,0,1,6737
1,1,0,0,1,0,1,6737
0,0,1,0,1,0,1,6738
1,1,1,0,2,0,2,6738
2,2,0,1,2,1,3,6738
3,3,0,0,2,1,3,6738
0,0,1,0,1,0,1,6739
1,1,0,0,1,0,1,6739
0,0,1,0,1,0,1,6740
1,1,1,0,2,0,2,6740
2,2,2,0,4,0,4,6740
3,3,1,0,5,0,5,6740
4,4,1,0,6,0,6,6740
5,5,1,0,7,0,7,6740
6,6,1,0,8,0,8,6740
7,7,0,0,8,0,8,6740
0,0,1,0,1,0,1,6741
1,1,2,0,3,0,3,6741
2,2,0,2,3,2,5,6741
3,3,0,2,3,4,7,6741
4,4,0,1,3,5,8,6741
5,5,2,1,5,6,11,6741
6,6,1,1,6,7,13,6741
7,7,0,1,6,8,14,6741
8,8,0,0,6,8,14,6741
0,0,1,0,1,0,1,6742
1,1,0,0,1,0,1,6742
0,0,1,0,1,0,1,6743
1,1,0,0,1,0,1,6743
0,0,1,0,1,0,1,6744
1,1,4,0,5,0,5,6744
2,2,8,1,13,1,14,6744
3,3,8,3,21,4,25,6744
4,4,9,2,30,6,36,6744
5,5,9,0,39,6,45,6744
6,6,3,1,42,7,49,6744
7,7,1,0,43,7,50,6744
8,8,0,0,43,7,50,6744
0,0,1,0,1,0,1,6745
1,1,0,0,1,0,1,6745
0,0,1,0,1,0,1,6746
1,1,0,0,1,0,1,6746
0,0,1,0,1,0,1,6747
1,1,0,0,1,0,1,6747
0,0,1,0,1,0,1,6748
1,1,0,0,1,0,1,6748
0,0,1,0,1,0,1,6749
1,1,0,0,1,0,1,6749
0,0,1,0,1,0,1,6750
1,1,0,0,1,0,1,6750
0,0,1,0,1,0,1,6751
1,1,1,0,2,0,2,6751
2,2,0,0,2,0,2,6751
0,0,1,0,1,0,1,6752
1,1,0,0,1,0,1,6752
0,0,1,0,1,0,1,6753
1,1,0,0,1,0,1,6753
0,0,1,0,1,0,1,6754
1,1,0,0,1,0,1,6754
0,0,1,0,1,0,1,6755
1,1,1,1,2,1,3,6755
2,2,1,0,3,1,4,6755
3,3,1,2,4,3,7,6755
4,4,1,1,5,4,9,6755
5,5,2,0,7,4,11,6755
6,6,2,0,9,4,13,6755
7,7,1,1,10,5,15,6755
8,8,1,0,11,5,16,6755
9,9,2,0,13,5,18,6755
10,10,1,1,14,6,20,6755
11,11,0,2,14,8,22,6755
12,12,0,3,14,11,25,6755
13,13,0,1,14,12,26,6755
14,14,0,1,14,13,27,6755
15,15,0,1,14,14,28,6755
16,16,2,0,16,14,30,6755
17,17,1,0,17,14,31,6755
18,18,2,0,19,14,33,6755
19,19,1,0,20,14,34,6755
20,20,1,0,21,14,35,6755
21,21,1,0,22,14,36,6755
22,22,1,0,23,14,37,6755
23,23,1,0,24,14,38,6755
24,24,1,0,25,14,39,6755
25,25,1,0,26,14,40,6755
26,26,0,0,26,14,40,6755
0,0,1,0,1,0,1,6756
1,1,1,0,2,0,2,6756
2,2,1,0,3,0,3,6756
3,3,0,0,3,0,3,6756
0,0,1,0,1,0,1,6757
1,1,0,0,1,0,1,6757
0,0,1,0,1,0,1,6758
1,1,0,0,1,0,1,6758
0,0,1,0,1,0,1,6759
1,1,1,0,2,0,2,6759
2,2,1,0,3,0,3,6759
3,3,0,1,3,1,4,6759
4,4,0,1,3,2,5,6759
5,5,1,0,4,2,6,6759
6,6,0,1,4,3,7,6759
7,7,0,2,4,5,9,6759
8,8,1,4,5,9,14,6759
9,9,1,1,6,10,16,6759
10,10,3,0,9,10,19,6759
11,11,4,2,13,12,25,6759
12,12,4,2,17,14,31,6759
13,13,4,3,21,17,38,6759
14,14,2,2,23,19,42,6759
15,15,1,2,24,21,45,6759
16,16,2,3,26,24,50,6759
17,17,4,1,30,25,55,6759
18,18,6,2,36,27,63,6759
19,19,9,0,45,27,72,6759
20,20,5,1,50,28,78,6759
21,21,4,5,54,33,87,6759
22,22,4,2,58,35,93,6759
23,23,5,1,63,36,99,6759
24,24,5,0,68,36,104,6759
25,25,2,2,70,38,108,6759
26,26,1,4,71,42,113,6759
27,27,2,4,73,46,119,6759
28,28,2,3,75,49,124,6759
29,29,0,4,75,53,128,6759
30,30,1,5,76,58,134,6759
31,31,0,4,76,62,138,6759
32,32,2,1,78,63,141,6759
33,33,4,3,82,66,148,6759
34,34,5,6,87,72,159,6759
35,35,4,5,91,77,168,6759
36,36,4,6,95,83,178,6759
37,37,3,4,98,87,185,6759
38,38,1,0,99,87,186,6759
39,39,1,0,100,87,187,6759
40,40,0,3,100,90,190,6759
41,41,0,5,100,95,195,6759
42,42,1,4,101,99,200,6759
43,43,5,3,106,102,208,6759
44,44,3,3,109,105,214,6759
45,45,3,3,112,108,220,6759
46,46,1,2,113,110,223,6759
47,47,1,0,114,110,224,6759
48,48,1,0,115,110,225,6759
49,49,0,0,115,110,225,6759
0,0,1,0,1,0,1,6760
1,1,0,0,1,0,1,6760
0,0,1,0,1,0,1,6761
1,1,1,0,2,0,2,6761
2,2,0,1,2,1,3,6761
3,3,0,2,2,3,5,6761
4,4,0,1,2,4,6,6761
5,5,0,1,2,5,7,6761
6,6,0,2,2,7,9,6761
7,7,0,1,2,8,10,6761
8,8,0,0,2,8,10,6761
0,0,1,0,1,0,1,6762
1,1,0,1,1,1,2,6762
2,2,1,1,2,2,4,6762
3,3,1,0,3,2,5,6762
4,4,1,0,4,2,6,6762
5,5,0,0,4,2,6,6762
0,0,1,0,1,0,1,6763
1,1,1,0,2,0,2,6763
2,2,1,0,3,0,3,6763
3,3,0,0,3,0,3,6763
0,0,1,0,1,0,1,6764
1,1,1,0,2,0,2,6764
2,2,1,0,3,0,3,6764
3,3,0,0,3,0,3,6764
0,0,1,0,1,0,1,6765
1,1,2,0,3,0,3,6765
2,2,1,3,4,3,7,6765
3,3,0,3,4,6,10,6765
4,4,0,3,4,9,13,6765
5,5,1,1,5,10,15,6765
6,6,3,3,8,13,21,6765
7,7,1,2,9,15,24,6765
8,8,3,3,12,18,30,6765
9,9,3,4,15,22,37,6765
10,10,5,4,20,26,46,6765
11,11,5,5,25,31,56,6765
12,12,7,4,32,35,67,6765
13,13,5,2,37,37,74,6765
14,14,7,2,44,39,83,6765
15,15,14,2,58,41,99,6765
16,16,8,3,66,44,110,6765
17,17,10,1,76,45,121,6765
18,18,9,5,85,50,135,6765
19,19,9,2,94,52,146,6765
20,20,12,5,106,57,163,6765
21,21,10,3,116,60,176,6765
22,22,2,8,118,68,186,6765
23,23,5,7,123,75,198,6765
24,24,7,6,130,81,211,6765
25,25,8,5,138,86,224,6765
26,26,3,8,141,94,235,6765
27,27,2,5,143,99,242,6765
28,28,2,5,145,104,249,6765
29,29,2,7,147,111,258,6765
30,30,3,10,150,121,271,6765
31,31,1,10,151,131,282,6765
32,32,0,6,151,137,288,6765
33,33,1,4,152,141,293,6765
34,34,2,2,154,143,297,6765
35,35,1,2,155,145,300,6765
36,36,0,2,155,147,302,6765
37,37,0,2,155,149,304,6765
38,38,0,0,155,149,304,6765
0,0,1,0,1,0,1,6766
1,1,0,0,1,0,1,6766
0,0,1,0,1,0,1,6767
1,1,1,0,2,0,2,6767
2,2,0,0,2,0,2,6767
0,0,1,0,1,0,1,6768
1,1,0,1,1,1,2,6768
2,2,0,1,1,2,3,6768
3,3,0,2,1,4,5,6768
4,4,0,0,1,4,5,6768
0,0,1,0,1,0,1,6769
1,1,2,0,3,0,3,6769
2,2,2,0,5,0,5,6769
3,3,1,0,6,0,6,6769
4,4,0,1,6,1,7,6769
5,5,0,0,6,1,7,6769
0,0,1,0,1,0,1,6770
1,1,0,0,1,0,1,6770
0,0,1,0,1,0,1,6771
1,1,0,1,1,1,2,6771
2,2,0,0,1,1,2,6771
0,0,1,0,1,0,1,6772
1,1,1,0,2,0,2,6772
2,2,1,0,3,0,3,6772
3,3,0,0,3,0,3,6772
0,0,1,0,1,0,1,6773
1,1,0,0,1,0,1,6773
0,0,1,0,1,0,1,6774
1,1,3,0,4,0,4,6774
2,2,2,0,6,0,6,6774
3,3,2,1,8,1,9,6774
4,4,0,0,8,1,9,6774
0,0,1,0,1,0,1,6775
1,1,0,0,1,0,1,6775
0,0,1,0,1,0,1,6776
1,1,2,0,3,0,3,6776
2,2,1,0,4,0,4,6776
3,3,4,0,8,0,8,6776
4,4,4,1,12,1,13,6776
5,5,2,0,14,1,15,6776
6,6,2,1,16,2,18,6776
7,7,0,1,16,3,19,6776
8,8,0,1,16,4,20,6776
9,9,0,1,16,5,21,6776
10,10,0,3,16,8,24,6776
11,11,1,3,17,11,28,6776
12,12,0,1,17,12,29,6776
13,13,0,2,17,14,31,6776
14,14,0,2,17,16,33,6776
15,15,0,0,17,16,33,6776
0,0,1,0,1,0,1,6777
1,1,1,0,2,0,2,6777
2,2,0,0,2,0,2,6777
0,0,1,0,1,0,1,6778
1,1,1,0,2,0,2,6778
2,2,2,0,4,0,4,6778
3,3,0,0,4,0,4,6778
0,0,1,0,1,0,1,6779
1,1,1,0,2,0,2,6779
2,2,1,0,3,0,3,6779
3,3,2,0,5,0,5,6779
4,4,1,0,6,0,6,6779
5,5,2,0,8,0,8,6779
6,6,0,0,8,0,8,6779
0,0,1,0,1,0,1,6780
1,1,1,0,2,0,2,6780
2,2,3,0,5,0,5,6780
3,3,1,1,6,1,7,6780
4,4,1,1,7,2,9,6780
5,5,3,0,10,2,12,6780
6,6,1,1,11,3,14,6780
7,7,2,0,13,3,16,6780
8,8,2,0,15,3,18,6780
9,9,0,0,15,3,18,6780
0,0,1,0,1,0,1,6781
1,1,0,0,1,0,1,6781
0,0,1,0,1,0,1,6782
1,1,0,0,1,0,1,6782
0,0,1,0,1,0,1,6783
1,1,1,0,2,0,2,6783
2,2,0,0,2,0,2,6783
0,0,1,0,1,0,1,6784
1,1,0,0,1,0,1,6784
0,0,1,0,1,0,1,6785
1,1,1,0,2,0,2,6785
2,2,0,0,2,0,2,6785
0,0,1,0,1,0,1,6786
1,1,0,1,1,1,2,6786
2,2,0,3,1,4,5,6786
3,3,1,0,2,4,6,6786
4,4,0,0,2,4,6,6786
0,0,1,0,1,0,1,6787
1,1,0,0,1,0,1,6787
0,0,1,0,1,0,1,6788
1,1,0,0,1,0,1,6788
0,0,1,0,1,0,1,6789
1,1,0,0,1,0,1,6789
0,0,1,0,1,0,1,6790
1,1,1,0,2,0,2,6790
2,2,1,0,3,0,3,6790
3,3,1,0,4,0,4,6790
4,4,2,0,6,0,6,6790
5,5,2,1,8,1,9,6790
6,6,1,1,9,2,11,6790
7,7,1,1,10,3,13,6790
8,8,3,2,13,5,18,6790
9,9,2,3,15,8,23,6790
10,10,4,3,19,11,30,6790
11,11,4,5,23,16,39,6790
12,12,6,2,29,18,47,6790
13,13,5,1,34,19,53,6790
14,14,3,5,37,24,61,6790
15,15,2,1,39,25,64,6790
16,16,2,1,41,26,67,6790
17,17,5,3,46,29,75,6790
18,18,4,3,50,32,82,6790
19,19,5,2,55,34,89,6790
20,20,0,2,55,36,91,6790
21,21,0,0,55,36,91,6790
0,0,1,0,1,0,1,6791
1,1,1,0,2,0,2,6791
2,2,3,0,5,0,5,6791
3,3,2,2,7,2,9,6791
4,4,1,1,8,3,11,6791
5,5,1,1,9,4,13,6791
6,6,2,0,11,4,15,6791
7,7,1,1,12,5,17,6791
8,8,1,0,13,5,18,6791
9,9,3,0,16,5,21,6791
10,10,1,3,17,8,25,6791
11,11,1,2,18,10,28,6791
12,12,1,2,19,12,31,6791
13,13,1,2,20,14,34,6791
14,14,1,3,21,17,38,6791
15,15,0,3,21,20,41,6791
16,16,1,2,22,22,44,6791
17,17,1,1,23,23,46,6791
18,18,0,0,23,23,46,6791
0,0,1,0,1,0,1,6792
1,1,0,2,1,2,3,6792
2,2,0,0,1,2,3,6792
0,0,1,0,1,0,1,6793
1,1,1,1,2,1,3,6793
2,2,0,0,2,1,3,6793
0,0,1,0,1,0,1,6794
1,1,1,0,2,0,2,6794
2,2,0,0,2,0,2,6794
0,0,1,0,1,0,1,6795
1,1,2,0,3,0,3,6795
2,2,0,1,3,1,4,6795
3,3,0,1,3,2,5,6795
4,4,0,0,3,2,5,6795
0,0,1,0,1,0,1,6796
1,1,0,1,1,1,2,6796
2,2,0,2,1,3,4,6796
3,3,0,0,1,3,4,6796
0,0,1,0,1,0,1,6797
1,1,1,0,2,0,2,6797
2,2,0,0,2,0,2,6797
0,0,1,0,1,0,1,6798
1,1,3,0,4,0,4,6798
2,2,2,0,6,0,6,6798
3,3,1,0,7,0,7,6798
4,4,1,0,8,0,8,6798
5,5,0,0,8,0,8,6798
0,0,1,0,1,0,1,6799
1,1,0,0,1,0,1,6799
0,0,1,0,1,0,1,6800
1,1,0,0,1,0,1,6800
0,0,1,0,1,0,1,6801
1,1,1,0,2,0,2,6801
2,2,0,0,2,0,2,6801
0,0,1,0,1,0,1,6802
1,1,1,0,2,0,2,6802
2,2,0,0,2,0,2,6802
0,0,1,0,1,0,1,6803
1,1,0,0,1,0,1,6803
0,0,1,0,1,0,1,6804
1,1,0,0,1,0,1,6804
0,0,1,0,1,0,1,6805
1,1,2,0,3,0,3,6805
2,2,4,0,7,0,7,6805
3,3,5,2,12,2,14,6805
4,4,3,3,15,5,20,6805
5,5,2,2,17,7,24,6805
6,6,2,2,19,9,28,6805
7,7,0,3,19,12,31,6805
8,8,1,2,20,14,34,6805
9,9,1,1,21,15,36,6805
10,10,0,0,21,15,36,6805
0,0,1,0,1,0,1,6806
1,1,2,0,3,0,3,6806
2,2,0,0,3,0,3,6806
0,0,1,0,1,0,1,6807
1,1,0,0,1,0,1,6807
0,0,1,0,1,0,1,6808
1,1,2,0,3,0,3,6808
2,2,2,0,5,0,5,6808
3,3,5,0,10,0,10,6808
4,4,5,0,15,0,15,6808
5,5,3,0,18,0,18,6808
6,6,2,0,20,0,20,6808
7,7,2,0,22,0,22,6808
8,8,0,0,22,0,22,6808
0,0,1,0,1,0,1,6809
1,1,1,0,2,0,2,6809
2,2,0,0,2,0,2,6809
0,0,1,0,1,0,1,6810
1,1,1,0,2,0,2,6810
2,2,2,1,4,1,5,6810
3,3,0,0,4,1,5,6810
0,0,1,0,1,0,1,6811
1,1,1,0,2,0,2,6811
2,2,2,0,4,0,4,6811
3,3,3,1,7,1,8,6811
4,4,3,1,10,2,12,6811
5,5,3,1,13,3,16,6811
6,6,1,2,14,5,19,6811
7,7,2,2,16,7,23,6811
8,8,4,3,20,10,30,6811
9,9,2,4,22,14,36,6811
10,10,4,3,26,17,43,6811
11,11,5,2,31,19,50,6811
12,12,8,1,39,20,59,6811
13,13,3,1,42,21,63,6811
14,14,0,3,42,24,66,6811
15,15,1,1,43,25,68,6811
16,16,1,1,44,26,70,6811
17,17,0,0,44,26,70,6811
0,0,1,0,1,0,1,6812
1,1,3,0,4,0,4,6812
2,2,3,0,7,0,7,6812
3,3,4,0,11,0,11,6812
4,4,1,0,12,0,12,6812
5,5,0,1,12,1,13,6812
6,6,0,0,12,1,13,6812
0,0,1,0,1,0,1,6813
1,1,2,0,3,0,3,6813
2,2,1,0,4,0,4,6813
3,3,3,0,7,0,7,6813
4,4,2,0,9,0,9,6813
5,5,1,0,10,0,10,6813
6,6,2,1,12,1,13,6813
7,7,3,1,15,2,17,6813
8,8,0,1,15,3,18,6813
9,9,0,2,15,5,20,6813
10,10,0,2,15,7,22,6813
11,11,0,2,15,9,24,6813
12,12,2,1,17,10,27,6813
13,13,3,0,20,10,30,6813
14,14,2,0,22,10,32,6813
15,15,3,0,25,10,35,6813
16,16,3,0,28,10,38,6813
17,17,1,1,29,11,40,6813
18,18,0,4,29,15,44,6813
19,19,2,5,31,20,51,6813
20,20,6,8,37,28,65,6813
21,21,7,5,44,33,77,6813
22,22,3,4,47,37,84,6813
23,23,3,10,50,47,97,6813
24,24,4,6,54,53,107,6813
25,25,8,5,62,58,120,6813
26,26,7,6,69,64,133,6813
27,27,3,2,72,66,138,6813
28,28,3,3,75,69,144,6813
29,29,4,4,79,73,152,6813
30,30,4,4,83,77,160,6813
31,31,3,1,86,78,164,6813
32,32,4,4,90,82,172,6813
33,33,4,3,94,85,179,6813
34,34,5,1,99,86,185,6813
35,35,4,3,103,89,192,6813
36,36,1,1,104,90,194,6813
37,37,0,2,104,92,196,6813
38,38,0,3,104,95,199,6813
39,39,1,3,105,98,203,6813
40,40,0,1,105,99,204,6813
41,41,2,0,107,99,206,6813
42,42,2,0,109,99,208,6813
43,43,0,0,109,99,208,6813
0,0,1,0,1,0,1,6814
1,1,0,0,1,0,1,6814
0,0,1,0,1,0,1,6815
1,1,0,0,1,0,1,6815
0,0,1,0,1,0,1,6816
1,1,0,0,1,0,1,6816
0,0,1,0,1,0,1,6817
1,1,1,0,2,0,2,6817
2,2,0,0,2,0,2,6817
0,0,1,0,1,0,1,6818
1,1,1,0,2,0,2,6818
2,2,0,0,2,0,2,6818
0,0,1,0,1,0,1,6819
1,1,1,0,2,0,2,6819
2,2,0,0,2,0,2,6819
0,0,1,0,1,0,1,6820
1,1,1,0,2,0,2,6820
2,2,1,0,3,0,3,6820
3,3,1,0,4,0,4,6820
4,4,0,0,4,0,4,6820
0,0,1,0,1,0,1,6821
1,1,1,0,2,0,2,6821
2,2,2,0,4,0,4,6821
3,3,5,0,9,0,9,6821
4,4,2,1,11,1,12,6821
5,5,0,0,11,1,12,6821
0,0,1,0,1,0,1,6822
1,1,1,0,2,0,2,6822
2,2,2,1,4,1,5,6822
3,3,2,1,6,2,8,6822
4,4,2,0,8,2,10,6822
5,5,0,0,8,2,10,6822
0,0,1,0,1,0,1,6823
1,1,2,0,3,0,3,6823
2,2,3,0,6,0,6,6823
3,3,2,0,8,0,8,6823
4,4,2,0,10,0,10,6823
5,5,3,1,13,1,14,6823
6,6,2,3,15,4,19,6823
7,7,2,2,17,6,23,6823
8,8,3,1,20,7,27,6823
9,9,1,2,21,9,30,6823
10,10,2,1,23,10,33,6823
11,11,1,2,24,12,36,6823
12,12,0,0,24,12,36,6823
0,0,1,0,1,0,1,6824
1,1,0,0,1,0,1,6824
0,0,1,0,1,0,1,6825
1,1,0,0,1,0,1,6825
0,0,1,0,1,0,1,6826
1,1,0,1,1,1,2,6826
2,2,0,2,1,3,4,6826
3,3,1,1,2,4,6,6826
4,4,1,2,3,6,9,6826
5,5,2,1,5,7,12,6826
6,6,0,1,5,8,13,6826
7,7,1,0,6,8,14,6826
8,8,2,0,8,8,16,6826
9,9,3,0,11,8,19,6826
10,10,4,1,15,9,24,6826
11,11,1,1,16,10,26,6826
12,12,1,2,17,12,29,6826
13,13,1,1,18,13,31,6826
14,14,1,0,19,13,32,6826
15,15,3,0,22,13,35,6826
16,16,4,0,26,13,39,6826
17,17,3,1,29,14,43,6826
18,18,3,0,32,14,46,6826
19,19,2,0,34,14,48,6826
20,20,2,0,36,14,50,6826
21,21,3,0,39,14,53,6826
22,22,2,0,41,14,55,6826
23,23,0,1,41,15,56,6826
24,24,0,0,41,15,56,6826
0,0,1,0,1,0,1,6827
1,1,1,0,2,0,2,6827
2,2,0,0,2,0,2,6827
0,0,1,0,1,0,1,6828
1,1,0,0,1,0,1,6828
0,0,1,0,1,0,1,6829
1,1,1,1,2,1,3,6829
2,2,0,1,2,2,4,6829
3,3,0,1,2,3,5,6829
4,4,0,1,2,4,6,6829
5,5,0,3,2,7,9,6829
6,6,0,1,2,8,10,6829
7,7,0,1,2,9,11,6829
8,8,1,0,3,9,12,6829
9,9,1,0,4,9,13,6829
10,10,3,0,7,9,16,6829
11,11,1,0,8,9,17,6829
12,12,2,0,10,9,19,6829
13,13,0,0,10,9,19,6829
0,0,1,0,1,0,1,6830
1,1,0,0,1,0,1,6830
0,0,1,0,1,0,1,6831
1,1,1,0,2,0,2,6831
2,2,0,0,2,0,2,6831
0,0,1,0,1,0,1,6832
1,1,0,0,1,0,1,6832
0,0,1,0,1,0,1,6833
1,1,0,0,1,0,1,6833
0,0,1,0,1,0,1,6834
1,1,0,0,1,0,1,6834
0,0,1,0,1,0,1,6835
1,1,1,0,2,0,2,6835
2,2,0,0,2,0,2,6835
0,0,1,0,1,0,1,6836
1,1,0,0,1,0,1,6836
0,0,1,0,1,0,1,6837
1,1,0,1,1,1,2,6837
2,2,2,0,3,1,4,6837
3,3,0,1,3,2,5,6837
4,4,0,0,3,2,5,6837
0,0,1,0,1,0,1,6838
1,1,2,0,3,0,3,6838
2,2,3,1,6,1,7,6838
3,3,7,2,13,3,16,6838
4,4,6,1,19,4,23,6838
5,5,1,3,20,7,27,6838
6,6,4,5,24,12,36,6838
7,7,3,5,27,17,44,6838
8,8,2,3,29,20,49,6838
9,9,1,4,30,24,54,6838
10,10,4,3,34,27,61,6838
11,11,4,2,38,29,67,6838
12,12,3,5,41,34,75,6838
13,13,3,2,44,36,80,6838
14,14,0,2,44,38,82,6838
15,15,0,3,44,41,85,6838
16,16,0,2,44,43,87,6838
17,17,0,1,44,44,88,6838
18,18,0,0,44,44,88,6838
0,0,1,0,1,0,1,6839
1,1,1,0,2,0,2,6839
2,2,1,0,3,0,3,6839
3,3,0,1,3,1,4,6839
4,4,0,0,3,1,4,6839
0,0,1,0,1,0,1,6840
1,1,0,1,1,1,2,6840
2,2,0,2,1,3,4,6840
3,3,0,1,1,4,5,6840
4,4,0,1,1,5,6,6840
5,5,0,0,1,5,6,6840
0,0,1,0,1,0,1,6841
1,1,0,0,1,0,1,6841
0,0,1,0,1,0,1,6842
1,1,1,1,2,1,3,6842
2,2,1,2,3,3,6,6842
3,3,0,2,3,5,8,6842
4,4,1,6,4,11,15,6842
5,5,1,6,5,17,22,6842
6,6,2,4,7,21,28,6842
7,7,4,6,11,27,38,6842
8,8,3,3,14,30,44,6842
9,9,10,4,24,34,58,6842
10,10,8,3,32,37,69,6842
11,11,9,4,41,41,82,6842
12,12,5,5,46,46,92,6842
13,13,3,10,49,56,105,6842
14,14,7,5,56,61,117,6842
15,15,3,3,59,64,123,6842
16,16,1,2,60,66,126,6842
17,17,0,3,60,69,129,6842
18,18,1,2,61,71,132,6842
19,19,3,4,64,75,139,6842
20,20,5,5,69,80,149,6842
21,21,5,6,74,86,160,6842
22,22,6,5,80,91,171,6842
23,23,4,3,84,94,178,6842
24,24,3,1,87,95,182,6842
25,25,6,2,93,97,190,6842
26,26,5,1,98,98,196,6842
27,27,2,5,100,103,203,6842
28,28,4,2,104,105,209,6842
29,29,4,3,108,108,216,6842
30,30,7,4,115,112,227,6842
31,31,5,7,120,119,239,6842
32,32,3,9,123,128,251,6842
33,33,2,5,125,133,258,6842
34,34,3,5,128,138,266,6842
35,35,6,3,134,141,275,6842
36,36,2,2,136,143,279,6842
37,37,5,0,141,143,284,6842
38,38,0,0,141,143,284,6842
0,0,1,0,1,0,1,6843
1,1,2,0,3,0,3,6843
2,2,0,0,3,0,3,6843
0,0,1,0,1,0,1,6844
1,1,1,0,2,0,2,6844
2,2,1,0,3,0,3,6844
3,3,1,0,4,0,4,6844
4,4,2,0,6,0,6,6844
5,5,0,0,6,0,6,6844
0,0,1,0,1,0,1,6845
1,1,0,1,1,1,2,6845
2,2,0,0,1,1,2,6845
0,0,1,0,1,0,1,6846
1,1,0,0,1,0,1,6846
0,0,1,0,1,0,1,6847
1,1,0,1,1,1,2,6847
2,2,2,1,3,2,5,6847
3,3,2,2,5,4,9,6847
4,4,1,2,6,6,12,6847
5,5,1,4,7,10,17,6847
6,6,2,0,9,10,19,6847
7,7,3,0,12,10,22,6847
8,8,0,0,12,10,22,6847
0,0,1,0,1,0,1,6848
1,1,1,0,2,0,2,6848
2,2,1,1,3,1,4,6848
3,3,0,1,3,2,5,6848
4,4,0,0,3,2,5,6848
0,0,1,0,1,0,1,6849
1,1,2,0,3,0,3,6849
2,2,2,0,5,0,5,6849
3,3,3,1,8,1,9,6849
4,4,3,3,11,4,15,6849
5,5,4,4,15,8,23,6849
6,6,3,2,18,10,28,6849
7,7,1,2,19,12,31,6849
8,8,1,2,20,14,34,6849
9,9,0,1,20,15,35,6849
10,10,0,0,20,15,35,6849
0,0,1,0,1,0,1,6850
1,1,2,0,3,0,3,6850
2,2,2,0,5,0,5,6850
3,3,2,0,7,0,7,6850
4,4,0,1,7,1,8,6850
5,5,0,0,7,1,8,6850
0,0,1,0,1,0,1,6851
1,1,0,0,1,0,1,6851
0,0,1,0,1,0,1,6852
1,1,0,0,1,0,1,6852
0,0,1,0,1,0,1,6853
1,1,0,0,1,0,1,6853
0,0,1,0,1,0,1,6854
1,1,0,0,1,0,1,6854
0,0,1,0,1,0,1,6855
1,1,1,0,2,0,2,6855
2,2,0,0,2,0,2,6855
0,0,1,0,1,0,1,6856
1,1,0,0,1,0,1,6856
0,0,1,0,1,0,1,6857
1,1,0,0,1,0,1,6857
0,0,1,0,1,0,1,6858
1,1,1,0,2,0,2,6858
2,2,0,0,2,0,2,6858
0,0,1,0,1,0,1,6859
1,1,0,1,1,1,2,6859
2,2,1,1,2,2,4,6859
3,3,1,0,3,2,5,6859
4,4,2,0,5,2,7,6859
5,5,1,1,6,3,9,6859
6,6,1,1,7,4,11,6859
7,7,0,1,7,5,12,6859
8,8,0,1,7,6,13,6859
9,9,0,2,7,8,15,6859
10,10,0,6,7,14,21,6859
11,11,0,4,7,18,25,6859
12,12,1,3,8,21,29,6859
13,13,4,5,12,26,38,6859
14,14,2,6,14,32,46,6859
15,15,4,5,18,37,55,6859
16,16,3,3,21,40,61,6859
17,17,2,2,23,42,65,6859
18,18,0,2,23,44,67,6859
19,19,1,0,24,44,68,6859
20,20,1,1,25,45,70,6859
21,21,3,0,28,45,73,6859
22,22,2,0,30,45,75,6859
23,23,1,0,31,45,76,6859
24,24,0,2,31,47,78,6859
25,25,0,2,31,49,80,6859
26,26,0,2,31,51,82,6859
27,27,0,1,31,52,83,6859
28,28,0,2,31,54,85,6859
29,29,2,1,33,55,88,6859
30,30,2,0,35,55,90,6859
31,31,3,0,38,55,93,6859
32,32,1,0,39,55,94,6859
33,33,0,0,39,55,94,6859
0,0,1,0,1,0,1,6860
1,1,0,2,1,2,3,6860
2,2,1,1,2,3,5,6860
3,3,0,0,2,3,5,6860
0,0,1,0,1,0,1,6861
1,1,1,0,2,0,2,6861
2,2,0,0,2,0,2,6861
0,0,1,0,1,0,1,6862
1,1,0,0,1,0,1,6862
0,0,1,0,1,0,1,6863
1,1,0,0,1,0,1,6863
0,0,1,0,1,0,1,6864
1,1,0,0,1,0,1,6864
0,0,1,0,1,0,1,6865
1,1,1,0,2,0,2,6865
2,2,2,0,4,0,4,6865
3,3,0,0,4,0,4,6865
0,0,1,0,1,0,1,6866
1,1,0,0,1,0,1,6866
0,0,1,0,1,0,1,6867
1,1,1,0,2,0,2,6867
2,2,0,1,2,1,3,6867
3,3,0,1,2,2,4,6867
4,4,0,0,2,2,4,6867
0,0,1,0,1,0,1,6868
1,1,0,0,1,0,1,6868
0,0,1,0,1,0,1,6869
1,1,0,0,1,0,1,6869
0,0,1,0,1,0,1,6870
1,1,0,0,1,0,1,6870
0,0,1,0,1,0,1,6871
1,1,0,0,1,0,1,6871
0,0,1,0,1,0,1,6872
1,1,0,0,1,0,1,6872
0,0,1,0,1,0,1,6873
1,1,3,1,4,1,5,6873
2,2,2,0,6,1,7,6873
3,3,1,0,7,1,8,6873
4,4,0,0,7,1,8,6873
0,0,1,0,1,0,1,6874
1,1,2,0,3,0,3,6874
2,2,1,0,4,0,4,6874
3,3,0,0,4,0,4,6874
0,0,1,0,1,0,1,6875
1,1,0,0,1,0,1,6875
0,0,1,0,1,0,1,6876
1,1,1,1,2,1,3,6876
2,2,0,1,2,2,4,6876
3,3,0,1,2,3,5,6876
4,4,0,0,2,3,5,6876
0,0,1,0,1,0,1,6877
1,1,0,0,1,0,1,6877
0,0,1,0,1,0,1,6878
1,1,0,1,1,1,2,6878
2,2,0,1,1,2,3,6878
3,3,0,0,1,2,3,6878
0,0,1,0,1,0,1,6879
1,1,0,0,1,0,1,6879
0,0,1,0,1,0,1,6880
1,1,2,0,3,0,3,6880
2,2,1,0,4,0,4,6880
3,3,1,0,5,0,5,6880
4,4,0,0,5,0,5,6880
0,0,1,0,1,0,1,6881
1,1,0,0,1,0,1,6881
0,0,1,0,1,0,1,6882
1,1,2,0,3,0,3,6882
2,2,1,1,4,1,5,6882
3,3,5,2,9,3,12,6882
4,4,4,3,13,6,19,6882
5,5,5,4,18,10,28,6882
6,6,6,0,24,10,34,6882
7,7,3,2,27,12,39,6882
8,8,2,2,29,14,43,6882
9,9,1,3,30,17,47,6882
10,10,3,3,33,20,53,6882
11,11,0,1,33,21,54,6882
12,12,0,2,33,23,56,6882
13,13,0,0,33,23,56,6882
0,0,1,0,1,0,1,6883
1,1,2,0,3,0,3,6883
2,2,1,2,4,2,6,6883
3,3,1,0,5,2,7,6883
4,4,2,0,7,2,9,6883
5,5,0,0,7,2,9,6883
0,0,1,0,1,0,1,6884
1,1,3,0,4,0,4,6884
2,2,2,0,6,0,6,6884
3,3,0,1,6,1,7,6884
4,4,0,0,6,1,7,6884
0,0,1,0,1,0,1,6885
1,1,1,0,2,0,2,6885
2,2,0,0,2,0,2,6885
0,0,1,0,1,0,1,6886
1,1,0,1,1,1,2,6886
2,2,0,0,1,1,2,6886
0,0,1,0,1,0,1,6887
1,1,0,1,1,1,2,6887
2,2,0,1,1,2,3,6887
3,3,0,0,1,2,3,6887
0,0,1,0,1,0,1,6888
1,1,2,0,3,0,3,6888
2,2,1,0,4,0,4,6888
3,3,3,0,7,0,7,6888
4,4,0,0,7,0,7,6888
0,0,1,0,1,0,1,6889
1,1,3,0,4,0,4,6889
2,2,4,0,8,0,8,6889
3,3,2,1,10,1,11,6889
4,4,3,0,13,1,14,6889
5,5,2,0,15,1,16,6889
6,6,1,0,16,1,17,6889
7,7,1,0,17,1,18,6889
8,8,1,0,18,1,19,6889
9,9,1,0,19,1,20,6889
10,10,1,0,20,1,21,6889
11,11,3,0,23,1,24,6889
12,12,0,3,23,4,27,6889
13,13,0,1,23,5,28,6889
14,14,0,0,23,5,28,6889
0,0,1,0,1,0,1,6890
1,1,0,0,1,0,1,6890
0,0,1,0,1,0,1,6891
1,1,1,1,2,1,3,6891
2,2,0,1,2,2,4,6891
3,3,0,0,2,2,4,6891
0,0,1,0,1,0,1,6892
1,1,1,0,2,0,2,6892
2,2,0,0,2,0,2,6892
0,0,1,0,1,0,1,6893
1,1,2,1,3,1,4,6893
2,2,1,1,4,2,6,6893
3,3,1,0,5,2,7,6893
4,4,1,1,6,3,9,6893
5,5,0,2,6,5,11,6893
6,6,0,0,6,5,11,6893
0,0,1,0,1,0,1,6894
1,1,0,0,1,0,1,6894
0,0,1,0,1,0,1,6895
1,1,1,0,2,0,2,6895
2,2,1,0,3,0,3,6895
3,3,0,0,3,0,3,6895
0,0,1,0,1,0,1,6896
1,1,0,0,1,0,1,6896
0,0,1,0,1,0,1,6897
1,1,2,1,3,1,4,6897
2,2,2,0,5,1,6,6897
3,3,3,0,8,1,9,6897
4,4,2,0,10,1,11,6897
5,5,0,0,10,1,11,6897
0,0,1,0,1,0,1,6898
1,1,1,0,2,0,2,6898
2,2,1,0,3,0,3,6898
3,3,1,0,4,0,4,6898
4,4,2,0,6,0,6,6898
5,5,3,0,9,0,9,6898
6,6,4,1,13,1,14,6898
7,7,2,2,15,3,18,6898
8,8,3,1,18,4,22,6898
9,9,2,1,20,5,25,6898
10,10,4,1,24,6,30,6898
11,11,4,1,28,7,35,6898
12,12,6,2,34,9,43,6898
13,13,5,2,39,11,50,6898
14,14,8,2,47,13,60,6898
15,15,3,2,50,15,65,6898
16,16,2,2,52,17,69,6898
17,17,3,2,55,19,74,6898
18,18,6,0,61,19,80,6898
19,19,6,0,67,19,86,6898
20,20,6,0,73,19,92,6898
21,21,6,0,79,19,98,6898
22,22,3,3,82,22,104,6898
23,23,5,1,87,23,110,6898
24,24,4,0,91,23,114,6898
25,25,1,0,92,23,115,6898
26,26,0,0,92,23,115,6898
0,0,1,0,1,0,1,6899
1,1,1,1,2,1,3,6899
2,2,0,0,2,1,3,6899
0,0,1,0,1,0,1,6900
1,1,1,0,2,0,2,6900
2,2,2,0,4,0,4,6900
3,3,0,1,4,1,5,6900
4,4,0,1,4,2,6,6900
5,5,1,1,5,3,8,6900
6,6,1,0,6,3,9,6900
7,7,0,0,6,3,9,6900
0,0,1,0,1,0,1,6901
1,1,1,0,2,0,2,6901
2,2,0,0,2,0,2,6901
0,0,1,0,1,0,1,6902
1,1,0,0,1,0,1,6902
0,0,1,0,1,0,1,6903
1,1,1,0,2,0,2,6903
2,2,3,1,5,1,6,6903
3,3,1,0,6,1,7,6903
4,4,0,0,6,1,7,6903
0,0,1,0,1,0,1,6904
1,1,1,0,2,0,2,6904
2,2,1,0,3,0,3,6904
3,3,0,0,3,0,3,6904
0,0,1,0,1,0,1,6905
1,1,3,0,4,0,4,6905
2,2,1,1,5,1,6,6905
3,3,0,0,5,1,6,6905
0,0,1,0,1,0,1,6906
1,1,0,1,1,1,2,6906
2,2,0,0,1,1,2,6906
0,0,1,0,1,0,1,6907
1,1,2,0,3,0,3,6907
2,2,0,0,3,0,3,6907
0,0,1,0,1,0,1,6908
1,1,0,0,1,0,1,6908
0,0,1,0,1,0,1,6909
1,1,0,0,1,0,1,6909
0,0,1,0,1,0,1,6910
1,1,0,0,1,0,1,6910
0,0,1,0,1,0,1,6911
1,1,1,1,2,1,3,6911
2,2,0,0,2,1,3,6911
0,0,1,0,1,0,1,6912
1,1,0,0,1,0,1,6912
0,0,1,0,1,0,1,6913
1,1,0,1,1,1,2,6913
2,2,1,1,2,2,4,6913
3,3,1,2,3,4,7,6913
4,4,0,1,3,5,8,6913
5,5,0,1,3,6,9,6913
6,6,0,1,3,7,10,6913
7,7,0,1,3,8,11,6913
8,8,1,0,4,8,12,6913
9,9,0,0,4,8,12,6913
0,0,1,0,1,0,1,6914
1,1,1,0,2,0,2,6914
2,2,2,0,4,0,4,6914
3,3,0,2,4,2,6,6914
4,4,1,2,5,4,9,6914
5,5,0,1,5,5,10,6914
6,6,0,1,5,6,11,6914
7,7,2,0,7,6,13,6914
8,8,2,0,9,6,15,6914
9,9,1,0,10,6,16,6914
10,10,1,0,11,6,17,6914
11,11,0,0,11,6,17,6914
0,0,1,0,1,0,1,6915
1,1,1,0,2,0,2,6915
2,2,2,0,4,0,4,6915
3,3,2,0,6,0,6,6915
4,4,0,1,6,1,7,6915
5,5,0,0,6,1,7,6915
0,0,1,0,1,0,1,6916
1,1,0,0,1,0,1,6916
0,0,1,0,1,0,1,6917
1,1,0,0,1,0,1,6917
0,0,1,0,1,0,1,6918
1,1,1,0,2,0,2,6918
2,2,1,0,3,0,3,6918
3,3,1,0,4,0,4,6918
4,4,2,0,6,0,6,6918
5,5,0,0,6,0,6,6918
0,0,1,0,1,0,1,6919
1,1,1,0,2,0,2,6919
2,2,1,0,3,0,3,6919
3,3,0,0,3,0,3,6919
0,0,1,0,1,0,1,6920
1,1,0,0,1,0,1,6920
0,0,1,0,1,0,1,6921
1,1,1,1,2,1,3,6921
2,2,2,2,4,3,7,6921
3,3,2,1,6,4,10,6921
4,4,1,0,7,4,11,6921
5,5,0,0,7,4,11,6921
0,0,1,0,1,0,1,6922
1,1,1,0,2,0,2,6922
2,2,1,0,3,0,3,6922
3,3,1,0,4,0,4,6922
4,4,1,0,5,0,5,6922
5,5,0,0,5,0,5,6922
0,0,1,0,1,0,1,6923
1,1,1,0,2,0,2,6923
2,2,2,0,4,0,4,6923
3,3,0,0,4,0,4,6923
0,0,1,0,1,0,1,6924
1,1,3,0,4,0,4,6924
2,2,1,0,5,0,5,6924
3,3,0,0,5,0,5,6924
0,0,1,0,1,0,1,6925
1,1,0,1,1,1,2,6925
2,2,0,0,1,1,2,6925
0,0,1,0,1,0,1,6926
1,1,1,0,2,0,2,6926
2,2,0,1,2,1,3,6926
3,3,0,1,2,2,4,6926
4,4,1,0,3,2,5,6926
5,5,1,0,4,2,6,6926
6,6,0,0,4,2,6,6926
0,0,1,0,1,0,1,6927
1,1,1,0,2,0,2,6927
2,2,0,0,2,0,2,6927
0,0,1,0,1,0,1,6928
1,1,0,1,1,1,2,6928
2,2,0,1,1,2,3,6928
3,3,0,0,1,2,3,6928
0,0,1,0,1,0,1,6929
1,1,0,0,1,0,1,6929
0,0,1,0,1,0,1,6930
1,1,0,0,1,0,1,6930
0,0,1,0,1,0,1,6931
1,1,1,0,2,0,2,6931
2,2,1,0,3,0,3,6931
3,3,1,0,4,0,4,6931
4,4,3,0,7,0,7,6931
5,5,3,0,10,0,10,6931
6,6,2,0,12,0,12,6931
7,7,3,0,15,0,15,6931
8,8,2,0,17,0,17,6931
9,9,3,0,20,0,20,6931
10,10,1,0,21,0,21,6931
11,11,1,0,22,0,22,6931
12,12,0,0,22,0,22,6931
0,0,1,0,1,0,1,6932
1,1,0,0,1,0,1,6932
0,0,1,0,1,0,1,6933
1,1,3,0,4,0,4,6933
2,2,1,0,5,0,5,6933
3,3,0,1,5,1,6,6933
4,4,0,2,5,3,8,6933
5,5,1,3,6,6,12,6933
6,6,2,4,8,10,18,6933
7,7,3,5,11,15,26,6933
8,8,4,4,15,19,34,6933
9,9,2,2,17,21,38,6933
10,10,2,1,19,22,41,6933
11,11,1,2,20,24,44,6933
12,12,0,2,20,26,46,6933
13,13,0,2,20,28,48,6933
14,14,0,2,20,30,50,6933
15,15,0,1,20,31,51,6933
16,16,0,1,20,32,52,6933
17,17,0,1,20,33,53,6933
18,18,0,2,20,35,55,6933
19,19,0,1,20,36,56,6933
20,20,0,1,20,37,57,6933
21,21,0,0,20,37,57,6933
0,0,1,0,1,0,1,6934
1,1,0,0,1,0,1,6934
0,0,1,0,1,0,1,6935
1,1,0,0,1,0,1,6935
0,0,1,0,1,0,1,6936
1,1,0,0,1,0,1,6936
0,0,1,0,1,0,1,6937
1,1,0,0,1,0,1,6937
0,0,1,0,1,0,1,6938
1,1,1,0,2,0,2,6938
2,2,0,0,2,0,2,6938
0,0,1,0,1,0,1,6939
1,1,1,0,2,0,2,6939
2,2,1,0,3,0,3,6939
3,3,0,1,3,1,4,6939
4,4,0,1,3,2,5,6939
5,5,0,2,3,4,7,6939
6,6,0,1,3,5,8,6939
7,7,0,2,3,7,10,6939
8,8,1,1,4,8,12,6939
9,9,0,0,4,8,12,6939
0,0,1,0,1,0,1,6940
1,1,1,0,2,0,2,6940
2,2,2,0,4,0,4,6940
3,3,1,0,5,0,5,6940
4,4,2,1,7,1,8,6940
5,5,3,0,10,1,11,6940
6,6,4,0,14,1,15,6940
7,7,4,1,18,2,20,6940
8,8,1,2,19,4,23,6940
9,9,1,0,20,4,24,6940
10,10,0,0,20,4,24,6940
0,0,1,0,1,0,1,6941
1,1,1,0,2,0,2,6941
2,2,0,1,2,1,3,6941
3,3,0,0,2,1,3,6941
0,0,1,0,1,0,1,6942
1,1,0,0,1,0,1,6942
0,0,1,0,1,0,1,6943
1,1,0,0,1,0,1,6943
0,0,1,0,1,0,1,6944
1,1,0,0,1,0,1,6944
0,0,1,0,1,0,1,6945
1,1,0,0,1,0,1,6945
0,0,1,0,1,0,1,6946
1,1,1,0,2,0,2,6946
2,2,3,0,5,0,5,6946
3,3,1,1,6,1,7,6946
4,4,2,1,8,2,10,6946
5,5,3,3,11,5,16,6946
6,6,3,1,14,6,20,6946
7,7,1,2,15,8,23,6946
8,8,1,2,16,10,26,6946
9,9,0,0,16,10,26,6946
0,0,1,0,1,0,1,6947
1,1,3,0,4,0,4,6947
2,2,1,2,5,2,7,6947
3,3,0,2,5,4,9,6947
4,4,0,0,5,4,9,6947
0,0,1,0,1,0,1,6948
1,1,1,0,2,0,2,6948
2,2,0,0,2,0,2,6948
0,0,1,0,1,0,1,6949
1,1,0,0,1,0,1,6949
0,0,1,0,1,0,1,6950
1,1,0,0,1,0,1,6950
0,0,1,0,1,0,1,6951
1,1,1,0,2,0,2,6951
2,2,2,0,4,0,4,6951
3,3,3,0,7,0,7,6951
4,4,2,1,9,1,10,6951
5,5,0,0,9,1,10,6951
0,0,1,0,1,0,1,6952
1,1,2,0,3,0,3,6952
2,2,0,0,3,0,3,6952
0,0,1,0,1,0,1,6953
1,1,1,0,2,0,2,6953
2,2,2,0,4,0,4,6953
3,3,0,0,4,0,4,6953
0,0,1,0,1,0,1,6954
1,1,1,0,2,0,2,6954
2,2,1,0,3,0,3,6954
3,3,1,0,4,0,4,6954
4,4,1,0,5,0,5,6954
5,5,0,0,5,0,5,6954
0,0,1,0,1,0,1,6955
1,1,1,0,2,0,2,6955
2,2,0,0,2,0,2,6955
0,0,1,0,1,0,1,6956
1,1,1,0,2,0,2,6956
2,2,2,0,4,0,4,6956
3,3,4,0,8,0,8,6956
4,4,1,1,9,1,10,6956
5,5,0,1,9,2,11,6956
6,6,0,0,9,2,11,6956
0,0,1,0,1,0,1,6957
1,1,0,0,1,0,1,6957
0,0,1,0,1,0,1,6958
1,1,1,0,2,0,2,6958
2,2,0,0,2,0,2,6958
0,0,1,0,1,0,1,6959
1,1,1,1,2,1,3,6959
2,2,0,0,2,1,3,6959
0,0,1,0,1,0,1,6960
1,1,2,1,3,1,4,6960
2,2,4,2,7,3,10,6960
3,3,4,1,11,4,15,6960
4,4,4,3,15,7,22,6960
5,5,4,2,19,9,28,6960
6,6,3,1,22,10,32,6960
7,7,3,3,25,13,38,6960
8,8,1,3,26,16,42,6960
9,9,1,1,27,17,44,6960
10,10,0,1,27,18,45,6960
11,11,0,2,27,20,47,6960
12,12,0,1,27,21,48,6960
13,13,1,0,28,21,49,6960
14,14,1,1,29,22,51,6960
15,15,2,1,31,23,54,6960
16,16,2,0,33,23,56,6960
17,17,2,1,35,24,59,6960
18,18,2,3,37,27,64,6960
19,19,2,0,39,27,66,6960
20,20,4,0,43,27,70,6960
21,21,1,1,44,28,72,6960
22,22,1,0,45,28,73,6960
23,23,3,0,48,28,76,6960
24,24,3,0,51,28,79,6960
25,25,1,1,52,29,81,6960
26,26,0,0,52,29,81,6960
0,0,1,0,1,0,1,6961
1,1,1,0,2,0,2,6961
2,2,1,0,3,0,3,6961
3,3,1,0,4,0,4,6961
4,4,2,1,6,1,7,6961
5,5,1,0,7,1,8,6961
6,6,1,0,8,1,9,6961
7,7,2,0,10,1,11,6961
8,8,2,2,12,3,15,6961
9,9,3,1,15,4,19,6961
10,10,1,1,16,5,21,6961
11,11,0,1,16,6,22,6961
12,12,0,3,16,9,25,6961
13,13,2,3,18,12,30,6961
14,14,4,2,22,14,36,6961
15,15,2,1,24,15,39,6961
16,16,0,4,24,19,43,6961
17,17,1,2,25,21,46,6961
18,18,0,0,25,21,46,6961
0,0,1,0,1,0,1,6962
1,1,0,0,1,0,1,6962
0,0,1,0,1,0,1,6963
1,1,1,0,2,0,2,6963
2,2,1,0,3,0,3,6963
3,3,2,0,5,0,5,6963
4,4,3,0,8,0,8,6963
5,5,4,0,12,0,12,6963
6,6,4,1,16,1,17,6963
7,7,6,1,22,2,24,6963
8,8,8,1,30,3,33,6963
9,9,6,4,36,7,43,6963
10,10,5,2,41,9,50,6963
11,11,5,3,46,12,58,6963
12,12,4,5,50,17,67,6963
13,13,1,5,51,22,73,6963
14,14,0,2,51,24,75,6963
15,15,0,3,51,27,78,6963
16,16,1,0,52,27,79,6963
17,17,0,0,52,27,79,6963
0,0,1,0,1,0,1,6964
1,1,1,1,2,1,3,6964
2,2,2,0,4,1,5,6964
3,3,1,0,5,1,6,6964
4,4,2,0,7,1,8,6964
5,5,6,0,13,1,14,6964
6,6,5,0,18,1,19,6964
7,7,3,0,21,1,22,6964
8,8,4,0,25,1,26,6964
9,9,2,1,27,2,29,6964
10,10,4,2,31,4,35,6964
11,11,1,4,32,8,40,6964
12,12,0,1,32,9,41,6964
13,13,0,0,32,9,41,6964
0,0,1,0,1,0,1,6965
1,1,0,1,1,1,2,6965
2,2,0,0,1,1,2,6965
0,0,1,0,1,0,1,6966
1,1,0,1,1,1,2,6966
2,2,1,1,2,2,4,6966
3,3,0,2,2,4,6,6966
4,4,0,1,2,5,7,6966
5,5,0,1,2,6,8,6966
6,6,0,0,2,6,8,6966
0,0,1,0,1,0,1,6967
1,1,1,0,2,0,2,6967
2,2,0,0,2,0,2,6967
0,0,1,0,1,0,1,6968
1,1,2,0,3,0,3,6968
2,2,1,0,4,0,4,6968
3,3,0,0,4,0,4,6968
0,0,1,0,1,0,1,6969
1,1,0,1,1,1,2,6969
2,2,0,1,1,2,3,6969
3,3,0,0,1,2,3,6969
0,0,1,0,1,0,1,6970
1,1,2,0,3,0,3,6970
2,2,1,0,4,0,4,6970
3,3,0,0,4,0,4,6970
0,0,1,0,1,0,1,6971
1,1,0,0,1,0,1,6971
0,0,1,0,1,0,1,6972
1,1,1,0,2,0,2,6972
2,2,0,0,2,0,2,6972
0,0,1,0,1,0,1,6973
1,1,1,0,2,0,2,6973
2,2,0,0,2,0,2,6973
0,0,1,0,1,0,1,6974
1,1,0,0,1,0,1,6974
0,0,1,0,1,0,1,6975
1,1,1,1,2,1,3,6975
2,2,1,0,3,1,4,6975
3,3,1,0,4,1,5,6975
4,4,0,1,4,2,6,6975
5,5,1,0,5,2,7,6975
6,6,0,0,5,2,7,6975
0,0,1,0,1,0,1,6976
1,1,0,0,1,0,1,6976
0,0,1,0,1,0,1,6977
1,1,3,0,4,0,4,6977
2,2,2,1,6,1,7,6977
3,3,7,0,13,1,14,6977
4,4,8,0,21,1,22,6977
5,5,4,1,25,2,27,6977
6,6,3,4,28,6,34,6977
7,7,4,3,32,9,41,6977
8,8,2,7,34,16,50,6977
9,9,4,8,38,24,62,6977
10,10,3,7,41,31,72,6977
11,11,4,7,45,38,83,6977
12,12,4,6,49,44,93,6977
13,13,5,3,54,47,101,6977
14,14,7,5,61,52,113,6977
15,15,5,7,66,59,125,6977
16,16,5,4,71,63,134,6977
17,17,2,4,73,67,140,6977
18,18,2,1,75,68,143,6977
19,19,0,0,75,68,143,6977
0,0,1,0,1,0,1,6978
1,1,1,0,2,0,2,6978
2,2,0,0,2,0,2,6978
0,0,1,0,1,0,1,6979
1,1,1,0,2,0,2,6979
2,2,1,1,3,1,4,6979
3,3,0,2,3,3,6,6979
4,4,1,1,4,4,8,6979
5,5,0,0,4,4,8,6979
0,0,1,0,1,0,1,6980
1,1,1,0,2,0,2,6980
2,2,2,0,4,0,4,6980
3,3,0,0,4,0,4,6980
0,0,1,0,1,0,1,6981
1,1,0,1,1,1,2,6981
2,2,0,0,1,1,2,6981
0,0,1,0,1,0,1,6982
1,1,0,0,1,0,1,6982
0,0,1,0,1,0,1,6983
1,1,1,0,2,0,2,6983
2,2,0,0,2,0,2,6983
0,0,1,0,1,0,1,6984
1,1,1,0,2,0,2,6984
2,2,0,0,2,0,2,6984
0,0,1,0,1,0,1,6985
1,1,0,1,1,1,2,6985
2,2,2,0,3,1,4,6985
3,3,4,1,7,2,9,6985
4,4,4,0,11,2,13,6985
5,5,1,1,12,3,15,6985
6,6,2,0,14,3,17,6985
7,7,5,0,19,3,22,6985
8,8,2,0,21,3,24,6985
9,9,0,0,21,3,24,6985
0,0,1,0,1,0,1,6986
1,1,0,0,1,0,1,6986
0,0,1,0,1,0,1,6987
1,1,1,0,2,0,2,6987
2,2,1,0,3,0,3,6987
3,3,1,0,4,0,4,6987
4,4,0,0,4,0,4,6987
0,0,1,0,1,0,1,6988
1,1,1,0,2,0,2,6988
2,2,1,0,3,0,3,6988
3,3,2,1,5,1,6,6988
4,4,1,1,6,2,8,6988
5,5,0,3,6,5,11,6988
6,6,0,1,6,6,12,6988
7,7,0,1,6,7,13,6988
8,8,0,1,6,8,14,6988
9,9,0,2,6,10,16,6988
10,10,0,1,6,11,17,6988
11,11,0,1,6,12,18,6988
12,12,1,0,7,12,19,6988
13,13,0,0,7,12,19,6988
0,0,1,0,1,0,1,6989
1,1,1,0,2,0,2,6989
2,2,1,0,3,0,3,6989
3,3,0,0,3,0,3,6989
0,0,1,0,1,0,1,6990
1,1,1,0,2,0,2,6990
2,2,0,0,2,0,2,6990
0,0,1,0,1,0,1,6991
1,1,1,0,2,0,2,6991
2,2,2,0,4,0,4,6991
3,3,4,0,8,0,8,6991
4,4,8,0,16,0,16,6991
5,5,4,1,20,1,21,6991
6,6,3,2,23,3,26,6991
7,7,4,0,27,3,30,6991
8,8,2,3,29,6,35,6991
9,9,0,2,29,8,37,6991
10,10,0,0,29,8,37,6991
0,0,1,0,1,0,1,6992
1,1,0,0,1,0,1,6992
0,0,1,0,1,0,1,6993
1,1,1,0,2,0,2,6993
2,2,1,0,3,0,3,6993
3,3,1,0,4,0,4,6993
4,4,1,0,5,0,5,6993
5,5,0,0,5,0,5,6993
0,0,1,0,1,0,1,6994
1,1,1,0,2,0,2,6994
2,2,0,0,2,0,2,6994
0,0,1,0,1,0,1,6995
1,1,0,0,1,0,1,6995
0,0,1,0,1,0,1,6996
1,1,0,0,1,0,1,6996
0,0,1,0,1,0,1,6997
1,1,0,0,1,0,1,6997
0,0,1,0,1,0,1,6998
1,1,3,0,4,0,4,6998
2,2,4,0,8,0,8,6998
3,3,2,0,10,0,10,6998
4,4,0,1,10,1,11,6998
5,5,0,3,10,4,14,6998
6,6,0,3,10,7,17,6998
7,7,2,1,12,8,20,6998
8,8,4,1,16,9,25,6998
9,9,5,1,21,10,31,6998
10,10,5,1,26,11,37,6998
11,11,3,2,29,13,42,6998
12,12,0,0,29,13,42,6998
0,0,1,0,1,0,1,6999
1,1,1,0,2,0,2,6999
2,2,1,0,3,0,3,6999
3,3,1,0,4,0,4,6999
4,4,0,0,4,0,4,6999
0,0,1,0,1,0,1,7000
1,1,2,0,3,0,3,7000
2,2,1,1,4,1,5,7000
3,3,1,2,5,3,8,7000
4,4,1,2,6,5,11,7000
5,5,1,1,7,6,13,7000
6,6,0,0,7,6,13,7000
0,0,1,0,1,0,1,7001
1,1,1,0,2,0,2,7001
2,2,2,1,4,1,5,7001
3,3,1,1,5,2,7,7001
4,4,1,0,6,2,8,7001
5,5,1,0,7,2,9,7001
6,6,1,0,8,2,10,7001
7,7,0,0,8,2,10,7001
0,0,1,0,1,0,1,7002
1,1,2,1,3,1,4,7002
2,2,0,1,3,2,5,7002
3,3,1,0,4,2,6,7002
4,4,1,0,5,2,7,7002
5,5,1,1,6,3,9,7002
6,6,2,0,8,3,11,7002
7,7,1,2,9,5,14,7002
8,8,2,1,11,6,17,7002
9,9,2,2,13,8,21,7002
10,10,2,3,15,11,26,7002
11,11,3,4,18,15,33,7002
12,12,3,3,21,18,39,7002
13,13,7,2,28,20,48,7002
14,14,4,3,32,23,55,7002
15,15,4,4,36,27,63,7002
16,16,1,1,37,28,65,7002
17,17,2,0,39,28,67,7002
18,18,0,1,39,29,68,7002
19,19,0,1,39,30,69,7002
20,20,0,0,39,30,69,7002
0,0,1,0,1,0,1,7003
1,1,0,0,1,0,1,7003
0,0,1,0,1,0,1,7004
1,1,1,2,2,2,4,7004
2,2,0,7,2,9,11,7004
3,3,3,6,5,15,20,7004
4,4,2,3,7,18,25,7004
5,5,2,4,9,22,31,7004
6,6,1,2,10,24,34,7004
7,7,1,3,11,27,38,7004
8,8,1,2,12,29,41,7004
9,9,2,1,14,30,44,7004
10,10,2,3,16,33,49,7004
11,11,2,1,18,34,52,7004
12,12,0,1,18,35,53,7004
13,13,0,0,18,35,53,7004
0,0,1,0,1,0,1,7005
1,1,0,0,1,0,1,7005
0,0,1,0,1,0,1,7006
1,1,0,1,1,1,2,7006
2,2,0,1,1,2,3,7006
3,3,1,0,2,2,4,7006
4,4,2,0,4,2,6,7006
5,5,2,0,6,2,8,7006
6,6,2,0,8,2,10,7006
7,7,0,0,8,2,10,7006
0,0,1,0,1,0,1,7007
1,1,0,0,1,0,1,7007
0,0,1,0,1,0,1,7008
1,1,0,1,1,1,2,7008
2,2,1,1,2,2,4,7008
3,3,0,3,2,5,7,7008
4,4,0,5,2,10,12,7008
5,5,2,3,4,13,17,7008
6,6,3,4,7,17,24,7008
7,7,1,2,8,19,27,7008
8,8,2,0,10,19,29,7008
9,9,1,0,11,19,30,7008
10,10,3,1,14,20,34,7008
11,11,3,2,17,22,39,7008
12,12,2,2,19,24,43,7008
13,13,1,0,20,24,44,7008
14,14,0,0,20,24,44,7008
0,0,1,0,1,0,1,7009
1,1,0,0,1,0,1,7009
0,0,1,0,1,0,1,7010
1,1,1,0,2,0,2,7010
2,2,1,0,3,0,3,7010
3,3,1,0,4,0,4,7010
4,4,0,0,4,0,4,7010
0,0,1,0,1,0,1,7011
1,1,1,0,2,0,2,7011
2,2,0,0,2,0,2,7011
0,0,1,0,1,0,1,7012
1,1,0,0,1,0,1,7012
0,0,1,0,1,0,1,7013
1,1,2,2,3,2,5,7013
2,2,2,0,5,2,7,7013
3,3,3,1,8,3,11,7013
4,4,3,0,11,3,14,7013
5,5,2,1,13,4,17,7013
6,6,1,1,14,5,19,7013
7,7,2,1,16,6,22,7013
8,8,3,1,19,7,26,7013
9,9,0,3,19,10,29,7013
10,10,1,4,20,14,34,7013
11,11,4,2,24,16,40,7013
12,12,1,2,25,18,43,7013
13,13,0,0,25,18,43,7013
0,0,1,0,1,0,1,7014
1,1,1,1,2,1,3,7014
2,2,1,4,3,5,8,7014
3,3,0,1,3,6,9,7014
4,4,0,1,3,7,10,7014
5,5,2,4,5,11,16,7014
6,6,5,2,10,13,23,7014
7,7,5,2,15,15,30,7014
8,8,4,1,19,16,35,7014
9,9,2,1,21,17,38,7014
10,10,0,1,21,18,39,7014
11,11,0,1,21,19,40,7014
12,12,0,0,21,19,40,7014
0,0,1,0,1,0,1,7015
1,1,1,0,2,0,2,7015
2,2,1,0,3,0,3,7015
3,3,1,0,4,0,4,7015
4,4,0,0,4,0,4,7015
0,0,1,0,1,0,1,7016
1,1,2,0,3,0,3,7016
2,2,0,2,3,2,5,7016
3,3,0,3,3,5,8,7016
4,4,2,1,5,6,11,7016
5,5,3,0,8,6,14,7016
6,6,2,2,10,8,18,7016
7,7,2,1,12,9,21,7016
8,8,2,1,14,10,24,7016
9,9,1,1,15,11,26,7016
10,10,1,1,16,12,28,7016
11,11,1,1,17,13,30,7016
12,12,0,1,17,14,31,7016
13,13,0,1,17,15,32,7016
14,14,0,0,17,15,32,7016
0,0,1,0,1,0,1,7017
1,1,0,0,1,0,1,7017
0,0,1,0,1,0,1,7018
1,1,1,0,2,0,2,7018
2,2,2,1,4,1,5,7018
3,3,5,0,9,1,10,7018
4,4,7,0,16,1,17,7018
5,5,6,1,22,2,24,7018
6,6,3,4,25,6,31,7018
7,7,0,3,25,9,34,7018
8,8,0,3,25,12,37,7018
9,9,2,3,27,15,42,7018
10,10,2,5,29,20,49,7018
11,11,4,4,33,24,57,7018
12,12,5,3,38,27,65,7018
13,13,7,1,45,28,73,7018
14,14,6,4,51,32,83,7018
15,15,6,6,57,38,95,7018
16,16,5,6,62,44,106,7018
17,17,6,4,68,48,116,7018
18,18,5,8,73,56,129,7018
19,19,2,8,75,64,139,7018
20,20,8,6,83,70,153,7018
21,21,4,6,87,76,163,7018
22,22,3,3,90,79,169,7018
23,23,2,4,92,83,175,7018
24,24,2,2,94,85,179,7018
25,25,1,1,95,86,181,7018
26,26,2,4,97,90,187,7018
27,27,2,2,99,92,191,7018
28,28,4,1,103,93,196,7018
29,29,4,3,107,96,203,7018
30,30,3,3,110,99,209,7018
31,31,3,3,113,102,215,7018
32,32,3,2,116,104,220,7018
33,33,1,4,117,108,225,7018
34,34,0,4,117,112,229,7018
35,35,2,4,119,116,235,7018
36,36,4,1,123,117,240,7018
37,37,1,2,124,119,243,7018
38,38,0,3,124,122,246,7018
39,39,0,3,124,125,249,7018
40,40,0,5,124,130,254,7018
41,41,2,3,126,133,259,7018
42,42,2,4,128,137,265,7018
43,43,1,5,129,142,271,7018
44,44,1,9,130,151,281,7018
45,45,3,6,133,157,290,7018
46,46,6,8,139,165,304,7018
47,47,2,6,141,171,312,7018
48,48,3,5,144,176,320,7018
49,49,5,3,149,179,328,7018
50,50,6,3,155,182,337,7018
51,51,6,2,161,184,345,7018
52,52,4,3,165,187,352,7018
53,53,3,2,168,189,357,7018
54,54,0,5,168,194,362,7018
55,55,1,2,169,196,365,7018
56,56,2,1,171,197,368,7018
57,57,1,3,172,200,372,7018
58,58,2,4,174,204,378,7018
59,59,1,5,175,209,384,7018
60,60,3,3,178,212,390,7018
61,61,2,3,180,215,395,7018
62,62,3,3,183,218,401,7018
63,63,2,1,185,219,404,7018
64,64,3,2,188,221,409,7018
65,65,6,3,194,224,418,7018
66,66,4,1,198,225,423,7018
67,67,0,2,198,227,425,7018
68,68,0,2,198,229,427,7018
69,69,1,2,199,231,430,7018
70,70,4,2,203,233,436,7018
71,71,4,0,207,233,440,7018
72,72,1,0,208,233,441,7018
73,73,1,0,209,233,442,7018
74,74,0,0,209,233,442,7018
0,0,1,0,1,0,1,7019
1,1,1,0,2,0,2,7019
2,2,1,0,3,0,3,7019
3,3,0,0,3,0,3,7019
0,0,1,0,1,0,1,7020
1,1,1,0,2,0,2,7020
2,2,1,0,3,0,3,7020
3,3,0,0,3,0,3,7020
0,0,1,0,1,0,1,7021
1,1,1,0,2,0,2,7021
2,2,0,0,2,0,2,7021
0,0,1,0,1,0,1,7022
1,1,0,0,1,0,1,7022
0,0,1,0,1,0,1,7023
1,1,2,0,3,0,3,7023
2,2,0,0,3,0,3,7023
0,0,1,0,1,0,1,7024
1,1,0,1,1,1,2,7024
2,2,0,1,1,2,3,7024
3,3,0,1,1,3,4,7024
4,4,0,1,1,4,5,7024
5,5,1,0,2,4,6,7024
6,6,2,0,4,4,8,7024
7,7,3,1,7,5,12,7024
8,8,2,1,9,6,15,7024
9,9,2,0,11,6,17,7024
10,10,1,0,12,6,18,7024
11,11,2,0,14,6,20,7024
12,12,3,0,17,6,23,7024
13,13,3,0,20,6,26,7024
14,14,3,0,23,6,29,7024
15,15,1,1,24,7,31,7024
16,16,0,1,24,8,32,7024
17,17,1,0,25,8,33,7024
18,18,2,0,27,8,35,7024
19,19,3,1,30,9,39,7024
20,20,5,2,35,11,46,7024
21,21,3,3,38,14,52,7024
22,22,4,4,42,18,60,7024
23,23,8,5,50,23,73,7024
24,24,6,8,56,31,87,7024
25,25,5,14,61,45,106,7024
26,26,12,11,73,56,129,7024
27,27,8,11,81,67,148,7024
28,28,4,11,85,78,163,7024
29,29,5,9,90,87,177,7024
30,30,5,12,95,99,194,7024
31,31,9,8,104,107,211,7024
32,32,9,6,113,113,226,7024
33,33,10,11,123,124,247,7024
34,34,8,12,131,136,267,7024
35,35,9,5,140,141,281,7024
36,36,4,6,144,147,291,7024
37,37,1,6,145,153,298,7024
38,38,5,5,150,158,308,7024
39,39,3,7,153,165,318,7024
40,40,7,5,160,170,330,7024
41,41,7,5,167,175,342,7024
42,42,6,1,173,176,349,7024
43,43,7,2,180,178,358,7024
44,44,4,1,184,179,363,7024
45,45,6,2,190,181,371,7024
46,46,4,2,194,183,377,7024
47,47,3,2,197,185,382,7024
48,48,1,5,198,190,388,7024
49,49,1,2,199,192,391,7024
50,50,1,1,200,193,393,7024
51,51,2,0,202,193,395,7024
52,52,1,0,203,193,396,7024
53,53,0,0,203,193,396,7024
0,0,1,0,1,0,1,7025
1,1,2,0,3,0,3,7025
2,2,2,1,5,1,6,7025
3,3,3,1,8,2,10,7025
4,4,2,1,10,3,13,7025
5,5,2,2,12,5,17,7025
6,6,0,0,12,5,17,7025
0,0,1,0,1,0,1,7026
1,1,0,0,1,0,1,7026
0,0,1,0,1,0,1,7027
1,1,0,0,1,0,1,7027
0,0,1,0,1,0,1,7028
1,1,0,1,1,1,2,7028
2,2,0,1,1,2,3,7028
3,3,0,3,1,5,6,7028
4,4,0,5,1,10,11,7028
5,5,3,5,4,15,19,7028
6,6,5,3,9,18,27,7028
7,7,4,3,13,21,34,7028
8,8,1,7,14,28,42,7028
9,9,2,2,16,30,46,7028
10,10,2,2,18,32,50,7028
11,11,0,2,18,34,52,7028
12,12,0,1,18,35,53,7028
13,13,0,1,18,36,54,7028
14,14,1,0,19,36,55,7028
15,15,0,0,19,36,55,7028
0,0,1,0,1,0,1,7029
1,1,2,0,3,0,3,7029
2,2,1,0,4,0,4,7029
3,3,0,1,4,1,5,7029
4,4,0,1,4,2,6,7029
5,5,0,0,4,2,6,7029
0,0,1,0,1,0,1,7030
1,1,0,0,1,0,1,7030
0,0,1,0,1,0,1,7031
1,1,2,1,3,1,4,7031
2,2,0,1,3,2,5,7031
3,3,0,0,3,2,5,7031
0,0,1,0,1,0,1,7032
1,1,0,0,1,0,1,7032
0,0,1,0,1,0,1,7033
1,1,1,0,2,0,2,7033
2,2,1,0,3,0,3,7033
3,3,1,1,4,1,5,7033
4,4,0,0,4,1,5,7033
0,0,1,0,1,0,1,7034
1,1,1,0,2,0,2,7034
2,2,0,0,2,0,2,7034
0,0,1,0,1,0,1,7035
1,1,0,0,1,0,1,7035
0,0,1,0,1,0,1,7036
1,1,0,0,1,0,1,7036
0,0,1,0,1,0,1,7037
1,1,0,0,1,0,1,7037
0,0,1,0,1,0,1,7038
1,1,1,0,2,0,2,7038
2,2,0,0,2,0,2,7038
0,0,1,0,1,0,1,7039
1,1,1,0,2,0,2,7039
2,2,0,0,2,0,2,7039
0,0,1,0,1,0,1,7040
1,1,1,0,2,0,2,7040
2,2,0,0,2,0,2,7040
0,0,1,0,1,0,1,7041
1,1,0,0,1,0,1,7041
0,0,1,0,1,0,1,7042
1,1,0,0,1,0,1,7042
0,0,1,0,1,0,1,7043
1,1,0,0,1,0,1,7043
0,0,1,0,1,0,1,7044
1,1,0,0,1,0,1,7044
0,0,1,0,1,0,1,7045
1,1,0,1,1,1,2,7045
2,2,0,1,1,2,3,7045
3,3,1,0,2,2,4,7045
4,4,1,0,3,2,5,7045
5,5,3,0,6,2,8,7045
6,6,1,1,7,3,10,7045
7,7,1,2,8,5,13,7045
8,8,0,1,8,6,14,7045
9,9,0,0,8,6,14,7045
0,0,1,0,1,0,1,7046
1,1,2,0,3,0,3,7046
2,2,1,0,4,0,4,7046
3,3,0,1,4,1,5,7046
4,4,0,0,4,1,5,7046
0,0,1,0,1,0,1,7047
1,1,1,0,2,0,2,7047
2,2,3,0,5,0,5,7047
3,3,2,0,7,0,7,7047
4,4,2,0,9,0,9,7047
5,5,2,0,11,0,11,7047
6,6,0,1,11,1,12,7047
7,7,0,0,11,1,12,7047
0,0,1,0,1,0,1,7048
1,1,1,0,2,0,2,7048
2,2,1,0,3,0,3,7048
3,3,0,0,3,0,3,7048
0,0,1,0,1,0,1,7049
1,1,1,0,2,0,2,7049
2,2,0,0,2,0,2,7049
0,0,1,0,1,0,1,7050
1,1,0,0,1,0,1,7050
0,0,1,0,1,0,1,7051
1,1,0,1,1,1,2,7051
2,2,0,0,1,1,2,7051
0,0,1,0,1,0,1,7052
1,1,3,0,4,0,4,7052
2,2,4,1,8,1,9,7052
3,3,2,2,10,3,13,7052
4,4,2,2,12,5,17,7052
5,5,3,0,15,5,20,7052
6,6,3,0,18,5,23,7052
7,7,0,1,18,6,24,7052
8,8,0,1,18,7,25,7052
9,9,0,1,18,8,26,7052
10,10,0,0,18,8,26,7052
0,0,1,0,1,0,1,7053
1,1,1,0,2,0,2,7053
2,2,2,0,4,0,4,7053
3,3,3,1,7,1,8,7053
4,4,2,0,9,1,10,7053
5,5,3,0,12,1,13,7053
6,6,2,0,14,1,15,7053
7,7,0,1,14,2,16,7053
8,8,0,2,14,4,18,7053
9,9,0,3,14,7,21,7053
10,10,1,1,15,8,23,7053
11,11,0,0,15,8,23,7053
0,0,1,0,1,0,1,7054
1,1,0,0,1,0,1,7054
0,0,1,0,1,0,1,7055
1,1,1,0,2,0,2,7055
2,2,2,1,4,1,5,7055
3,3,1,2,5,3,8,7055
4,4,1,1,6,4,10,7055
5,5,1,1,7,5,12,7055
6,6,1,2,8,7,15,7055
7,7,0,0,8,7,15,7055
0,0,1,0,1,0,1,7056
1,1,0,0,1,0,1,7056
0,0,1,0,1,0,1,7057
1,1,0,0,1,0,1,7057
0,0,1,0,1,0,1,7058
1,1,2,0,3,0,3,7058
2,2,1,0,4,0,4,7058
3,3,1,0,5,0,5,7058
4,4,1,0,6,0,6,7058
5,5,1,0,7,0,7,7058
6,6,0,0,7,0,7,7058
0,0,1,0,1,0,1,7059
1,1,0,0,1,0,1,7059
0,0,1,0,1,0,1,7060
1,1,0,0,1,0,1,7060
0,0,1,0,1,0,1,7061
1,1,2,0,3,0,3,7061
2,2,1,1,4,1,5,7061
3,3,1,0,5,1,6,7061
4,4,0,0,5,1,6,7061
0,0,1,0,1,0,1,7062
1,1,0,0,1,0,1,7062
0,0,1,0,1,0,1,7063
1,1,1,0,2,0,2,7063
2,2,2,1,4,1,5,7063
3,3,4,2,8,3,11,7063
4,4,3,0,11,3,14,7063
5,5,1,1,12,4,16,7063
6,6,0,2,12,6,18,7063
7,7,0,0,12,6,18,7063
0,0,1,0,1,0,1,7064
1,1,1,0,2,0,2,7064
2,2,0,1,2,1,3,7064
3,3,0,1,2,2,4,7064
4,4,0,0,2,2,4,7064
0,0,1,0,1,0,1,7065
1,1,1,0,2,0,2,7065
2,2,0,0,2,0,2,7065
0,0,1,0,1,0,1,7066
1,1,0,1,1,1,2,7066
2,2,0,1,1,2,3,7066
3,3,0,0,1,2,3,7066
0,0,1,0,1,0,1,7067
1,1,0,0,1,0,1,7067
0,0,1,0,1,0,1,7068
1,1,0,1,1,1,2,7068
2,2,0,3,1,4,5,7068
3,3,0,0,1,4,5,7068
0,0,1,0,1,0,1,7069
1,1,2,0,3,0,3,7069
2,2,0,0,3,0,3,7069
0,0,1,0,1,0,1,7070
1,1,0,0,1,0,1,7070
0,0,1,0,1,0,1,7071
1,1,0,0,1,0,1,7071
0,0,1,0,1,0,1,7072
1,1,1,0,2,0,2,7072
2,2,0,1,2,1,3,7072
3,3,0,1,2,2,4,7072
4,4,0,1,2,3,5,7072
5,5,0,0,2,3,5,7072
0,0,1,0,1,0,1,7073
1,1,2,0,3,0,3,7073
2,2,2,0,5,0,5,7073
3,3,1,0,6,0,6,7073
4,4,0,1,6,1,7,7073
5,5,0,0,6,1,7,7073
0,0,1,0,1,0,1,7074
1,1,1,0,2,0,2,7074
2,2,0,0,2,0,2,7074
0,0,1,0,1,0,1,7075
1,1,0,0,1,0,1,7075
0,0,1,0,1,0,1,7076
1,1,1,0,2,0,2,7076
2,2,0,0,2,0,2,7076
0,0,1,0,1,0,1,7077
1,1,1,0,2,0,2,7077
2,2,0,0,2,0,2,7077
0,0,1,0,1,0,1,7078
1,1,0,0,1,0,1,7078
0,0,1,0,1,0,1,7079
1,1,1,0,2,0,2,7079
2,2,0,1,2,1,3,7079
3,3,0,1,2,2,4,7079
4,4,0,1,2,3,5,7079
5,5,0,1,2,4,6,7079
6,6,0,0,2,4,6,7079
0,0,1,0,1,0,1,7080
1,1,1,0,2,0,2,7080
2,2,0,0,2,0,2,7080
0,0,1,0,1,0,1,7081
1,1,0,0,1,0,1,7081
0,0,1,0,1,0,1,7082
1,1,0,1,1,1,2,7082
2,2,1,1,2,2,4,7082
3,3,0,1,2,3,5,7082
4,4,0,1,2,4,6,7082
5,5,0,0,2,4,6,7082
0,0,1,0,1,0,1,7083
1,1,0,1,1,1,2,7083
2,2,0,1,1,2,3,7083
3,3,0,1,1,3,4,7083
4,4,0,0,1,3,4,7083
0,0,1,0,1,0,1,7084
1,1,1,0,2,0,2,7084
2,2,0,1,2,1,3,7084
3,3,0,2,2,3,5,7084
4,4,0,0,2,3,5,7084
0,0,1,0,1,0,1,7085
1,1,1,0,2,0,2,7085
2,2,1,0,3,0,3,7085
3,3,0,0,3,0,3,7085
0,0,1,0,1,0,1,7086
1,1,0,0,1,0,1,7086
0,0,1,0,1,0,1,7087
1,1,0,1,1,1,2,7087
2,2,0,2,1,3,4,7087
3,3,1,0,2,3,5,7087
4,4,1,0,3,3,6,7087
5,5,1,0,4,3,7,7087
6,6,0,0,4,3,7,7087
0,0,1,0,1,0,1,7088
1,1,0,0,1,0,1,7088
0,0,1,0,1,0,1,7089
1,1,0,0,1,0,1,7089
0,0,1,0,1,0,1,7090
1,1,1,0,2,0,2,7090
2,2,0,1,2,1,3,7090
3,3,0,2,2,3,5,7090
4,4,0,2,2,5,7,7090
5,5,0,3,2,8,10,7090
6,6,0,1,2,9,11,7090
7,7,0,2,2,11,13,7090
8,8,0,2,2,13,15,7090
9,9,0,3,2,16,18,7090
10,10,0,4,2,20,22,7090
11,11,2,1,4,21,25,7090
12,12,1,0,5,21,26,7090
13,13,1,0,6,21,27,7090
14,14,0,0,6,21,27,7090
0,0,1,0,1,0,1,7091
1,1,2,0,3,0,3,7091
2,2,0,0,3,0,3,7091
0,0,1,0,1,0,1,7092
1,1,0,0,1,0,1,7092
0,0,1,0,1,0,1,7093
1,1,1,0,2,0,2,7093
2,2,1,0,3,0,3,7093
3,3,1,0,4,0,4,7093
4,4,2,0,6,0,6,7093
5,5,2,0,8,0,8,7093
6,6,1,1,9,1,10,7093
7,7,2,2,11,3,14,7093
8,8,2,3,13,6,19,7093
9,9,3,3,16,9,25,7093
10,10,1,2,17,11,28,7093
11,11,0,0,17,11,28,7093
0,0,1,0,1,0,1,7094
1,1,0,2,1,2,3,7094
2,2,2,1,3,3,6,7094
3,3,1,1,4,4,8,7094
4,4,0,1,4,5,9,7094
5,5,0,0,4,5,9,7094
0,0,1,0,1,0,1,7095
1,1,0,0,1,0,1,7095
0,0,1,0,1,0,1,7096
1,1,1,0,2,0,2,7096
2,2,1,0,3,0,3,7096
3,3,2,0,5,0,5,7096
4,4,0,0,5,0,5,7096
0,0,1,0,1,0,1,7097
1,1,0,0,1,0,1,7097
0,0,1,0,1,0,1,7098
1,1,2,0,3,0,3,7098
2,2,3,1,6,1,7,7098
3,3,2,0,8,1,9,7098
4,4,1,0,9,1,10,7098
5,5,0,0,9,1,10,7098
0,0,1,0,1,0,1,7099
1,1,0,0,1,0,1,7099
0,0,1,0,1,0,1,7100
1,1,0,0,1,0,1,7100
0,0,1,0,1,0,1,7101
1,1,0,0,1,0,1,7101
0,0,1,0,1,0,1,7102
1,1,0,0,1,0,1,7102
0,0,1,0,1,0,1,7103
1,1,0,0,1,0,1,7103
0,0,1,0,1,0,1,7104
1,1,0,0,1,0,1,7104
0,0,1,0,1,0,1,7105
1,1,0,0,1,0,1,7105
0,0,1,0,1,0,1,7106
1,1,0,0,1,0,1,7106
0,0,1,0,1,0,1,7107
1,1,0,0,1,0,1,7107
0,0,1,0,1,0,1,7108
1,1,0,0,1,0,1,7108
0,0,1,0,1,0,1,7109
1,1,0,0,1,0,1,7109
0,0,1,0,1,0,1,7110
1,1,0,1,1,1,2,7110
2,2,0,0,1,1,2,7110
0,0,1,0,1,0,1,7111
1,1,1,1,2,1,3,7111
2,2,1,2,3,3,6,7111
3,3,0,1,3,4,7,7111
4,4,0,1,3,5,8,7111
5,5,0,0,3,5,8,7111
0,0,1,0,1,0,1,7112
1,1,0,0,1,0,1,7112
0,0,1,0,1,0,1,7113
1,1,0,0,1,0,1,7113
0,0,1,0,1,0,1,7114
1,1,1,0,2,0,2,7114
2,2,1,1,3,1,4,7114
3,3,1,1,4,2,6,7114
4,4,3,1,7,3,10,7114
5,5,1,1,8,4,12,7114
6,6,1,0,9,4,13,7114
7,7,1,0,10,4,14,7114
8,8,0,0,10,4,14,7114
0,0,1,0,1,0,1,7115
1,1,1,0,2,0,2,7115
2,2,0,0,2,0,2,7115
0,0,1,0,1,0,1,7116
1,1,0,1,1,1,2,7116
2,2,0,0,1,1,2,7116
0,0,1,0,1,0,1,7117
1,1,1,0,2,0,2,7117
2,2,0,1,2,1,3,7117
3,3,0,0,2,1,3,7117
0,0,1,0,1,0,1,7118
1,1,1,0,2,0,2,7118
2,2,2,0,4,0,4,7118
3,3,3,0,7,0,7,7118
4,4,6,1,13,1,14,7118
5,5,4,4,17,5,22,7118
6,6,4,3,21,8,29,7118
7,7,5,4,26,12,38,7118
8,8,2,5,28,17,45,7118
9,9,4,3,32,20,52,7118
10,10,5,0,37,20,57,7118
11,11,6,2,43,22,65,7118
12,12,3,2,46,24,70,7118
13,13,0,2,46,26,72,7118
14,14,0,2,46,28,74,7118
15,15,1,1,47,29,76,7118
16,16,2,1,49,30,79,7118
17,17,0,0,49,30,79,7118
0,0,1,0,1,0,1,7119
1,1,1,0,2,0,2,7119
2,2,1,0,3,0,3,7119
3,3,1,0,4,0,4,7119
4,4,2,0,6,0,6,7119
5,5,3,0,9,0,9,7119
6,6,2,1,11,1,12,7119
7,7,2,1,13,2,15,7119
8,8,6,1,19,3,22,7119
9,9,3,1,22,4,26,7119
10,10,0,0,22,4,26,7119
0,0,1,0,1,0,1,7120
1,1,1,1,2,1,3,7120
2,2,1,1,3,2,5,7120
3,3,0,2,3,4,7,7120
4,4,0,3,3,7,10,7120
5,5,1,0,4,7,11,7120
6,6,3,0,7,7,14,7120
7,7,3,1,10,8,18,7120
8,8,1,0,11,8,19,7120
9,9,0,0,11,8,19,7120
0,0,1,0,1,0,1,7121
1,1,0,0,1,0,1,7121
0,0,1,0,1,0,1,7122
1,1,0,0,1,0,1,7122
0,0,1,0,1,0,1,7123
1,1,2,0,3,0,3,7123
2,2,1,0,4,0,4,7123
3,3,0,0,4,0,4,7123
0,0,1,0,1,0,1,7124
1,1,1,0,2,0,2,7124
2,2,0,1,2,1,3,7124
3,3,0,0,2,1,3,7124
0,0,1,0,1,0,1,7125
1,1,2,1,3,1,4,7125
2,2,1,0,4,1,5,7125
3,3,2,0,6,1,7,7125
4,4,1,0,7,1,8,7125
5,5,0,0,7,1,8,7125
0,0,1,0,1,0,1,7126
1,1,0,0,1,0,1,7126
0,0,1,0,1,0,1,7127
1,1,0,0,1,0,1,7127
0,0,1,0,1,0,1,7128
1,1,0,0,1,0,1,7128
0,0,1,0,1,0,1,7129
1,1,2,0,3,0,3,7129
2,2,1,0,4,0,4,7129
3,3,0,0,4,0,4,7129
0,0,1,0,1,0,1,7130
1,1,0,0,1,0,1,7130
0,0,1,0,1,0,1,7131
1,1,1,1,2,1,3,7131
2,2,2,3,4,4,8,7131
3,3,4,2,8,6,14,7131
4,4,4,2,12,8,20,7131
5,5,2,1,14,9,23,7131
6,6,0,0,14,9,23,7131
0,0,1,0,1,0,1,7132
1,1,1,0,2,0,2,7132
2,2,0,0,2,0,2,7132
0,0,1,0,1,0,1,7133
1,1,2,0,3,0,3,7133
2,2,3,1,6,1,7,7133
3,3,7,1,13,2,15,7133
4,4,4,0,17,2,19,7133
5,5,2,2,19,4,23,7133
6,6,1,1,20,5,25,7133
7,7,0,3,20,8,28,7133
8,8,0,1,20,9,29,7133
9,9,0,1,20,10,30,7133
10,10,0,1,20,11,31,7133
11,11,1,0,21,11,32,7133
12,12,0,0,21,11,32,7133
0,0,1,0,1,0,1,7134
1,1,1,1,2,1,3,7134
2,2,2,2,4,3,7,7134
3,3,2,1,6,4,10,7134
4,4,2,0,8,4,12,7134
5,5,2,0,10,4,14,7134
6,6,3,1,13,5,18,7134
7,7,3,0,16,5,21,7134
8,8,4,0,20,5,25,7134
9,9,0,2,20,7,27,7134
10,10,0,1,20,8,28,7134
11,11,0,1,20,9,29,7134
12,12,0,2,20,11,31,7134
13,13,1,0,21,11,32,7134
14,14,0,0,21,11,32,7134
0,0,1,0,1,0,1,7135
1,1,0,0,1,0,1,7135
0,0,1,0,1,0,1,7136
1,1,0,1,1,1,2,7136
2,2,1,1,2,2,4,7136
3,3,0,1,2,3,5,7136
4,4,0,1,2,4,6,7136
5,5,0,2,2,6,8,7136
6,6,0,1,2,7,9,7136
7,7,0,0,2,7,9,7136
0,0,1,0,1,0,1,7137
1,1,1,0,2,0,2,7137
2,2,0,1,2,1,3,7137
3,3,0,1,2,2,4,7137
4,4,0,0,2,2,4,7137
0,0,1,0,1,0,1,7138
1,1,0,0,1,0,1,7138
0,0,1,0,1,0,1,7139
1,1,2,0,3,0,3,7139
2,2,1,0,4,0,4,7139
3,3,1,1,5,1,6,7139
4,4,1,0,6,1,7,7139
5,5,2,2,8,3,11,7139
6,6,2,2,10,5,15,7139
7,7,2,0,12,5,17,7139
8,8,2,0,14,5,19,7139
9,9,3,0,17,5,22,7139
10,10,0,0,17,5,22,7139
0,0,1,0,1,0,1,7140
1,1,0,0,1,0,1,7140
0,0,1,0,1,0,1,7141
1,1,0,0,1,0,1,7141
0,0,1,0,1,0,1,7142
1,1,0,0,1,0,1,7142
0,0,1,0,1,0,1,7143
1,1,0,0,1,0,1,7143
0,0,1,0,1,0,1,7144
1,1,1,0,2,0,2,7144
2,2,2,0,4,0,4,7144
3,3,0,1,4,1,5,7144
4,4,0,0,4,1,5,7144
0,0,1,0,1,0,1,7145
1,1,3,0,4,0,4,7145
2,2,1,1,5,1,6,7145
3,3,0,0,5,1,6,7145
0,0,1,0,1,0,1,7146
1,1,0,1,1,1,2,7146
2,2,0,1,1,2,3,7146
3,3,2,1,3,3,6,7146
4,4,2,0,5,3,8,7146
5,5,6,0,11,3,14,7146
6,6,7,0,18,3,21,7146
7,7,3,2,21,5,26,7146
8,8,1,0,22,5,27,7146
9,9,0,0,22,5,27,7146
0,0,1,0,1,0,1,7147
1,1,0,0,1,0,1,7147
0,0,1,0,1,0,1,7148
1,1,1,0,2,0,2,7148
2,2,2,0,4,0,4,7148
3,3,2,0,6,0,6,7148
4,4,3,0,9,0,9,7148
5,5,2,0,11,0,11,7148
6,6,0,0,11,0,11,7148
0,0,1,0,1,0,1,7149
1,1,1,0,2,0,2,7149
2,2,1,0,3,0,3,7149
3,3,0,0,3,0,3,7149
0,0,1,0,1,0,1,7150
1,1,1,0,2,0,2,7150
2,2,0,0,2,0,2,7150
0,0,1,0,1,0,1,7151
1,1,1,0,2,0,2,7151
2,2,1,0,3,0,3,7151
3,3,1,0,4,0,4,7151
4,4,0,0,4,0,4,7151
0,0,1,0,1,0,1,7152
1,1,0,0,1,0,1,7152
0,0,1,0,1,0,1,7153
1,1,0,1,1,1,2,7153
2,2,1,1,2,2,4,7153
3,3,3,1,5,3,8,7153
4,4,1,0,6,3,9,7153
5,5,2,0,8,3,11,7153
6,6,2,2,10,5,15,7153
7,7,2,2,12,7,19,7153
8,8,4,4,16,11,27,7153
9,9,3,2,19,13,32,7153
10,10,2,2,21,15,36,7153
11,11,3,1,24,16,40,7153
12,12,2,2,26,18,44,7153
13,13,2,1,28,19,47,7153
14,14,2,1,30,20,50,7153
15,15,1,4,31,24,55,7153
16,16,5,3,36,27,63,7153
17,17,2,1,38,28,66,7153
18,18,0,1,38,29,67,7153
19,19,0,0,38,29,67,7153
0,0,1,0,1,0,1,7154
1,1,1,0,2,0,2,7154
2,2,0,0,2,0,2,7154
0,0,1,0,1,0,1,7155
1,1,0,0,1,0,1,7155
0,0,1,0,1,0,1,7156
1,1,1,0,2,0,2,7156
2,2,0,1,2,1,3,7156
3,3,0,0,2,1,3,7156
0,0,1,0,1,0,1,7157
1,1,2,0,3,0,3,7157
2,2,2,2,5,2,7,7157
3,3,3,3,8,5,13,7157
4,4,5,2,13,7,20,7157
5,5,3,1,16,8,24,7157
6,6,3,1,19,9,28,7157
7,7,0,1,19,10,29,7157
8,8,0,1,19,11,30,7157
9,9,0,0,19,11,30,7157
0,0,1,0,1,0,1,7158
1,1,0,0,1,0,1,7158
0,0,1,0,1,0,1,7159
1,1,1,0,2,0,2,7159
2,2,0,0,2,0,2,7159
0,0,1,0,1,0,1,7160
1,1,2,0,3,0,3,7160
2,2,1,0,4,0,4,7160
3,3,1,0,5,0,5,7160
4,4,1,0,6,0,6,7160
5,5,2,0,8,0,8,7160
6,6,2,2,10,2,12,7160
7,7,2,1,12,3,15,7160
8,8,3,0,15,3,18,7160
9,9,3,1,18,4,22,7160
10,10,3,1,21,5,26,7160
11,11,0,6,21,11,32,7160
12,12,3,4,24,15,39,7160
13,13,4,5,28,20,48,7160
14,14,3,7,31,27,58,7160
15,15,2,7,33,34,67,7160
16,16,2,7,35,41,76,7160
17,17,1,3,36,44,80,7160
18,18,3,2,39,46,85,7160
19,19,1,3,40,49,89,7160
20,20,1,3,41,52,93,7160
21,21,0,2,41,54,95,7160
22,22,0,3,41,57,98,7160
23,23,1,4,42,61,103,7160
24,24,1,2,43,63,106,7160
25,25,0,4,43,67,110,7160
26,26,1,3,44,70,114,7160
27,27,0,3,44,73,117,7160
28,28,0,2,44,75,119,7160
29,29,1,0,45,75,120,7160
30,30,2,0,47,75,122,7160
31,31,0,1,47,76,123,7160
32,32,0,0,47,76,123,7160
0,0,1,0,1,0,1,7161
1,1,1,1,2,1,3,7161
2,2,2,0,4,1,5,7161
3,3,3,0,7,1,8,7161
4,4,6,0,13,1,14,7161
5,5,5,0,18,1,19,7161
6,6,0,1,18,2,20,7161
7,7,0,0,18,2,20,7161
0,0,1,0,1,0,1,7162
1,1,1,2,2,2,4,7162
2,2,1,4,3,6,9,7162
3,3,2,2,5,8,13,7162
4,4,1,4,6,12,18,7162
5,5,3,2,9,14,23,7162
6,6,1,1,10,15,25,7162
7,7,0,0,10,15,25,7162
0,0,1,0,1,0,1,7163
1,1,0,0,1,0,1,7163
0,0,1,0,1,0,1,7164
1,1,0,0,1,0,1,7164
0,0,1,0,1,0,1,7165
1,1,2,0,3,0,3,7165
2,2,0,0,3,0,3,7165
0,0,1,0,1,0,1,7166
1,1,2,0,3,0,3,7166
2,2,1,0,4,0,4,7166
3,3,0,0,4,0,4,7166
0,0,1,0,1,0,1,7167
1,1,0,0,1,0,1,7167
0,0,1,0,1,0,1,7168
1,1,0,0,1,0,1,7168
0,0,1,0,1,0,1,7169
1,1,0,0,1,0,1,7169
0,0,1,0,1,0,1,7170
1,1,1,1,2,1,3,7170
2,2,1,1,3,2,5,7170
3,3,1,2,4,4,8,7170
4,4,0,2,4,6,10,7170
5,5,1,3,5,9,14,7170
6,6,1,2,6,11,17,7170
7,7,2,2,8,13,21,7170
8,8,5,1,13,14,27,7170
9,9,5,2,18,16,34,7170
10,10,6,1,24,17,41,7170
11,11,5,2,29,19,48,7170
12,12,5,4,34,23,57,7170
13,13,6,2,40,25,65,7170
14,14,6,1,46,26,72,7170
15,15,3,1,49,27,76,7170
16,16,0,2,49,29,78,7170
17,17,0,2,49,31,80,7170
18,18,1,1,50,32,82,7170
19,19,1,1,51,33,84,7170
20,20,1,1,52,34,86,7170
21,21,1,1,53,35,88,7170
22,22,3,2,56,37,93,7170
23,23,4,2,60,39,99,7170
24,24,2,1,62,40,102,7170
25,25,1,1,63,41,104,7170
26,26,1,0,64,41,105,7170
27,27,1,0,65,41,106,7170
28,28,2,0,67,41,108,7170
29,29,2,0,69,41,110,7170
30,30,1,0,70,41,111,7170
31,31,2,0,72,41,113,7170
32,32,0,0,72,41,113,7170
0,0,1,0,1,0,1,7171
1,1,0,0,1,0,1,7171
0,0,1,0,1,0,1,7172
1,1,0,1,1,1,2,7172
2,2,0,0,1,1,2,7172
0,0,1,0,1,0,1,7173
1,1,0,0,1,0,1,7173
0,0,1,0,1,0,1,7174
1,1,1,0,2,0,2,7174
2,2,1,0,3,0,3,7174
3,3,1,0,4,0,4,7174
4,4,0,0,4,0,4,7174
0,0,1,0,1,0,1,7175
1,1,0,0,1,0,1,7175
0,0,1,0,1,0,1,7176
1,1,0,0,1,0,1,7176
0,0,1,0,1,0,1,7177
1,1,1,0,2,0,2,7177
2,2,1,0,3,0,3,7177
3,3,2,0,5,0,5,7177
4,4,3,0,8,0,8,7177
5,5,0,0,8,0,8,7177
0,0,1,0,1,0,1,7178
1,1,1,0,2,0,2,7178
2,2,0,1,2,1,3,7178
3,3,0,2,2,3,5,7178
4,4,1,0,3,3,6,7178
5,5,0,0,3,3,6,7178
0,0,1,0,1,0,1,7179
1,1,1,0,2,0,2,7179
2,2,0,0,2,0,2,7179
0,0,1,0,1,0,1,7180
1,1,1,0,2,0,2,7180
2,2,0,0,2,0,2,7180
0,0,1,0,1,0,1,7181
1,1,1,0,2,0,2,7181
2,2,2,0,4,0,4,7181
3,3,4,1,8,1,9,7181
4,4,1,3,9,4,13,7181
5,5,2,2,11,6,17,7181
6,6,3,0,14,6,20,7181
7,7,1,1,15,7,22,7181
8,8,2,0,17,7,24,7181
9,9,0,1,17,8,25,7181
10,10,1,0,18,8,26,7181
11,11,0,0,18,8,26,7181
0,0,1,0,1,0,1,7182
1,1,2,1,3,1,4,7182
2,2,2,1,5,2,7,7182
3,3,2,1,7,3,10,7182
4,4,4,1,11,4,15,7182
5,5,6,0,17,4,21,7182
6,6,6,2,23,6,29,7182
7,7,7,2,30,8,38,7182
8,8,0,1,30,9,39,7182
9,9,0,1,30,10,40,7182
10,10,1,1,31,11,42,7182
11,11,2,2,33,13,46,7182
12,12,5,2,38,15,53,7182
13,13,3,3,41,18,59,7182
14,14,3,0,44,18,62,7182
15,15,2,0,46,18,64,7182
16,16,2,1,48,19,67,7182
17,17,3,0,51,19,70,7182
18,18,0,0,51,19,70,7182
0,0,1,0,1,0,1,7183
1,1,0,0,1,0,1,7183
0,0,1,0,1,0,1,7184
1,1,0,0,1,0,1,7184
0,0,1,0,1,0,1,7185
1,1,0,0,1,0,1,7185
0,0,1,0,1,0,1,7186
1,1,1,1,2,1,3,7186
2,2,0,1,2,2,4,7186
3,3,0,0,2,2,4,7186
0,0,1,0,1,0,1,7187
1,1,2,0,3,0,3,7187
2,2,1,2,4,2,6,7187
3,3,1,3,5,5,10,7187
4,4,1,3,6,8,14,7187
5,5,1,4,7,12,19,7187
6,6,2,2,9,14,23,7187
7,7,1,1,10,15,25,7187
8,8,1,0,11,15,26,7187
9,9,1,0,12,15,27,7187
10,10,0,0,12,15,27,7187
0,0,1,0,1,0,1,7188
1,1,0,0,1,0,1,7188
0,0,1,0,1,0,1,7189
1,1,1,0,2,0,2,7189
2,2,2,0,4,0,4,7189
3,3,1,0,5,0,5,7189
4,4,0,0,5,0,5,7189
0,0,1,0,1,0,1,7190
1,1,0,0,1,0,1,7190
0,0,1,0,1,0,1,7191
1,1,0,1,1,1,2,7191
2,2,0,1,1,2,3,7191
3,3,0,0,1,2,3,7191
0,0,1,0,1,0,1,7192
1,1,1,0,2,0,2,7192
2,2,1,0,3,0,3,7192
3,3,1,0,4,0,4,7192
4,4,0,0,4,0,4,7192
0,0,1,0,1,0,1,7193
1,1,1,0,2,0,2,7193
2,2,1,0,3,0,3,7193
3,3,1,0,4,0,4,7193
4,4,2,1,6,1,7,7193
5,5,3,0,9,1,10,7193
6,6,3,1,12,2,14,7193
7,7,2,1,14,3,17,7193
8,8,1,2,15,5,20,7193
9,9,1,1,16,6,22,7193
10,10,2,0,18,6,24,7193
11,11,2,1,20,7,27,7193
12,12,1,3,21,10,31,7193
13,13,2,2,23,12,35,7193
14,14,2,1,25,13,38,7193
15,15,2,1,27,14,41,7193
16,16,3,3,30,17,47,7193
17,17,5,1,35,18,53,7193
18,18,3,1,38,19,57,7193
19,19,1,0,39,19,58,7193
20,20,0,0,39,19,58,7193
0,0,1,0,1,0,1,7194
1,1,0,0,1,0,1,7194
0,0,1,0,1,0,1,7195
1,1,2,0,3,0,3,7195
2,2,1,0,4,0,4,7195
3,3,1,0,5,0,5,7195
4,4,1,1,6,1,7,7195
5,5,2,1,8,2,10,7195
6,6,2,0,10,2,12,7195
7,7,4,1,14,3,17,7195
8,8,0,3,14,6,20,7195
9,9,1,2,15,8,23,7195
10,10,2,0,17,8,25,7195
11,11,2,0,19,8,27,7195
12,12,3,0,22,8,30,7195
13,13,2,0,24,8,32,7195
14,14,2,0,26,8,34,7195
15,15,1,0,27,8,35,7195
16,16,1,0,28,8,36,7195
17,17,1,0,29,8,37,7195
18,18,1,0,30,8,38,7195
19,19,0,0,30,8,38,7195
0,0,1,0,1,0,1,7196
1,1,1,0,2,0,2,7196
2,2,1,0,3,0,3,7196
3,3,0,0,3,0,3,7196
0,0,1,0,1,0,1,7197
1,1,0,0,1,0,1,7197
0,0,1,0,1,0,1,7198
1,1,1,0,2,0,2,7198
2,2,0,0,2,0,2,7198
0,0,1,0,1,0,1,7199
1,1,1,0,2,0,2,7199
2,2,0,1,2,1,3,7199
3,3,0,0,2,1,3,7199
0,0,1,0,1,0,1,7200
1,1,1,2,2,2,4,7200
2,2,1,1,3,3,6,7200
3,3,2,2,5,5,10,7200
4,4,2,0,7,5,12,7200
5,5,1,0,8,5,13,7200
6,6,0,1,8,6,14,7200
7,7,0,1,8,7,15,7200
8,8,0,1,8,8,16,7200
9,9,0,2,8,10,18,7200
10,10,0,2,8,12,20,7200
11,11,1,4,9,16,25,7200
12,12,1,5,10,21,31,7200
13,13,0,4,10,25,35,7200
14,14,0,10,10,35,45,7200
15,15,0,9,10,44,54,7200
16,16,2,10,12,54,66,7200
17,17,5,8,17,62,79,7200
18,18,4,9,21,71,92,7200
19,19,6,10,27,81,108,7200
20,20,9,9,36,90,126,7200
21,21,13,7,49,97,146,7200
22,22,17,7,66,104,170,7200
23,23,16,10,82,114,196,7200
24,24,15,7,97,121,218,7200
25,25,12,10,109,131,240,7200
26,26,7,12,116,143,259,7200
27,27,9,8,125,151,276,7200
28,28,12,9,137,160,297,7200
29,29,11,3,148,163,311,7200
30,30,6,8,154,171,325,7200
31,31,4,11,158,182,340,7200
32,32,3,10,161,192,353,7200
33,33,5,6,166,198,364,7200
34,34,7,5,173,203,376,7200
35,35,4,9,177,212,389,7200
36,36,7,8,184,220,404,7200
37,37,7,5,191,225,416,7200
38,38,6,1,197,226,423,7200
39,39,3,5,200,231,431,7200
40,40,1,1,201,232,433,7200
41,41,0,0,201,232,433,7200
0,0,1,0,1,0,1,7201
1,1,1,1,2,1,3,7201
2,2,0,2,2,3,5,7201
3,3,0,2,2,5,7,7201
4,4,1,1,3,6,9,7201
5,5,2,1,5,7,12,7201
6,6,0,1,5,8,13,7201
7,7,0,0,5,8,13,7201
0,0,1,0,1,0,1,7202
1,1,0,0,1,0,1,7202
0,0,1,0,1,0,1,7203
1,1,1,0,2,0,2,7203
2,2,1,0,3,0,3,7203
3,3,0,0,3,0,3,7203
0,0,1,0,1,0,1,7204
1,1,3,0,4,0,4,7204
2,2,1,0,5,0,5,7204
3,3,0,0,5,0,5,7204
0,0,1,0,1,0,1,7205
1,1,0,0,1,0,1,7205
0,0,1,0,1,0,1,7206
1,1,0,0,1,0,1,7206
0,0,1,0,1,0,1,7207
1,1,0,0,1,0,1,7207
0,0,1,0,1,0,1,7208
1,1,2,0,3,0,3,7208
2,2,1,1,4,1,5,7208
3,3,2,1,6,2,8,7208
4,4,2,1,8,3,11,7208
5,5,1,0,9,3,12,7208
6,6,0,0,9,3,12,7208
0,0,1,0,1,0,1,7209
1,1,1,0,2,0,2,7209
2,2,0,0,2,0,2,7209
0,0,1,0,1,0,1,7210
1,1,0,0,1,0,1,7210
0,0,1,0,1,0,1,7211
1,1,1,0,2,0,2,7211
2,2,1,0,3,0,3,7211
3,3,0,1,3,1,4,7211
4,4,0,3,3,4,7,7211
5,5,0,2,3,6,9,7211
6,6,0,1,3,7,10,7211
7,7,0,1,3,8,11,7211
8,8,0,0,3,8,11,7211
0,0,1,0,1,0,1,7212
1,1,1,0,2,0,2,7212
2,2,0,2,2,2,4,7212
3,3,1,3,3,5,8,7212
4,4,0,2,3,7,10,7212
5,5,0,2,3,9,12,7212
6,6,0,3,3,12,15,7212
7,7,0,2,3,14,17,7212
8,8,0,3,3,17,20,7212
9,9,0,2,3,19,22,7212
10,10,0,2,3,21,24,7212
11,11,0,1,3,22,25,7212
12,12,1,1,4,23,27,7212
13,13,2,0,6,23,29,7212
14,14,0,1,6,24,30,7212
15,15,0,1,6,25,31,7212
16,16,0,0,6,25,31,7212
0,0,1,0,1,0,1,7213
1,1,0,0,1,0,1,7213
0,0,1,0,1,0,1,7214
1,1,1,0,2,0,2,7214
2,2,1,0,3,0,3,7214
3,3,0,1,3,1,4,7214
4,4,0,1,3,2,5,7214
5,5,0,0,3,2,5,7214
0,0,1,0,1,0,1,7215
1,1,1,0,2,0,2,7215
2,2,0,0,2,0,2,7215
0,0,1,0,1,0,1,7216
1,1,1,0,2,0,2,7216
2,2,2,0,4,0,4,7216
3,3,2,0,6,0,6,7216
4,4,1,1,7,1,8,7216
5,5,1,4,8,5,13,7216
6,6,2,1,10,6,16,7216
7,7,1,1,11,7,18,7216
8,8,1,2,12,9,21,7216
9,9,0,1,12,10,22,7216
10,10,0,1,12,11,23,7216
11,11,0,0,12,11,23,7216
0,0,1,0,1,0,1,7217
1,1,2,0,3,0,3,7217
2,2,3,0,6,0,6,7217
3,3,3,1,9,1,10,7217
4,4,0,0,9,1,10,7217
0,0,1,0,1,0,1,7218
1,1,0,0,1,0,1,7218
0,0,1,0,1,0,1,7219
1,1,0,0,1,0,1,7219
0,0,1,0,1,0,1,7220
1,1,0,0,1,0,1,7220
0,0,1,0,1,0,1,7221
1,1,1,0,2,0,2,7221
2,2,1,0,3,0,3,7221
3,3,1,0,4,0,4,7221
4,4,3,1,7,1,8,7221
5,5,2,2,9,3,12,7221
6,6,0,0,9,3,12,7221
0,0,1,0,1,0,1,7222
1,1,3,0,4,0,4,7222
2,2,2,0,6,0,6,7222
3,3,0,0,6,0,6,7222
0,0,1,0,1,0,1,7223
1,1,0,0,1,0,1,7223
0,0,1,0,1,0,1,7224
1,1,0,0,1,0,1,7224
0,0,1,0,1,0,1,7225
1,1,0,0,1,0,1,7225
0,0,1,0,1,0,1,7226
1,1,0,0,1,0,1,7226
0,0,1,0,1,0,1,7227
1,1,1,0,2,0,2,7227
2,2,0,1,2,1,3,7227
3,3,0,2,2,3,5,7227
4,4,3,0,5,3,8,7227
5,5,2,0,7,3,10,7227
6,6,3,0,10,3,13,7227
7,7,1,0,11,3,14,7227
8,8,1,0,12,3,15,7227
9,9,0,0,12,3,15,7227
0,0,1,0,1,0,1,7228
1,1,0,0,1,0,1,7228
0,0,1,0,1,0,1,7229
1,1,2,0,3,0,3,7229
2,2,2,0,5,0,5,7229
3,3,1,0,6,0,6,7229
4,4,3,0,9,0,9,7229
5,5,1,0,10,0,10,7229
6,6,0,0,10,0,10,7229
0,0,1,0,1,0,1,7230
1,1,1,0,2,0,2,7230
2,2,0,0,2,0,2,7230
0,0,1,0,1,0,1,7231
1,1,1,0,2,0,2,7231
2,2,0,0,2,0,2,7231
0,0,1,0,1,0,1,7232
1,1,1,0,2,0,2,7232
2,2,0,0,2,0,2,7232
0,0,1,0,1,0,1,7233
1,1,0,0,1,0,1,7233
0,0,1,0,1,0,1,7234
1,1,0,0,1,0,1,7234
0,0,1,0,1,0,1,7235
1,1,0,1,1,1,2,7235
2,2,0,0,1,1,2,7235
0,0,1,0,1,0,1,7236
1,1,1,0,2,0,2,7236
2,2,1,0,3,0,3,7236
3,3,0,0,3,0,3,7236
0,0,1,0,1,0,1,7237
1,1,0,0,1,0,1,7237
0,0,1,0,1,0,1,7238
1,1,2,0,3,0,3,7238
2,2,0,0,3,0,3,7238
0,0,1,0,1,0,1,7239
1,1,0,0,1,0,1,7239
0,0,1,0,1,0,1,7240
1,1,1,1,2,1,3,7240
2,2,0,3,2,4,6,7240
3,3,0,1,2,5,7,7240
4,4,0,0,2,5,7,7240
0,0,1,0,1,0,1,7241
1,1,1,0,2,0,2,7241
2,2,1,0,3,0,3,7241
3,3,1,1,4,1,5,7241
4,4,1,2,5,3,8,7241
5,5,1,1,6,4,10,7241
6,6,1,0,7,4,11,7241
7,7,0,0,7,4,11,7241
0,0,1,0,1,0,1,7242
1,1,1,0,2,0,2,7242
2,2,1,1,3,1,4,7242
3,3,5,2,8,3,11,7242
4,4,3,3,11,6,17,7242
5,5,2,0,13,6,19,7242
6,6,3,0,16,6,22,7242
7,7,4,2,20,8,28,7242
8,8,5,1,25,9,34,7242
9,9,6,2,31,11,42,7242
10,10,7,2,38,13,51,7242
11,11,6,2,44,15,59,7242
12,12,3,8,47,23,70,7242
13,13,4,4,51,27,78,7242
14,14,2,2,53,29,82,7242
15,15,3,1,56,30,86,7242
16,16,4,0,60,30,90,7242
17,17,2,0,62,30,92,7242
18,18,0,0,62,30,92,7242
0,0,1,0,1,0,1,7243
1,1,0,0,1,0,1,7243
0,0,1,0,1,0,1,7244
1,1,0,0,1,0,1,7244
0,0,1,0,1,0,1,7245
1,1,3,1,4,1,5,7245
2,2,2,3,6,4,10,7245
3,3,2,1,8,5,13,7245
4,4,2,0,10,5,15,7245
5,5,1,1,11,6,17,7245
6,6,0,1,11,7,18,7245
7,7,1,3,12,10,22,7245
8,8,2,1,14,11,25,7245
9,9,2,2,16,13,29,7245
10,10,5,2,21,15,36,7245
11,11,7,0,28,15,43,7245
12,12,5,1,33,16,49,7245
13,13,4,0,37,16,53,7245
14,14,1,0,38,16,54,7245
15,15,0,0,38,16,54,7245
0,0,1,0,1,0,1,7246
1,1,1,0,2,0,2,7246
2,2,0,0,2,0,2,7246
0,0,1,0,1,0,1,7247
1,1,0,1,1,1,2,7247
2,2,0,0,1,1,2,7247
0,0,1,0,1,0,1,7248
1,1,0,2,1,2,3,7248
2,2,0,1,1,3,4,7248
3,3,0,0,1,3,4,7248
0,0,1,0,1,0,1,7249
1,1,0,0,1,0,1,7249
0,0,1,0,1,0,1,7250
1,1,0,0,1,0,1,7250
0,0,1,0,1,0,1,7251
1,1,0,0,1,0,1,7251
0,0,1,0,1,0,1,7252
1,1,0,0,1,0,1,7252
0,0,1,0,1,0,1,7253
1,1,3,1,4,1,5,7253
2,2,3,1,7,2,9,7253
3,3,5,0,12,2,14,7253
4,4,4,0,16,2,18,7253
5,5,4,1,20,3,23,7253
6,6,2,2,22,5,27,7253
7,7,0,4,22,9,31,7253
8,8,1,2,23,11,34,7253
9,9,0,1,23,12,35,7253
10,10,0,1,23,13,36,7253
11,11,0,2,23,15,38,7253
12,12,0,2,23,17,40,7253
13,13,2,1,25,18,43,7253
14,14,1,0,26,18,44,7253
15,15,0,0,26,18,44,7253
0,0,1,0,1,0,1,7254
1,1,2,0,3,0,3,7254
2,2,1,0,4,0,4,7254
3,3,3,0,7,0,7,7254
4,4,2,1,9,1,10,7254
5,5,1,0,10,1,11,7254
6,6,4,0,14,1,15,7254
7,7,2,1,16,2,18,7254
8,8,2,0,18,2,20,7254
9,9,2,0,20,2,22,7254
10,10,3,1,23,3,26,7254
11,11,3,1,26,4,30,7254
12,12,3,2,29,6,35,7254
13,13,3,4,32,10,42,7254
14,14,6,2,38,12,50,7254
15,15,2,5,40,17,57,7254
16,16,4,4,44,21,65,7254
17,17,4,3,48,24,72,7254
18,18,3,5,51,29,80,7254
19,19,2,4,53,33,86,7254
20,20,3,1,56,34,90,7254
21,21,5,3,61,37,98,7254
22,22,3,2,64,39,103,7254
23,23,2,1,66,40,106,7254
24,24,0,2,66,42,108,7254
25,25,1,1,67,43,110,7254
26,26,0,0,67,43,110,7254
0,0,1,0,1,0,1,7255
1,1,1,1,2,1,3,7255
2,2,0,1,2,2,4,7255
3,3,0,1,2,3,5,7255
4,4,0,0,2,3,5,7255
0,0,1,0,1,0,1,7256
1,1,1,0,2,0,2,7256
2,2,1,0,3,0,3,7256
3,3,1,0,4,0,4,7256
4,4,2,0,6,0,6,7256
5,5,3,1,9,1,10,7256
6,6,4,2,13,3,16,7256
7,7,2,1,15,4,19,7256
8,8,2,0,17,4,21,7256
9,9,2,0,19,4,23,7256
10,10,1,2,20,6,26,7256
11,11,0,2,20,8,28,7256
12,12,0,4,20,12,32,7256
13,13,1,3,21,15,36,7256
14,14,1,2,22,17,39,7256
15,15,0,0,22,17,39,7256
0,0,1,0,1,0,1,7257
1,1,2,0,3,0,3,7257
2,2,0,0,3,0,3,7257
0,0,1,0,1,0,1,7258
1,1,0,0,1,0,1,7258
0,0,1,0,1,0,1,7259
1,1,1,0,2,0,2,7259
2,2,1,0,3,0,3,7259
3,3,0,0,3,0,3,7259
0,0,1,0,1,0,1,7260
1,1,2,0,3,0,3,7260
2,2,1,1,4,1,5,7260
3,3,0,2,4,3,7,7260
4,4,0,2,4,5,9,7260
5,5,0,3,4,8,12,7260
6,6,0,2,4,10,14,7260
7,7,0,1,4,11,15,7260
8,8,1,4,5,15,20,7260
9,9,0,5,5,20,25,7260
10,10,0,2,5,22,27,7260
11,11,0,2,5,24,29,7260
12,12,1,1,6,25,31,7260
13,13,1,2,7,27,34,7260
14,14,0,2,7,29,36,7260
15,15,0,2,7,31,38,7260
16,16,0,3,7,34,41,7260
17,17,0,6,7,40,47,7260
18,18,0,5,7,45,52,7260
19,19,0,2,7,47,54,7260
20,20,0,2,7,49,56,7260
21,21,0,1,7,50,57,7260
22,22,0,0,7,50,57,7260
0,0,1,0,1,0,1,7261
1,1,0,0,1,0,1,7261
0,0,1,0,1,0,1,7262
1,1,1,0,2,0,2,7262
2,2,0,0,2,0,2,7262
0,0,1,0,1,0,1,7263
1,1,0,0,1,0,1,7263
0,0,1,0,1,0,1,7264
1,1,0,0,1,0,1,7264
0,0,1,0,1,0,1,7265
1,1,1,0,2,0,2,7265
2,2,2,0,4,0,4,7265
3,3,2,1,6,1,7,7265
4,4,4,2,10,3,13,7265
5,5,7,2,17,5,22,7265
6,6,5,4,22,9,31,7265
7,7,6,6,28,15,43,7265
8,8,5,5,33,20,53,7265
9,9,9,3,42,23,65,7265
10,10,8,4,50,27,77,7265
11,11,9,3,59,30,89,7265
12,12,7,7,66,37,103,7265
13,13,8,10,74,47,121,7265
14,14,7,9,81,56,137,7265
15,15,3,10,84,66,150,7265
16,16,2,4,86,70,156,7265
17,17,2,0,88,70,158,7265
18,18,4,0,92,70,162,7265
19,19,5,1,97,71,168,7265
20,20,4,1,101,72,173,7265
21,21,2,2,103,74,177,7265
22,22,0,1,103,75,178,7265
23,23,0,1,103,76,179,7265
24,24,0,0,103,76,179,7265
0,0,1,0,1,0,1,7266
1,1,0,0,1,0,1,7266
0,0,1,0,1,0,1,7267
1,1,0,0,1,0,1,7267
0,0,1,0,1,0,1,7268
1,1,1,0,2,0,2,7268
2,2,0,0,2,0,2,7268
0,0,1,0,1,0,1,7269
1,1,0,1,1,1,2,7269
2,2,0,2,1,3,4,7269
3,3,0,4,1,7,8,7269
4,4,0,3,1,10,11,7269
5,5,1,2,2,12,14,7269
6,6,0,1,2,13,15,7269
7,7,0,0,2,13,15,7269
0,0,1,0,1,0,1,7270
1,1,1,0,2,0,2,7270
2,2,1,0,3,0,3,7270
3,3,1,0,4,0,4,7270
4,4,0,1,4,1,5,7270
5,5,0,1,4,2,6,7270
6,6,1,0,5,2,7,7270
7,7,1,0,6,2,8,7270
8,8,1,1,7,3,10,7270
9,9,0,0,7,3,10,7270
0,0,1,0,1,0,1,7271
1,1,2,0,3,0,3,7271
2,2,1,1,4,1,5,7271
3,3,1,1,5,2,7,7271
4,4,1,1,6,3,9,7271
5,5,1,1,7,4,11,7271
6,6,1,2,8,6,14,7271
7,7,1,4,9,10,19,7271
8,8,4,3,13,13,26,7271
9,9,2,4,15,17,32,7271
10,10,3,0,18,17,35,7271
11,11,5,0,23,17,40,7271
12,12,5,0,28,17,45,7271
13,13,4,0,32,17,49,7271
14,14,5,0,37,17,54,7271
15,15,4,2,41,19,60,7271
16,16,5,2,46,21,67,7271
17,17,3,5,49,26,75,7271
18,18,1,2,50,28,78,7271
19,19,2,2,52,30,82,7271
20,20,2,2,54,32,86,7271
21,21,2,2,56,34,90,7271
22,22,1,4,57,38,95,7271
23,23,1,2,58,40,98,7271
24,24,2,2,60,42,102,7271
25,25,3,1,63,43,106,7271
26,26,1,4,64,47,111,7271
27,27,1,1,65,48,113,7271
28,28,1,1,66,49,115,7271
29,29,2,0,68,49,117,7271
30,30,1,0,69,49,118,7271
31,31,0,0,69,49,118,7271
0,0,1,0,1,0,1,7272
1,1,1,1,2,1,3,7272
2,2,2,0,4,1,5,7272
3,3,2,0,6,1,7,7272
4,4,0,1,6,2,8,7272
5,5,0,0,6,2,8,7272
0,0,1,0,1,0,1,7273
1,1,1,1,2,1,3,7273
2,2,0,3,2,4,6,7273
3,3,0,0,2,4,6,7273
0,0,1,0,1,0,1,7274
1,1,3,0,4,0,4,7274
2,2,1,1,5,1,6,7274
3,3,1,0,6,1,7,7274
4,4,1,1,7,2,9,7274
5,5,1,0,8,2,10,7274
6,6,0,0,8,2,10,7274
0,0,1,0,1,0,1,7275
1,1,1,1,2,1,3,7275
2,2,0,1,2,2,4,7275
3,3,0,0,2,2,4,7275
0,0,1,0,1,0,1,7276
1,1,0,0,1,0,1,7276
0,0,1,0,1,0,1,7277
1,1,2,0,3,0,3,7277
2,2,0,0,3,0,3,7277
0,0,1,0,1,0,1,7278
1,1,0,1,1,1,2,7278
2,2,0,3,1,4,5,7278
3,3,0,1,1,5,6,7278
4,4,0,2,1,7,8,7278
5,5,0,0,1,7,8,7278
0,0,1,0,1,0,1,7279
1,1,0,1,1,1,2,7279
2,2,0,0,1,1,2,7279
0,0,1,0,1,0,1,7280
1,1,1,0,2,0,2,7280
2,2,2,1,4,1,5,7280
3,3,2,0,6,1,7,7280
4,4,0,0,6,1,7,7280
0,0,1,0,1,0,1,7281
1,1,1,0,2,0,2,7281
2,2,2,0,4,0,4,7281
3,3,1,1,5,1,6,7281
4,4,1,1,6,2,8,7281
5,5,0,3,6,5,11,7281
6,6,0,4,6,9,15,7281
7,7,1,2,7,11,18,7281
8,8,4,1,11,12,23,7281
9,9,6,1,17,13,30,7281
10,10,1,0,18,13,31,7281
11,11,1,0,19,13,32,7281
12,12,0,0,19,13,32,7281
0,0,1,0,1,0,1,7282
1,1,0,0,1,0,1,7282
0,0,1,0,1,0,1,7283
1,1,3,0,4,0,4,7283
2,2,1,1,5,1,6,7283
3,3,0,1,5,2,7,7283
4,4,0,2,5,4,9,7283
5,5,0,0,5,4,9,7283
0,0,1,0,1,0,1,7284
1,1,2,0,3,0,3,7284
2,2,0,0,3,0,3,7284
0,0,1,0,1,0,1,7285
1,1,1,0,2,0,2,7285
2,2,0,0,2,0,2,7285
0,0,1,0,1,0,1,7286
1,1,0,0,1,0,1,7286
0,0,1,0,1,0,1,7287
1,1,0,1,1,1,2,7287
2,2,0,0,1,1,2,7287
0,0,1,0,1,0,1,7288
1,1,0,0,1,0,1,7288
0,0,1,0,1,0,1,7289
1,1,1,0,2,0,2,7289
2,2,1,0,3,0,3,7289
3,3,0,1,3,1,4,7289
4,4,0,1,3,2,5,7289
5,5,0,0,3,2,5,7289
0,0,1,0,1,0,1,7290
1,1,0,0,1,0,1,7290
0,0,1,0,1,0,1,7291
1,1,0,1,1,1,2,7291
2,2,0,2,1,3,4,7291
3,3,0,2,1,5,6,7291
4,4,0,0,1,5,6,7291
0,0,1,0,1,0,1,7292
1,1,2,0,3,0,3,7292
2,2,2,0,5,0,5,7292
3,3,0,0,5,0,5,7292
0,0,1,0,1,0,1,7293
1,1,1,0,2,0,2,7293
2,2,1,0,3,0,3,7293
3,3,0,0,3,0,3,7293
0,0,1,0,1,0,1,7294
1,1,0,1,1,1,2,7294
2,2,0,0,1,1,2,7294
0,0,1,0,1,0,1,7295
1,1,3,0,4,0,4,7295
2,2,1,1,5,1,6,7295
3,3,1,2,6,3,9,7295
4,4,1,1,7,4,11,7295
5,5,0,0,7,4,11,7295
0,0,1,0,1,0,1,7296
1,1,1,0,2,0,2,7296
2,2,1,1,3,1,4,7296
3,3,1,0,4,1,5,7296
4,4,1,0,5,1,6,7296
5,5,0,0,5,1,6,7296
0,0,1,0,1,0,1,7297
1,1,1,0,2,0,2,7297
2,2,2,0,4,0,4,7297
3,3,2,0,6,0,6,7297
4,4,0,1,6,1,7,7297
5,5,0,0,6,1,7,7297
0,0,1,0,1,0,1,7298
1,1,1,0,2,0,2,7298
2,2,0,0,2,0,2,7298
0,0,1,0,1,0,1,7299
1,1,1,0,2,0,2,7299
2,2,1,0,3,0,3,7299
3,3,0,0,3,0,3,7299
0,0,1,0,1,0,1,7300
1,1,0,0,1,0,1,7300
0,0,1,0,1,0,1,7301
1,1,2,0,3,0,3,7301
2,2,2,0,5,0,5,7301
3,3,2,0,7,0,7,7301
4,4,3,0,10,0,10,7301
5,5,1,0,11,0,11,7301
6,6,0,1,11,1,12,7301
7,7,0,1,11,2,13,7301
8,8,0,0,11,2,13,7301
0,0,1,0,1,0,1,7302
1,1,0,0,1,0,1,7302
0,0,1,0,1,0,1,7303
1,1,0,1,1,1,2,7303
2,2,0,0,1,1,2,7303
0,0,1,0,1,0,1,7304
1,1,0,0,1,0,1,7304
0,0,1,0,1,0,1,7305
1,1,0,1,1,1,2,7305
2,2,0,0,1,1,2,7305
0,0,1,0,1,0,1,7306
1,1,0,0,1,0,1,7306
0,0,1,0,1,0,1,7307
1,1,1,1,2,1,3,7307
2,2,1,1,3,2,5,7307
3,3,0,1,3,3,6,7307
4,4,1,1,4,4,8,7307
5,5,0,0,4,4,8,7307
0,0,1,0,1,0,1,7308
1,1,0,0,1,0,1,7308
0,0,1,0,1,0,1,7309
1,1,1,0,2,0,2,7309
2,2,1,0,3,0,3,7309
3,3,3,0,6,0,6,7309
4,4,1,0,7,0,7,7309
5,5,0,0,7,0,7,7309
0,0,1,0,1,0,1,7310
1,1,3,0,4,0,4,7310
2,2,3,0,7,0,7,7310
3,3,2,0,9,0,9,7310
4,4,0,0,9,0,9,7310
0,0,1,0,1,0,1,7311
1,1,2,1,3,1,4,7311
2,2,1,2,4,3,7,7311
3,3,1,1,5,4,9,7311
4,4,2,1,7,5,12,7311
5,5,5,0,12,5,17,7311
6,6,1,3,13,8,21,7311
7,7,0,2,13,10,23,7311
8,8,0,1,13,11,24,7311
9,9,0,1,13,12,25,7311
10,10,0,0,13,12,25,7311
0,0,1,0,1,0,1,7312
1,1,1,0,2,0,2,7312
2,2,0,0,2,0,2,7312
0,0,1,0,1,0,1,7313
1,1,1,0,2,0,2,7313
2,2,0,0,2,0,2,7313
0,0,1,0,1,0,1,7314
1,1,0,0,1,0,1,7314
0,0,1,0,1,0,1,7315
1,1,2,0,3,0,3,7315
2,2,1,0,4,0,4,7315
3,3,1,0,5,0,5,7315
4,4,0,0,5,0,5,7315
0,0,1,0,1,0,1,7316
1,1,1,1,2,1,3,7316
2,2,1,0,3,1,4,7316
3,3,0,0,3,1,4,7316
0,0,1,0,1,0,1,7317
1,1,2,0,3,0,3,7317
2,2,1,0,4,0,4,7317
3,3,0,0,4,0,4,7317
0,0,1,0,1,0,1,7318
1,1,0,1,1,1,2,7318
2,2,0,0,1,1,2,7318
0,0,1,0,1,0,1,7319
1,1,1,0,2,0,2,7319
2,2,1,0,3,0,3,7319
3,3,0,0,3,0,3,7319
0,0,1,0,1,0,1,7320
1,1,1,0,2,0,2,7320
2,2,0,0,2,0,2,7320
0,0,1,0,1,0,1,7321
1,1,0,0,1,0,1,7321
0,0,1,0,1,0,1,7322
1,1,1,0,2,0,2,7322
2,2,1,0,3,0,3,7322
3,3,1,0,4,0,4,7322
4,4,1,0,5,0,5,7322
5,5,2,0,7,0,7,7322
6,6,0,0,7,0,7,7322
0,0,1,0,1,0,1,7323
1,1,2,1,3,1,4,7323
2,2,2,2,5,3,8,7323
3,3,1,2,6,5,11,7323
4,4,1,0,7,5,12,7323
5,5,3,0,10,5,15,7323
6,6,2,0,12,5,17,7323
7,7,2,0,14,5,19,7323
8,8,7,0,21,5,26,7323
9,9,4,2,25,7,32,7323
10,10,5,4,30,11,41,7323
11,11,4,3,34,14,48,7323
12,12,3,4,37,18,55,7323
13,13,2,1,39,19,58,7323
14,14,0,3,39,22,61,7323
15,15,0,2,39,24,63,7323
16,16,0,2,39,26,65,7323
17,17,1,2,40,28,68,7323
18,18,1,3,41,31,72,7323
19,19,0,1,41,32,73,7323
20,20,1,0,42,32,74,7323
21,21,0,1,42,33,75,7323
22,22,0,1,42,34,76,7323
23,23,0,2,42,36,78,7323
24,24,0,2,42,38,80,7323
25,25,0,3,42,41,83,7323
26,26,0,3,42,44,86,7323
27,27,0,1,42,45,87,7323
28,28,0,1,42,46,88,7323
29,29,0,0,42,46,88,7323
0,0,1,0,1,0,1,7324
1,1,1,0,2,0,2,7324
2,2,1,0,3,0,3,7324
3,3,0,1,3,1,4,7324
4,4,0,0,3,1,4,7324
0,0,1,0,1,0,1,7325
1,1,1,0,2,0,2,7325
2,2,1,1,3,1,4,7325
3,3,0,0,3,1,4,7325
0,0,1,0,1,0,1,7326
1,1,0,0,1,0,1,7326
0,0,1,0,1,0,1,7327
1,1,2,1,3,1,4,7327
2,2,2,1,5,2,7,7327
3,3,2,1,7,3,10,7327
4,4,2,1,9,4,13,7327
5,5,4,0,13,4,17,7327
6,6,6,2,19,6,25,7327
7,7,3,1,22,7,29,7327
8,8,1,0,23,7,30,7327
9,9,3,0,26,7,33,7327
10,10,1,0,27,7,34,7327
11,11,1,0,28,7,35,7327
12,12,1,0,29,7,36,7327
13,13,0,0,29,7,36,7327
0,0,1,0,1,0,1,7328
1,1,0,0,1,0,1,7328
0,0,1,0,1,0,1,7329
1,1,3,0,4,0,4,7329
2,2,2,1,6,1,7,7329
3,3,1,0,7,1,8,7329
4,4,1,1,8,2,10,7329
5,5,1,0,9,2,11,7329
6,6,1,0,10,2,12,7329
7,7,2,0,12,2,14,7329
8,8,0,0,12,2,14,7329
0,0,1,0,1,0,1,7330
1,1,2,0,3,0,3,7330
2,2,1,0,4,0,4,7330
3,3,1,0,5,0,5,7330
4,4,1,0,6,0,6,7330
5,5,0,0,6,0,6,7330
0,0,1,0,1,0,1,7331
1,1,1,0,2,0,2,7331
2,2,0,1,2,1,3,7331
3,3,0,1,2,2,4,7331
4,4,1,0,3,2,5,7331
5,5,2,1,5,3,8,7331
6,6,2,2,7,5,12,7331
7,7,1,1,8,6,14,7331
8,8,2,1,10,7,17,7331
9,9,0,0,10,7,17,7331
0,0,1,0,1,0,1,7332
1,1,2,0,3,0,3,7332
2,2,1,0,4,0,4,7332
3,3,0,0,4,0,4,7332
0,0,1,0,1,0,1,7333
1,1,1,0,2,0,2,7333
2,2,1,0,3,0,3,7333
3,3,1,0,4,0,4,7333
4,4,0,0,4,0,4,7333
0,0,1,0,1,0,1,7334
1,1,2,0,3,0,3,7334
2,2,1,0,4,0,4,7334
3,3,0,0,4,0,4,7334
0,0,1,0,1,0,1,7335
1,1,2,0,3,0,3,7335
2,2,1,1,4,1,5,7335
3,3,1,3,5,4,9,7335
4,4,2,3,7,7,14,7335
5,5,1,0,8,7,15,7335
6,6,0,0,8,7,15,7335
0,0,1,0,1,0,1,7336
1,1,3,0,4,0,4,7336
2,2,0,0,4,0,4,7336
0,0,1,0,1,0,1,7337
1,1,0,1,1,1,2,7337
2,2,0,0,1,1,2,7337
0,0,1,0,1,0,1,7338
1,1,1,0,2,0,2,7338
2,2,1,0,3,0,3,7338
3,3,1,0,4,0,4,7338
4,4,3,1,7,1,8,7338
5,5,1,0,8,1,9,7338
6,6,1,0,9,1,10,7338
7,7,2,0,11,1,12,7338
8,8,2,0,13,1,14,7338
9,9,2,0,15,1,16,7338
10,10,1,0,16,1,17,7338
11,11,1,0,17,1,18,7338
12,12,0,0,17,1,18,7338
0,0,1,0,1,0,1,7339
1,1,0,0,1,0,1,7339
0,0,1,0,1,0,1,7340
1,1,0,0,1,0,1,7340
0,0,1,0,1,0,1,7341
1,1,0,0,1,0,1,7341
0,0,1,0,1,0,1,7342
1,1,0,0,1,0,1,7342
0,0,1,0,1,0,1,7343
1,1,1,0,2,0,2,7343
2,2,0,0,2,0,2,7343
0,0,1,0,1,0,1,7344
1,1,3,0,4,0,4,7344
2,2,4,0,8,0,8,7344
3,3,2,1,10,1,11,7344
4,4,1,4,11,5,16,7344
5,5,2,5,13,10,23,7344
6,6,0,4,13,14,27,7344
7,7,0,1,13,15,28,7344
8,8,0,0,13,15,28,7344
0,0,1,0,1,0,1,7345
1,1,1,0,2,0,2,7345
2,2,1,0,3,0,3,7345
3,3,1,0,4,0,4,7345
4,4,1,0,5,0,5,7345
5,5,0,1,5,1,6,7345
6,6,1,0,6,1,7,7345
7,7,0,0,6,1,7,7345
0,0,1,0,1,0,1,7346
1,1,0,0,1,0,1,7346
0,0,1,0,1,0,1,7347
1,1,2,0,3,0,3,7347
2,2,2,0,5,0,5,7347
3,3,0,0,5,0,5,7347
0,0,1,0,1,0,1,7348
1,1,1,0,2,0,2,7348
2,2,0,0,2,0,2,7348
0,0,1,0,1,0,1,7349
1,1,1,0,2,0,2,7349
2,2,0,1,2,1,3,7349
3,3,0,0,2,1,3,7349
0,0,1,0,1,0,1,7350
1,1,0,0,1,0,1,7350
0,0,1,0,1,0,1,7351
1,1,1,0,2,0,2,7351
2,2,1,0,3,0,3,7351
3,3,1,1,4,1,5,7351
4,4,0,0,4,1,5,7351
0,0,1,0,1,0,1,7352
1,1,0,0,1,0,1,7352
0,0,1,0,1,0,1,7353
1,1,2,0,3,0,3,7353
2,2,3,0,6,0,6,7353
3,3,5,1,11,1,12,7353
4,4,1,4,12,5,17,7353
5,5,1,4,13,9,22,7353
6,6,1,5,14,14,28,7353
7,7,2,2,16,16,32,7353
8,8,4,2,20,18,38,7353
9,9,6,2,26,20,46,7353
10,10,10,3,36,23,59,7353
11,11,8,2,44,25,69,7353
12,12,6,3,50,28,78,7353
13,13,7,4,57,32,89,7353
14,14,4,3,61,35,96,7353
15,15,5,3,66,38,104,7353
16,16,4,6,70,44,114,7353
17,17,4,5,74,49,123,7353
18,18,3,3,77,52,129,7353
19,19,2,3,79,55,134,7353
20,20,1,2,80,57,137,7353
21,21,1,2,81,59,140,7353
22,22,3,4,84,63,147,7353
23,23,2,5,86,68,154,7353
24,24,1,0,87,68,155,7353
25,25,0,0,87,68,155,7353
0,0,1,0,1,0,1,7354
1,1,0,0,1,0,1,7354
0,0,1,0,1,0,1,7355
1,1,0,0,1,0,1,7355
0,0,1,0,1,0,1,7356
1,1,0,0,1,0,1,7356
0,0,1,0,1,0,1,7357
1,1,0,0,1,0,1,7357
0,0,1,0,1,0,1,7358
1,1,3,1,4,1,5,7358
2,2,1,1,5,2,7,7358
3,3,1,3,6,5,11,7358
4,4,0,0,6,5,11,7358
0,0,1,0,1,0,1,7359
1,1,1,0,2,0,2,7359
2,2,0,1,2,1,3,7359
3,3,1,2,3,3,6,7359
4,4,1,5,4,8,12,7359
5,5,2,5,6,13,19,7359
6,6,3,2,9,15,24,7359
7,7,3,0,12,15,27,7359
8,8,1,0,13,15,28,7359
9,9,0,0,13,15,28,7359
0,0,1,0,1,0,1,7360
1,1,0,0,1,0,1,7360
0,0,1,0,1,0,1,7361
1,1,0,0,1,0,1,7361
0,0,1,0,1,0,1,7362
1,1,0,0,1,0,1,7362
0,0,1,0,1,0,1,7363
1,1,2,0,3,0,3,7363
2,2,1,0,4,0,4,7363
3,3,0,0,4,0,4,7363
0,0,1,0,1,0,1,7364
1,1,0,1,1,1,2,7364
2,2,0,0,1,1,2,7364
0,0,1,0,1,0,1,7365
1,1,0,0,1,0,1,7365
0,0,1,0,1,0,1,7366
1,1,2,0,3,0,3,7366
2,2,0,1,3,1,4,7366
3,3,0,1,3,2,5,7366
4,4,0,0,3,2,5,7366
0,0,1,0,1,0,1,7367
1,1,1,0,2,0,2,7367
2,2,0,0,2,0,2,7367
0,0,1,0,1,0,1,7368
1,1,2,2,3,2,5,7368
2,2,0,3,3,5,8,7368
3,3,0,1,3,6,9,7368
4,4,0,0,3,6,9,7368
0,0,1,0,1,0,1,7369
1,1,0,0,1,0,1,7369
0,0,1,0,1,0,1,7370
1,1,1,0,2,0,2,7370
2,2,0,0,2,0,2,7370
0,0,1,0,1,0,1,7371
1,1,0,0,1,0,1,7371
0,0,1,0,1,0,1,7372
1,1,1,0,2,0,2,7372
2,2,2,1,4,1,5,7372
3,3,0,1,4,2,6,7372
4,4,0,0,4,2,6,7372
0,0,1,0,1,0,1,7373
1,1,1,0,2,0,2,7373
2,2,1,0,3,0,3,7373
3,3,0,0,3,0,3,7373
0,0,1,0,1,0,1,7374
1,1,2,0,3,0,3,7374
2,2,0,0,3,0,3,7374
0,0,1,0,1,0,1,7375
1,1,0,1,1,1,2,7375
2,2,0,0,1,1,2,7375
0,0,1,0,1,0,1,7376
1,1,1,0,2,0,2,7376
2,2,1,0,3,0,3,7376
3,3,2,0,5,0,5,7376
4,4,1,1,6,1,7,7376
5,5,0,1,6,2,8,7376
6,6,0,1,6,3,9,7376
7,7,0,1,6,4,10,7376
8,8,0,1,6,5,11,7376
9,9,0,3,6,8,14,7376
10,10,0,0,6,8,14,7376
0,0,1,0,1,0,1,7377
1,1,0,0,1,0,1,7377
0,0,1,0,1,0,1,7378
1,1,0,1,1,1,2,7378
2,2,0,0,1,1,2,7378
0,0,1,0,1,0,1,7379
1,1,0,0,1,0,1,7379
0,0,1,0,1,0,1,7380
1,1,2,0,3,0,3,7380
2,2,4,0,7,0,7,7380
3,3,1,1,8,1,9,7380
4,4,0,1,8,2,10,7380
5,5,0,0,8,2,10,7380
0,0,1,0,1,0,1,7381
1,1,1,0,2,0,2,7381
2,2,4,0,6,0,6,7381
3,3,4,0,10,0,10,7381
4,4,1,0,11,0,11,7381
5,5,0,1,11,1,12,7381
6,6,0,1,11,2,13,7381
7,7,0,0,11,2,13,7381
0,0,1,0,1,0,1,7382
1,1,0,0,1,0,1,7382
0,0,1,0,1,0,1,7383
1,1,1,0,2,0,2,7383
2,2,0,0,2,0,2,7383
0,0,1,0,1,0,1,7384
1,1,2,0,3,0,3,7384
2,2,2,0,5,0,5,7384
3,3,3,0,8,0,8,7384
4,4,0,1,8,1,9,7384
5,5,0,0,8,1,9,7384
0,0,1,0,1,0,1,7385
1,1,0,0,1,0,1,7385
0,0,1,0,1,0,1,7386
1,1,0,0,1,0,1,7386
0,0,1,0,1,0,1,7387
1,1,1,0,2,0,2,7387
2,2,0,2,2,2,4,7387
3,3,0,1,2,3,5,7387
4,4,0,1,2,4,6,7387
5,5,0,2,2,6,8,7387
6,6,0,1,2,7,9,7387
7,7,0,0,2,7,9,7387
0,0,1,0,1,0,1,7388
1,1,0,0,1,0,1,7388
0,0,1,0,1,0,1,7389
1,1,0,0,1,0,1,7389
0,0,1,0,1,0,1,7390
1,1,0,0,1,0,1,7390
0,0,1,0,1,0,1,7391
1,1,1,1,2,1,3,7391
2,2,1,3,3,4,7,7391
3,3,0,3,3,7,10,7391
4,4,0,3,3,10,13,7391
5,5,1,2,4,12,16,7391
6,6,1,3,5,15,20,7391
7,7,2,8,7,23,30,7391
8,8,3,4,10,27,37,7391
9,9,2,4,12,31,43,7391
10,10,2,10,14,41,55,7391
11,11,6,8,20,49,69,7391
12,12,12,0,32,49,81,7391
13,13,9,4,41,53,94,7391
14,14,10,11,51,64,115,7391
15,15,6,10,57,74,131,7391
16,16,7,8,64,82,146,7391
17,17,5,5,69,87,156,7391
18,18,6,5,75,92,167,7391
19,19,5,2,80,94,174,7391
20,20,7,1,87,95,182,7391
21,21,5,2,92,97,189,7391
22,22,1,2,93,99,192,7391
23,23,1,2,94,101,195,7391
24,24,1,2,95,103,198,7391
25,25,1,3,96,106,202,7391
26,26,1,2,97,108,205,7391
27,27,1,1,98,109,207,7391
28,28,0,0,98,109,207,7391
0,0,1,0,1,0,1,7392
1,1,0,0,1,0,1,7392
0,0,1,0,1,0,1,7393
1,1,1,0,2,0,2,7393
2,2,1,0,3,0,3,7393
3,3,1,0,4,0,4,7393
4,4,1,0,5,0,5,7393
5,5,0,0,5,0,5,7393
0,0,1,0,1,0,1,7394
1,1,0,0,1,0,1,7394
0,0,1,0,1,0,1,7395
1,1,1,0,2,0,2,7395
2,2,0,0,2,0,2,7395
0,0,1,0,1,0,1,7396
1,1,0,0,1,0,1,7396
0,0,1,0,1,0,1,7397
1,1,0,0,1,0,1,7397
0,0,1,0,1,0,1,7398
1,1,1,0,2,0,2,7398
2,2,1,0,3,0,3,7398
3,3,0,0,3,0,3,7398
0,0,1,0,1,0,1,7399
1,1,0,0,1,0,1,7399
0,0,1,0,1,0,1,7400
1,1,2,1,3,1,4,7400
2,2,1,1,4,2,6,7400
3,3,0,2,4,4,8,7400
4,4,0,2,4,6,10,7400
5,5,0,2,4,8,12,7400
6,6,0,0,4,8,12,7400
0,0,1,0,1,0,1,7401
1,1,2,0,3,0,3,7401
2,2,2,0,5,0,5,7401
3,3,3,0,8,0,8,7401
4,4,3,0,11,0,11,7401
5,5,3,1,14,1,15,7401
6,6,2,1,16,2,18,7401
7,7,1,2,17,4,21,7401
8,8,0,3,17,7,24,7401
9,9,0,2,17,9,26,7401
10,10,1,1,18,10,28,7401
11,11,2,0,20,10,30,7401
12,12,4,0,24,10,34,7401
13,13,2,0,26,10,36,7401
14,14,4,0,30,10,40,7401
15,15,5,0,35,10,45,7401
16,16,7,2,42,12,54,7401
17,17,8,3,50,15,65,7401
18,18,3,2,53,17,70,7401
19,19,2,2,55,19,74,7401
20,20,0,2,55,21,76,7401
21,21,0,1,55,22,77,7401
22,22,0,0,55,22,77,7401
0,0,1,0,1,0,1,7402
1,1,0,1,1,1,2,7402
2,2,1,2,2,3,5,7402
3,3,1,1,3,4,7,7402
4,4,1,0,4,4,8,7402
5,5,2,0,6,4,10,7402
6,6,3,1,9,5,14,7402
7,7,2,1,11,6,17,7402
8,8,2,2,13,8,21,7402
9,9,2,3,15,11,26,7402
10,10,2,3,17,14,31,7402
11,11,0,2,17,16,33,7402
12,12,0,2,17,18,35,7402
13,13,0,2,17,20,37,7402
14,14,0,3,17,23,40,7402
15,15,0,1,17,24,41,7402
16,16,0,0,17,24,41,7402
0,0,1,0,1,0,1,7403
1,1,0,0,1,0,1,7403
0,0,1,0,1,0,1,7404
1,1,2,0,3,0,3,7404
2,2,0,0,3,0,3,7404
0,0,1,0,1,0,1,7405
1,1,0,0,1,0,1,7405
0,0,1,0,1,0,1,7406
1,1,0,0,1,0,1,7406
0,0,1,0,1,0,1,7407
1,1,0,0,1,0,1,7407
0,0,1,0,1,0,1,7408
1,1,1,1,2,1,3,7408
2,2,2,0,4,1,5,7408
3,3,3,0,7,1,8,7408
4,4,1,1,8,2,10,7408
5,5,1,1,9,3,12,7408
6,6,2,1,11,4,15,7408
7,7,2,1,13,5,18,7408
8,8,0,1,13,6,19,7408
9,9,2,0,15,6,21,7408
10,10,1,0,16,6,22,7408
11,11,1,0,17,6,23,7408
12,12,0,0,17,6,23,7408
0,0,1,0,1,0,1,7409
1,1,0,0,1,0,1,7409
0,0,1,0,1,0,1,7410
1,1,0,0,1,0,1,7410
0,0,1,0,1,0,1,7411
1,1,1,0,2,0,2,7411
2,2,1,0,3,0,3,7411
3,3,0,0,3,0,3,7411
0,0,1,0,1,0,1,7412
1,1,0,0,1,0,1,7412
0,0,1,0,1,0,1,7413
1,1,0,0,1,0,1,7413
0,0,1,0,1,0,1,7414
1,1,0,1,1,1,2,7414
2,2,0,0,1,1,2,7414
0,0,1,0,1,0,1,7415
1,1,0,0,1,0,1,7415
0,0,1,0,1,0,1,7416
1,1,1,1,2,1,3,7416
2,2,0,1,2,2,4,7416
3,3,1,1,3,3,6,7416
4,4,1,0,4,3,7,7416
5,5,0,0,4,3,7,7416
0,0,1,0,1,0,1,7417
1,1,2,0,3,0,3,7417
2,2,6,1,9,1,10,7417
3,3,4,1,13,2,15,7417
4,4,7,2,20,4,24,7417
5,5,2,3,22,7,29,7417
6,6,3,1,25,8,33,7417
7,7,2,2,27,10,37,7417
8,8,0,2,27,12,39,7417
9,9,0,2,27,14,41,7417
10,10,0,0,27,14,41,7417
0,0,1,0,1,0,1,7418
1,1,0,0,1,0,1,7418
0,0,1,0,1,0,1,7419
1,1,0,0,1,0,1,7419
0,0,1,0,1,0,1,7420
1,1,0,0,1,0,1,7420
0,0,1,0,1,0,1,7421
1,1,1,0,2,0,2,7421
2,2,2,0,4,0,4,7421
3,3,0,0,4,0,4,7421
0,0,1,0,1,0,1,7422
1,1,0,0,1,0,1,7422
0,0,1,0,1,0,1,7423
1,1,2,0,3,0,3,7423
2,2,3,0,6,0,6,7423
3,3,5,1,11,1,12,7423
4,4,2,3,13,4,17,7423
5,5,3,5,16,9,25,7423
6,6,1,1,17,10,27,7423
7,7,0,1,17,11,28,7423
8,8,0,0,17,11,28,7423
0,0,1,0,1,0,1,7424
1,1,1,0,2,0,2,7424
2,2,1,0,3,0,3,7424
3,3,0,1,3,1,4,7424
4,4,0,0,3,1,4,7424
0,0,1,0,1,0,1,7425
1,1,0,0,1,0,1,7425
0,0,1,0,1,0,1,7426
1,1,0,1,1,1,2,7426
2,2,0,0,1,1,2,7426
0,0,1,0,1,0,1,7427
1,1,1,1,2,1,3,7427
2,2,0,3,2,4,6,7427
3,3,0,0,2,4,6,7427
0,0,1,0,1,0,1,7428
1,1,1,0,2,0,2,7428
2,2,2,0,4,0,4,7428
3,3,4,2,8,2,10,7428
4,4,2,3,10,5,15,7428
5,5,3,3,13,8,21,7428
6,6,0,2,13,10,23,7428
7,7,0,1,13,11,24,7428
8,8,0,1,13,12,25,7428
9,9,1,0,14,12,26,7428
10,10,1,0,15,12,27,7428
11,11,0,0,15,12,27,7428
0,0,1,0,1,0,1,7429
1,1,1,0,2,0,2,7429
2,2,0,0,2,0,2,7429
0,0,1,0,1,0,1,7430
1,1,0,0,1,0,1,7430
0,0,1,0,1,0,1,7431
1,1,1,0,2,0,2,7431
2,2,1,1,3,1,4,7431
3,3,1,1,4,2,6,7431
4,4,1,1,5,3,8,7431
5,5,0,2,5,5,10,7431
6,6,0,2,5,7,12,7431
7,7,0,0,5,7,12,7431
0,0,1,0,1,0,1,7432
1,1,0,0,1,0,1,7432
0,0,1,0,1,0,1,7433
1,1,0,0,1,0,1,7433
0,0,1,0,1,0,1,7434
1,1,0,0,1,0,1,7434
0,0,1,0,1,0,1,7435
1,1,1,0,2,0,2,7435
2,2,2,0,4,0,4,7435
3,3,3,1,7,1,8,7435
4,4,2,1,9,2,11,7435
5,5,0,1,9,3,12,7435
6,6,0,1,9,4,13,7435
7,7,0,0,9,4,13,7435
0,0,1,0,1,0,1,7436
1,1,1,0,2,0,2,7436
2,2,0,0,2,0,2,7436
0,0,1,0,1,0,1,7437
1,1,3,1,4,1,5,7437
2,2,4,1,8,2,10,7437
3,3,3,1,11,3,14,7437
4,4,1,0,12,3,15,7437
5,5,0,0,12,3,15,7437
0,0,1,0,1,0,1,7438
1,1,1,0,2,0,2,7438
2,2,1,0,3,0,3,7438
3,3,0,0,3,0,3,7438
0,0,1,0,1,0,1,7439
1,1,0,0,1,0,1,7439
0,0,1,0,1,0,1,7440
1,1,1,0,2,0,2,7440
2,2,1,0,3,0,3,7440
3,3,0,0,3,0,3,7440
0,0,1,0,1,0,1,7441
1,1,0,1,1,1,2,7441
2,2,0,0,1,1,2,7441
0,0,1,0,1,0,1,7442
1,1,0,1,1,1,2,7442
2,2,0,1,1,2,3,7442
3,3,0,0,1,2,3,7442
0,0,1,0,1,0,1,7443
1,1,0,0,1,0,1,7443
0,0,1,0,1,0,1,7444
1,1,1,0,2,0,2,7444
2,2,2,0,4,0,4,7444
3,3,3,1,7,1,8,7444
4,4,4,0,11,1,12,7444
5,5,1,1,12,2,14,7444
6,6,1,2,13,4,17,7444
7,7,2,0,15,4,19,7444
8,8,2,0,17,4,21,7444
9,9,3,0,20,4,24,7444
10,10,4,0,24,4,28,7444
11,11,2,0,26,4,30,7444
12,12,2,0,28,4,32,7444
13,13,1,0,29,4,33,7444
14,14,0,0,29,4,33,7444
0,0,1,0,1,0,1,7445
1,1,0,0,1,0,1,7445
0,0,1,0,1,0,1,7446
1,1,1,1,2,1,3,7446
2,2,2,0,4,1,5,7446
3,3,4,1,8,2,10,7446
4,4,1,2,9,4,13,7446
5,5,1,0,10,4,14,7446
6,6,0,0,10,4,14,7446
0,0,1,0,1,0,1,7447
1,1,1,0,2,0,2,7447
2,2,1,0,3,0,3,7447
3,3,0,0,3,0,3,7447
0,0,1,0,1,0,1,7448
1,1,0,0,1,0,1,7448
0,0,1,0,1,0,1,7449
1,1,0,0,1,0,1,7449
0,0,1,0,1,0,1,7450
1,1,0,1,1,1,2,7450
2,2,0,0,1,1,2,7450
0,0,1,0,1,0,1,7451
1,1,1,0,2,0,2,7451
2,2,1,0,3,0,3,7451
3,3,0,0,3,0,3,7451
0,0,1,0,1,0,1,7452
1,1,0,1,1,1,2,7452
2,2,0,1,1,2,3,7452
3,3,1,2,2,4,6,7452
4,4,1,0,3,4,7,7452
5,5,0,0,3,4,7,7452
0,0,1,0,1,0,1,7453
1,1,0,0,1,0,1,7453
0,0,1,0,1,0,1,7454
1,1,1,0,2,0,2,7454
2,2,3,0,5,0,5,7454
3,3,2,1,7,1,8,7454
4,4,3,0,10,1,11,7454
5,5,4,0,14,1,15,7454
6,6,1,0,15,1,16,7454
7,7,1,1,16,2,18,7454
8,8,0,0,16,2,18,7454
0,0,1,0,1,0,1,7455
1,1,0,0,1,0,1,7455
0,0,1,0,1,0,1,7456
1,1,4,0,5,0,5,7456
2,2,6,0,11,0,11,7456
3,3,8,0,19,0,19,7456
4,4,3,3,22,3,25,7456
5,5,1,7,23,10,33,7456
6,6,2,7,25,17,42,7456
7,7,4,6,29,23,52,7456
8,8,3,3,32,26,58,7456
9,9,3,3,35,29,64,7456
10,10,0,8,35,37,72,7456
11,11,1,8,36,45,81,7456
12,12,1,7,37,52,89,7456
13,13,2,7,39,59,98,7456
14,14,3,7,42,66,108,7456
15,15,4,5,46,71,117,7456
16,16,5,9,51,80,131,7456
17,17,7,7,58,87,145,7456
18,18,9,4,67,91,158,7456
19,19,8,7,75,98,173,7456
20,20,6,10,81,108,189,7456
21,21,8,8,89,116,205,7456
22,22,9,8,98,124,222,7456
23,23,8,5,106,129,235,7456
24,24,4,8,110,137,247,7456
25,25,3,7,113,144,257,7456
26,26,1,5,114,149,263,7456
27,27,3,2,117,151,268,7456
28,28,2,2,119,153,272,7456
29,29,2,1,121,154,275,7456
30,30,2,2,123,156,279,7456
31,31,1,2,124,158,282,7456
32,32,2,1,126,159,285,7456
33,33,3,1,129,160,289,7456
34,34,1,2,130,162,292,7456
35,35,1,1,131,163,294,7456
36,36,0,0,131,163,294,7456
0,0,1,0,1,0,1,7457
1,1,1,1,2,1,3,7457
2,2,2,1,4,2,6,7457
3,3,2,4,6,6,12,7457
4,4,1,0,7,6,13,7457
5,5,0,0,7,6,13,7457
0,0,1,0,1,0,1,7458
1,1,2,0,3,0,3,7458
2,2,2,0,5,0,5,7458
3,3,0,0,5,0,5,7458
0,0,1,0,1,0,1,7459
1,1,0,1,1,1,2,7459
2,2,1,0,2,1,3,7459
3,3,0,0,2,1,3,7459
0,0,1,0,1,0,1,7460
1,1,0,1,1,1,2,7460
2,2,0,1,1,2,3,7460
3,3,0,1,1,3,4,7460
4,4,0,0,1,3,4,7460
0,0,1,0,1,0,1,7461
1,1,1,0,2,0,2,7461
2,2,0,0,2,0,2,7461
0,0,1,0,1,0,1,7462
1,1,0,0,1,0,1,7462
0,0,1,0,1,0,1,7463
1,1,0,1,1,1,2,7463
2,2,0,0,1,1,2,7463
0,0,1,0,1,0,1,7464
1,1,2,0,3,0,3,7464
2,2,2,0,5,0,5,7464
3,3,2,0,7,0,7,7464
4,4,1,1,8,1,9,7464
5,5,0,1,8,2,10,7464
6,6,1,0,9,2,11,7464
7,7,1,0,10,2,12,7464
8,8,0,0,10,2,12,7464
0,0,1,0,1,0,1,7465
1,1,1,0,2,0,2,7465
2,2,1,0,3,0,3,7465
3,3,2,0,5,0,5,7465
4,4,1,1,6,1,7,7465
5,5,3,1,9,2,11,7465
6,6,2,2,11,4,15,7465
7,7,2,2,13,6,19,7465
8,8,2,2,15,8,23,7465
9,9,1,0,16,8,24,7465
10,10,1,0,17,8,25,7465
11,11,0,0,17,8,25,7465
0,0,1,0,1,0,1,7466
1,1,0,1,1,1,2,7466
2,2,0,1,1,2,3,7466
3,3,1,0,2,2,4,7466
4,4,0,0,2,2,4,7466
0,0,1,0,1,0,1,7467
1,1,1,0,2,0,2,7467
2,2,1,0,3,0,3,7467
3,3,1,0,4,0,4,7467
4,4,0,0,4,0,4,7467
0,0,1,0,1,0,1,7468
1,1,0,0,1,0,1,7468
0,0,1,0,1,0,1,7469
1,1,0,0,1,0,1,7469
0,0,1,0,1,0,1,7470
1,1,2,0,3,0,3,7470
2,2,1,0,4,0,4,7470
3,3,1,0,5,0,5,7470
4,4,2,0,7,0,7,7470
5,5,2,0,9,0,9,7470
6,6,3,2,12,2,14,7470
7,7,4,3,16,5,21,7470
8,8,3,3,19,8,27,7470
9,9,3,5,22,13,35,7470
10,10,3,7,25,20,45,7470
11,11,5,9,30,29,59,7470
12,12,6,9,36,38,74,7470
13,13,6,12,42,50,92,7470
14,14,8,3,50,53,103,7470
15,15,7,3,57,56,113,7470
16,16,5,3,62,59,121,7470
17,17,5,2,67,61,128,7470
18,18,3,4,70,65,135,7470
19,19,7,2,77,67,144,7470
20,20,6,5,83,72,155,7470
21,21,4,6,87,78,165,7470
22,22,2,6,89,84,173,7470
23,23,1,4,90,88,178,7470
24,24,1,2,91,90,181,7470
25,25,0,3,91,93,184,7470
26,26,1,0,92,93,185,7470
27,27,1,0,93,93,186,7470
28,28,0,0,93,93,186,7470
0,0,1,0,1,0,1,7471
1,1,1,0,2,0,2,7471
2,2,0,0,2,0,2,7471
0,0,1,0,1,0,1,7472
1,1,1,0,2,0,2,7472
2,2,0,0,2,0,2,7472
0,0,1,0,1,0,1,7473
1,1,2,0,3,0,3,7473
2,2,1,1,4,1,5,7473
3,3,2,1,6,2,8,7473
4,4,1,1,7,3,10,7473
5,5,0,0,7,3,10,7473
0,0,1,0,1,0,1,7474
1,1,0,0,1,0,1,7474
0,0,1,0,1,0,1,7475
1,1,2,2,3,2,5,7475
2,2,1,2,4,4,8,7475
3,3,0,2,4,6,10,7475
4,4,0,0,4,6,10,7475
0,0,1,0,1,0,1,7476
1,1,0,1,1,1,2,7476
2,2,1,0,2,1,3,7476
3,3,1,0,3,1,4,7476
4,4,1,0,4,1,5,7476
5,5,0,0,4,1,5,7476
0,0,1,0,1,0,1,7477
1,1,1,0,2,0,2,7477
2,2,0,1,2,1,3,7477
3,3,1,1,3,2,5,7477
4,4,0,1,3,3,6,7477
5,5,0,0,3,3,6,7477
0,0,1,0,1,0,1,7478
1,1,1,0,2,0,2,7478
2,2,0,0,2,0,2,7478
0,0,1,0,1,0,1,7479
1,1,1,0,2,0,2,7479
2,2,1,0,3,0,3,7479
3,3,1,0,4,0,4,7479
4,4,2,0,6,0,6,7479
5,5,2,0,8,0,8,7479
6,6,2,0,10,0,10,7479
7,7,0,1,10,1,11,7479
8,8,0,1,10,2,12,7479
9,9,0,1,10,3,13,7479
10,10,1,0,11,3,14,7479
11,11,0,0,11,3,14,7479
0,0,1,0,1,0,1,7480
1,1,0,1,1,1,2,7480
2,2,0,0,1,1,2,7480
0,0,1,0,1,0,1,7481
1,1,0,0,1,0,1,7481
0,0,1,0,1,0,1,7482
1,1,1,0,2,0,2,7482
2,2,2,0,4,0,4,7482
3,3,1,0,5,0,5,7482
4,4,1,0,6,0,6,7482
5,5,0,1,6,1,7,7482
6,6,0,0,6,1,7,7482
0,0,1,0,1,0,1,7483
1,1,1,0,2,0,2,7483
2,2,2,1,4,1,5,7483
3,3,2,0,6,1,7,7483
4,4,1,0,7,1,8,7483
5,5,1,0,8,1,9,7483
6,6,0,0,8,1,9,7483
0,0,1,0,1,0,1,7484
1,1,0,0,1,0,1,7484
0,0,1,0,1,0,1,7485
1,1,0,0,1,0,1,7485
0,0,1,0,1,0,1,7486
1,1,0,0,1,0,1,7486
0,0,1,0,1,0,1,7487
1,1,1,1,2,1,3,7487
2,2,1,3,3,4,7,7487
3,3,0,0,3,4,7,7487
0,0,1,0,1,0,1,7488
1,1,0,0,1,0,1,7488
0,0,1,0,1,0,1,7489
1,1,3,0,4,0,4,7489
2,2,3,0,7,0,7,7489
3,3,3,0,10,0,10,7489
4,4,4,1,14,1,15,7489
5,5,4,4,18,5,23,7489
6,6,4,1,22,6,28,7489
7,7,4,1,26,7,33,7489
8,8,4,2,30,9,39,7489
9,9,5,1,35,10,45,7489
10,10,2,2,37,12,49,7489
11,11,2,1,39,13,52,7489
12,12,2,0,41,13,54,7489
13,13,3,1,44,14,58,7489
14,14,2,0,46,14,60,7489
15,15,1,0,47,14,61,7489
16,16,1,0,48,14,62,7489
17,17,0,0,48,14,62,7489
0,0,1,0,1,0,1,7490
1,1,0,0,1,0,1,7490
0,0,1,0,1,0,1,7491
1,1,0,1,1,1,2,7491
2,2,0,1,1,2,3,7491
3,3,1,0,2,2,4,7491
4,4,2,0,4,2,6,7491
5,5,0,0,4,2,6,7491
0,0,1,0,1,0,1,7492
1,1,0,1,1,1,2,7492
2,2,0,2,1,3,4,7492
3,3,0,4,1,7,8,7492
4,4,3,2,4,9,13,7492
5,5,2,2,6,11,17,7492
6,6,5,1,11,12,23,7492
7,7,4,1,15,13,28,7492
8,8,3,0,18,13,31,7492
9,9,3,1,21,14,35,7492
10,10,5,2,26,16,42,7492
11,11,5,2,31,18,49,7492
12,12,4,0,35,18,53,7492
13,13,1,0,36,18,54,7492
14,14,2,0,38,18,56,7492
15,15,1,1,39,19,58,7492
16,16,1,0,40,19,59,7492
17,17,0,0,40,19,59,7492
0,0,1,0,1,0,1,7493
1,1,2,0,3,0,3,7493
2,2,2,0,5,0,5,7493
3,3,2,0,7,0,7,7493
4,4,2,0,9,0,9,7493
5,5,2,0,11,0,11,7493
6,6,1,1,12,1,13,7493
7,7,1,0,13,1,14,7493
8,8,2,0,15,1,16,7493
9,9,0,0,15,1,16,7493
0,0,1,0,1,0,1,7494
1,1,0,1,1,1,2,7494
2,2,0,0,1,1,2,7494
0,0,1,0,1,0,1,7495
1,1,1,0,2,0,2,7495
2,2,2,0,4,0,4,7495
3,3,2,0,6,0,6,7495
4,4,1,0,7,0,7,7495
5,5,0,0,7,0,7,7495
0,0,1,0,1,0,1,7496
1,1,0,0,1,0,1,7496
0,0,1,0,1,0,1,7497
1,1,1,0,2,0,2,7497
2,2,1,0,3,0,3,7497
3,3,0,1,3,1,4,7497
4,4,0,1,3,2,5,7497
5,5,0,2,3,4,7,7497
6,6,0,2,3,6,9,7497
7,7,1,2,4,8,12,7497
8,8,1,2,5,10,15,7497
9,9,0,1,5,11,16,7497
10,10,0,0,5,11,16,7497
0,0,1,0,1,0,1,7498
1,1,0,1,1,1,2,7498
2,2,0,0,1,1,2,7498
0,0,1,0,1,0,1,7499
1,1,1,0,2,0,2,7499
2,2,0,0,2,0,2,7499
0,0,1,0,1,0,1,7500
1,1,2,0,3,0,3,7500
2,2,1,0,4,0,4,7500
3,3,1,1,5,1,6,7500
4,4,2,1,7,2,9,7500
5,5,2,1,9,3,12,7500
6,6,2,1,11,4,15,7500
7,7,0,1,11,5,16,7500
8,8,0,3,11,8,19,7500
9,9,1,0,12,8,20,7500
10,10,0,0,12,8,20,7500
0,0,1,0,1,0,1,7501
1,1,3,1,4,1,5,7501
2,2,2,0,6,1,7,7501
3,3,2,0,8,1,9,7501
4,4,3,0,11,1,12,7501
5,5,4,1,15,2,17,7501
6,6,0,2,15,4,19,7501
7,7,0,2,15,6,21,7501
8,8,1,3,16,9,25,7501
9,9,0,2,16,11,27,7501
10,10,0,3,16,14,30,7501
11,11,1,2,17,16,33,7501
12,12,1,0,18,16,34,7501
13,13,0,1,18,17,35,7501
14,14,0,1,18,18,36,7501
15,15,0,1,18,19,37,7501
16,16,0,1,18,20,38,7501
17,17,0,2,18,22,40,7501
18,18,0,1,18,23,41,7501
19,19,0,0,18,23,41,7501
0,0,1,0,1,0,1,7502
1,1,0,0,1,0,1,7502
0,0,1,0,1,0,1,7503
1,1,0,1,1,1,2,7503
2,2,0,1,1,2,3,7503
3,3,1,1,2,3,5,7503
4,4,0,0,2,3,5,7503
0,0,1,0,1,0,1,7504
1,1,2,0,3,0,3,7504
2,2,0,0,3,0,3,7504
0,0,1,0,1,0,1,7505
1,1,0,0,1,0,1,7505
0,0,1,0,1,0,1,7506
1,1,1,0,2,0,2,7506
2,2,0,0,2,0,2,7506
0,0,1,0,1,0,1,7507
1,1,0,0,1,0,1,7507
0,0,1,0,1,0,1,7508
1,1,2,1,3,1,4,7508
2,2,1,2,4,3,7,7508
3,3,0,1,4,4,8,7508
4,4,0,1,4,5,9,7508
5,5,1,0,5,5,10,7508
6,6,1,0,6,5,11,7508
7,7,1,0,7,5,12,7508
8,8,1,0,8,5,13,7508
9,9,2,0,10,5,15,7508
10,10,3,0,13,5,18,7508
11,11,3,1,16,6,22,7508
12,12,1,0,17,6,23,7508
13,13,1,0,18,6,24,7508
14,14,0,0,18,6,24,7508
0,0,1,0,1,0,1,7509
1,1,1,0,2,0,2,7509
2,2,1,0,3,0,3,7509
3,3,1,0,4,0,4,7509
4,4,0,0,4,0,4,7509
0,0,1,0,1,0,1,7510
1,1,0,0,1,0,1,7510
0,0,1,0,1,0,1,7511
1,1,1,0,2,0,2,7511
2,2,0,1,2,1,3,7511
3,3,0,0,2,1,3,7511
0,0,1,0,1,0,1,7512
1,1,2,0,3,0,3,7512
2,2,2,0,5,0,5,7512
3,3,1,0,6,0,6,7512
4,4,0,0,6,0,6,7512
0,0,1,0,1,0,1,7513
1,1,1,0,2,0,2,7513
2,2,1,0,3,0,3,7513
3,3,3,0,6,0,6,7513
4,4,0,1,6,1,7,7513
5,5,0,0,6,1,7,7513
0,0,1,0,1,0,1,7514
1,1,0,0,1,0,1,7514
0,0,1,0,1,0,1,7515
1,1,1,0,2,0,2,7515
2,2,0,0,2,0,2,7515
0,0,1,0,1,0,1,7516
1,1,0,0,1,0,1,7516
0,0,1,0,1,0,1,7517
1,1,0,0,1,0,1,7517
0,0,1,0,1,0,1,7518
1,1,1,0,2,0,2,7518
2,2,0,0,2,0,2,7518
0,0,1,0,1,0,1,7519
1,1,1,1,2,1,3,7519
2,2,2,1,4,2,6,7519
3,3,4,0,8,2,10,7519
4,4,4,1,12,3,15,7519
5,5,6,2,18,5,23,7519
6,6,4,3,22,8,30,7519
7,7,3,1,25,9,34,7519
8,8,6,1,31,10,41,7519
9,9,5,1,36,11,47,7519
10,10,7,0,43,11,54,7519
11,11,2,0,45,11,56,7519
12,12,0,0,45,11,56,7519
0,0,1,0,1,0,1,7520
1,1,0,2,1,2,3,7520
2,2,0,1,1,3,4,7520
3,3,0,0,1,3,4,7520
0,0,1,0,1,0,1,7521
1,1,0,0,1,0,1,7521
0,0,1,0,1,0,1,7522
1,1,2,0,3,0,3,7522
2,2,1,0,4,0,4,7522
3,3,1,0,5,0,5,7522
4,4,1,1,6,1,7,7522
5,5,2,0,8,1,9,7522
6,6,0,0,8,1,9,7522
0,0,1,0,1,0,1,7523
1,1,1,0,2,0,2,7523
2,2,1,0,3,0,3,7523
3,3,2,2,5,2,7,7523
4,4,3,0,8,2,10,7523
5,5,4,1,12,3,15,7523
6,6,2,3,14,6,20,7523
7,7,3,2,17,8,25,7523
8,8,4,6,21,14,35,7523
9,9,1,0,22,14,36,7523
10,10,1,0,23,14,37,7523
11,11,1,0,24,14,38,7523
12,12,0,0,24,14,38,7523
0,0,1,0,1,0,1,7524
1,1,0,0,1,0,1,7524
0,0,1,0,1,0,1,7525
1,1,0,0,1,0,1,7525
0,0,1,0,1,0,1,7526
1,1,0,0,1,0,1,7526
0,0,1,0,1,0,1,7527
1,1,1,0,2,0,2,7527
2,2,0,0,2,0,2,7527
0,0,1,0,1,0,1,7528
1,1,2,1,3,1,4,7528
2,2,1,0,4,1,5,7528
3,3,0,0,4,1,5,7528
0,0,1,0,1,0,1,7529
1,1,3,0,4,0,4,7529
2,2,3,1,7,1,8,7529
3,3,2,0,9,1,10,7529
4,4,3,1,12,2,14,7529
5,5,3,2,15,4,19,7529
6,6,1,7,16,11,27,7529
7,7,2,3,18,14,32,7529
8,8,0,4,18,18,36,7529
9,9,2,1,20,19,39,7529
10,10,2,0,22,19,41,7529
11,11,1,0,23,19,42,7529
12,12,0,0,23,19,42,7529
0,0,1,0,1,0,1,7530
1,1,1,0,2,0,2,7530
2,2,0,0,2,0,2,7530
0,0,1,0,1,0,1,7531
1,1,0,0,1,0,1,7531
0,0,1,0,1,0,1,7532
1,1,1,0,2,0,2,7532
2,2,0,0,2,0,2,7532
0,0,1,0,1,0,1,7533
1,1,2,0,3,0,3,7533
2,2,1,0,4,0,4,7533
3,3,1,1,5,1,6,7533
4,4,0,1,5,2,7,7533
5,5,0,2,5,4,9,7533
6,6,0,2,5,6,11,7533
7,7,0,1,5,7,12,7533
8,8,0,1,5,8,13,7533
9,9,0,1,5,9,14,7533
10,10,0,0,5,9,14,7533
0,0,1,0,1,0,1,7534
1,1,1,1,2,1,3,7534
2,2,0,1,2,2,4,7534
3,3,0,0,2,2,4,7534
0,0,1,0,1,0,1,7535
1,1,1,0,2,0,2,7535
2,2,1,0,3,0,3,7535
3,3,1,0,4,0,4,7535
4,4,1,0,5,0,5,7535
5,5,1,0,6,0,6,7535
6,6,2,0,8,0,8,7535
7,7,0,0,8,0,8,7535
0,0,1,0,1,0,1,7536
1,1,2,0,3,0,3,7536
2,2,3,0,6,0,6,7536
3,3,2,0,8,0,8,7536
4,4,0,0,8,0,8,7536
0,0,1,0,1,0,1,7537
1,1,0,0,1,0,1,7537
0,0,1,0,1,0,1,7538
1,1,0,0,1,0,1,7538
0,0,1,0,1,0,1,7539
1,1,2,0,3,0,3,7539
2,2,0,0,3,0,3,7539
0,0,1,0,1,0,1,7540
1,1,0,0,1,0,1,7540
0,0,1,0,1,0,1,7541
1,1,2,0,3,0,3,7541
2,2,0,0,3,0,3,7541
0,0,1,0,1,0,1,7542
1,1,1,0,2,0,2,7542
2,2,1,0,3,0,3,7542
3,3,1,0,4,0,4,7542
4,4,0,0,4,0,4,7542
0,0,1,0,1,0,1,7543
1,1,0,1,1,1,2,7543
2,2,0,1,1,2,3,7543
3,3,0,0,1,2,3,7543
0,0,1,0,1,0,1,7544
1,1,1,1,2,1,3,7544
2,2,0,0,2,1,3,7544
0,0,1,0,1,0,1,7545
1,1,1,0,2,0,2,7545
2,2,1,0,3,0,3,7545
3,3,1,0,4,0,4,7545
4,4,0,0,4,0,4,7545
0,0,1,0,1,0,1,7546
1,1,1,0,2,0,2,7546
2,2,0,1,2,1,3,7546
3,3,0,0,2,1,3,7546
0,0,1,0,1,0,1,7547
1,1,1,1,2,1,3,7547
2,2,0,1,2,2,4,7547
3,3,0,2,2,4,6,7547
4,4,0,2,2,6,8,7547
5,5,1,3,3,9,12,7547
6,6,0,3,3,12,15,7547
7,7,1,1,4,13,17,7547
8,8,1,1,5,14,19,7547
9,9,0,1,5,15,20,7547
10,10,0,0,5,15,20,7547
0,0,1,0,1,0,1,7548
1,1,1,0,2,0,2,7548
2,2,1,0,3,0,3,7548
3,3,1,0,4,0,4,7548
4,4,2,0,6,0,6,7548
5,5,2,0,8,0,8,7548
6,6,3,0,11,0,11,7548
7,7,2,0,13,0,13,7548
8,8,1,0,14,0,14,7548
9,9,1,0,15,0,15,7548
10,10,0,1,15,1,16,7548
11,11,0,1,15,2,17,7548
12,12,0,1,15,3,18,7548
13,13,0,0,15,3,18,7548
0,0,1,0,1,0,1,7549
1,1,0,0,1,0,1,7549
0,0,1,0,1,0,1,7550
1,1,0,0,1,0,1,7550
0,0,1,0,1,0,1,7551
1,1,0,0,1,0,1,7551
0,0,1,0,1,0,1,7552
1,1,0,0,1,0,1,7552
0,0,1,0,1,0,1,7553
1,1,0,0,1,0,1,7553
0,0,1,0,1,0,1,7554
1,1,1,0,2,0,2,7554
2,2,1,0,3,0,3,7554
3,3,2,0,5,0,5,7554
4,4,1,0,6,0,6,7554
5,5,1,0,7,0,7,7554
6,6,0,0,7,0,7,7554
0,0,1,0,1,0,1,7555
1,1,0,0,1,0,1,7555
0,0,1,0,1,0,1,7556
1,1,2,1,3,1,4,7556
2,2,0,2,3,3,6,7556
3,3,0,2,3,5,8,7556
4,4,0,2,3,7,10,7556
5,5,1,0,4,7,11,7556
6,6,0,0,4,7,11,7556
0,0,1,0,1,0,1,7557
1,1,0,0,1,0,1,7557
0,0,1,0,1,0,1,7558
1,1,0,0,1,0,1,7558
0,0,1,0,1,0,1,7559
1,1,2,1,3,1,4,7559
2,2,1,1,4,2,6,7559
3,3,0,1,4,3,7,7559
4,4,0,0,4,3,7,7559
0,0,1,0,1,0,1,7560
1,1,1,0,2,0,2,7560
2,2,1,1,3,1,4,7560
3,3,0,0,3,1,4,7560
0,0,1,0,1,0,1,7561
1,1,1,0,2,0,2,7561
2,2,0,1,2,1,3,7561
3,3,1,1,3,2,5,7561
4,4,1,0,4,2,6,7561
5,5,1,0,5,2,7,7561
6,6,0,1,5,3,8,7561
7,7,0,1,5,4,9,7561
8,8,0,1,5,5,10,7561
9,9,0,0,5,5,10,7561
0,0,1,0,1,0,1,7562
1,1,0,0,1,0,1,7562
0,0,1,0,1,0,1,7563
1,1,1,0,2,0,2,7563
2,2,0,0,2,0,2,7563
0,0,1,0,1,0,1,7564
1,1,1,0,2,0,2,7564
2,2,1,0,3,0,3,7564
3,3,0,0,3,0,3,7564
0,0,1,0,1,0,1,7565
1,1,1,0,2,0,2,7565
2,2,1,0,3,0,3,7565
3,3,0,0,3,0,3,7565
0,0,1,0,1,0,1,7566
1,1,1,0,2,0,2,7566
2,2,1,0,3,0,3,7566
3,3,0,0,3,0,3,7566
0,0,1,0,1,0,1,7567
1,1,0,0,1,0,1,7567
0,0,1,0,1,0,1,7568
1,1,1,0,2,0,2,7568
2,2,0,0,2,0,2,7568
0,0,1,0,1,0,1,7569
1,1,1,0,2,0,2,7569
2,2,0,0,2,0,2,7569
0,0,1,0,1,0,1,7570
1,1,2,0,3,0,3,7570
2,2,2,0,5,0,5,7570
3,3,1,0,6,0,6,7570
4,4,1,0,7,0,7,7570
5,5,1,1,8,1,9,7570
6,6,0,0,8,1,9,7570
0,0,1,0,1,0,1,7571
1,1,1,0,2,0,2,7571
2,2,3,0,5,0,5,7571
3,3,1,0,6,0,6,7571
4,4,1,0,7,0,7,7571
5,5,0,0,7,0,7,7571
0,0,1,0,1,0,1,7572
1,1,1,0,2,0,2,7572
2,2,2,0,4,0,4,7572
3,3,1,0,5,0,5,7572
4,4,1,0,6,0,6,7572
5,5,2,0,8,0,8,7572
6,6,1,0,9,0,9,7572
7,7,3,0,12,0,12,7572
8,8,2,0,14,0,14,7572
9,9,2,0,16,0,16,7572
10,10,2,0,18,0,18,7572
11,11,1,1,19,1,20,7572
12,12,1,1,20,2,22,7572
13,13,2,0,22,2,24,7572
14,14,1,0,23,2,25,7572
15,15,0,1,23,3,26,7572
16,16,0,1,23,4,27,7572
17,17,0,2,23,6,29,7572
18,18,1,2,24,8,32,7572
19,19,0,4,24,12,36,7572
20,20,0,5,24,17,41,7572
21,21,0,4,24,21,45,7572
22,22,1,3,25,24,49,7572
23,23,1,5,26,29,55,7572
24,24,1,6,27,35,62,7572
25,25,2,5,29,40,69,7572
26,26,0,7,29,47,76,7572
27,27,1,1,30,48,78,7572
28,28,2,1,32,49,81,7572
29,29,1,0,33,49,82,7572
30,30,1,1,34,50,84,7572
31,31,2,2,36,52,88,7572
32,32,3,0,39,52,91,7572
33,33,4,2,43,54,97,7572
34,34,3,1,46,55,101,7572
35,35,0,1,46,56,102,7572
36,36,0,2,46,58,104,7572
37,37,0,4,46,62,108,7572
38,38,1,3,47,65,112,7572
39,39,1,2,48,67,115,7572
40,40,1,3,49,70,119,7572
41,41,0,0,49,70,119,7572
0,0,1,0,1,0,1,7573
1,1,1,0,2,0,2,7573
2,2,2,0,4,0,4,7573
3,3,6,0,10,0,10,7573
4,4,6,2,16,2,18,7573
5,5,2,2,18,4,22,7573
6,6,2,2,20,6,26,7573
7,7,1,1,21,7,28,7573
8,8,1,1,22,8,30,7573
9,9,0,0,22,8,30,7573
0,0,1,0,1,0,1,7574
1,1,1,0,2,0,2,7574
2,2,1,0,3,0,3,7574
3,3,0,0,3,0,3,7574
0,0,1,0,1,0,1,7575
1,1,0,0,1,0,1,7575
0,0,1,0,1,0,1,7576
1,1,0,0,1,0,1,7576
0,0,1,0,1,0,1,7577
1,1,1,0,2,0,2,7577
2,2,0,1,2,1,3,7577
3,3,0,0,2,1,3,7577
0,0,1,0,1,0,1,7578
1,1,3,0,4,0,4,7578
2,2,3,2,7,2,9,7578
3,3,2,2,9,4,13,7578
4,4,3,2,12,6,18,7578
5,5,3,4,15,10,25,7578
6,6,0,3,15,13,28,7578
7,7,0,1,15,14,29,7578
8,8,0,3,15,17,32,7578
9,9,0,2,15,19,34,7578
10,10,0,0,15,19,34,7578
0,0,1,0,1,0,1,7579
1,1,0,0,1,0,1,7579
0,0,1,0,1,0,1,7580
1,1,1,0,2,0,2,7580
2,2,0,0,2,0,2,7580
0,0,1,0,1,0,1,7581
1,1,0,1,1,1,2,7581
2,2,0,3,1,4,5,7581
3,3,1,1,2,5,7,7581
4,4,1,1,3,6,9,7581
5,5,1,0,4,6,10,7581
6,6,0,0,4,6,10,7581
0,0,1,0,1,0,1,7582
1,1,1,0,2,0,2,7582
2,2,0,0,2,0,2,7582
0,0,1,0,1,0,1,7583
1,1,1,0,2,0,2,7583
2,2,0,0,2,0,2,7583
0,0,1,0,1,0,1,7584
1,1,0,0,1,0,1,7584
0,0,1,0,1,0,1,7585
1,1,0,0,1,0,1,7585
0,0,1,0,1,0,1,7586
1,1,0,0,1,0,1,7586
0,0,1,0,1,0,1,7587
1,1,0,0,1,0,1,7587
0,0,1,0,1,0,1,7588
1,1,1,1,2,1,3,7588
2,2,0,3,2,4,6,7588
3,3,0,1,2,5,7,7588
4,4,0,0,2,5,7,7588
0,0,1,0,1,0,1,7589
1,1,1,0,2,0,2,7589
2,2,1,0,3,0,3,7589
3,3,0,0,3,0,3,7589
0,0,1,0,1,0,1,7590
1,1,0,2,1,2,3,7590
2,2,1,2,2,4,6,7590
3,3,1,0,3,4,7,7590
4,4,0,0,3,4,7,7590
0,0,1,0,1,0,1,7591
1,1,2,0,3,0,3,7591
2,2,1,1,4,1,5,7591
3,3,0,1,4,2,6,7591
4,4,0,0,4,2,6,7591
0,0,1,0,1,0,1,7592
1,1,2,0,3,0,3,7592
2,2,1,0,4,0,4,7592
3,3,1,0,5,0,5,7592
4,4,0,0,5,0,5,7592
0,0,1,0,1,0,1,7593
1,1,1,0,2,0,2,7593
2,2,0,0,2,0,2,7593
0,0,1,0,1,0,1,7594
1,1,0,0,1,0,1,7594
0,0,1,0,1,0,1,7595
1,1,2,0,3,0,3,7595
2,2,2,1,5,1,6,7595
3,3,2,2,7,3,10,7595
4,4,1,2,8,5,13,7595
5,5,1,0,9,5,14,7595
6,6,0,0,9,5,14,7595
0,0,1,0,1,0,1,7596
1,1,0,0,1,0,1,7596
0,0,1,0,1,0,1,7597
1,1,0,0,1,0,1,7597
0,0,1,0,1,0,1,7598
1,1,0,0,1,0,1,7598
0,0,1,0,1,0,1,7599
1,1,1,0,2,0,2,7599
2,2,1,0,3,0,3,7599
3,3,0,0,3,0,3,7599
0,0,1,0,1,0,1,7600
1,1,0,0,1,0,1,7600
0,0,1,0,1,0,1,7601
1,1,1,0,2,0,2,7601
2,2,0,0,2,0,2,7601
0,0,1,0,1,0,1,7602
1,1,0,0,1,0,1,7602
0,0,1,0,1,0,1,7603
1,1,0,0,1,0,1,7603
0,0,1,0,1,0,1,7604
1,1,0,1,1,1,2,7604
2,2,0,0,1,1,2,7604
0,0,1,0,1,0,1,7605
1,1,0,1,1,1,2,7605
2,2,0,1,1,2,3,7605
3,3,0,1,1,3,4,7605
4,4,0,0,1,3,4,7605
0,0,1,0,1,0,1,7606
1,1,1,1,2,1,3,7606
2,2,0,3,2,4,6,7606
3,3,0,2,2,6,8,7606
4,4,0,3,2,9,11,7606
5,5,0,2,2,11,13,7606
6,6,1,1,3,12,15,7606
7,7,0,2,3,14,17,7606
8,8,0,1,3,15,18,7606
9,9,0,0,3,15,18,7606
0,0,1,0,1,0,1,7607
1,1,0,0,1,0,1,7607
0,0,1,0,1,0,1,7608
1,1,1,0,2,0,2,7608
2,2,0,0,2,0,2,7608
0,0,1,0,1,0,1,7609
1,1,2,0,3,0,3,7609
2,2,1,1,4,1,5,7609
3,3,1,0,5,1,6,7609
4,4,0,0,5,1,6,7609
0,0,1,0,1,0,1,7610
1,1,1,0,2,0,2,7610
2,2,1,0,3,0,3,7610
3,3,1,0,4,0,4,7610
4,4,0,0,4,0,4,7610
0,0,1,0,1,0,1,7611
1,1,1,0,2,0,2,7611
2,2,1,0,3,0,3,7611
3,3,0,0,3,0,3,7611
0,0,1,0,1,0,1,7612
1,1,0,0,1,0,1,7612
0,0,1,0,1,0,1,7613
1,1,0,0,1,0,1,7613
0,0,1,0,1,0,1,7614
1,1,0,1,1,1,2,7614
2,2,0,2,1,3,4,7614
3,3,1,1,2,4,6,7614
4,4,2,1,4,5,9,7614
5,5,0,2,4,7,11,7614
6,6,0,1,4,8,12,7614
7,7,0,0,4,8,12,7614
0,0,1,0,1,0,1,7615
1,1,0,0,1,0,1,7615
0,0,1,0,1,0,1,7616
1,1,0,0,1,0,1,7616
0,0,1,0,1,0,1,7617
1,1,0,0,1,0,1,7617
0,0,1,0,1,0,1,7618
1,1,0,0,1,0,1,7618
0,0,1,0,1,0,1,7619
1,1,2,0,3,0,3,7619
2,2,1,1,4,1,5,7619
3,3,1,0,5,1,6,7619
4,4,3,0,8,1,9,7619
5,5,1,0,9,1,10,7619
6,6,1,0,10,1,11,7619
7,7,0,0,10,1,11,7619
0,0,1,0,1,0,1,7620
1,1,1,0,2,0,2,7620
2,2,0,0,2,0,2,7620
0,0,1,0,1,0,1,7621
1,1,0,0,1,0,1,7621
0,0,1,0,1,0,1,7622
1,1,0,0,1,0,1,7622
0,0,1,0,1,0,1,7623
1,1,0,1,1,1,2,7623
2,2,0,0,1,1,2,7623
0,0,1,0,1,0,1,7624
1,1,0,1,1,1,2,7624
2,2,0,2,1,3,4,7624
3,3,1,0,2,3,5,7624
4,4,1,0,3,3,6,7624
5,5,0,0,3,3,6,7624
0,0,1,0,1,0,1,7625
1,1,0,0,1,0,1,7625
0,0,1,0,1,0,1,7626
1,1,1,0,2,0,2,7626
2,2,0,0,2,0,2,7626
0,0,1,0,1,0,1,7627
1,1,0,0,1,0,1,7627
0,0,1,0,1,0,1,7628
1,1,1,0,2,0,2,7628
2,2,0,0,2,0,2,7628
0,0,1,0,1,0,1,7629
1,1,0,0,1,0,1,7629
0,0,1,0,1,0,1,7630
1,1,0,0,1,0,1,7630
0,0,1,0,1,0,1,7631
1,1,2,0,3,0,3,7631
2,2,0,2,3,2,5,7631
3,3,1,1,4,3,7,7631
4,4,1,0,5,3,8,7631
5,5,0,1,5,4,9,7631
6,6,0,1,5,5,10,7631
7,7,0,0,5,5,10,7631
0,0,1,0,1,0,1,7632
1,1,2,0,3,0,3,7632
2,2,1,0,4,0,4,7632
3,3,1,0,5,0,5,7632
4,4,2,2,7,2,9,7632
5,5,1,2,8,4,12,7632
6,6,2,0,10,4,14,7632
7,7,1,0,11,4,15,7632
8,8,0,0,11,4,15,7632
0,0,1,0,1,0,1,7633
1,1,2,0,3,0,3,7633
2,2,1,0,4,0,4,7633
3,3,0,0,4,0,4,7633
0,0,1,0,1,0,1,7634
1,1,1,0,2,0,2,7634
2,2,0,0,2,0,2,7634
0,0,1,0,1,0,1,7635
1,1,0,0,1,0,1,7635
0,0,1,0,1,0,1,7636
1,1,0,0,1,0,1,7636
0,0,1,0,1,0,1,7637
1,1,1,0,2,0,2,7637
2,2,0,0,2,0,2,7637
0,0,1,0,1,0,1,7638
1,1,1,0,2,0,2,7638
2,2,0,0,2,0,2,7638
0,0,1,0,1,0,1,7639
1,1,1,1,2,1,3,7639
2,2,2,2,4,3,7,7639
3,3,2,3,6,6,12,7639
4,4,0,0,6,6,12,7639
0,0,1,0,1,0,1,7640
1,1,0,1,1,1,2,7640
2,2,1,2,2,3,5,7640
3,3,1,3,3,6,9,7640
4,4,2,2,5,8,13,7640
5,5,2,3,7,11,18,7640
6,6,1,1,8,12,20,7640
7,7,0,0,8,12,20,7640
0,0,1,0,1,0,1,7641
1,1,0,0,1,0,1,7641
0,0,1,0,1,0,1,7642
1,1,1,0,2,0,2,7642
2,2,3,0,5,0,5,7642
3,3,2,0,7,0,7,7642
4,4,1,2,8,2,10,7642
5,5,1,0,9,2,11,7642
6,6,0,0,9,2,11,7642
0,0,1,0,1,0,1,7643
1,1,0,0,1,0,1,7643
0,0,1,0,1,0,1,7644
1,1,0,0,1,0,1,7644
0,0,1,0,1,0,1,7645
1,1,0,0,1,0,1,7645
0,0,1,0,1,0,1,7646
1,1,4,0,5,0,5,7646
2,2,2,0,7,0,7,7646
3,3,1,0,8,0,8,7646
4,4,2,0,10,0,10,7646
5,5,2,0,12,0,12,7646
6,6,1,0,13,0,13,7646
7,7,0,0,13,0,13,7646
0,0,1,0,1,0,1,7647
1,1,0,0,1,0,1,7647
0,0,1,0,1,0,1,7648
1,1,1,0,2,0,2,7648
2,2,0,0,2,0,2,7648
0,0,1,0,1,0,1,7649
1,1,0,0,1,0,1,7649
0,0,1,0,1,0,1,7650
1,1,0,0,1,0,1,7650
0,0,1,0,1,0,1,7651
1,1,1,1,2,1,3,7651
2,2,3,2,5,3,8,7651
3,3,3,0,8,3,11,7651
4,4,2,1,10,4,14,7651
5,5,1,2,11,6,17,7651
6,6,0,3,11,9,20,7651
7,7,0,0,11,9,20,7651
0,0,1,0,1,0,1,7652
1,1,0,0,1,0,1,7652
0,0,1,0,1,0,1,7653
1,1,0,1,1,1,2,7653
2,2,0,1,1,2,3,7653
3,3,0,0,1,2,3,7653
0,0,1,0,1,0,1,7654
1,1,1,1,2,1,3,7654
2,2,1,0,3,1,4,7654
3,3,0,0,3,1,4,7654
0,0,1,0,1,0,1,7655
1,1,0,0,1,0,1,7655
0,0,1,0,1,0,1,7656
1,1,1,0,2,0,2,7656
2,2,0,0,2,0,2,7656
0,0,1,0,1,0,1,7657
1,1,0,0,1,0,1,7657
0,0,1,0,1,0,1,7658
1,1,0,0,1,0,1,7658
0,0,1,0,1,0,1,7659
1,1,0,0,1,0,1,7659
0,0,1,0,1,0,1,7660
1,1,1,0,2,0,2,7660
2,2,0,0,2,0,2,7660
0,0,1,0,1,0,1,7661
1,1,1,0,2,0,2,7661
2,2,2,0,4,0,4,7661
3,3,1,0,5,0,5,7661
4,4,0,0,5,0,5,7661
0,0,1,0,1,0,1,7662
1,1,1,0,2,0,2,7662
2,2,2,0,4,0,4,7662
3,3,1,1,5,1,6,7662
4,4,0,1,5,2,7,7662
5,5,0,2,5,4,9,7662
6,6,0,2,5,6,11,7662
7,7,1,0,6,6,12,7662
8,8,2,0,8,6,14,7662
9,9,0,0,8,6,14,7662
0,0,1,0,1,0,1,7663
1,1,1,0,2,0,2,7663
2,2,1,0,3,0,3,7663
3,3,0,0,3,0,3,7663
0,0,1,0,1,0,1,7664
1,1,1,0,2,0,2,7664
2,2,0,0,2,0,2,7664
0,0,1,0,1,0,1,7665
1,1,1,0,2,0,2,7665
2,2,0,0,2,0,2,7665
0,0,1,0,1,0,1,7666
1,1,0,0,1,0,1,7666
0,0,1,0,1,0,1,7667
1,1,0,0,1,0,1,7667
0,0,1,0,1,0,1,7668
1,1,2,0,3,0,3,7668
2,2,4,0,7,0,7,7668
3,3,1,0,8,0,8,7668
4,4,0,0,8,0,8,7668
0,0,1,0,1,0,1,7669
1,1,0,0,1,0,1,7669
0,0,1,0,1,0,1,7670
1,1,1,0,2,0,2,7670
2,2,0,0,2,0,2,7670
0,0,1,0,1,0,1,7671
1,1,1,0,2,0,2,7671
2,2,1,0,3,0,3,7671
3,3,1,0,4,0,4,7671
4,4,0,0,4,0,4,7671
0,0,1,0,1,0,1,7672
1,1,1,0,2,0,2,7672
2,2,0,0,2,0,2,7672
0,0,1,0,1,0,1,7673
1,1,0,0,1,0,1,7673
0,0,1,0,1,0,1,7674
1,1,0,0,1,0,1,7674
0,0,1,0,1,0,1,7675
1,1,1,0,2,0,2,7675
2,2,0,0,2,0,2,7675
0,0,1,0,1,0,1,7676
1,1,0,0,1,0,1,7676
0,0,1,0,1,0,1,7677
1,1,1,0,2,0,2,7677
2,2,0,0,2,0,2,7677
0,0,1,0,1,0,1,7678
1,1,0,0,1,0,1,7678
0,0,1,0,1,0,1,7679
1,1,0,0,1,0,1,7679
0,0,1,0,1,0,1,7680
1,1,0,0,1,0,1,7680
0,0,1,0,1,0,1,7681
1,1,0,0,1,0,1,7681
0,0,1,0,1,0,1,7682
1,1,0,0,1,0,1,7682
0,0,1,0,1,0,1,7683
1,1,0,0,1,0,1,7683
0,0,1,0,1,0,1,7684
1,1,0,0,1,0,1,7684
0,0,1,0,1,0,1,7685
1,1,1,0,2,0,2,7685
2,2,1,0,3,0,3,7685
3,3,1,1,4,1,5,7685
4,4,2,0,6,1,7,7685
5,5,3,0,9,1,10,7685
6,6,2,0,11,1,12,7685
7,7,1,0,12,1,13,7685
8,8,2,0,14,1,15,7685
9,9,2,0,16,1,17,7685
10,10,0,0,16,1,17,7685
0,0,1,0,1,0,1,7686
1,1,2,0,3,0,3,7686
2,2,1,0,4,0,4,7686
3,3,0,0,4,0,4,7686
0,0,1,0,1,0,1,7687
1,1,0,1,1,1,2,7687
2,2,0,3,1,4,5,7687
3,3,1,2,2,6,8,7687
4,4,2,1,4,7,11,7687
5,5,0,1,4,8,12,7687
6,6,1,2,5,10,15,7687
7,7,0,5,5,15,20,7687
8,8,0,3,5,18,23,7687
9,9,0,0,5,18,23,7687
0,0,1,0,1,0,1,7688
1,1,0,0,1,0,1,7688
0,0,1,0,1,0,1,7689
1,1,1,0,2,0,2,7689
2,2,1,0,3,0,3,7689
3,3,1,0,4,0,4,7689
4,4,1,0,5,0,5,7689
5,5,0,0,5,0,5,7689
0,0,1,0,1,0,1,7690
1,1,0,0,1,0,1,7690
0,0,1,0,1,0,1,7691
1,1,0,1,1,1,2,7691
2,2,0,1,1,2,3,7691
3,3,0,1,1,3,4,7691
4,4,1,0,2,3,5,7691
5,5,1,0,3,3,6,7691
6,6,0,0,3,3,6,7691
0,0,1,0,1,0,1,7692
1,1,0,0,1,0,1,7692
0,0,1,0,1,0,1,7693
1,1,2,0,3,0,3,7693
2,2,1,0,4,0,4,7693
3,3,0,0,4,0,4,7693
0,0,1,0,1,0,1,7694
1,1,1,0,2,0,2,7694
2,2,0,0,2,0,2,7694
0,0,1,0,1,0,1,7695
1,1,0,1,1,1,2,7695
2,2,0,0,1,1,2,7695
0,0,1,0,1,0,1,7696
1,1,0,0,1,0,1,7696
0,0,1,0,1,0,1,7697
1,1,0,0,1,0,1,7697
0,0,1,0,1,0,1,7698
1,1,0,1,1,1,2,7698
2,2,1,0,2,1,3,7698
3,3,1,0,3,1,4,7698
4,4,1,0,4,1,5,7698
5,5,1,0,5,1,6,7698
6,6,1,0,6,1,7,7698
7,7,1,0,7,1,8,7698
8,8,0,0,7,1,8,7698
0,0,1,0,1,0,1,7699
1,1,0,0,1,0,1,7699
0,0,1,0,1,0,1,7700
1,1,2,0,3,0,3,7700
2,2,2,0,5,0,5,7700
3,3,0,0,5,0,5,7700
0,0,1,0,1,0,1,7701
1,1,0,0,1,0,1,7701
0,0,1,0,1,0,1,7702
1,1,0,0,1,0,1,7702
0,0,1,0,1,0,1,7703
1,1,1,0,2,0,2,7703
2,2,1,1,3,1,4,7703
3,3,1,0,4,1,5,7703
4,4,2,0,6,1,7,7703
5,5,0,0,6,1,7,7703
0,0,1,0,1,0,1,7704
1,1,0,0,1,0,1,7704
0,0,1,0,1,0,1,7705
1,1,0,0,1,0,1,7705
0,0,1,0,1,0,1,7706
1,1,1,0,2,0,2,7706
2,2,0,0,2,0,2,7706
0,0,1,0,1,0,1,7707
1,1,0,0,1,0,1,7707
0,0,1,0,1,0,1,7708
1,1,1,1,2,1,3,7708
2,2,1,1,3,2,5,7708
3,3,2,1,5,3,8,7708
4,4,1,0,6,3,9,7708
5,5,1,0,7,3,10,7708
6,6,1,0,8,3,11,7708
7,7,1,0,9,3,12,7708
8,8,0,0,9,3,12,7708
0,0,1,0,1,0,1,7709
1,1,0,0,1,0,1,7709
0,0,1,0,1,0,1,7710
1,1,2,0,3,0,3,7710
2,2,1,0,4,0,4,7710
3,3,0,0,4,0,4,7710
0,0,1,0,1,0,1,7711
1,1,0,0,1,0,1,7711
0,0,1,0,1,0,1,7712
1,1,0,0,1,0,1,7712
0,0,1,0,1,0,1,7713
1,1,1,0,2,0,2,7713
2,2,1,0,3,0,3,7713
3,3,0,0,3,0,3,7713
0,0,1,0,1,0,1,7714
1,1,0,0,1,0,1,7714
0,0,1,0,1,0,1,7715
1,1,0,0,1,0,1,7715
0,0,1,0,1,0,1,7716
1,1,0,0,1,0,1,7716
0,0,1,0,1,0,1,7717
1,1,1,0,2,0,2,7717
2,2,0,0,2,0,2,7717
0,0,1,0,1,0,1,7718
1,1,1,2,2,2,4,7718
2,2,2,2,4,4,8,7718
3,3,2,0,6,4,10,7718
4,4,2,1,8,5,13,7718
5,5,3,0,11,5,16,7718
6,6,2,2,13,7,20,7718
7,7,1,2,14,9,23,7718
8,8,1,1,15,10,25,7718
9,9,2,1,17,11,28,7718
10,10,0,0,17,11,28,7718
0,0,1,0,1,0,1,7719
1,1,1,0,2,0,2,7719
2,2,2,0,4,0,4,7719
3,3,0,0,4,0,4,7719
0,0,1,0,1,0,1,7720
1,1,0,0,1,0,1,7720
0,0,1,0,1,0,1,7721
1,1,1,0,2,0,2,7721
2,2,0,0,2,0,2,7721
0,0,1,0,1,0,1,7722
1,1,1,0,2,0,2,7722
2,2,0,1,2,1,3,7722
3,3,0,2,2,3,5,7722
4,4,0,2,2,5,7,7722
5,5,0,0,2,5,7,7722
0,0,1,0,1,0,1,7723
1,1,1,0,2,0,2,7723
2,2,1,0,3,0,3,7723
3,3,0,0,3,0,3,7723
0,0,1,0,1,0,1,7724
1,1,1,0,2,0,2,7724
2,2,1,0,3,0,3,7724
3,3,2,0,5,0,5,7724
4,4,1,0,6,0,6,7724
5,5,1,0,7,0,7,7724
6,6,0,0,7,0,7,7724
0,0,1,0,1,0,1,7725
1,1,0,1,1,1,2,7725
2,2,0,2,1,3,4,7725
3,3,0,3,1,6,7,7725
4,4,1,3,2,9,11,7725
5,5,2,4,4,13,17,7725
6,6,0,5,4,18,22,7725
7,7,2,6,6,24,30,7725
8,8,4,0,10,24,34,7725
9,9,2,2,12,26,38,7725
10,10,6,3,18,29,47,7725
11,11,3,0,21,29,50,7725
12,12,2,1,23,30,53,7725
13,13,2,2,25,32,57,7725
14,14,1,1,26,33,59,7725
15,15,0,1,26,34,60,7725
16,16,1,2,27,36,63,7725
17,17,3,3,30,39,69,7725
18,18,4,2,34,41,75,7725
19,19,5,1,39,42,81,7725
20,20,2,0,41,42,83,7725
21,21,3,0,44,42,86,7725
22,22,3,0,47,42,89,7725
23,23,5,0,52,42,94,7725
24,24,2,1,54,43,97,7725
25,25,2,1,56,44,100,7725
26,26,3,1,59,45,104,7725
27,27,6,2,65,47,112,7725
28,28,4,2,69,49,118,7725
29,29,1,1,70,50,120,7725
30,30,2,1,72,51,123,7725
31,31,1,1,73,52,125,7725
32,32,1,1,74,53,127,7725
33,33,1,0,75,53,128,7725
34,34,2,0,77,53,130,7725
35,35,2,0,79,53,132,7725
36,36,1,0,80,53,133,7725
37,37,1,0,81,53,134,7725
38,38,4,0,85,53,138,7725
39,39,0,0,85,53,138,7725
0,0,1,0,1,0,1,7726
1,1,0,0,1,0,1,7726
0,0,1,0,1,0,1,7727
1,1,0,0,1,0,1,7727
0,0,1,0,1,0,1,7728
1,1,0,1,1,1,2,7728
2,2,0,1,1,2,3,7728
3,3,0,1,1,3,4,7728
4,4,0,0,1,3,4,7728
0,0,1,0,1,0,1,7729
1,1,0,0,1,0,1,7729
0,0,1,0,1,0,1,7730
1,1,0,0,1,0,1,7730
0,0,1,0,1,0,1,7731
1,1,0,0,1,0,1,7731
0,0,1,0,1,0,1,7732
1,1,0,0,1,0,1,7732
0,0,1,0,1,0,1,7733
1,1,0,1,1,1,2,7733
2,2,1,0,2,1,3,7733
3,3,0,0,2,1,3,7733
0,0,1,0,1,0,1,7734
1,1,2,1,3,1,4,7734
2,2,1,1,4,2,6,7734
3,3,2,3,6,5,11,7734
4,4,1,2,7,7,14,7734
5,5,1,3,8,10,18,7734
6,6,1,4,9,14,23,7734
7,7,1,3,10,17,27,7734
8,8,1,3,11,20,31,7734
9,9,1,2,12,22,34,7734
10,10,1,2,13,24,37,7734
11,11,1,1,14,25,39,7734
12,12,0,0,14,25,39,7734
0,0,1,0,1,0,1,7735
1,1,0,0,1,0,1,7735
0,0,1,0,1,0,1,7736
1,1,0,0,1,0,1,7736
0,0,1,0,1,0,1,7737
1,1,0,0,1,0,1,7737
0,0,1,0,1,0,1,7738
1,1,0,0,1,0,1,7738
0,0,1,0,1,0,1,7739
1,1,0,0,1,0,1,7739
0,0,1,0,1,0,1,7740
1,1,0,0,1,0,1,7740
0,0,1,0,1,0,1,7741
1,1,0,1,1,1,2,7741
2,2,0,1,1,2,3,7741
3,3,0,0,1,2,3,7741
0,0,1,0,1,0,1,7742
1,1,1,2,2,2,4,7742
2,2,0,2,2,4,6,7742
3,3,1,1,3,5,8,7742
4,4,0,0,3,5,8,7742
0,0,1,0,1,0,1,7743
1,1,0,0,1,0,1,7743
0,0,1,0,1,0,1,7744
1,1,1,0,2,0,2,7744
2,2,1,0,3,0,3,7744
3,3,0,0,3,0,3,7744
0,0,1,0,1,0,1,7745
1,1,1,0,2,0,2,7745
2,2,0,2,2,2,4,7745
3,3,0,0,2,2,4,7745
0,0,1,0,1,0,1,7746
1,1,1,0,2,0,2,7746
2,2,3,0,5,0,5,7746
3,3,3,0,8,0,8,7746
4,4,2,0,10,0,10,7746
5,5,0,0,10,0,10,7746
0,0,1,0,1,0,1,7747
1,1,1,0,2,0,2,7747
2,2,0,0,2,0,2,7747
0,0,1,0,1,0,1,7748
1,1,1,0,2,0,2,7748
2,2,0,0,2,0,2,7748
0,0,1,0,1,0,1,7749
1,1,2,0,3,0,3,7749
2,2,2,0,5,0,5,7749
3,3,1,0,6,0,6,7749
4,4,1,1,7,1,8,7749
5,5,1,2,8,3,11,7749
6,6,1,3,9,6,15,7749
7,7,1,3,10,9,19,7749
8,8,0,2,10,11,21,7749
9,9,1,2,11,13,24,7749
10,10,3,2,14,15,29,7749
11,11,1,0,15,15,30,7749
12,12,1,0,16,15,31,7749
13,13,3,0,19,15,34,7749
14,14,1,1,20,16,36,7749
15,15,0,1,20,17,37,7749
16,16,1,0,21,17,38,7749
17,17,0,0,21,17,38,7749
0,0,1,0,1,0,1,7750
1,1,0,0,1,0,1,7750
0,0,1,0,1,0,1,7751
1,1,1,0,2,0,2,7751
2,2,1,0,3,0,3,7751
3,3,0,1,3,1,4,7751
4,4,0,1,3,2,5,7751
5,5,0,2,3,4,7,7751
6,6,0,2,3,6,9,7751
7,7,0,0,3,6,9,7751
0,0,1,0,1,0,1,7752
1,1,4,0,5,0,5,7752
2,2,6,0,11,0,11,7752
3,3,4,1,15,1,16,7752
4,4,3,2,18,3,21,7752
5,5,2,1,20,4,24,7752
6,6,1,0,21,4,25,7752
7,7,1,1,22,5,27,7752
8,8,2,0,24,5,29,7752
9,9,1,1,25,6,31,7752
10,10,0,0,25,6,31,7752
0,0,1,0,1,0,1,7753
1,1,0,1,1,1,2,7753
2,2,0,1,1,2,3,7753
3,3,0,1,1,3,4,7753
4,4,0,0,1,3,4,7753
0,0,1,0,1,0,1,7754
1,1,0,0,1,0,1,7754
0,0,1,0,1,0,1,7755
1,1,1,0,2,0,2,7755
2,2,0,0,2,0,2,7755
0,0,1,0,1,0,1,7756
1,1,0,0,1,0,1,7756
0,0,1,0,1,0,1,7757
1,1,3,0,4,0,4,7757
2,2,4,2,8,2,10,7757
3,3,1,0,9,2,11,7757
4,4,1,0,10,2,12,7757
5,5,0,0,10,2,12,7757
0,0,1,0,1,0,1,7758
1,1,2,2,3,2,5,7758
2,2,0,1,3,3,6,7758
3,3,0,0,3,3,6,7758
0,0,1,0,1,0,1,7759
1,1,1,0,2,0,2,7759
2,2,0,0,2,0,2,7759
0,0,1,0,1,0,1,7760
1,1,1,0,2,0,2,7760
2,2,1,0,3,0,3,7760
3,3,2,0,5,0,5,7760
4,4,3,0,8,0,8,7760
5,5,5,0,13,0,13,7760
6,6,3,0,16,0,16,7760
7,7,1,0,17,0,17,7760
8,8,0,0,17,0,17,7760
0,0,1,0,1,0,1,7761
1,1,1,0,2,0,2,7761
2,2,0,0,2,0,2,7761
0,0,1,0,1,0,1,7762
1,1,1,0,2,0,2,7762
2,2,1,0,3,0,3,7762
3,3,1,0,4,0,4,7762
4,4,1,0,5,0,5,7762
5,5,0,0,5,0,5,7762
0,0,1,0,1,0,1,7763
1,1,0,0,1,0,1,7763
0,0,1,0,1,0,1,7764
1,1,1,0,2,0,2,7764
2,2,0,1,2,1,3,7764
3,3,0,2,2,3,5,7764
4,4,1,3,3,6,9,7764
5,5,1,3,4,9,13,7764
6,6,1,3,5,12,17,7764
7,7,3,1,8,13,21,7764
8,8,1,1,9,14,23,7764
9,9,0,0,9,14,23,7764
0,0,1,0,1,0,1,7765
1,1,2,0,3,0,3,7765
2,2,2,0,5,0,5,7765
3,3,3,1,8,1,9,7765
4,4,2,0,10,1,11,7765
5,5,0,0,10,1,11,7765
0,0,1,0,1,0,1,7766
1,1,0,0,1,0,1,7766
0,0,1,0,1,0,1,7767
1,1,0,0,1,0,1,7767
0,0,1,0,1,0,1,7768
1,1,0,1,1,1,2,7768
2,2,0,0,1,1,2,7768
0,0,1,0,1,0,1,7769
1,1,1,0,2,0,2,7769
2,2,1,0,3,0,3,7769
3,3,0,0,3,0,3,7769
0,0,1,0,1,0,1,7770
1,1,0,0,1,0,1,7770
0,0,1,0,1,0,1,7771
1,1,1,0,2,0,2,7771
2,2,0,0,2,0,2,7771
0,0,1,0,1,0,1,7772
1,1,0,0,1,0,1,7772
0,0,1,0,1,0,1,7773
1,1,1,0,2,0,2,7773
2,2,1,0,3,0,3,7773
3,3,0,0,3,0,3,7773
0,0,1,0,1,0,1,7774
1,1,0,1,1,1,2,7774
2,2,0,0,1,1,2,7774
0,0,1,0,1,0,1,7775
1,1,1,0,2,0,2,7775
2,2,1,0,3,0,3,7775
3,3,0,0,3,0,3,7775
0,0,1,0,1,0,1,7776
1,1,0,0,1,0,1,7776
0,0,1,0,1,0,1,7777
1,1,0,0,1,0,1,7777
0,0,1,0,1,0,1,7778
1,1,3,0,4,0,4,7778
2,2,1,0,5,0,5,7778
3,3,0,0,5,0,5,7778
0,0,1,0,1,0,1,7779
1,1,0,0,1,0,1,7779
0,0,1,0,1,0,1,7780
1,1,1,0,2,0,2,7780
2,2,0,0,2,0,2,7780
0,0,1,0,1,0,1,7781
1,1,0,0,1,0,1,7781
0,0,1,0,1,0,1,7782
1,1,0,0,1,0,1,7782
0,0,1,0,1,0,1,7783
1,1,2,0,3,0,3,7783
2,2,1,0,4,0,4,7783
3,3,1,0,5,0,5,7783
4,4,0,0,5,0,5,7783
0,0,1,0,1,0,1,7784
1,1,0,0,1,0,1,7784
0,0,1,0,1,0,1,7785
1,1,1,0,2,0,2,7785
2,2,1,0,3,0,3,7785
3,3,1,0,4,0,4,7785
4,4,1,0,5,0,5,7785
5,5,1,0,6,0,6,7785
6,6,1,0,7,0,7,7785
7,7,0,0,7,0,7,7785
0,0,1,0,1,0,1,7786
1,1,0,0,1,0,1,7786
0,0,1,0,1,0,1,7787
1,1,0,0,1,0,1,7787
0,0,1,0,1,0,1,7788
1,1,1,0,2,0,2,7788
2,2,0,0,2,0,2,7788
0,0,1,0,1,0,1,7789
1,1,0,0,1,0,1,7789
0,0,1,0,1,0,1,7790
1,1,0,0,1,0,1,7790
0,0,1,0,1,0,1,7791
1,1,0,0,1,0,1,7791
0,0,1,0,1,0,1,7792
1,1,1,1,2,1,3,7792
2,2,1,1,3,2,5,7792
3,3,0,0,3,2,5,7792
0,0,1,0,1,0,1,7793
1,1,2,0,3,0,3,7793
2,2,1,0,4,0,4,7793
3,3,1,0,5,0,5,7793
4,4,0,0,5,0,5,7793
0,0,1,0,1,0,1,7794
1,1,1,0,2,0,2,7794
2,2,0,0,2,0,2,7794
0,0,1,0,1,0,1,7795
1,1,1,0,2,0,2,7795
2,2,1,0,3,0,3,7795
3,3,1,0,4,0,4,7795
4,4,0,0,4,0,4,7795
0,0,1,0,1,0,1,7796
1,1,0,0,1,0,1,7796
0,0,1,0,1,0,1,7797
1,1,3,0,4,0,4,7797
2,2,2,0,6,0,6,7797
3,3,1,0,7,0,7,7797
4,4,0,0,7,0,7,7797
0,0,1,0,1,0,1,7798
1,1,0,0,1,0,1,7798
0,0,1,0,1,0,1,7799
1,1,1,0,2,0,2,7799
2,2,0,0,2,0,2,7799
0,0,1,0,1,0,1,7800
1,1,0,0,1,0,1,7800
0,0,1,0,1,0,1,7801
1,1,0,0,1,0,1,7801
0,0,1,0,1,0,1,7802
1,1,0,0,1,0,1,7802
0,0,1,0,1,0,1,7803
1,1,3,0,4,0,4,7803
2,2,2,0,6,0,6,7803
3,3,2,1,8,1,9,7803
4,4,1,1,9,2,11,7803
5,5,4,1,13,3,16,7803
6,6,1,1,14,4,18,7803
7,7,0,0,14,4,18,7803
0,0,1,0,1,0,1,7804
1,1,0,0,1,0,1,7804
0,0,1,0,1,0,1,7805
1,1,0,0,1,0,1,7805
0,0,1,0,1,0,1,7806
1,1,1,1,2,1,3,7806
2,2,0,1,2,2,4,7806
3,3,0,0,2,2,4,7806
0,0,1,0,1,0,1,7807
1,1,0,0,1,0,1,7807
0,0,1,0,1,0,1,7808
1,1,1,0,2,0,2,7808
2,2,0,0,2,0,2,7808
0,0,1,0,1,0,1,7809
1,1,0,0,1,0,1,7809
0,0,1,0,1,0,1,7810
1,1,0,0,1,0,1,7810
0,0,1,0,1,0,1,7811
1,1,0,0,1,0,1,7811
0,0,1,0,1,0,1,7812
1,1,1,0,2,0,2,7812
2,2,1,1,3,1,4,7812
3,3,0,2,3,3,6,7812
4,4,1,3,4,6,10,7812
5,5,0,3,4,9,13,7812
6,6,1,4,5,13,18,7812
7,7,1,2,6,15,21,7812
8,8,1,2,7,17,24,7812
9,9,0,0,7,17,24,7812
0,0,1,0,1,0,1,7813
1,1,0,0,1,0,1,7813
0,0,1,0,1,0,1,7814
1,1,0,0,1,0,1,7814
0,0,1,0,1,0,1,7815
1,1,0,0,1,0,1,7815
0,0,1,0,1,0,1,7816
1,1,0,0,1,0,1,7816
0,0,1,0,1,0,1,7817
1,1,1,0,2,0,2,7817
2,2,0,0,2,0,2,7817
0,0,1,0,1,0,1,7818
1,1,1,1,2,1,3,7818
2,2,1,4,3,5,8,7818
3,3,0,4,3,9,12,7818
4,4,0,1,3,10,13,7818
5,5,0,0,3,10,13,7818
0,0,1,0,1,0,1,7819
1,1,2,0,3,0,3,7819
2,2,0,0,3,0,3,7819
0,0,1,0,1,0,1,7820
1,1,1,1,2,1,3,7820
2,2,0,1,2,2,4,7820
3,3,0,0,2,2,4,7820
0,0,1,0,1,0,1,7821
1,1,2,2,3,2,5,7821
2,2,2,2,5,4,9,7821
3,3,0,0,5,4,9,7821
0,0,1,0,1,0,1,7822
1,1,0,1,1,1,2,7822
2,2,0,1,1,2,3,7822
3,3,0,0,1,2,3,7822
0,0,1,0,1,0,1,7823
1,1,1,0,2,0,2,7823
2,2,1,0,3,0,3,7823
3,3,1,0,4,0,4,7823
4,4,1,1,5,1,6,7823
5,5,3,0,8,1,9,7823
6,6,1,0,9,1,10,7823
7,7,1,0,10,1,11,7823
8,8,1,1,11,2,13,7823
9,9,0,0,11,2,13,7823
0,0,1,0,1,0,1,7824
1,1,1,0,2,0,2,7824
2,2,1,0,3,0,3,7824
3,3,2,0,5,0,5,7824
4,4,1,0,6,0,6,7824
5,5,0,0,6,0,6,7824
0,0,1,0,1,0,1,7825
1,1,1,0,2,0,2,7825
2,2,0,0,2,0,2,7825
0,0,1,0,1,0,1,7826
1,1,0,0,1,0,1,7826
0,0,1,0,1,0,1,7827
1,1,2,0,3,0,3,7827
2,2,0,1,3,1,4,7827
3,3,0,0,3,1,4,7827
0,0,1,0,1,0,1,7828
1,1,0,0,1,0,1,7828
0,0,1,0,1,0,1,7829
1,1,1,0,2,0,2,7829
2,2,0,0,2,0,2,7829
0,0,1,0,1,0,1,7830
1,1,2,1,3,1,4,7830
2,2,0,3,3,4,7,7830
3,3,1,2,4,6,10,7830
4,4,0,1,4,7,11,7830
5,5,0,1,4,8,12,7830
6,6,0,1,4,9,13,7830
7,7,0,0,4,9,13,7830
0,0,1,0,1,0,1,7831
1,1,1,0,2,0,2,7831
2,2,1,0,3,0,3,7831
3,3,1,0,4,0,4,7831
4,4,2,0,6,0,6,7831
5,5,2,1,8,1,9,7831
6,6,2,1,10,2,12,7831
7,7,3,2,13,4,17,7831
8,8,2,2,15,6,21,7831
9,9,0,1,15,7,22,7831
10,10,0,0,15,7,22,7831
0,0,1,0,1,0,1,7832
1,1,1,0,2,0,2,7832
2,2,1,1,3,1,4,7832
3,3,1,1,4,2,6,7832
4,4,1,3,5,5,10,7832
5,5,2,3,7,8,15,7832
6,6,2,2,9,10,19,7832
7,7,2,2,11,12,23,7832
8,8,2,1,13,13,26,7832
9,9,0,0,13,13,26,7832
0,0,1,0,1,0,1,7833
1,1,0,0,1,0,1,7833
0,0,1,0,1,0,1,7834
1,1,1,0,2,0,2,7834
2,2,2,0,4,0,4,7834
3,3,1,0,5,0,5,7834
4,4,0,0,5,0,5,7834
0,0,1,0,1,0,1,7835
1,1,1,0,2,0,2,7835
2,2,1,1,3,1,4,7835
3,3,3,1,6,2,8,7835
4,4,2,2,8,4,12,7835
5,5,1,0,9,4,13,7835
6,6,0,0,9,4,13,7835
0,0,1,0,1,0,1,7836
1,1,0,1,1,1,2,7836
2,2,0,1,1,2,3,7836
3,3,0,1,1,3,4,7836
4,4,0,0,1,3,4,7836
0,0,1,0,1,0,1,7837
1,1,0,0,1,0,1,7837
0,0,1,0,1,0,1,7838
1,1,1,0,2,0,2,7838
2,2,1,0,3,0,3,7838
3,3,2,1,5,1,6,7838
4,4,1,2,6,3,9,7838
5,5,0,1,6,4,10,7838
6,6,2,1,8,5,13,7838
7,7,1,0,9,5,14,7838
8,8,2,0,11,5,16,7838
9,9,2,0,13,5,18,7838
10,10,1,0,14,5,19,7838
11,11,0,0,14,5,19,7838
0,0,1,0,1,0,1,7839
1,1,0,0,1,0,1,7839
0,0,1,0,1,0,1,7840
1,1,1,0,2,0,2,7840
2,2,4,0,6,0,6,7840
3,3,4,2,10,2,12,7840
4,4,7,1,17,3,20,7840
5,5,6,1,23,4,27,7840
6,6,6,1,29,5,34,7840
7,7,5,5,34,10,44,7840
8,8,5,4,39,14,53,7840
9,9,4,2,43,16,59,7840
10,10,4,2,47,18,65,7840
11,11,3,2,50,20,70,7840
12,12,3,3,53,23,76,7840
13,13,3,1,56,24,80,7840
14,14,2,2,58,26,84,7840
15,15,2,0,60,26,86,7840
16,16,3,1,63,27,90,7840
17,17,1,2,64,29,93,7840
18,18,1,0,65,29,94,7840
19,19,0,0,65,29,94,7840
0,0,1,0,1,0,1,7841
1,1,1,1,2,1,3,7841
2,2,1,1,3,2,5,7841
3,3,1,1,4,3,7,7841
4,4,3,0,7,3,10,7841
5,5,2,0,9,3,12,7841
6,6,4,0,13,3,16,7841
7,7,2,1,15,4,19,7841
8,8,2,1,17,5,22,7841
9,9,1,1,18,6,24,7841
10,10,1,0,19,6,25,7841
11,11,0,0,19,6,25,7841
0,0,1,0,1,0,1,7842
1,1,1,1,2,1,3,7842
2,2,3,0,5,1,6,7842
3,3,4,2,9,3,12,7842
4,4,2,3,11,6,17,7842
5,5,0,2,11,8,19,7842
6,6,0,2,11,10,21,7842
7,7,0,1,11,11,22,7842
8,8,0,1,11,12,23,7842
9,9,0,1,11,13,24,7842
10,10,1,1,12,14,26,7842
11,11,0,0,12,14,26,7842
0,0,1,0,1,0,1,7843
1,1,1,0,2,0,2,7843
2,2,1,1,3,1,4,7843
3,3,1,0,4,1,5,7843
4,4,1,0,5,1,6,7843
5,5,2,0,7,1,8,7843
6,6,1,0,8,1,9,7843
7,7,1,0,9,1,10,7843
8,8,0,0,9,1,10,7843
0,0,1,0,1,0,1,7844
1,1,1,1,2,1,3,7844
2,2,0,0,2,1,3,7844
0,0,1,0,1,0,1,7845
1,1,0,0,1,0,1,7845
0,0,1,0,1,0,1,7846
1,1,0,0,1,0,1,7846
0,0,1,0,1,0,1,7847
1,1,0,0,1,0,1,7847
0,0,1,0,1,0,1,7848
1,1,0,0,1,0,1,7848
0,0,1,0,1,0,1,7849
1,1,0,1,1,1,2,7849
2,2,0,0,1,1,2,7849
0,0,1,0,1,0,1,7850
1,1,0,0,1,0,1,7850
0,0,1,0,1,0,1,7851
1,1,0,1,1,1,2,7851
2,2,0,1,1,2,3,7851
3,3,1,0,2,2,4,7851
4,4,2,0,4,2,6,7851
5,5,2,1,6,3,9,7851
6,6,0,0,6,3,9,7851
0,0,1,0,1,0,1,7852
1,1,2,0,3,0,3,7852
2,2,0,0,3,0,3,7852
0,0,1,0,1,0,1,7853
1,1,0,0,1,0,1,7853
0,0,1,0,1,0,1,7854
1,1,0,0,1,0,1,7854
0,0,1,0,1,0,1,7855
1,1,1,0,2,0,2,7855
2,2,0,0,2,0,2,7855
0,0,1,0,1,0,1,7856
1,1,0,1,1,1,2,7856
2,2,0,1,1,2,3,7856
3,3,0,1,1,3,4,7856
4,4,1,2,2,5,7,7856
5,5,0,1,2,6,8,7856
6,6,1,0,3,6,9,7856
7,7,0,0,3,6,9,7856
0,0,1,0,1,0,1,7857
1,1,1,0,2,0,2,7857
2,2,0,0,2,0,2,7857
0,0,1,0,1,0,1,7858
1,1,1,0,2,0,2,7858
2,2,2,0,4,0,4,7858
3,3,3,1,7,1,8,7858
4,4,2,1,9,2,11,7858
5,5,0,0,9,2,11,7858
0,0,1,0,1,0,1,7859
1,1,0,0,1,0,1,7859
0,0,1,0,1,0,1,7860
1,1,0,0,1,0,1,7860
0,0,1,0,1,0,1,7861
1,1,0,0,1,0,1,7861
0,0,1,0,1,0,1,7862
1,1,2,1,3,1,4,7862
2,2,3,0,6,1,7,7862
3,3,2,1,8,2,10,7862
4,4,0,0,8,2,10,7862
0,0,1,0,1,0,1,7863
1,1,0,0,1,0,1,7863
0,0,1,0,1,0,1,7864
1,1,1,0,2,0,2,7864
2,2,3,0,5,0,5,7864
3,3,2,0,7,0,7,7864
4,4,4,0,11,0,11,7864
5,5,3,1,14,1,15,7864
6,6,3,1,17,2,19,7864
7,7,4,3,21,5,26,7864
8,8,2,3,23,8,31,7864
9,9,1,3,24,11,35,7864
10,10,1,5,25,16,41,7864
11,11,0,3,25,19,44,7864
12,12,0,3,25,22,47,7864
13,13,0,2,25,24,49,7864
14,14,1,1,26,25,51,7864
15,15,1,2,27,27,54,7864
16,16,3,2,30,29,59,7864
17,17,1,4,31,33,64,7864
18,18,5,3,36,36,72,7864
19,19,4,3,40,39,79,7864
20,20,2,6,42,45,87,7864
21,21,3,3,45,48,93,7864
22,22,1,1,46,49,95,7864
23,23,0,2,46,51,97,7864
24,24,1,2,47,53,100,7864
25,25,2,2,49,55,104,7864
26,26,1,3,50,58,108,7864
27,27,1,5,51,63,114,7864
28,28,2,3,53,66,119,7864
29,29,1,2,54,68,122,7864
30,30,1,1,55,69,124,7864
31,31,0,1,55,70,125,7864
32,32,1,0,56,70,126,7864
33,33,0,0,56,70,126,7864
0,0,1,0,1,0,1,7865
1,1,0,0,1,0,1,7865
0,0,1,0,1,0,1,7866
1,1,1,0,2,0,2,7866
2,2,0,0,2,0,2,7866
0,0,1,0,1,0,1,7867
1,1,0,0,1,0,1,7867
0,0,1,0,1,0,1,7868
1,1,1,0,2,0,2,7868
2,2,0,0,2,0,2,7868
0,0,1,0,1,0,1,7869
1,1,0,0,1,0,1,7869
0,0,1,0,1,0,1,7870
1,1,0,0,1,0,1,7870
0,0,1,0,1,0,1,7871
1,1,1,0,2,0,2,7871
2,2,2,0,4,0,4,7871
3,3,2,1,6,1,7,7871
4,4,0,1,6,2,8,7871
5,5,0,0,6,2,8,7871
0,0,1,0,1,0,1,7872
1,1,0,1,1,1,2,7872
2,2,0,1,1,2,3,7872
3,3,0,1,1,3,4,7872
4,4,0,0,1,3,4,7872
0,0,1,0,1,0,1,7873
1,1,3,0,4,0,4,7873
2,2,1,1,5,1,6,7873
3,3,1,1,6,2,8,7873
4,4,1,0,7,2,9,7873
5,5,1,0,8,2,10,7873
6,6,2,0,10,2,12,7873
7,7,1,0,11,2,13,7873
8,8,0,0,11,2,13,7873
0,0,1,0,1,0,1,7874
1,1,1,0,2,0,2,7874
2,2,1,0,3,0,3,7874
3,3,0,0,3,0,3,7874
0,0,1,0,1,0,1,7875
1,1,0,0,1,0,1,7875
0,0,1,0,1,0,1,7876
1,1,1,1,2,1,3,7876
2,2,2,1,4,2,6,7876
3,3,1,1,5,3,8,7876
4,4,1,0,6,3,9,7876
5,5,1,1,7,4,11,7876
6,6,2,1,9,5,14,7876
7,7,1,1,10,6,16,7876
8,8,1,2,11,8,19,7876
9,9,0,0,11,8,19,7876
0,0,1,0,1,0,1,7877
1,1,0,0,1,0,1,7877
0,0,1,0,1,0,1,7878
1,1,0,0,1,0,1,7878
0,0,1,0,1,0,1,7879
1,1,0,0,1,0,1,7879
0,0,1,0,1,0,1,7880
1,1,2,0,3,0,3,7880
2,2,3,1,6,1,7,7880
3,3,3,0,9,1,10,7880
4,4,1,1,10,2,12,7880
5,5,1,0,11,2,13,7880
6,6,1,0,12,2,14,7880
7,7,2,0,14,2,16,7880
8,8,0,1,14,3,17,7880
9,9,0,2,14,5,19,7880
10,10,1,1,15,6,21,7880
11,11,1,1,16,7,23,7880
12,12,2,1,18,8,26,7880
13,13,4,0,22,8,30,7880
14,14,2,1,24,9,33,7880
15,15,2,0,26,9,35,7880
16,16,1,0,27,9,36,7880
17,17,2,0,29,9,38,7880
18,18,0,1,29,10,39,7880
19,19,1,1,30,11,41,7880
20,20,0,1,30,12,42,7880
21,21,1,0,31,12,43,7880
22,22,1,0,32,12,44,7880
23,23,0,0,32,12,44,7880
0,0,1,0,1,0,1,7881
1,1,1,0,2,0,2,7881
2,2,2,1,4,1,5,7881
3,3,3,0,7,1,8,7881
4,4,2,0,9,1,10,7881
5,5,0,3,9,4,13,7881
6,6,1,1,10,5,15,7881
7,7,0,2,10,7,17,7881
8,8,1,2,11,9,20,7881
9,9,1,1,12,10,22,7881
10,10,0,1,12,11,23,7881
11,11,0,1,12,12,24,7881
12,12,0,0,12,12,24,7881
0,0,1,0,1,0,1,7882
1,1,0,0,1,0,1,7882
0,0,1,0,1,0,1,7883
1,1,0,0,1,0,1,7883
0,0,1,0,1,0,1,7884
1,1,0,0,1,0,1,7884
0,0,1,0,1,0,1,7885
1,1,0,0,1,0,1,7885
0,0,1,0,1,0,1,7886
1,1,2,0,3,0,3,7886
2,2,3,0,6,0,6,7886
3,3,3,0,9,0,9,7886
4,4,1,0,10,0,10,7886
5,5,0,0,10,0,10,7886
0,0,1,0,1,0,1,7887
1,1,1,0,2,0,2,7887
2,2,0,0,2,0,2,7887
0,0,1,0,1,0,1,7888
1,1,0,0,1,0,1,7888
0,0,1,0,1,0,1,7889
1,1,1,0,2,0,2,7889
2,2,2,0,4,0,4,7889
3,3,0,0,4,0,4,7889
0,0,1,0,1,0,1,7890
1,1,0,0,1,0,1,7890
0,0,1,0,1,0,1,7891
1,1,1,0,2,0,2,7891
2,2,1,0,3,0,3,7891
3,3,1,0,4,0,4,7891
4,4,0,0,4,0,4,7891
0,0,1,0,1,0,1,7892
1,1,2,1,3,1,4,7892
2,2,1,1,4,2,6,7892
3,3,1,2,5,4,9,7892
4,4,1,0,6,4,10,7892
5,5,0,0,6,4,10,7892
0,0,1,0,1,0,1,7893
1,1,2,1,3,1,4,7893
2,2,3,0,6,1,7,7893
3,3,0,0,6,1,7,7893
0,0,1,0,1,0,1,7894
1,1,1,0,2,0,2,7894
2,2,1,0,3,0,3,7894
3,3,0,1,3,1,4,7894
4,4,0,1,3,2,5,7894
5,5,0,1,3,3,6,7894
6,6,1,1,4,4,8,7894
7,7,1,1,5,5,10,7894
8,8,2,1,7,6,13,7894
9,9,2,3,9,9,18,7894
10,10,3,0,12,9,21,7894
11,11,0,0,12,9,21,7894
0,0,1,0,1,0,1,7895
1,1,0,0,1,0,1,7895
0,0,1,0,1,0,1,7896
1,1,1,0,2,0,2,7896
2,2,1,0,3,0,3,7896
3,3,1,0,4,0,4,7896
4,4,0,1,4,1,5,7896
5,5,0,2,4,3,7,7896
6,6,0,1,4,4,8,7896
7,7,0,0,4,4,8,7896
0,0,1,0,1,0,1,7897
1,1,1,0,2,0,2,7897
2,2,3,0,5,0,5,7897
3,3,1,1,6,1,7,7897
4,4,3,1,9,2,11,7897
5,5,1,1,10,3,13,7897
6,6,0,1,10,4,14,7897
7,7,1,0,11,4,15,7897
8,8,1,0,12,4,16,7897
9,9,0,0,12,4,16,7897
0,0,1,0,1,0,1,7898
1,1,0,0,1,0,1,7898
0,0,1,0,1,0,1,7899
1,1,2,0,3,0,3,7899
2,2,2,0,5,0,5,7899
3,3,3,0,8,0,8,7899
4,4,1,0,9,0,9,7899
5,5,1,1,10,1,11,7899
6,6,1,0,11,1,12,7899
7,7,0,0,11,1,12,7899
0,0,1,0,1,0,1,7900
1,1,3,0,4,0,4,7900
2,2,0,1,4,1,5,7900
3,3,0,0,4,1,5,7900
0,0,1,0,1,0,1,7901
1,1,1,1,2,1,3,7901
2,2,1,1,3,2,5,7901
3,3,2,1,5,3,8,7901
4,4,1,3,6,6,12,7901
5,5,1,5,7,11,18,7901
6,6,2,2,9,13,22,7901
7,7,8,1,17,14,31,7901
8,8,2,1,19,15,34,7901
9,9,2,1,21,16,37,7901
10,10,2,2,23,18,41,7901
11,11,1,1,24,19,43,7901
12,12,1,1,25,20,45,7901
13,13,0,0,25,20,45,7901
0,0,1,0,1,0,1,7902
1,1,0,0,1,0,1,7902
0,0,1,0,1,0,1,7903
1,1,0,1,1,1,2,7903
2,2,0,1,1,2,3,7903
3,3,0,1,1,3,4,7903
4,4,0,2,1,5,6,7903
5,5,0,3,1,8,9,7903
6,6,0,3,1,11,12,7903
7,7,0,0,1,11,12,7903
0,0,1,0,1,0,1,7904
1,1,1,0,2,0,2,7904
2,2,1,0,3,0,3,7904
3,3,4,1,7,1,8,7904
4,4,5,2,12,3,15,7904
5,5,3,0,15,3,18,7904
6,6,1,0,16,3,19,7904
7,7,1,0,17,3,20,7904
8,8,1,0,18,3,21,7904
9,9,1,0,19,3,22,7904
10,10,0,0,19,3,22,7904
0,0,1,0,1,0,1,7905
1,1,1,0,2,0,2,7905
2,2,1,0,3,0,3,7905
3,3,2,0,5,0,5,7905
4,4,0,2,5,2,7,7905
5,5,2,2,7,4,11,7905
6,6,3,2,10,6,16,7905
7,7,4,2,14,8,22,7905
8,8,2,3,16,11,27,7905
9,9,1,3,17,14,31,7905
10,10,1,4,18,18,36,7905
11,11,4,3,22,21,43,7905
12,12,5,5,27,26,53,7905
13,13,4,6,31,32,63,7905
14,14,3,6,34,38,72,7905
15,15,0,3,34,41,75,7905
16,16,1,2,35,43,78,7905
17,17,0,2,35,45,80,7905
18,18,0,2,35,47,82,7905
19,19,0,2,35,49,84,7905
20,20,1,0,36,49,85,7905
21,21,1,0,37,49,86,7905
22,22,2,0,39,49,88,7905
23,23,0,0,39,49,88,7905
0,0,1,0,1,0,1,7906
1,1,0,1,1,1,2,7906
2,2,0,0,1,1,2,7906
0,0,1,0,1,0,1,7907
1,1,0,0,1,0,1,7907
0,0,1,0,1,0,1,7908
1,1,1,0,2,0,2,7908
2,2,0,0,2,0,2,7908
0,0,1,0,1,0,1,7909
1,1,1,0,2,0,2,7909
2,2,1,0,3,0,3,7909
3,3,0,0,3,0,3,7909
0,0,1,0,1,0,1,7910
1,1,0,0,1,0,1,7910
0,0,1,0,1,0,1,7911
1,1,0,1,1,1,2,7911
2,2,0,2,1,3,4,7911
3,3,0,1,1,4,5,7911
4,4,1,2,2,6,8,7911
5,5,0,2,2,8,10,7911
6,6,0,1,2,9,11,7911
7,7,0,1,2,10,12,7911
8,8,0,0,2,10,12,7911
0,0,1,0,1,0,1,7912
1,1,0,0,1,0,1,7912
0,0,1,0,1,0,1,7913
1,1,0,1,1,1,2,7913
2,2,0,0,1,1,2,7913
0,0,1,0,1,0,1,7914
1,1,0,1,1,1,2,7914
2,2,0,0,1,1,2,7914
0,0,1,0,1,0,1,7915
1,1,1,0,2,0,2,7915
2,2,1,0,3,0,3,7915
3,3,0,0,3,0,3,7915
0,0,1,0,1,0,1,7916
1,1,0,1,1,1,2,7916
2,2,0,1,1,2,3,7916
3,3,1,2,2,4,6,7916
4,4,0,7,2,11,13,7916
5,5,2,5,4,16,20,7916
6,6,5,5,9,21,30,7916
7,7,1,6,10,27,37,7916
8,8,1,4,11,31,42,7916
9,9,1,1,12,32,44,7916
10,10,0,1,12,33,45,7916
11,11,0,0,12,33,45,7916
0,0,1,0,1,0,1,7917
1,1,2,0,3,0,3,7917
2,2,2,0,5,0,5,7917
3,3,2,0,7,0,7,7917
4,4,4,0,11,0,11,7917
5,5,2,0,13,0,13,7917
6,6,1,1,14,1,15,7917
7,7,0,1,14,2,16,7917
8,8,0,2,14,4,18,7917
9,9,0,1,14,5,19,7917
10,10,0,0,14,5,19,7917
0,0,1,0,1,0,1,7918
1,1,0,0,1,0,1,7918
0,0,1,0,1,0,1,7919
1,1,0,0,1,0,1,7919
0,0,1,0,1,0,1,7920
1,1,2,1,3,1,4,7920
2,2,3,1,6,2,8,7920
3,3,1,0,7,2,9,7920
4,4,0,0,7,2,9,7920
0,0,1,0,1,0,1,7921
1,1,1,0,2,0,2,7921
2,2,1,1,3,1,4,7921
3,3,0,1,3,2,5,7921
4,4,0,0,3,2,5,7921
0,0,1,0,1,0,1,7922
1,1,1,1,2,1,3,7922
2,2,2,0,4,1,5,7922
3,3,0,0,4,1,5,7922
0,0,1,0,1,0,1,7923
1,1,0,0,1,0,1,7923
0,0,1,0,1,0,1,7924
1,1,0,1,1,1,2,7924
2,2,0,2,1,3,4,7924
3,3,0,1,1,4,5,7924
4,4,0,2,1,6,7,7924
5,5,0,1,1,7,8,7924
6,6,0,2,1,9,10,7924
7,7,0,3,1,12,13,7924
8,8,1,0,2,12,14,7924
9,9,1,0,3,12,15,7924
10,10,0,0,3,12,15,7924
0,0,1,0,1,0,1,7925
1,1,0,1,1,1,2,7925
2,2,0,1,1,2,3,7925
3,3,0,0,1,2,3,7925
0,0,1,0,1,0,1,7926
1,1,0,0,1,0,1,7926
0,0,1,0,1,0,1,7927
1,1,2,0,3,0,3,7927
2,2,0,1,3,1,4,7927
3,3,0,2,3,3,6,7927
4,4,1,2,4,5,9,7927
5,5,0,2,4,7,11,7927
6,6,1,3,5,10,15,7927
7,7,3,4,8,14,22,7927
8,8,1,2,9,16,25,7927
9,9,0,1,9,17,26,7927
10,10,0,0,9,17,26,7927
0,0,1,0,1,0,1,7928
1,1,3,0,4,0,4,7928
2,2,3,1,7,1,8,7928
3,3,3,2,10,3,13,7928
4,4,3,2,13,5,18,7928
5,5,3,0,16,5,21,7928
6,6,2,1,18,6,24,7928
7,7,4,2,22,8,30,7928
8,8,6,3,28,11,39,7928
9,9,5,0,33,11,44,7928
10,10,3,1,36,12,48,7928
11,11,1,1,37,13,50,7928
12,12,2,1,39,14,53,7928
13,13,1,3,40,17,57,7928
14,14,3,1,43,18,61,7928
15,15,5,0,48,18,66,7928
16,16,5,0,53,18,71,7928
17,17,2,1,55,19,74,7928
18,18,1,0,56,19,75,7928
19,19,0,0,56,19,75,7928
0,0,1,0,1,0,1,7929
1,1,0,0,1,0,1,7929
0,0,1,0,1,0,1,7930
1,1,1,0,2,0,2,7930
2,2,0,0,2,0,2,7930
0,0,1,0,1,0,1,7931
1,1,1,0,2,0,2,7931
2,2,0,0,2,0,2,7931
0,0,1,0,1,0,1,7932
1,1,2,0,3,0,3,7932
2,2,1,0,4,0,4,7932
3,3,1,0,5,0,5,7932
4,4,1,0,6,0,6,7932
5,5,1,0,7,0,7,7932
6,6,1,0,8,0,8,7932
7,7,2,0,10,0,10,7932
8,8,0,0,10,0,10,7932
0,0,1,0,1,0,1,7933
1,1,0,0,1,0,1,7933
0,0,1,0,1,0,1,7934
1,1,0,0,1,0,1,7934
0,0,1,0,1,0,1,7935
1,1,0,1,1,1,2,7935
2,2,0,1,1,2,3,7935
3,3,1,0,2,2,4,7935
4,4,1,1,3,3,6,7935
5,5,0,1,3,4,7,7935
6,6,0,3,3,7,10,7935
7,7,0,1,3,8,11,7935
8,8,0,1,3,9,12,7935
9,9,0,0,3,9,12,7935
0,0,1,0,1,0,1,7936
1,1,2,0,3,0,3,7936
2,2,0,1,3,1,4,7936
3,3,0,1,3,2,5,7936
4,4,0,0,3,2,5,7936
0,0,1,0,1,0,1,7937
1,1,0,0,1,0,1,7937
0,0,1,0,1,0,1,7938
1,1,1,0,2,0,2,7938
2,2,1,0,3,0,3,7938
3,3,0,0,3,0,3,7938
0,0,1,0,1,0,1,7939
1,1,1,0,2,0,2,7939
2,2,3,0,5,0,5,7939
3,3,2,0,7,0,7,7939
4,4,1,0,8,0,8,7939
5,5,0,0,8,0,8,7939
0,0,1,0,1,0,1,7940
1,1,0,0,1,0,1,7940
0,0,1,0,1,0,1,7941
1,1,0,1,1,1,2,7941
2,2,1,1,2,2,4,7941
3,3,0,3,2,5,7,7941
4,4,2,2,4,7,11,7941
5,5,1,0,5,7,12,7941
6,6,0,0,5,7,12,7941
0,0,1,0,1,0,1,7942
1,1,0,1,1,1,2,7942
2,2,0,0,1,1,2,7942
0,0,1,0,1,0,1,7943
1,1,0,0,1,0,1,7943
0,0,1,0,1,0,1,7944
1,1,0,0,1,0,1,7944
0,0,1,0,1,0,1,7945
1,1,0,0,1,0,1,7945
0,0,1,0,1,0,1,7946
1,1,0,0,1,0,1,7946
0,0,1,0,1,0,1,7947
1,1,1,0,2,0,2,7947
2,2,0,0,2,0,2,7947
0,0,1,0,1,0,1,7948
1,1,0,0,1,0,1,7948
0,0,1,0,1,0,1,7949
1,1,0,2,1,2,3,7949
2,2,1,0,2,2,4,7949
3,3,3,0,5,2,7,7949
4,4,5,1,10,3,13,7949
5,5,5,1,15,4,19,7949
6,6,3,4,18,8,26,7949
7,7,1,2,19,10,29,7949
8,8,1,2,20,12,32,7949
9,9,2,4,22,16,38,7949
10,10,2,3,24,19,43,7949
11,11,3,4,27,23,50,7949
12,12,2,4,29,27,56,7949
13,13,2,2,31,29,60,7949
14,14,1,2,32,31,63,7949
15,15,2,0,34,31,65,7949
16,16,1,0,35,31,66,7949
17,17,1,0,36,31,67,7949
18,18,1,0,37,31,68,7949
19,19,0,0,37,31,68,7949
0,0,1,0,1,0,1,7950
1,1,1,1,2,1,3,7950
2,2,1,0,3,1,4,7950
3,3,0,0,3,1,4,7950
0,0,1,0,1,0,1,7951
1,1,0,1,1,1,2,7951
2,2,0,1,1,2,3,7951
3,3,0,0,1,2,3,7951
0,0,1,0,1,0,1,7952
1,1,0,0,1,0,1,7952
0,0,1,0,1,0,1,7953
1,1,2,0,3,0,3,7953
2,2,0,0,3,0,3,7953
0,0,1,0,1,0,1,7954
1,1,0,0,1,0,1,7954
0,0,1,0,1,0,1,7955
1,1,0,0,1,0,1,7955
0,0,1,0,1,0,1,7956
1,1,1,0,2,0,2,7956
2,2,1,1,3,1,4,7956
3,3,0,1,3,2,5,7956
4,4,0,0,3,2,5,7956
0,0,1,0,1,0,1,7957
1,1,1,0,2,0,2,7957
2,2,0,0,2,0,2,7957
0,0,1,0,1,0,1,7958
1,1,1,0,2,0,2,7958
2,2,2,0,4,0,4,7958
3,3,2,0,6,0,6,7958
4,4,0,0,6,0,6,7958
0,0,1,0,1,0,1,7959
1,1,0,1,1,1,2,7959
2,2,1,0,2,1,3,7959
3,3,0,1,2,2,4,7959
4,4,0,0,2,2,4,7959
0,0,1,0,1,0,1,7960
1,1,1,0,2,0,2,7960
2,2,0,0,2,0,2,7960
0,0,1,0,1,0,1,7961
1,1,0,0,1,0,1,7961
0,0,1,0,1,0,1,7962
1,1,1,0,2,0,2,7962
2,2,0,1,2,1,3,7962
3,3,0,1,2,2,4,7962
4,4,0,1,2,3,5,7962
5,5,0,3,2,6,8,7962
6,6,0,3,2,9,11,7962
7,7,0,0,2,9,11,7962
0,0,1,0,1,0,1,7963
1,1,0,0,1,0,1,7963
0,0,1,0,1,0,1,7964
1,1,1,0,2,0,2,7964
2,2,2,0,4,0,4,7964
3,3,3,1,7,1,8,7964
4,4,3,2,10,3,13,7964
5,5,2,1,12,4,16,7964
6,6,1,0,13,4,17,7964
7,7,2,0,15,4,19,7964
8,8,1,0,16,4,20,7964
9,9,1,0,17,4,21,7964
10,10,0,0,17,4,21,7964
0,0,1,0,1,0,1,7965
1,1,1,0,2,0,2,7965
2,2,0,0,2,0,2,7965
0,0,1,0,1,0,1,7966
1,1,0,0,1,0,1,7966
0,0,1,0,1,0,1,7967
1,1,0,0,1,0,1,7967
0,0,1,0,1,0,1,7968
1,1,2,0,3,0,3,7968
2,2,1,0,4,0,4,7968
3,3,0,0,4,0,4,7968
0,0,1,0,1,0,1,7969
1,1,0,0,1,0,1,7969
0,0,1,0,1,0,1,7970
1,1,1,0,2,0,2,7970
2,2,2,0,4,0,4,7970
3,3,2,1,6,1,7,7970
4,4,0,3,6,4,10,7970
5,5,1,3,7,7,14,7970
6,6,2,1,9,8,17,7970
7,7,2,1,11,9,20,7970
8,8,4,4,15,13,28,7970
9,9,0,2,15,15,30,7970
10,10,0,2,15,17,32,7970
11,11,0,0,15,17,32,7970
0,0,1,0,1,0,1,7971
1,1,0,0,1,0,1,7971
0,0,1,0,1,0,1,7972
1,1,0,0,1,0,1,7972
0,0,1,0,1,0,1,7973
1,1,0,1,1,1,2,7973
2,2,0,1,1,2,3,7973
3,3,0,1,1,3,4,7973
4,4,0,0,1,3,4,7973
0,0,1,0,1,0,1,7974
1,1,1,0,2,0,2,7974
2,2,2,0,4,0,4,7974
3,3,0,0,4,0,4,7974
0,0,1,0,1,0,1,7975
1,1,1,0,2,0,2,7975
2,2,0,0,2,0,2,7975
0,0,1,0,1,0,1,7976
1,1,0,0,1,0,1,7976
0,0,1,0,1,0,1,7977
1,1,0,0,1,0,1,7977
0,0,1,0,1,0,1,7978
1,1,1,0,2,0,2,7978
2,2,3,1,5,1,6,7978
3,3,4,0,9,1,10,7978
4,4,7,1,16,2,18,7978
5,5,4,2,20,4,24,7978
6,6,3,3,23,7,30,7978
7,7,2,1,25,8,33,7978
8,8,2,1,27,9,36,7978
9,9,0,1,27,10,37,7978
10,10,0,1,27,11,38,7978
11,11,1,0,28,11,39,7978
12,12,1,1,29,12,41,7978
13,13,2,0,31,12,43,7978
14,14,1,1,32,13,45,7978
15,15,1,0,33,13,46,7978
16,16,2,0,35,13,48,7978
17,17,3,0,38,13,51,7978
18,18,2,2,40,15,55,7978
19,19,1,1,41,16,57,7978
20,20,0,3,41,19,60,7978
21,21,0,0,41,19,60,7978
0,0,1,0,1,0,1,7979
1,1,1,1,2,1,3,7979
2,2,0,0,2,1,3,7979
0,0,1,0,1,0,1,7980
1,1,0,1,1,1,2,7980
2,2,0,0,1,1,2,7980
0,0,1,0,1,0,1,7981
1,1,2,0,3,0,3,7981
2,2,1,0,4,0,4,7981
3,3,0,0,4,0,4,7981
0,0,1,0,1,0,1,7982
1,1,1,0,2,0,2,7982
2,2,1,0,3,0,3,7982
3,3,1,0,4,0,4,7982
4,4,1,0,5,0,5,7982
5,5,0,0,5,0,5,7982
0,0,1,0,1,0,1,7983
1,1,2,0,3,0,3,7983
2,2,1,0,4,0,4,7983
3,3,0,0,4,0,4,7983
0,0,1,0,1,0,1,7984
1,1,0,0,1,0,1,7984
0,0,1,0,1,0,1,7985
1,1,1,0,2,0,2,7985
2,2,0,0,2,0,2,7985
0,0,1,0,1,0,1,7986
1,1,1,0,2,0,2,7986
2,2,2,0,4,0,4,7986
3,3,4,1,8,1,9,7986
4,4,4,1,12,2,14,7986
5,5,5,2,17,4,21,7986
6,6,2,2,19,6,25,7986
7,7,2,2,21,8,29,7986
8,8,4,0,25,8,33,7986
9,9,3,1,28,9,37,7986
10,10,3,2,31,11,42,7986
11,11,1,1,32,12,44,7986
12,12,0,2,32,14,46,7986
13,13,1,2,33,16,49,7986
14,14,2,2,35,18,53,7986
15,15,3,0,38,18,56,7986
16,16,1,0,39,18,57,7986
17,17,0,0,39,18,57,7986
0,0,1,0,1,0,1,7987
1,1,1,0,2,0,2,7987
2,2,0,0,2,0,2,7987
0,0,1,0,1,0,1,7988
1,1,2,0,3,0,3,7988
2,2,2,0,5,0,5,7988
3,3,2,0,7,0,7,7988
4,4,1,1,8,1,9,7988
5,5,1,1,9,2,11,7988
6,6,1,0,10,2,12,7988
7,7,1,0,11,2,13,7988
8,8,2,0,13,2,15,7988
9,9,0,0,13,2,15,7988
0,0,1,0,1,0,1,7989
1,1,1,0,2,0,2,7989
2,2,0,0,2,0,2,7989
0,0,1,0,1,0,1,7990
1,1,1,0,2,0,2,7990
2,2,0,0,2,0,2,7990
0,0,1,0,1,0,1,7991
1,1,2,0,3,0,3,7991
2,2,1,0,4,0,4,7991
3,3,1,0,5,0,5,7991
4,4,0,0,5,0,5,7991
0,0,1,0,1,0,1,7992
1,1,2,0,3,0,3,7992
2,2,0,1,3,1,4,7992
3,3,1,2,4,3,7,7992
4,4,0,0,4,3,7,7992
0,0,1,0,1,0,1,7993
1,1,1,0,2,0,2,7993
2,2,0,0,2,0,2,7993
0,0,1,0,1,0,1,7994
1,1,0,0,1,0,1,7994
0,0,1,0,1,0,1,7995
1,1,2,0,3,0,3,7995
2,2,1,1,4,1,5,7995
3,3,0,4,4,5,9,7995
4,4,0,7,4,12,16,7995
5,5,1,3,5,15,20,7995
6,6,2,6,7,21,28,7995
7,7,3,6,10,27,37,7995
8,8,3,2,13,29,42,7995
9,9,1,2,14,31,45,7995
10,10,0,2,14,33,47,7995
11,11,0,1,14,34,48,7995
12,12,0,2,14,36,50,7995
13,13,0,0,14,36,50,7995
0,0,1,0,1,0,1,7996
1,1,2,0,3,0,3,7996
2,2,1,0,4,0,4,7996
3,3,1,0,5,0,5,7996
4,4,1,0,6,0,6,7996
5,5,0,0,6,0,6,7996
0,0,1,0,1,0,1,7997
1,1,1,0,2,0,2,7997
2,2,0,0,2,0,2,7997
0,0,1,0,1,0,1,7998
1,1,0,0,1,0,1,7998
0,0,1,0,1,0,1,7999
1,1,1,0,2,0,2,7999
2,2,0,1,2,1,3,7999
3,3,0,0,2,1,3,7999
0,0,1,0,1,0,1,8000
1,1,0,0,1,0,1,8000
0,0,1,0,1,0,1,8001
1,1,1,0,2,0,2,8001
2,2,1,0,3,0,3,8001
3,3,0,0,3,0,3,8001
0,0,1,0,1,0,1,8002
1,1,1,0,2,0,2,8002
2,2,2,1,4,1,5,8002
3,3,3,1,7,2,9,8002
4,4,1,2,8,4,12,8002
5,5,1,2,9,6,15,8002
6,6,0,5,9,11,20,8002
7,7,0,5,9,16,25,8002
8,8,0,1,9,17,26,8002
9,9,0,0,9,17,26,8002
0,0,1,0,1,0,1,8003
1,1,1,1,2,1,3,8003
2,2,0,1,2,2,4,8003
3,3,1,0,3,2,5,8003
4,4,1,0,4,2,6,8003
5,5,4,0,8,2,10,8003
6,6,3,0,11,2,13,8003
7,7,4,0,15,2,17,8003
8,8,5,0,20,2,22,8003
9,9,4,1,24,3,27,8003
10,10,6,0,30,3,33,8003
11,11,3,2,33,5,38,8003
12,12,3,0,36,5,41,8003
13,13,2,1,38,6,44,8003
14,14,1,3,39,9,48,8003
15,15,1,5,40,14,54,8003
16,16,3,2,43,16,59,8003
17,17,1,3,44,19,63,8003
18,18,2,1,46,20,66,8003
19,19,3,0,49,20,69,8003
20,20,6,0,55,20,75,8003
21,21,6,0,61,20,81,8003
22,22,4,0,65,20,85,8003
23,23,2,1,67,21,88,8003
24,24,1,0,68,21,89,8003
25,25,1,0,69,21,90,8003
26,26,2,0,71,21,92,8003
27,27,0,1,71,22,93,8003
28,28,1,2,72,24,96,8003
29,29,1,1,73,25,98,8003
30,30,1,3,74,28,102,8003
31,31,3,1,77,29,106,8003
32,32,5,0,82,29,111,8003
33,33,2,1,84,30,114,8003
34,34,2,0,86,30,116,8003
35,35,2,0,88,30,118,8003
36,36,1,0,89,30,119,8003
37,37,0,0,89,30,119,8003
0,0,1,0,1,0,1,8004
1,1,0,0,1,0,1,8004
0,0,1,0,1,0,1,8005
1,1,0,0,1,0,1,8005
0,0,1,0,1,0,1,8006
1,1,1,0,2,0,2,8006
2,2,0,0,2,0,2,8006
0,0,1,0,1,0,1,8007
1,1,0,0,1,0,1,8007
0,0,1,0,1,0,1,8008
1,1,0,0,1,0,1,8008
0,0,1,0,1,0,1,8009
1,1,1,0,2,0,2,8009
2,2,0,0,2,0,2,8009
0,0,1,0,1,0,1,8010
1,1,1,0,2,0,2,8010
2,2,1,1,3,1,4,8010
3,3,0,1,3,2,5,8010
4,4,0,1,3,3,6,8010
5,5,0,1,3,4,7,8010
6,6,0,1,3,5,8,8010
7,7,0,0,3,5,8,8010
0,0,1,0,1,0,1,8011
1,1,0,0,1,0,1,8011
0,0,1,0,1,0,1,8012
1,1,0,0,1,0,1,8012
0,0,1,0,1,0,1,8013
1,1,1,0,2,0,2,8013
2,2,0,0,2,0,2,8013
0,0,1,0,1,0,1,8014
1,1,0,0,1,0,1,8014
0,0,1,0,1,0,1,8015
1,1,0,0,1,0,1,8015
0,0,1,0,1,0,1,8016
1,1,0,1,1,1,2,8016
2,2,0,1,1,2,3,8016
3,3,0,1,1,3,4,8016
4,4,0,0,1,3,4,8016
0,0,1,0,1,0,1,8017
1,1,1,1,2,1,3,8017
2,2,2,1,4,2,6,8017
3,3,0,2,4,4,8,8017
4,4,2,3,6,7,13,8017
5,5,1,3,7,10,17,8017
6,6,1,2,8,12,20,8017
7,7,0,2,8,14,22,8017
8,8,0,1,8,15,23,8017
9,9,0,1,8,16,24,8017
10,10,0,1,8,17,25,8017
11,11,0,2,8,19,27,8017
12,12,0,2,8,21,29,8017
13,13,1,1,9,22,31,8017
14,14,1,0,10,22,32,8017
15,15,0,0,10,22,32,8017
0,0,1,0,1,0,1,8018
1,1,0,0,1,0,1,8018
0,0,1,0,1,0,1,8019
1,1,3,0,4,0,4,8019
2,2,3,0,7,0,7,8019
3,3,1,1,8,1,9,8019
4,4,5,1,13,2,15,8019
5,5,3,2,16,4,20,8019
6,6,1,3,17,7,24,8019
7,7,1,3,18,10,28,8019
8,8,0,2,18,12,30,8019
9,9,0,1,18,13,31,8019
10,10,0,3,18,16,34,8019
11,11,1,2,19,18,37,8019
12,12,1,1,20,19,39,8019
13,13,2,1,22,20,42,8019
14,14,1,2,23,22,45,8019
15,15,3,2,26,24,50,8019
16,16,3,3,29,27,56,8019
17,17,2,1,31,28,59,8019
18,18,3,2,34,30,64,8019
19,19,2,1,36,31,67,8019
20,20,2,1,38,32,70,8019
21,21,3,1,41,33,74,8019
22,22,0,1,41,34,75,8019
23,23,2,0,43,34,77,8019
24,24,3,1,46,35,81,8019
25,25,6,0,52,35,87,8019
26,26,3,2,55,37,92,8019
27,27,2,3,57,40,97,8019
28,28,1,2,58,42,100,8019
29,29,1,0,59,42,101,8019
30,30,1,0,60,42,102,8019
31,31,1,0,61,42,103,8019
32,32,0,0,61,42,103,8019
0,0,1,0,1,0,1,8020
1,1,1,0,2,0,2,8020
2,2,2,0,4,0,4,8020
3,3,2,1,6,1,7,8020
4,4,1,1,7,2,9,8020
5,5,0,1,7,3,10,8020
6,6,0,1,7,4,11,8020
7,7,1,1,8,5,13,8020
8,8,0,2,8,7,15,8020
9,9,1,1,9,8,17,8020
10,10,4,2,13,10,23,8020
11,11,4,2,17,12,29,8020
12,12,1,2,18,14,32,8020
13,13,4,5,22,19,41,8020
14,14,5,5,27,24,51,8020
15,15,7,4,34,28,62,8020
16,16,6,6,40,34,74,8020
17,17,5,2,45,36,81,8020
18,18,5,4,50,40,90,8020
19,19,1,4,51,44,95,8020
20,20,4,1,55,45,100,8020
21,21,6,0,61,45,106,8020
22,22,4,0,65,45,110,8020
23,23,1,1,66,46,112,8020
24,24,0,1,66,47,113,8020
25,25,0,0,66,47,113,8020
0,0,1,0,1,0,1,8021
1,1,0,0,1,0,1,8021
0,0,1,0,1,0,1,8022
1,1,1,0,2,0,2,8022
2,2,0,0,2,0,2,8022
0,0,1,0,1,0,1,8023
1,1,1,0,2,0,2,8023
2,2,1,0,3,0,3,8023
3,3,1,0,4,0,4,8023
4,4,2,0,6,0,6,8023
5,5,2,0,8,0,8,8023
6,6,1,2,9,2,11,8023
7,7,3,0,12,2,14,8023
8,8,2,0,14,2,16,8023
9,9,2,0,16,2,18,8023
10,10,0,0,16,2,18,8023
0,0,1,0,1,0,1,8024
1,1,2,0,3,0,3,8024
2,2,1,0,4,0,4,8024
3,3,1,0,5,0,5,8024
4,4,1,0,6,0,6,8024
5,5,0,0,6,0,6,8024
0,0,1,0,1,0,1,8025
1,1,0,0,1,0,1,8025
0,0,1,0,1,0,1,8026
1,1,0,0,1,0,1,8026
0,0,1,0,1,0,1,8027
1,1,0,1,1,1,2,8027
2,2,0,0,1,1,2,8027
0,0,1,0,1,0,1,8028
1,1,1,0,2,0,2,8028
2,2,0,1,2,1,3,8028
3,3,0,0,2,1,3,8028
0,0,1,0,1,0,1,8029
1,1,1,0,2,0,2,8029
2,2,0,0,2,0,2,8029
0,0,1,0,1,0,1,8030
1,1,0,1,1,1,2,8030
2,2,1,0,2,1,3,8030
3,3,1,0,3,1,4,8030
4,4,0,0,3,1,4,8030
0,0,1,0,1,0,1,8031
1,1,1,0,2,0,2,8031
2,2,1,0,3,0,3,8031
3,3,1,0,4,0,4,8031
4,4,0,0,4,0,4,8031
0,0,1,0,1,0,1,8032
1,1,1,0,2,0,2,8032
2,2,1,0,3,0,3,8032
3,3,0,0,3,0,3,8032
0,0,1,0,1,0,1,8033
1,1,3,0,4,0,4,8033
2,2,3,1,7,1,8,8033
3,3,2,1,9,2,11,8033
4,4,2,3,11,5,16,8033
5,5,2,6,13,11,24,8033
6,6,3,4,16,15,31,8033
7,7,0,2,16,17,33,8033
8,8,0,3,16,20,36,8033
9,9,0,2,16,22,38,8033
10,10,0,1,16,23,39,8033
11,11,0,0,16,23,39,8033
0,0,1,0,1,0,1,8034
1,1,1,0,2,0,2,8034
2,2,4,0,6,0,6,8034
3,3,4,2,10,2,12,8034
4,4,8,2,18,4,22,8034
5,5,8,4,26,8,34,8034
6,6,6,6,32,14,46,8034
7,7,4,7,36,21,57,8034
8,8,6,4,42,25,67,8034
9,9,6,6,48,31,79,8034
10,10,10,9,58,40,98,8034
11,11,7,9,65,49,114,8034
12,12,5,8,70,57,127,8034
13,13,6,6,76,63,139,8034
14,14,3,4,79,67,146,8034
15,15,0,3,79,70,149,8034
16,16,0,5,79,75,154,8034
17,17,1,3,80,78,158,8034
18,18,1,2,81,80,161,8034
19,19,0,4,81,84,165,8034
20,20,0,5,81,89,170,8034
21,21,1,1,82,90,172,8034
22,22,1,1,83,91,174,8034
23,23,0,1,83,92,175,8034
24,24,0,1,83,93,176,8034
25,25,0,1,83,94,177,8034
26,26,0,0,83,94,177,8034
0,0,1,0,1,0,1,8035
1,1,0,0,1,0,1,8035
0,0,1,0,1,0,1,8036
1,1,0,0,1,0,1,8036
0,0,1,0,1,0,1,8037
1,1,1,0,2,0,2,8037
2,2,1,0,3,0,3,8037
3,3,0,1,3,1,4,8037
4,4,2,1,5,2,7,8037
5,5,4,1,9,3,12,8037
6,6,2,1,11,4,15,8037
7,7,3,0,14,4,18,8037
8,8,3,0,17,4,21,8037
9,9,2,0,19,4,23,8037
10,10,2,0,21,4,25,8037
11,11,1,1,22,5,27,8037
12,12,0,0,22,5,27,8037
0,0,1,0,1,0,1,8038
1,1,0,0,1,0,1,8038
0,0,1,0,1,0,1,8039
1,1,1,0,2,0,2,8039
2,2,1,0,3,0,3,8039
3,3,0,0,3,0,3,8039
0,0,1,0,1,0,1,8040
1,1,2,0,3,0,3,8040
2,2,2,0,5,0,5,8040
3,3,1,2,6,2,8,8040
4,4,4,2,10,4,14,8040
5,5,3,2,13,6,19,8040
6,6,3,4,16,10,26,8040
7,7,3,4,19,14,33,8040
8,8,2,0,21,14,35,8040
9,9,2,0,23,14,37,8040
10,10,3,0,26,14,40,8040
11,11,2,0,28,14,42,8040
12,12,0,1,28,15,43,8040
13,13,0,1,28,16,44,8040
14,14,0,3,28,19,47,8040
15,15,0,1,28,20,48,8040
16,16,0,0,28,20,48,8040
0,0,1,0,1,0,1,8041
1,1,0,0,1,0,1,8041
0,0,1,0,1,0,1,8042
1,1,1,0,2,0,2,8042
2,2,2,0,4,0,4,8042
3,3,2,0,6,0,6,8042
4,4,1,1,7,1,8,8042
5,5,2,0,9,1,10,8042
6,6,2,0,11,1,12,8042
7,7,2,0,13,1,14,8042
8,8,2,1,15,2,17,8042
9,9,3,0,18,2,20,8042
10,10,3,1,21,3,24,8042
11,11,2,1,23,4,27,8042
12,12,1,2,24,6,30,8042
13,13,1,3,25,9,34,8042
14,14,0,4,25,13,38,8042
15,15,0,2,25,15,40,8042
16,16,1,2,26,17,43,8042
17,17,0,0,26,17,43,8042
0,0,1,0,1,0,1,8043
1,1,0,0,1,0,1,8043
0,0,1,0,1,0,1,8044
1,1,1,0,2,0,2,8044
2,2,0,0,2,0,2,8044
0,0,1,0,1,0,1,8045
1,1,1,0,2,0,2,8045
2,2,0,0,2,0,2,8045
0,0,1,0,1,0,1,8046
1,1,1,0,2,0,2,8046
2,2,1,0,3,0,3,8046
3,3,0,0,3,0,3,8046
0,0,1,0,1,0,1,8047
1,1,0,0,1,0,1,8047
0,0,1,0,1,0,1,8048
1,1,0,0,1,0,1,8048
0,0,1,0,1,0,1,8049
1,1,1,0,2,0,2,8049
2,2,0,0,2,0,2,8049
0,0,1,0,1,0,1,8050
1,1,0,0,1,0,1,8050
0,0,1,0,1,0,1,8051
1,1,2,0,3,0,3,8051
2,2,3,0,6,0,6,8051
3,3,4,0,10,0,10,8051
4,4,1,0,11,0,11,8051
5,5,1,2,12,2,14,8051
6,6,1,1,13,3,16,8051
7,7,0,0,13,3,16,8051
0,0,1,0,1,0,1,8052
1,1,1,0,2,0,2,8052
2,2,1,0,3,0,3,8052
3,3,0,0,3,0,3,8052
0,0,1,0,1,0,1,8053
1,1,0,0,1,0,1,8053
0,0,1,0,1,0,1,8054
1,1,1,1,2,1,3,8054
2,2,0,4,2,5,7,8054
3,3,1,2,3,7,10,8054
4,4,3,1,6,8,14,8054
5,5,2,2,8,10,18,8054
6,6,1,1,9,11,20,8054
7,7,1,2,10,13,23,8054
8,8,1,1,11,14,25,8054
9,9,1,0,12,14,26,8054
10,10,0,1,12,15,27,8054
11,11,1,2,13,17,30,8054
12,12,1,1,14,18,32,8054
13,13,0,1,14,19,33,8054
14,14,0,1,14,20,34,8054
15,15,0,0,14,20,34,8054
0,0,1,0,1,0,1,8055
1,1,2,0,3,0,3,8055
2,2,3,0,6,0,6,8055
3,3,1,0,7,0,7,8055
4,4,0,0,7,0,7,8055
0,0,1,0,1,0,1,8056
1,1,1,1,2,1,3,8056
2,2,1,0,3,1,4,8056
3,3,0,0,3,1,4,8056
0,0,1,0,1,0,1,8057
1,1,3,0,4,0,4,8057
2,2,4,1,8,1,9,8057
3,3,4,0,12,1,13,8057
4,4,2,1,14,2,16,8057
5,5,0,1,14,3,17,8057
6,6,0,0,14,3,17,8057
0,0,1,0,1,0,1,8058
1,1,1,0,2,0,2,8058
2,2,2,1,4,1,5,8058
3,3,3,3,7,4,11,8058
4,4,2,2,9,6,15,8058
5,5,1,1,10,7,17,8058
6,6,0,0,10,7,17,8058
0,0,1,0,1,0,1,8059
1,1,0,0,1,0,1,8059
0,0,1,0,1,0,1,8060
1,1,0,0,1,0,1,8060
0,0,1,0,1,0,1,8061
1,1,2,0,3,0,3,8061
2,2,0,0,3,0,3,8061
0,0,1,0,1,0,1,8062
1,1,1,0,2,0,2,8062
2,2,1,0,3,0,3,8062
3,3,2,0,5,0,5,8062
4,4,2,1,7,1,8,8062
5,5,1,0,8,1,9,8062
6,6,0,0,8,1,9,8062
0,0,1,0,1,0,1,8063
1,1,0,0,1,0,1,8063
0,0,1,0,1,0,1,8064
1,1,0,0,1,0,1,8064
0,0,1,0,1,0,1,8065
1,1,1,0,2,0,2,8065
2,2,1,0,3,0,3,8065
3,3,0,0,3,0,3,8065
0,0,1,0,1,0,1,8066
1,1,0,0,1,0,1,8066
0,0,1,0,1,0,1,8067
1,1,0,0,1,0,1,8067
0,0,1,0,1,0,1,8068
1,1,0,1,1,1,2,8068
2,2,0,1,1,2,3,8068
3,3,0,1,1,3,4,8068
4,4,0,0,1,3,4,8068
0,0,1,0,1,0,1,8069
1,1,1,0,2,0,2,8069
2,2,0,0,2,0,2,8069
0,0,1,0,1,0,1,8070
1,1,1,0,2,0,2,8070
2,2,0,0,2,0,2,8070
0,0,1,0,1,0,1,8071
1,1,1,0,2,0,2,8071
2,2,0,0,2,0,2,8071
0,0,1,0,1,0,1,8072
1,1,0,0,1,0,1,8072
0,0,1,0,1,0,1,8073
1,1,1,0,2,0,2,8073
2,2,1,0,3,0,3,8073
3,3,0,0,3,0,3,8073
0,0,1,0,1,0,1,8074
1,1,2,1,3,1,4,8074
2,2,1,0,4,1,5,8074
3,3,3,0,7,1,8,8074
4,4,1,0,8,1,9,8074
5,5,1,0,9,1,10,8074
6,6,0,1,9,2,11,8074
7,7,0,0,9,2,11,8074
0,0,1,0,1,0,1,8075
1,1,0,1,1,1,2,8075
2,2,2,2,3,3,6,8075
3,3,1,1,4,4,8,8075
4,4,2,0,6,4,10,8075
5,5,0,1,6,5,11,8075
6,6,0,2,6,7,13,8075
7,7,1,2,7,9,16,8075
8,8,1,2,8,11,19,8075
9,9,0,1,8,12,20,8075
10,10,0,1,8,13,21,8075
11,11,0,1,8,14,22,8075
12,12,0,1,8,15,23,8075
13,13,0,2,8,17,25,8075
14,14,0,0,8,17,25,8075
0,0,1,0,1,0,1,8076
1,1,1,1,2,1,3,8076
2,2,1,0,3,1,4,8076
3,3,0,0,3,1,4,8076
0,0,1,0,1,0,1,8077
1,1,0,0,1,0,1,8077
0,0,1,0,1,0,1,8078
1,1,2,0,3,0,3,8078
2,2,1,0,4,0,4,8078
3,3,0,0,4,0,4,8078
0,0,1,0,1,0,1,8079
1,1,0,0,1,0,1,8079
0,0,1,0,1,0,1,8080
1,1,1,0,2,0,2,8080
2,2,1,0,3,0,3,8080
3,3,2,1,5,1,6,8080
4,4,2,1,7,2,9,8080
5,5,2,1,9,3,12,8080
6,6,0,0,9,3,12,8080
0,0,1,0,1,0,1,8081
1,1,1,1,2,1,3,8081
2,2,1,1,3,2,5,8081
3,3,2,2,5,4,9,8081
4,4,6,0,11,4,15,8081
5,5,5,1,16,5,21,8081
6,6,8,2,24,7,31,8081
7,7,9,0,33,7,40,8081
8,8,10,4,43,11,54,8081
9,9,9,7,52,18,70,8081
10,10,16,7,68,25,93,8081
11,11,11,6,79,31,110,8081
12,12,10,7,89,38,127,8081
13,13,10,11,99,49,148,8081
14,14,6,5,105,54,159,8081
15,15,8,1,113,55,168,8081
16,16,3,1,116,56,172,8081
17,17,3,0,119,56,175,8081
18,18,2,1,121,57,178,8081
19,19,0,3,121,60,181,8081
20,20,0,4,121,64,185,8081
21,21,2,4,123,68,191,8081
22,22,3,3,126,71,197,8081
23,23,4,2,130,73,203,8081
24,24,3,1,133,74,207,8081
25,25,6,0,139,74,213,8081
26,26,8,0,147,74,221,8081
27,27,2,0,149,74,223,8081
28,28,1,1,150,75,225,8081
29,29,2,1,152,76,228,8081
30,30,2,0,154,76,230,8081
31,31,1,0,155,76,231,8081
32,32,1,0,156,76,232,8081
33,33,0,0,156,76,232,8081
0,0,1,0,1,0,1,8082
1,1,3,0,4,0,4,8082
2,2,2,0,6,0,6,8082
3,3,1,1,7,1,8,8082
4,4,1,2,8,3,11,8082
5,5,1,1,9,4,13,8082
6,6,1,1,10,5,15,8082
7,7,1,1,11,6,17,8082
8,8,1,1,12,7,19,8082
9,9,1,0,13,7,20,8082
10,10,1,0,14,7,21,8082
11,11,1,2,15,9,24,8082
12,12,1,1,16,10,26,8082
13,13,0,0,16,10,26,8082
0,0,1,0,1,0,1,8083
1,1,1,0,2,0,2,8083
2,2,3,0,5,0,5,8083
3,3,2,0,7,0,7,8083
4,4,2,1,9,1,10,8083
5,5,0,1,9,2,11,8083
6,6,0,0,9,2,11,8083
0,0,1,0,1,0,1,8084
1,1,1,1,2,1,3,8084
2,2,2,0,4,1,5,8084
3,3,0,1,4,2,6,8084
4,4,0,0,4,2,6,8084
0,0,1,0,1,0,1,8085
1,1,0,0,1,0,1,8085
0,0,1,0,1,0,1,8086
1,1,0,0,1,0,1,8086
0,0,1,0,1,0,1,8087
1,1,2,0,3,0,3,8087
2,2,1,0,4,0,4,8087
3,3,0,0,4,0,4,8087
0,0,1,0,1,0,1,8088
1,1,0,0,1,0,1,8088
0,0,1,0,1,0,1,8089
1,1,3,0,4,0,4,8089
2,2,3,0,7,0,7,8089
3,3,7,1,14,1,15,8089
4,4,3,3,17,4,21,8089
5,5,6,2,23,6,29,8089
6,6,4,4,27,10,37,8089
7,7,5,3,32,13,45,8089
8,8,7,1,39,14,53,8089
9,9,4,1,43,15,58,8089
10,10,3,2,46,17,63,8089
11,11,5,2,51,19,70,8089
12,12,3,3,54,22,76,8089
13,13,5,3,59,25,84,8089
14,14,5,6,64,31,95,8089
15,15,8,6,72,37,109,8089
16,16,12,7,84,44,128,8089
17,17,5,7,89,51,140,8089
18,18,4,8,93,59,152,8089
19,19,3,13,96,72,168,8089
20,20,7,7,103,79,182,8089
21,21,4,5,107,84,191,8089
22,22,3,2,110,86,196,8089
23,23,1,2,111,88,199,8089
24,24,0,3,111,91,202,8089
25,25,1,4,112,95,207,8089
26,26,1,5,113,100,213,8089
27,27,0,2,113,102,215,8089
28,28,0,1,113,103,216,8089
29,29,0,2,113,105,218,8089
30,30,1,1,114,106,220,8089
31,31,0,1,114,107,221,8089
32,32,0,2,114,109,223,8089
33,33,0,1,114,110,224,8089
34,34,0,1,114,111,225,8089
35,35,0,1,114,112,226,8089
36,36,0,0,114,112,226,8089
0,0,1,0,1,0,1,8090
1,1,1,0,2,0,2,8090
2,2,0,0,2,0,2,8090
0,0,1,0,1,0,1,8091
1,1,0,0,1,0,1,8091
0,0,1,0,1,0,1,8092
1,1,2,0,3,0,3,8092
2,2,0,1,3,1,4,8092
3,3,0,1,3,2,5,8092
4,4,2,0,5,2,7,8092
5,5,3,1,8,3,11,8092
6,6,3,1,11,4,15,8092
7,7,1,0,12,4,16,8092
8,8,1,0,13,4,17,8092
9,9,0,0,13,4,17,8092
0,0,1,0,1,0,1,8093
1,1,0,0,1,0,1,8093
0,0,1,0,1,0,1,8094
1,1,1,0,2,0,2,8094
2,2,1,0,3,0,3,8094
3,3,1,0,4,0,4,8094
4,4,1,0,5,0,5,8094
5,5,0,0,5,0,5,8094
0,0,1,0,1,0,1,8095
1,1,1,0,2,0,2,8095
2,2,1,0,3,0,3,8095
3,3,0,0,3,0,3,8095
0,0,1,0,1,0,1,8096
1,1,1,0,2,0,2,8096
2,2,0,1,2,1,3,8096
3,3,1,3,3,4,7,8096
4,4,2,3,5,7,12,8096
5,5,1,2,6,9,15,8096
6,6,2,1,8,10,18,8096
7,7,4,2,12,12,24,8096
8,8,3,5,15,17,32,8096
9,9,3,7,18,24,42,8096
10,10,5,4,23,28,51,8096
11,11,4,10,27,38,65,8096
12,12,5,8,32,46,78,8096
13,13,5,5,37,51,88,8096
14,14,4,1,41,52,93,8096
15,15,4,2,45,54,99,8096
16,16,1,1,46,55,101,8096
17,17,0,1,46,56,102,8096
18,18,1,0,47,56,103,8096
19,19,0,0,47,56,103,8096
0,0,1,0,1,0,1,8097
1,1,0,1,1,1,2,8097
2,2,1,0,2,1,3,8097
3,3,2,0,4,1,5,8097
4,4,3,0,7,1,8,8097
5,5,0,0,7,1,8,8097
0,0,1,0,1,0,1,8098
1,1,0,2,1,2,3,8098
2,2,1,0,2,2,4,8098
3,3,0,0,2,2,4,8098
0,0,1,0,1,0,1,8099
1,1,0,0,1,0,1,8099
0,0,1,0,1,0,1,8100
1,1,1,1,2,1,3,8100
2,2,0,1,2,2,4,8100
3,3,0,0,2,2,4,8100
0,0,1,0,1,0,1,8101
1,1,0,0,1,0,1,8101
0,0,1,0,1,0,1,8102
1,1,0,0,1,0,1,8102
0,0,1,0,1,0,1,8103
1,1,0,0,1,0,1,8103
0,0,1,0,1,0,1,8104
1,1,1,0,2,0,2,8104
2,2,1,0,3,0,3,8104
3,3,3,0,6,0,6,8104
4,4,0,1,6,1,7,8104
5,5,0,0,6,1,7,8104
0,0,1,0,1,0,1,8105
1,1,0,1,1,1,2,8105
2,2,0,1,1,2,3,8105
3,3,0,2,1,4,5,8105
4,4,0,0,1,4,5,8105
0,0,1,0,1,0,1,8106
1,1,0,0,1,0,1,8106
0,0,1,0,1,0,1,8107
1,1,0,0,1,0,1,8107
0,0,1,0,1,0,1,8108
1,1,1,0,2,0,2,8108
2,2,0,0,2,0,2,8108
0,0,1,0,1,0,1,8109
1,1,0,0,1,0,1,8109
0,0,1,0,1,0,1,8110
1,1,1,2,2,2,4,8110
2,2,3,0,5,2,7,8110
3,3,4,1,9,3,12,8110
4,4,4,0,13,3,16,8110
5,5,1,0,14,3,17,8110
6,6,0,0,14,3,17,8110
0,0,1,0,1,0,1,8111
1,1,1,1,2,1,3,8111
2,2,0,1,2,2,4,8111
3,3,0,0,2,2,4,8111
0,0,1,0,1,0,1,8112
1,1,0,0,1,0,1,8112
0,0,1,0,1,0,1,8113
1,1,1,0,2,0,2,8113
2,2,0,1,2,1,3,8113
3,3,0,1,2,2,4,8113
4,4,0,1,2,3,5,8113
5,5,0,3,2,6,8,8113
6,6,0,0,2,6,8,8113
0,0,1,0,1,0,1,8114
1,1,1,1,2,1,3,8114
2,2,1,2,3,3,6,8114
3,3,1,1,4,4,8,8114
4,4,0,1,4,5,9,8114
5,5,0,0,4,5,9,8114
0,0,1,0,1,0,1,8115
1,1,4,0,5,0,5,8115
2,2,0,1,5,1,6,8115
3,3,1,1,6,2,8,8115
4,4,1,2,7,4,11,8115
5,5,0,1,7,5,12,8115
6,6,1,0,8,5,13,8115
7,7,1,0,9,5,14,8115
8,8,0,0,9,5,14,8115
0,0,1,0,1,0,1,8116
1,1,0,0,1,0,1,8116
0,0,1,0,1,0,1,8117
1,1,0,0,1,0,1,8117
0,0,1,0,1,0,1,8118
1,1,1,0,2,0,2,8118
2,2,1,0,3,0,3,8118
3,3,0,0,3,0,3,8118
0,0,1,0,1,0,1,8119
1,1,0,0,1,0,1,8119
0,0,1,0,1,0,1,8120
1,1,1,0,2,0,2,8120
2,2,0,0,2,0,2,8120
0,0,1,0,1,0,1,8121
1,1,3,0,4,0,4,8121
2,2,5,1,9,1,10,8121
3,3,3,2,12,3,15,8121
4,4,3,4,15,7,22,8121
5,5,3,6,18,13,31,8121
6,6,4,3,22,16,38,8121
7,7,7,2,29,18,47,8121
8,8,3,2,32,20,52,8121
9,9,4,0,36,20,56,8121
10,10,2,1,38,21,59,8121
11,11,2,1,40,22,62,8121
12,12,1,0,41,22,63,8121
13,13,0,1,41,23,64,8121
14,14,0,0,41,23,64,8121
0,0,1,0,1,0,1,8122
1,1,0,0,1,0,1,8122
0,0,1,0,1,0,1,8123
1,1,3,1,4,1,5,8123
2,2,3,0,7,1,8,8123
3,3,3,0,10,1,11,8123
4,4,0,0,10,1,11,8123
0,0,1,0,1,0,1,8124
1,1,0,0,1,0,1,8124
0,0,1,0,1,0,1,8125
1,1,0,0,1,0,1,8125
0,0,1,0,1,0,1,8126
1,1,1,0,2,0,2,8126
2,2,0,0,2,0,2,8126
0,0,1,0,1,0,1,8127
1,1,2,1,3,1,4,8127
2,2,3,1,6,2,8,8127
3,3,1,2,7,4,11,8127
4,4,0,1,7,5,12,8127
5,5,0,0,7,5,12,8127
0,0,1,0,1,0,1,8128
1,1,1,0,2,0,2,8128
2,2,1,0,3,0,3,8128
3,3,1,0,4,0,4,8128
4,4,1,1,5,1,6,8128
5,5,1,1,6,2,8,8128
6,6,1,1,7,3,10,8128
7,7,1,0,8,3,11,8128
8,8,1,0,9,3,12,8128
9,9,0,0,9,3,12,8128
0,0,1,0,1,0,1,8129
1,1,2,0,3,0,3,8129
2,2,3,0,6,0,6,8129
3,3,4,0,10,0,10,8129
4,4,4,1,14,1,15,8129
5,5,3,2,17,3,20,8129
6,6,2,1,19,4,23,8129
7,7,4,3,23,7,30,8129
8,8,2,2,25,9,34,8129
9,9,1,0,26,9,35,8129
10,10,2,0,28,9,37,8129
11,11,0,0,28,9,37,8129
0,0,1,0,1,0,1,8130
1,1,1,0,2,0,2,8130
2,2,0,0,2,0,2,8130
0,0,1,0,1,0,1,8131
1,1,1,0,2,0,2,8131
2,2,2,0,4,0,4,8131
3,3,3,1,7,1,8,8131
4,4,4,1,11,2,13,8131
5,5,5,1,16,3,19,8131
6,6,6,1,22,4,26,8131
7,7,1,3,23,7,30,8131
8,8,1,4,24,11,35,8131
9,9,2,4,26,15,41,8131
10,10,3,6,29,21,50,8131
11,11,3,4,32,25,57,8131
12,12,5,3,37,28,65,8131
13,13,9,2,46,30,76,8131
14,14,10,6,56,36,92,8131
15,15,11,3,67,39,106,8131
16,16,6,2,73,41,114,8131
17,17,7,2,80,43,123,8131
18,18,6,3,86,46,132,8131
19,19,7,1,93,47,140,8131
20,20,9,5,102,52,154,8131
21,21,10,6,112,58,170,8131
22,22,11,6,123,64,187,8131
23,23,12,7,135,71,206,8131
24,24,14,10,149,81,230,8131
25,25,12,8,161,89,250,8131
26,26,11,10,172,99,271,8131
27,27,11,8,183,107,290,8131
28,28,6,7,189,114,303,8131
29,29,6,4,195,118,313,8131
30,30,2,3,197,121,318,8131
31,31,1,5,198,126,324,8131
32,32,2,1,200,127,327,8131
33,33,7,1,207,128,335,8131
34,34,5,2,212,130,342,8131
35,35,6,2,218,132,350,8131
36,36,6,5,224,137,361,8131
37,37,4,9,228,146,374,8131
38,38,6,9,234,155,389,8131
39,39,9,7,243,162,405,8131
40,40,5,8,248,170,418,8131
41,41,6,7,254,177,431,8131
42,42,5,6,259,183,442,8131
43,43,5,1,264,184,448,8131
44,44,5,2,269,186,455,8131
45,45,5,3,274,189,463,8131
46,46,4,1,278,190,468,8131
47,47,3,1,281,191,472,8131
48,48,1,3,282,194,476,8131
49,49,1,3,283,197,480,8131
50,50,0,1,283,198,481,8131
51,51,1,0,284,198,482,8131
52,52,0,1,284,199,483,8131
53,53,0,0,284,199,483,8131
0,0,1,0,1,0,1,8132
1,1,1,0,2,0,2,8132
2,2,1,0,3,0,3,8132
3,3,1,0,4,0,4,8132
4,4,2,0,6,0,6,8132
5,5,0,0,6,0,6,8132
0,0,1,0,1,0,1,8133
1,1,1,0,2,0,2,8133
2,2,0,0,2,0,2,8133
0,0,1,0,1,0,1,8134
1,1,1,0,2,0,2,8134
2,2,0,0,2,0,2,8134
0,0,1,0,1,0,1,8135
1,1,0,2,1,2,3,8135
2,2,1,0,2,2,4,8135
3,3,0,0,2,2,4,8135
0,0,1,0,1,0,1,8136
1,1,2,1,3,1,4,8136
2,2,0,1,3,2,5,8136
3,3,0,0,3,2,5,8136
0,0,1,0,1,0,1,8137
1,1,0,0,1,0,1,8137
0,0,1,0,1,0,1,8138
1,1,1,0,2,0,2,8138
2,2,0,0,2,0,2,8138
0,0,1,0,1,0,1,8139
1,1,1,0,2,0,2,8139
2,2,5,1,7,1,8,8139
3,3,1,1,8,2,10,8139
4,4,1,0,9,2,11,8139
5,5,0,0,9,2,11,8139
0,0,1,0,1,0,1,8140
1,1,0,0,1,0,1,8140
0,0,1,0,1,0,1,8141
1,1,0,0,1,0,1,8141
0,0,1,0,1,0,1,8142
1,1,3,0,4,0,4,8142
2,2,3,0,7,0,7,8142
3,3,3,0,10,0,10,8142
4,4,3,0,13,0,13,8142
5,5,3,0,16,0,16,8142
6,6,1,0,17,0,17,8142
7,7,1,0,18,0,18,8142
8,8,1,0,19,0,19,8142
9,9,1,0,20,0,20,8142
10,10,1,0,21,0,21,8142
11,11,2,0,23,0,23,8142
12,12,2,0,25,0,25,8142
13,13,3,1,28,1,29,8142
14,14,3,0,31,1,32,8142
15,15,0,1,31,2,33,8142
16,16,0,1,31,3,34,8142
17,17,0,0,31,3,34,8142
0,0,1,0,1,0,1,8143
1,1,0,0,1,0,1,8143
0,0,1,0,1,0,1,8144
1,1,0,0,1,0,1,8144
0,0,1,0,1,0,1,8145
1,1,0,0,1,0,1,8145
0,0,1,0,1,0,1,8146
1,1,2,0,3,0,3,8146
2,2,0,0,3,0,3,8146
0,0,1,0,1,0,1,8147
1,1,0,1,1,1,2,8147
2,2,1,0,2,1,3,8147
3,3,1,0,3,1,4,8147
4,4,1,1,4,2,6,8147
5,5,2,0,6,2,8,8147
6,6,1,1,7,3,10,8147
7,7,2,2,9,5,14,8147
8,8,2,3,11,8,19,8147
9,9,2,1,13,9,22,8147
10,10,2,0,15,9,24,8147
11,11,2,0,17,9,26,8147
12,12,1,1,18,10,28,8147
13,13,2,3,20,13,33,8147
14,14,2,1,22,14,36,8147
15,15,3,0,25,14,39,8147
16,16,1,0,26,14,40,8147
17,17,0,1,26,15,41,8147
18,18,2,1,28,16,44,8147
19,19,1,3,29,19,48,8147
20,20,3,2,32,21,53,8147
21,21,3,1,35,22,57,8147
22,22,3,1,38,23,61,8147
23,23,2,1,40,24,64,8147
24,24,3,3,43,27,70,8147
25,25,2,0,45,27,72,8147
26,26,0,1,45,28,73,8147
27,27,0,1,45,29,74,8147
28,28,0,0,45,29,74,8147
0,0,1,0,1,0,1,8148
1,1,0,0,1,0,1,8148
0,0,1,0,1,0,1,8149
1,1,0,1,1,1,2,8149
2,2,0,2,1,3,4,8149
3,3,0,1,1,4,5,8149
4,4,0,0,1,4,5,8149
0,0,1,0,1,0,1,8150
1,1,3,0,4,0,4,8150
2,2,1,0,5,0,5,8150
3,3,2,0,7,0,7,8150
4,4,1,0,8,0,8,8150
5,5,1,1,9,1,10,8150
6,6,1,1,10,2,12,8150
7,7,1,0,11,2,13,8150
8,8,1,0,12,2,14,8150
9,9,0,1,12,3,15,8150
10,10,0,1,12,4,16,8150
11,11,0,1,12,5,17,8150
12,12,1,0,13,5,18,8150
13,13,0,0,13,5,18,8150
0,0,1,0,1,0,1,8151
1,1,1,0,2,0,2,8151
2,2,0,0,2,0,2,8151
0,0,1,0,1,0,1,8152
1,1,1,0,2,0,2,8152
2,2,1,0,3,0,3,8152
3,3,0,0,3,0,3,8152
0,0,1,0,1,0,1,8153
1,1,0,0,1,0,1,8153
0,0,1,0,1,0,1,8154
1,1,0,0,1,0,1,8154
0,0,1,0,1,0,1,8155
1,1,0,0,1,0,1,8155
0,0,1,0,1,0,1,8156
1,1,0,0,1,0,1,8156
0,0,1,0,1,0,1,8157
1,1,1,0,2,0,2,8157
2,2,1,0,3,0,3,8157
3,3,1,0,4,0,4,8157
4,4,1,0,5,0,5,8157
5,5,0,1,5,1,6,8157
6,6,0,0,5,1,6,8157
0,0,1,0,1,0,1,8158
1,1,1,0,2,0,2,8158
2,2,1,1,3,1,4,8158
3,3,2,1,5,2,7,8158
4,4,3,0,8,2,10,8158
5,5,1,1,9,3,12,8158
6,6,3,1,12,4,16,8158
7,7,2,0,14,4,18,8158
8,8,2,0,16,4,20,8158
9,9,5,0,21,4,25,8158
10,10,4,0,25,4,29,8158
11,11,3,2,28,6,34,8158
12,12,3,1,31,7,38,8158
13,13,1,3,32,10,42,8158
14,14,1,0,33,10,43,8158
15,15,2,0,35,10,45,8158
16,16,1,0,36,10,46,8158
17,17,0,0,36,10,46,8158
0,0,1,0,1,0,1,8159
1,1,1,0,2,0,2,8159
2,2,2,0,4,0,4,8159
3,3,1,1,5,1,6,8159
4,4,0,2,5,3,8,8159
5,5,0,1,5,4,9,8159
6,6,0,0,5,4,9,8159
0,0,1,0,1,0,1,8160
1,1,0,0,1,0,1,8160
0,0,1,0,1,0,1,8161
1,1,3,2,4,2,6,8161
2,2,3,1,7,3,10,8161
3,3,1,2,8,5,13,8161
4,4,2,5,10,10,20,8161
5,5,3,5,13,15,28,8161
6,6,4,3,17,18,35,8161
7,7,2,6,19,24,43,8161
8,8,0,4,19,28,47,8161
9,9,0,4,19,32,51,8161
10,10,0,5,19,37,56,8161
11,11,0,3,19,40,59,8161
12,12,0,4,19,44,63,8161
13,13,1,2,20,46,66,8161
14,14,1,2,21,48,69,8161
15,15,0,4,21,52,73,8161
16,16,1,1,22,53,75,8161
17,17,2,0,24,53,77,8161
18,18,1,0,25,53,78,8161
19,19,3,0,28,53,81,8161
20,20,2,1,30,54,84,8161
21,21,1,3,31,57,88,8161
22,22,2,3,33,60,93,8161
23,23,5,3,38,63,101,8161
24,24,5,2,43,65,108,8161
25,25,5,1,48,66,114,8161
26,26,4,0,52,66,118,8161
27,27,1,2,53,68,121,8161
28,28,0,0,53,68,121,8161
0,0,1,0,1,0,1,8162
1,1,0,0,1,0,1,8162
0,0,1,0,1,0,1,8163
1,1,0,1,1,1,2,8163
2,2,0,0,1,1,2,8163
0,0,1,0,1,0,1,8164
1,1,2,0,3,0,3,8164
2,2,2,1,5,1,6,8164
3,3,5,0,10,1,11,8164
4,4,5,1,15,2,17,8164
5,5,3,4,18,6,24,8164
6,6,2,2,20,8,28,8164
7,7,1,0,21,8,29,8164
8,8,0,0,21,8,29,8164
0,0,1,0,1,0,1,8165
1,1,0,0,1,0,1,8165
0,0,1,0,1,0,1,8166
1,1,3,1,4,1,5,8166
2,2,2,2,6,3,9,8166
3,3,1,5,7,8,15,8166
4,4,0,4,7,12,19,8166
5,5,1,1,8,13,21,8166
6,6,2,1,10,14,24,8166
7,7,1,4,11,18,29,8166
8,8,3,1,14,19,33,8166
9,9,4,1,18,20,38,8166
10,10,2,1,20,21,41,8166
11,11,0,0,20,21,41,8166
0,0,1,0,1,0,1,8167
1,1,1,0,2,0,2,8167
2,2,0,0,2,0,2,8167
0,0,1,0,1,0,1,8168
1,1,0,0,1,0,1,8168
0,0,1,0,1,0,1,8169
1,1,0,0,1,0,1,8169
0,0,1,0,1,0,1,8170
1,1,1,0,2,0,2,8170
2,2,0,0,2,0,2,8170
0,0,1,0,1,0,1,8171
1,1,0,0,1,0,1,8171
0,0,1,0,1,0,1,8172
1,1,2,1,3,1,4,8172
2,2,0,2,3,3,6,8172
3,3,0,2,3,5,8,8172
4,4,0,2,3,7,10,8172
5,5,1,1,4,8,12,8172
6,6,1,0,5,8,13,8172
7,7,0,0,5,8,13,8172
0,0,1,0,1,0,1,8173
1,1,1,0,2,0,2,8173
2,2,0,0,2,0,2,8173
0,0,1,0,1,0,1,8174
1,1,1,0,2,0,2,8174
2,2,0,0,2,0,2,8174
0,0,1,0,1,0,1,8175
1,1,0,0,1,0,1,8175
0,0,1,0,1,0,1,8176
1,1,0,0,1,0,1,8176
0,0,1,0,1,0,1,8177
1,1,0,0,1,0,1,8177
0,0,1,0,1,0,1,8178
1,1,0,0,1,0,1,8178
0,0,1,0,1,0,1,8179
1,1,1,1,2,1,3,8179
2,2,0,0,2,1,3,8179
0,0,1,0,1,0,1,8180
1,1,0,0,1,0,1,8180
0,0,1,0,1,0,1,8181
1,1,0,0,1,0,1,8181
0,0,1,0,1,0,1,8182
1,1,1,1,2,1,3,8182
2,2,0,0,2,1,3,8182
0,0,1,0,1,0,1,8183
1,1,1,0,2,0,2,8183
2,2,2,0,4,0,4,8183
3,3,2,0,6,0,6,8183
4,4,1,0,7,0,7,8183
5,5,0,0,7,0,7,8183
0,0,1,0,1,0,1,8184
1,1,0,0,1,0,1,8184
0,0,1,0,1,0,1,8185
1,1,1,0,2,0,2,8185
2,2,0,1,2,1,3,8185
3,3,0,0,2,1,3,8185
0,0,1,0,1,0,1,8186
1,1,2,0,3,0,3,8186
2,2,1,0,4,0,4,8186
3,3,0,0,4,0,4,8186
0,0,1,0,1,0,1,8187
1,1,1,0,2,0,2,8187
2,2,0,0,2,0,2,8187
0,0,1,0,1,0,1,8188
1,1,1,0,2,0,2,8188
2,2,1,0,3,0,3,8188
3,3,1,0,4,0,4,8188
4,4,0,0,4,0,4,8188
0,0,1,0,1,0,1,8189
1,1,3,1,4,1,5,8189
2,2,1,0,5,1,6,8189
3,3,0,0,5,1,6,8189
0,0,1,0,1,0,1,8190
1,1,0,0,1,0,1,8190
0,0,1,0,1,0,1,8191
1,1,0,0,1,0,1,8191
0,0,1,0,1,0,1,8192
1,1,0,1,1,1,2,8192
2,2,0,0,1,1,2,8192
0,0,1,0,1,0,1,8193
1,1,2,1,3,1,4,8193
2,2,1,1,4,2,6,8193
3,3,2,0,6,2,8,8193
4,4,0,0,6,2,8,8193
0,0,1,0,1,0,1,8194
1,1,1,1,2,1,3,8194
2,2,0,0,2,1,3,8194
0,0,1,0,1,0,1,8195
1,1,1,0,2,0,2,8195
2,2,2,1,4,1,5,8195
3,3,1,0,5,1,6,8195
4,4,2,0,7,1,8,8195
5,5,2,0,9,1,10,8195
6,6,0,1,9,2,11,8195
7,7,0,1,9,3,12,8195
8,8,0,0,9,3,12,8195
0,0,1,0,1,0,1,8196
1,1,1,0,2,0,2,8196
2,2,1,0,3,0,3,8196
3,3,0,0,3,0,3,8196
0,0,1,0,1,0,1,8197
1,1,1,0,2,0,2,8197
2,2,0,0,2,0,2,8197
0,0,1,0,1,0,1,8198
1,1,0,0,1,0,1,8198
0,0,1,0,1,0,1,8199
1,1,3,0,4,0,4,8199
2,2,4,0,8,0,8,8199
3,3,3,1,11,1,12,8199
4,4,0,1,11,2,13,8199
5,5,0,0,11,2,13,8199
0,0,1,0,1,0,1,8200
1,1,0,0,1,0,1,8200
0,0,1,0,1,0,1,8201
1,1,2,0,3,0,3,8201
2,2,0,1,3,1,4,8201
3,3,0,1,3,2,5,8201
4,4,0,0,3,2,5,8201
0,0,1,0,1,0,1,8202
1,1,0,1,1,1,2,8202
2,2,0,0,1,1,2,8202
0,0,1,0,1,0,1,8203
1,1,2,0,3,0,3,8203
2,2,0,0,3,0,3,8203
0,0,1,0,1,0,1,8204
1,1,1,0,2,0,2,8204
2,2,0,0,2,0,2,8204
0,0,1,0,1,0,1,8205
1,1,1,0,2,0,2,8205
2,2,1,1,3,1,4,8205
3,3,1,3,4,4,8,8205
4,4,2,0,6,4,10,8205
5,5,3,0,9,4,13,8205
6,6,2,0,11,4,15,8205
7,7,1,0,12,4,16,8205
8,8,2,0,14,4,18,8205
9,9,3,0,17,4,21,8205
10,10,2,0,19,4,23,8205
11,11,0,1,19,5,24,8205
12,12,0,0,19,5,24,8205
0,0,1,0,1,0,1,8206
1,1,1,0,2,0,2,8206
2,2,1,0,3,0,3,8206
3,3,3,0,6,0,6,8206
4,4,3,0,9,0,9,8206
5,5,2,0,11,0,11,8206
6,6,1,2,12,2,14,8206
7,7,1,3,13,5,18,8206
8,8,1,2,14,7,21,8206
9,9,3,2,17,9,26,8206
10,10,0,4,17,13,30,8206
11,11,0,3,17,16,33,8206
12,12,0,1,17,17,34,8206
13,13,0,1,17,18,35,8206
14,14,0,0,17,18,35,8206
0,0,1,0,1,0,1,8207
1,1,0,0,1,0,1,8207
0,0,1,0,1,0,1,8208
1,1,1,0,2,0,2,8208
2,2,0,0,2,0,2,8208
0,0,1,0,1,0,1,8209
1,1,0,1,1,1,2,8209
2,2,0,1,1,2,3,8209
3,3,0,1,1,3,4,8209
4,4,0,1,1,4,5,8209
5,5,0,0,1,4,5,8209
0,0,1,0,1,0,1,8210
1,1,1,0,2,0,2,8210
2,2,2,0,4,0,4,8210
3,3,1,0,5,0,5,8210
4,4,1,0,6,0,6,8210
5,5,2,0,8,0,8,8210
6,6,1,0,9,0,9,8210
7,7,1,1,10,1,11,8210
8,8,1,2,11,3,14,8210
9,9,0,2,11,5,16,8210
10,10,1,2,12,7,19,8210
11,11,1,0,13,7,20,8210
12,12,2,1,15,8,23,8210
13,13,1,1,16,9,25,8210
14,14,1,1,17,10,27,8210
15,15,0,0,17,10,27,8210
0,0,1,0,1,0,1,8211
1,1,1,0,2,0,2,8211
2,2,3,1,5,1,6,8211
3,3,2,0,7,1,8,8211
4,4,1,0,8,1,9,8211
5,5,1,1,9,2,11,8211
6,6,0,0,9,2,11,8211
0,0,1,0,1,0,1,8212
1,1,1,0,2,0,2,8212
2,2,0,1,2,1,3,8212
3,3,0,1,2,2,4,8212
4,4,0,0,2,2,4,8212
0,0,1,0,1,0,1,8213
1,1,0,0,1,0,1,8213
0,0,1,0,1,0,1,8214
1,1,1,1,2,1,3,8214
2,2,2,0,4,1,5,8214
3,3,1,0,5,1,6,8214
4,4,1,0,6,1,7,8214
5,5,1,0,7,1,8,8214
6,6,2,0,9,1,10,8214
7,7,2,0,11,1,12,8214
8,8,0,0,11,1,12,8214
0,0,1,0,1,0,1,8215
1,1,0,0,1,0,1,8215
0,0,1,0,1,0,1,8216
1,1,0,0,1,0,1,8216
0,0,1,0,1,0,1,8217
1,1,1,0,2,0,2,8217
2,2,0,0,2,0,2,8217
0,0,1,0,1,0,1,8218
1,1,0,0,1,0,1,8218
0,0,1,0,1,0,1,8219
1,1,0,1,1,1,2,8219
2,2,0,0,1,1,2,8219
0,0,1,0,1,0,1,8220
1,1,0,0,1,0,1,8220
0,0,1,0,1,0,1,8221
1,1,1,0,2,0,2,8221
2,2,0,0,2,0,2,8221
0,0,1,0,1,0,1,8222
1,1,0,0,1,0,1,8222
0,0,1,0,1,0,1,8223
1,1,1,0,2,0,2,8223
2,2,0,0,2,0,2,8223
0,0,1,0,1,0,1,8224
1,1,0,1,1,1,2,8224
2,2,0,0,1,1,2,8224
0,0,1,0,1,0,1,8225
1,1,0,1,1,1,2,8225
2,2,0,0,1,1,2,8225
0,0,1,0,1,0,1,8226
1,1,2,0,3,0,3,8226
2,2,0,0,3,0,3,8226
0,0,1,0,1,0,1,8227
1,1,2,0,3,0,3,8227
2,2,1,1,4,1,5,8227
3,3,4,0,8,1,9,8227
4,4,5,1,13,2,15,8227
5,5,9,0,22,2,24,8227
6,6,8,4,30,6,36,8227
7,7,5,3,35,9,44,8227
8,8,3,4,38,13,51,8227
9,9,4,7,42,20,62,8227
10,10,4,10,46,30,76,8227
11,11,3,9,49,39,88,8227
12,12,3,9,52,48,100,8227
13,13,4,5,56,53,109,8227
14,14,0,2,56,55,111,8227
15,15,0,1,56,56,112,8227
16,16,0,0,56,56,112,8227
0,0,1,0,1,0,1,8228
1,1,0,0,1,0,1,8228
0,0,1,0,1,0,1,8229
1,1,1,0,2,0,2,8229
2,2,0,0,2,0,2,8229
0,0,1,0,1,0,1,8230
1,1,2,0,3,0,3,8230
2,2,0,1,3,1,4,8230
3,3,1,1,4,2,6,8230
4,4,0,0,4,2,6,8230
0,0,1,0,1,0,1,8231
1,1,0,1,1,1,2,8231
2,2,0,0,1,1,2,8231
0,0,1,0,1,0,1,8232
1,1,0,0,1,0,1,8232
0,0,1,0,1,0,1,8233
1,1,1,0,2,0,2,8233
2,2,1,1,3,1,4,8233
3,3,2,0,5,1,6,8233
4,4,1,0,6,1,7,8233
5,5,1,0,7,1,8,8233
6,6,0,0,7,1,8,8233
0,0,1,0,1,0,1,8234
1,1,1,0,2,0,2,8234
2,2,1,0,3,0,3,8234
3,3,0,0,3,0,3,8234
0,0,1,0,1,0,1,8235
1,1,0,0,1,0,1,8235
0,0,1,0,1,0,1,8236
1,1,1,1,2,1,3,8236
2,2,1,1,3,2,5,8236
3,3,2,0,5,2,7,8236
4,4,0,0,5,2,7,8236
0,0,1,0,1,0,1,8237
1,1,1,0,2,0,2,8237
2,2,0,0,2,0,2,8237
0,0,1,0,1,0,1,8238
1,1,2,0,3,0,3,8238
2,2,1,1,4,1,5,8238
3,3,1,1,5,2,7,8238
4,4,1,2,6,4,10,8238
5,5,0,2,6,6,12,8238
6,6,0,2,6,8,14,8238
7,7,0,1,6,9,15,8238
8,8,0,0,6,9,15,8238
0,0,1,0,1,0,1,8239
1,1,1,0,2,0,2,8239
2,2,0,1,2,1,3,8239
3,3,0,1,2,2,4,8239
4,4,1,3,3,5,8,8239
5,5,1,3,4,8,12,8239
6,6,1,2,5,10,15,8239
7,7,0,2,5,12,17,8239
8,8,0,2,5,14,19,8239
9,9,1,0,6,14,20,8239
10,10,1,1,7,15,22,8239
11,11,0,0,7,15,22,8239
0,0,1,0,1,0,1,8240
1,1,0,0,1,0,1,8240
0,0,1,0,1,0,1,8241
1,1,0,1,1,1,2,8241
2,2,0,0,1,1,2,8241
0,0,1,0,1,0,1,8242
1,1,1,2,2,2,4,8242
2,2,0,3,2,5,7,8242
3,3,1,4,3,9,12,8242
4,4,0,4,3,13,16,8242
5,5,3,2,6,15,21,8242
6,6,1,1,7,16,23,8242
7,7,0,2,7,18,25,8242
8,8,1,3,8,21,29,8242
9,9,2,0,10,21,31,8242
10,10,3,0,13,21,34,8242
11,11,2,0,15,21,36,8242
12,12,1,1,16,22,38,8242
13,13,0,2,16,24,40,8242
14,14,0,1,16,25,41,8242
15,15,0,2,16,27,43,8242
16,16,0,1,16,28,44,8242
17,17,1,0,17,28,45,8242
18,18,1,0,18,28,46,8242
19,19,0,0,18,28,46,8242
0,0,1,0,1,0,1,8243
1,1,0,0,1,0,1,8243
0,0,1,0,1,0,1,8244
1,1,0,0,1,0,1,8244
0,0,1,0,1,0,1,8245
1,1,0,0,1,0,1,8245
0,0,1,0,1,0,1,8246
1,1,1,0,2,0,2,8246
2,2,0,0,2,0,2,8246
0,0,1,0,1,0,1,8247
1,1,0,0,1,0,1,8247
0,0,1,0,1,0,1,8248
1,1,2,0,3,0,3,8248
2,2,2,1,5,1,6,8248
3,3,1,0,6,1,7,8248
4,4,0,0,6,1,7,8248
0,0,1,0,1,0,1,8249
1,1,0,0,1,0,1,8249
0,0,1,0,1,0,1,8250
1,1,1,0,2,0,2,8250
2,2,1,1,3,1,4,8250
3,3,0,0,3,1,4,8250
0,0,1,0,1,0,1,8251
1,1,0,0,1,0,1,8251
0,0,1,0,1,0,1,8252
1,1,2,0,3,0,3,8252
2,2,1,1,4,1,5,8252
3,3,1,1,5,2,7,8252
4,4,0,0,5,2,7,8252
0,0,1,0,1,0,1,8253
1,1,1,0,2,0,2,8253
2,2,1,0,3,0,3,8253
3,3,1,0,4,0,4,8253
4,4,2,0,6,0,6,8253
5,5,2,0,8,0,8,8253
6,6,1,0,9,0,9,8253
7,7,3,0,12,0,12,8253
8,8,2,0,14,0,14,8253
9,9,0,0,14,0,14,8253
0,0,1,0,1,0,1,8254
1,1,1,0,2,0,2,8254
2,2,0,1,2,1,3,8254
3,3,1,2,3,3,6,8254
4,4,1,2,4,5,9,8254
5,5,2,1,6,6,12,8254
6,6,1,1,7,7,14,8254
7,7,0,2,7,9,16,8254
8,8,1,3,8,12,20,8254
9,9,1,1,9,13,22,8254
10,10,1,2,10,15,25,8254
11,11,0,2,10,17,27,8254
12,12,0,1,10,18,28,8254
13,13,1,1,11,19,30,8254
14,14,0,1,11,20,31,8254
15,15,0,0,11,20,31,8254
0,0,1,0,1,0,1,8255
1,1,1,1,2,1,3,8255
2,2,1,2,3,3,6,8255
3,3,0,0,3,3,6,8255
0,0,1,0,1,0,1,8256
1,1,1,0,2,0,2,8256
2,2,0,0,2,0,2,8256
0,0,1,0,1,0,1,8257
1,1,0,0,1,0,1,8257
0,0,1,0,1,0,1,8258
1,1,0,0,1,0,1,8258
0,0,1,0,1,0,1,8259
1,1,0,0,1,0,1,8259
0,0,1,0,1,0,1,8260
1,1,1,1,2,1,3,8260
2,2,1,1,3,2,5,8260
3,3,0,0,3,2,5,8260
0,0,1,0,1,0,1,8261
1,1,1,0,2,0,2,8261
2,2,1,0,3,0,3,8261
3,3,1,0,4,0,4,8261
4,4,1,0,5,0,5,8261
5,5,0,0,5,0,5,8261
0,0,1,0,1,0,1,8262
1,1,0,1,1,1,2,8262
2,2,0,1,1,2,3,8262
3,3,0,3,1,5,6,8262
4,4,0,2,1,7,8,8262
5,5,0,2,1,9,10,8262
6,6,0,0,1,9,10,8262
0,0,1,0,1,0,1,8263
1,1,0,0,1,0,1,8263
0,0,1,0,1,0,1,8264
1,1,1,1,2,1,3,8264
2,2,0,0,2,1,3,8264
0,0,1,0,1,0,1,8265
1,1,0,0,1,0,1,8265
0,0,1,0,1,0,1,8266
1,1,0,1,1,1,2,8266
2,2,0,0,1,1,2,8266
0,0,1,0,1,0,1,8267
1,1,0,0,1,0,1,8267
0,0,1,0,1,0,1,8268
1,1,1,0,2,0,2,8268
2,2,1,0,3,0,3,8268
3,3,1,0,4,0,4,8268
4,4,1,0,5,0,5,8268
5,5,0,0,5,0,5,8268
0,0,1,0,1,0,1,8269
1,1,0,0,1,0,1,8269
0,0,1,0,1,0,1,8270
1,1,2,0,3,0,3,8270
2,2,1,2,4,2,6,8270
3,3,0,3,4,5,9,8270
4,4,0,3,4,8,12,8270
5,5,0,2,4,10,14,8270
6,6,0,0,4,10,14,8270
0,0,1,0,1,0,1,8271
1,1,1,0,2,0,2,8271
2,2,1,1,3,1,4,8271
3,3,1,3,4,4,8,8271
4,4,1,1,5,5,10,8271
5,5,3,1,8,6,14,8271
6,6,5,2,13,8,21,8271
7,7,3,1,16,9,25,8271
8,8,1,1,17,10,27,8271
9,9,1,0,18,10,28,8271
10,10,0,0,18,10,28,8271
0,0,1,0,1,0,1,8272
1,1,1,0,2,0,2,8272
2,2,1,0,3,0,3,8272
3,3,1,0,4,0,4,8272
4,4,0,0,4,0,4,8272
0,0,1,0,1,0,1,8273
1,1,1,0,2,0,2,8273
2,2,1,0,3,0,3,8273
3,3,1,0,4,0,4,8273
4,4,2,0,6,0,6,8273
5,5,2,0,8,0,8,8273
6,6,2,0,10,0,10,8273
7,7,0,0,10,0,10,8273
0,0,1,0,1,0,1,8274
1,1,0,0,1,0,1,8274
0,0,1,0,1,0,1,8275
1,1,0,0,1,0,1,8275
0,0,1,0,1,0,1,8276
1,1,0,0,1,0,1,8276
0,0,1,0,1,0,1,8277
1,1,0,0,1,0,1,8277
0,0,1,0,1,0,1,8278
1,1,0,0,1,0,1,8278
0,0,1,0,1,0,1,8279
1,1,0,1,1,1,2,8279
2,2,0,0,1,1,2,8279
0,0,1,0,1,0,1,8280
1,1,0,2,1,2,3,8280
2,2,2,0,3,2,5,8280
3,3,0,1,3,3,6,8280
4,4,0,0,3,3,6,8280
0,0,1,0,1,0,1,8281
1,1,2,0,3,0,3,8281
2,2,0,0,3,0,3,8281
0,0,1,0,1,0,1,8282
1,1,1,0,2,0,2,8282
2,2,0,0,2,0,2,8282
0,0,1,0,1,0,1,8283
1,1,1,0,2,0,2,8283
2,2,0,0,2,0,2,8283
0,0,1,0,1,0,1,8284
1,1,0,0,1,0,1,8284
0,0,1,0,1,0,1,8285
1,1,1,0,2,0,2,8285
2,2,0,0,2,0,2,8285
0,0,1,0,1,0,1,8286
1,1,1,0,2,0,2,8286
2,2,1,0,3,0,3,8286
3,3,1,0,4,0,4,8286
4,4,0,1,4,1,5,8286
5,5,0,1,4,2,6,8286
6,6,0,0,4,2,6,8286
0,0,1,0,1,0,1,8287
1,1,1,0,2,0,2,8287
2,2,1,0,3,0,3,8287
3,3,0,0,3,0,3,8287
0,0,1,0,1,0,1,8288
1,1,3,0,4,0,4,8288
2,2,3,1,7,1,8,8288
3,3,2,0,9,1,10,8288
4,4,0,0,9,1,10,8288
0,0,1,0,1,0,1,8289
1,1,2,0,3,0,3,8289
2,2,0,0,3,0,3,8289
0,0,1,0,1,0,1,8290
1,1,0,0,1,0,1,8290
0,0,1,0,1,0,1,8291
1,1,2,1,3,1,4,8291
2,2,2,1,5,2,7,8291
3,3,3,0,8,2,10,8291
4,4,1,0,9,2,11,8291
5,5,2,0,11,2,13,8291
6,6,3,0,14,2,16,8291
7,7,3,0,17,2,19,8291
8,8,4,0,21,2,23,8291
9,9,1,1,22,3,25,8291
10,10,0,1,22,4,26,8291
11,11,1,1,23,5,28,8291
12,12,1,2,24,7,31,8291
13,13,1,4,25,11,36,8291
14,14,2,2,27,13,40,8291
15,15,1,2,28,15,43,8291
16,16,1,1,29,16,45,8291
17,17,0,0,29,16,45,8291
0,0,1,0,1,0,1,8292
1,1,0,0,1,0,1,8292
0,0,1,0,1,0,1,8293
1,1,2,0,3,0,3,8293
2,2,1,1,4,1,5,8293
3,3,1,3,5,4,9,8293
4,4,2,1,7,5,12,8293
5,5,1,2,8,7,15,8293
6,6,1,0,9,7,16,8293
7,7,0,0,9,7,16,8293
0,0,1,0,1,0,1,8294
1,1,0,1,1,1,2,8294
2,2,0,0,1,1,2,8294
0,0,1,0,1,0,1,8295
1,1,1,1,2,1,3,8295
2,2,0,0,2,1,3,8295
0,0,1,0,1,0,1,8296
1,1,1,0,2,0,2,8296
2,2,2,1,4,1,5,8296
3,3,1,1,5,2,7,8296
4,4,2,2,7,4,11,8296
5,5,1,0,8,4,12,8296
6,6,0,0,8,4,12,8296
0,0,1,0,1,0,1,8297
1,1,2,1,3,1,4,8297
2,2,2,3,5,4,9,8297
3,3,2,5,7,9,16,8297
4,4,4,5,11,14,25,8297
5,5,4,4,15,18,33,8297
6,6,1,0,16,18,34,8297
7,7,1,0,17,18,35,8297
8,8,1,0,18,18,36,8297
9,9,2,0,20,18,38,8297
10,10,1,0,21,18,39,8297
11,11,0,0,21,18,39,8297
0,0,1,0,1,0,1,8298
1,1,0,0,1,0,1,8298
0,0,1,0,1,0,1,8299
1,1,2,0,3,0,3,8299
2,2,2,0,5,0,5,8299
3,3,2,1,7,1,8,8299
4,4,1,0,8,1,9,8299
5,5,1,0,9,1,10,8299
6,6,0,0,9,1,10,8299
0,0,1,0,1,0,1,8300
1,1,0,0,1,0,1,8300
0,0,1,0,1,0,1,8301
1,1,1,1,2,1,3,8301
2,2,0,1,2,2,4,8301
3,3,0,1,2,3,5,8301
4,4,0,0,2,3,5,8301
0,0,1,0,1,0,1,8302
1,1,1,1,2,1,3,8302
2,2,1,0,3,1,4,8302
3,3,0,2,3,3,6,8302
4,4,0,0,3,3,6,8302
0,0,1,0,1,0,1,8303
1,1,2,0,3,0,3,8303
2,2,2,1,5,1,6,8303
3,3,0,0,5,1,6,8303
0,0,1,0,1,0,1,8304
1,1,1,0,2,0,2,8304
2,2,1,0,3,0,3,8304
3,3,1,0,4,0,4,8304
4,4,3,0,7,0,7,8304
5,5,0,0,7,0,7,8304
0,0,1,0,1,0,1,8305
1,1,1,2,2,2,4,8305
2,2,3,3,5,5,10,8305
3,3,3,2,8,7,15,8305
4,4,3,0,11,7,18,8305
5,5,6,1,17,8,25,8305
6,6,2,1,19,9,28,8305
7,7,0,1,19,10,29,8305
8,8,0,0,19,10,29,8305
0,0,1,0,1,0,1,8306
1,1,2,0,3,0,3,8306
2,2,2,1,5,1,6,8306
3,3,3,1,8,2,10,8306
4,4,1,1,9,3,12,8306
5,5,4,0,13,3,16,8306
6,6,5,0,18,3,21,8306
7,7,1,0,19,3,22,8306
8,8,3,0,22,3,25,8306
9,9,2,1,24,4,28,8306
10,10,4,1,28,5,33,8306
11,11,3,1,31,6,37,8306
12,12,3,0,34,6,40,8306
13,13,1,0,35,6,41,8306
14,14,2,0,37,6,43,8306
15,15,2,0,39,6,45,8306
16,16,2,0,41,6,47,8306
17,17,0,0,41,6,47,8306
0,0,1,0,1,0,1,8307
1,1,0,1,1,1,2,8307
2,2,1,1,2,2,4,8307
3,3,0,2,2,4,6,8307
4,4,1,1,3,5,8,8307
5,5,1,1,4,6,10,8307
6,6,1,2,5,8,13,8307
7,7,2,2,7,10,17,8307
8,8,4,0,11,10,21,8307
9,9,5,0,16,10,26,8307
10,10,3,0,19,10,29,8307
11,11,4,0,23,10,33,8307
12,12,5,0,28,10,38,8307
13,13,3,1,31,11,42,8307
14,14,4,0,35,11,46,8307
15,15,2,2,37,13,50,8307
16,16,2,1,39,14,53,8307
17,17,1,1,40,15,55,8307
18,18,1,2,41,17,58,8307
19,19,2,3,43,20,63,8307
20,20,2,8,45,28,73,8307
21,21,5,4,50,32,82,8307
22,22,6,6,56,38,94,8307
23,23,8,6,64,44,108,8307
24,24,5,8,69,52,121,8307
25,25,2,3,71,55,126,8307
26,26,8,2,79,57,136,8307
27,27,4,9,83,66,149,8307
28,28,5,4,88,70,158,8307
29,29,4,4,92,74,166,8307
30,30,3,4,95,78,173,8307
31,31,7,4,102,82,184,8307
32,32,6,8,108,90,198,8307
33,33,4,7,112,97,209,8307
34,34,5,3,117,100,217,8307
35,35,4,4,121,104,225,8307
36,36,7,2,128,106,234,8307
37,37,4,6,132,112,244,8307
38,38,4,4,136,116,252,8307
39,39,2,2,138,118,256,8307
40,40,3,1,141,119,260,8307
41,41,0,2,141,121,262,8307
42,42,0,1,141,122,263,8307
43,43,1,0,142,122,264,8307
44,44,0,0,142,122,264,8307
0,0,1,0,1,0,1,8308
1,1,1,2,2,2,4,8308
2,2,3,2,5,4,9,8308
3,3,4,2,9,6,15,8308
4,4,7,2,16,8,24,8308
5,5,5,2,21,10,31,8308
6,6,5,3,26,13,39,8308
7,7,7,4,33,17,50,8308
8,8,5,5,38,22,60,8308
9,9,3,8,41,30,71,8308
10,10,6,8,47,38,85,8308
11,11,3,10,50,48,98,8308
12,12,3,4,53,52,105,8308
13,13,4,4,57,56,113,8308
14,14,11,1,68,57,125,8308
15,15,9,6,77,63,140,8308
16,16,9,10,86,73,159,8308
17,17,9,7,95,80,175,8308
18,18,10,7,105,87,192,8308
19,19,5,10,110,97,207,8308
20,20,6,6,116,103,219,8308
21,21,6,6,122,109,231,8308
22,22,3,7,125,116,241,8308
23,23,5,6,130,122,252,8308
24,24,1,9,131,131,262,8308
25,25,1,8,132,139,271,8308
26,26,2,7,134,146,280,8308
27,27,3,9,137,155,292,8308
28,28,3,6,140,161,301,8308
29,29,4,6,144,167,311,8308
30,30,3,3,147,170,317,8308
31,31,3,1,150,171,321,8308
32,32,0,1,150,172,322,8308
33,33,0,3,150,175,325,8308
34,34,0,2,150,177,327,8308
35,35,0,2,150,179,329,8308
36,36,1,2,151,181,332,8308
37,37,0,1,151,182,333,8308
38,38,0,0,151,182,333,8308
0,0,1,0,1,0,1,8309
1,1,0,0,1,0,1,8309
0,0,1,0,1,0,1,8310
1,1,0,0,1,0,1,8310
0,0,1,0,1,0,1,8311
1,1,0,0,1,0,1,8311
0,0,1,0,1,0,1,8312
1,1,0,1,1,1,2,8312
2,2,0,0,1,1,2,8312
0,0,1,0,1,0,1,8313
1,1,0,0,1,0,1,8313
0,0,1,0,1,0,1,8314
1,1,0,0,1,0,1,8314
0,0,1,0,1,0,1,8315
1,1,0,0,1,0,1,8315
0,0,1,0,1,0,1,8316
1,1,1,0,2,0,2,8316
2,2,1,0,3,0,3,8316
3,3,0,0,3,0,3,8316
0,0,1,0,1,0,1,8317
1,1,1,0,2,0,2,8317
2,2,1,0,3,0,3,8317
3,3,0,0,3,0,3,8317
0,0,1,0,1,0,1,8318
1,1,1,0,2,0,2,8318
2,2,0,0,2,0,2,8318
0,0,1,0,1,0,1,8319
1,1,4,0,5,0,5,8319
2,2,1,1,6,1,7,8319
3,3,0,2,6,3,9,8319
4,4,1,2,7,5,12,8319
5,5,1,1,8,6,14,8319
6,6,0,1,8,7,15,8319
7,7,1,0,9,7,16,8319
8,8,3,1,12,8,20,8319
9,9,2,1,14,9,23,8319
10,10,1,0,15,9,24,8319
11,11,2,0,17,9,26,8319
12,12,0,0,17,9,26,8319
0,0,1,0,1,0,1,8320
1,1,1,0,2,0,2,8320
2,2,2,0,4,0,4,8320
3,3,0,1,4,1,5,8320
4,4,0,0,4,1,5,8320
0,0,1,0,1,0,1,8321
1,1,1,0,2,0,2,8321
2,2,3,0,5,0,5,8321
3,3,2,1,7,1,8,8321
4,4,2,1,9,2,11,8321
5,5,0,1,9,3,12,8321
6,6,0,0,9,3,12,8321
0,0,1,0,1,0,1,8322
1,1,1,1,2,1,3,8322
2,2,2,0,4,1,5,8322
3,3,2,0,6,1,7,8322
4,4,1,0,7,1,8,8322
5,5,1,0,8,1,9,8322
6,6,1,0,9,1,10,8322
7,7,1,0,10,1,11,8322
8,8,2,0,12,1,13,8322
9,9,1,0,13,1,14,8322
10,10,1,1,14,2,16,8322
11,11,0,0,14,2,16,8322
0,0,1,0,1,0,1,8323
1,1,0,0,1,0,1,8323
0,0,1,0,1,0,1,8324
1,1,0,1,1,1,2,8324
2,2,0,0,1,1,2,8324
0,0,1,0,1,0,1,8325
1,1,0,0,1,0,1,8325
0,0,1,0,1,0,1,8326
1,1,1,0,2,0,2,8326
2,2,0,0,2,0,2,8326
0,0,1,0,1,0,1,8327
1,1,0,0,1,0,1,8327
0,0,1,0,1,0,1,8328
1,1,1,0,2,0,2,8328
2,2,0,1,2,1,3,8328
3,3,0,1,2,2,4,8328
4,4,1,0,3,2,5,8328
5,5,0,0,3,2,5,8328
0,0,1,0,1,0,1,8329
1,1,1,0,2,0,2,8329
2,2,1,0,3,0,3,8329
3,3,0,0,3,0,3,8329
0,0,1,0,1,0,1,8330
1,1,1,0,2,0,2,8330
2,2,1,0,3,0,3,8330
3,3,1,0,4,0,4,8330
4,4,1,0,5,0,5,8330
5,5,3,0,8,0,8,8330
6,6,0,1,8,1,9,8330
7,7,0,0,8,1,9,8330
0,0,1,0,1,0,1,8331
1,1,1,1,2,1,3,8331
2,2,1,0,3,1,4,8331
3,3,1,0,4,1,5,8331
4,4,0,0,4,1,5,8331
0,0,1,0,1,0,1,8332
1,1,0,0,1,0,1,8332
0,0,1,0,1,0,1,8333
1,1,0,0,1,0,1,8333
0,0,1,0,1,0,1,8334
1,1,1,0,2,0,2,8334
2,2,1,0,3,0,3,8334
3,3,4,0,7,0,7,8334
4,4,3,0,10,0,10,8334
5,5,3,0,13,0,13,8334
6,6,3,1,16,1,17,8334
7,7,3,3,19,4,23,8334
8,8,5,4,24,8,32,8334
9,9,3,8,27,16,43,8334
10,10,3,11,30,27,57,8334
11,11,4,7,34,34,68,8334
12,12,5,3,39,37,76,8334
13,13,4,3,43,40,83,8334
14,14,2,0,45,40,85,8334
15,15,1,1,46,41,87,8334
16,16,1,0,47,41,88,8334
17,17,0,0,47,41,88,8334
0,0,1,0,1,0,1,8335
1,1,1,0,2,0,2,8335
2,2,1,0,3,0,3,8335
3,3,0,1,3,1,4,8335
4,4,0,1,3,2,5,8335
5,5,0,1,3,3,6,8335
6,6,0,1,3,4,7,8335
7,7,0,3,3,7,10,8335
8,8,1,1,4,8,12,8335
9,9,1,1,5,9,14,8335
10,10,0,0,5,9,14,8335
0,0,1,0,1,0,1,8336
1,1,0,0,1,0,1,8336
0,0,1,0,1,0,1,8337
1,1,0,0,1,0,1,8337
0,0,1,0,1,0,1,8338
1,1,0,0,1,0,1,8338
0,0,1,0,1,0,1,8339
1,1,1,0,2,0,2,8339
2,2,2,0,4,0,4,8339
3,3,2,0,6,0,6,8339
4,4,1,0,7,0,7,8339
5,5,4,0,11,0,11,8339
6,6,1,0,12,0,12,8339
7,7,1,2,13,2,15,8339
8,8,2,2,15,4,19,8339
9,9,3,4,18,8,26,8339
10,10,4,4,22,12,34,8339
11,11,1,4,23,16,39,8339
12,12,3,5,26,21,47,8339
13,13,3,2,29,23,52,8339
14,14,5,0,34,23,57,8339
15,15,0,1,34,24,58,8339
16,16,0,2,34,26,60,8339
17,17,1,1,35,27,62,8339
18,18,1,1,36,28,64,8339
19,19,2,1,38,29,67,8339
20,20,0,2,38,31,69,8339
21,21,0,2,38,33,71,8339
22,22,0,1,38,34,72,8339
23,23,0,1,38,35,73,8339
24,24,0,0,38,35,73,8339
0,0,1,0,1,0,1,8340
1,1,1,0,2,0,2,8340
2,2,1,0,3,0,3,8340
3,3,3,0,6,0,6,8340
4,4,5,0,11,0,11,8340
5,5,0,0,11,0,11,8340
0,0,1,0,1,0,1,8341
1,1,0,0,1,0,1,8341
0,0,1,0,1,0,1,8342
1,1,1,0,2,0,2,8342
2,2,1,0,3,0,3,8342
3,3,0,0,3,0,3,8342
0,0,1,0,1,0,1,8343
1,1,2,0,3,0,3,8343
2,2,2,0,5,0,5,8343
3,3,1,1,6,1,7,8343
4,4,1,1,7,2,9,8343
5,5,1,1,8,3,11,8343
6,6,0,2,8,5,13,8343
7,7,1,3,9,8,17,8343
8,8,1,3,10,11,21,8343
9,9,1,2,11,13,24,8343
10,10,1,1,12,14,26,8343
11,11,0,0,12,14,26,8343
0,0,1,0,1,0,1,8344
1,1,1,0,2,0,2,8344
2,2,3,0,5,0,5,8344
3,3,1,1,6,1,7,8344
4,4,1,1,7,2,9,8344
5,5,0,3,7,5,12,8344
6,6,0,1,7,6,13,8344
7,7,1,2,8,8,16,8344
8,8,0,1,8,9,17,8344
9,9,0,0,8,9,17,8344
0,0,1,0,1,0,1,8345
1,1,0,0,1,0,1,8345
0,0,1,0,1,0,1,8346
1,1,1,0,2,0,2,8346
2,2,0,0,2,0,2,8346
0,0,1,0,1,0,1,8347
1,1,0,0,1,0,1,8347
0,0,1,0,1,0,1,8348
1,1,0,0,1,0,1,8348
0,0,1,0,1,0,1,8349
1,1,0,1,1,1,2,8349
2,2,0,1,1,2,3,8349
3,3,0,0,1,2,3,8349
0,0,1,0,1,0,1,8350
1,1,1,0,2,0,2,8350
2,2,1,1,3,1,4,8350
3,3,1,1,4,2,6,8350
4,4,1,0,5,2,7,8350
5,5,1,0,6,2,8,8350
6,6,1,0,7,2,9,8350
7,7,1,0,8,2,10,8350
8,8,1,0,9,2,11,8350
9,9,0,0,9,2,11,8350
0,0,1,0,1,0,1,8351
1,1,1,0,2,0,2,8351
2,2,1,0,3,0,3,8351
3,3,1,0,4,0,4,8351
4,4,0,0,4,0,4,8351
0,0,1,0,1,0,1,8352
1,1,1,0,2,0,2,8352
2,2,1,0,3,0,3,8352
3,3,0,0,3,0,3,8352
0,0,1,0,1,0,1,8353
1,1,0,1,1,1,2,8353
2,2,0,2,1,3,4,8353
3,3,1,0,2,3,5,8353
4,4,1,0,3,3,6,8353
5,5,1,0,4,3,7,8353
6,6,2,0,6,3,9,8353
7,7,1,0,7,3,10,8353
8,8,0,0,7,3,10,8353
0,0,1,0,1,0,1,8354
1,1,0,0,1,0,1,8354
0,0,1,0,1,0,1,8355
1,1,3,0,4,0,4,8355
2,2,4,0,8,0,8,8355
3,3,2,0,10,0,10,8355
4,4,0,1,10,1,11,8355
5,5,0,0,10,1,11,8355
0,0,1,0,1,0,1,8356
1,1,0,0,1,0,1,8356
0,0,1,0,1,0,1,8357
1,1,0,0,1,0,1,8357
0,0,1,0,1,0,1,8358
1,1,1,0,2,0,2,8358
2,2,0,0,2,0,2,8358
0,0,1,0,1,0,1,8359
1,1,0,0,1,0,1,8359
0,0,1,0,1,0,1,8360
1,1,0,0,1,0,1,8360
0,0,1,0,1,0,1,8361
1,1,1,0,2,0,2,8361
2,2,1,0,3,0,3,8361
3,3,1,0,4,0,4,8361
4,4,0,1,4,1,5,8361
5,5,0,1,4,2,6,8361
6,6,0,0,4,2,6,8361
0,0,1,0,1,0,1,8362
1,1,0,0,1,0,1,8362
0,0,1,0,1,0,1,8363
1,1,1,0,2,0,2,8363
2,2,0,0,2,0,2,8363
0,0,1,0,1,0,1,8364
1,1,1,0,2,0,2,8364
2,2,2,2,4,2,6,8364
3,3,2,2,6,4,10,8364
4,4,3,3,9,7,16,8364
5,5,4,5,13,12,25,8364
6,6,2,8,15,20,35,8364
7,7,2,2,17,22,39,8364
8,8,3,1,20,23,43,8364
9,9,3,1,23,24,47,8364
10,10,5,2,28,26,54,8364
11,11,4,3,32,29,61,8364
12,12,1,5,33,34,67,8364
13,13,1,2,34,36,70,8364
14,14,1,1,35,37,72,8364
15,15,1,2,36,39,75,8364
16,16,0,1,36,40,76,8364
17,17,0,1,36,41,77,8364
18,18,1,1,37,42,79,8364
19,19,3,0,40,42,82,8364
20,20,2,1,42,43,85,8364
21,21,1,1,43,44,87,8364
22,22,1,0,44,44,88,8364
23,23,0,0,44,44,88,8364
0,0,1,0,1,0,1,8365
1,1,2,0,3,0,3,8365
2,2,1,0,4,0,4,8365
3,3,0,0,4,0,4,8365
0,0,1,0,1,0,1,8366
1,1,0,0,1,0,1,8366
0,0,1,0,1,0,1,8367
1,1,1,0,2,0,2,8367
2,2,1,0,3,0,3,8367
3,3,0,0,3,0,3,8367
0,0,1,0,1,0,1,8368
1,1,1,0,2,0,2,8368
2,2,2,0,4,0,4,8368
3,3,1,0,5,0,5,8368
4,4,0,0,5,0,5,8368
0,0,1,0,1,0,1,8369
1,1,0,0,1,0,1,8369
0,0,1,0,1,0,1,8370
1,1,2,0,3,0,3,8370
2,2,2,0,5,0,5,8370
3,3,0,0,5,0,5,8370
0,0,1,0,1,0,1,8371
1,1,0,0,1,0,1,8371
0,0,1,0,1,0,1,8372
1,1,0,0,1,0,1,8372
0,0,1,0,1,0,1,8373
1,1,1,0,2,0,2,8373
2,2,0,0,2,0,2,8373
0,0,1,0,1,0,1,8374
1,1,0,0,1,0,1,8374
0,0,1,0,1,0,1,8375
1,1,0,0,1,0,1,8375
0,0,1,0,1,0,1,8376
1,1,0,0,1,0,1,8376
0,0,1,0,1,0,1,8377
1,1,1,0,2,0,2,8377
2,2,0,0,2,0,2,8377
0,0,1,0,1,0,1,8378
1,1,1,0,2,0,2,8378
2,2,0,0,2,0,2,8378
0,0,1,0,1,0,1,8379
1,1,0,0,1,0,1,8379
0,0,1,0,1,0,1,8380
1,1,1,1,2,1,3,8380
2,2,1,0,3,1,4,8380
3,3,0,0,3,1,4,8380
0,0,1,0,1,0,1,8381
1,1,0,0,1,0,1,8381
0,0,1,0,1,0,1,8382
1,1,0,0,1,0,1,8382
0,0,1,0,1,0,1,8383
1,1,2,0,3,0,3,8383
2,2,3,0,6,0,6,8383
3,3,1,1,7,1,8,8383
4,4,1,4,8,5,13,8383
5,5,0,4,8,9,17,8383
6,6,2,2,10,11,21,8383
7,7,3,2,13,13,26,8383
8,8,2,1,15,14,29,8383
9,9,0,1,15,15,30,8383
10,10,0,0,15,15,30,8383
0,0,1,0,1,0,1,8384
1,1,0,0,1,0,1,8384
0,0,1,0,1,0,1,8385
1,1,0,0,1,0,1,8385
0,0,1,0,1,0,1,8386
1,1,1,0,2,0,2,8386
2,2,1,0,3,0,3,8386
3,3,2,0,5,0,5,8386
4,4,2,1,7,1,8,8386
5,5,1,1,8,2,10,8386
6,6,1,2,9,4,13,8386
7,7,3,1,12,5,17,8386
8,8,0,1,12,6,18,8386
9,9,0,3,12,9,21,8386
10,10,0,2,12,11,23,8386
11,11,1,2,13,13,26,8386
12,12,3,1,16,14,30,8386
13,13,4,4,20,18,38,8386
14,14,5,0,25,18,43,8386
15,15,8,0,33,18,51,8386
16,16,7,1,40,19,59,8386
17,17,9,1,49,20,69,8386
18,18,11,1,60,21,81,8386
19,19,7,4,67,25,92,8386
20,20,3,3,70,28,98,8386
21,21,2,5,72,33,105,8386
22,22,3,3,75,36,111,8386
23,23,2,2,77,38,115,8386
24,24,2,6,79,44,123,8386
25,25,3,2,82,46,128,8386
26,26,4,2,86,48,134,8386
27,27,1,1,87,49,136,8386
28,28,0,2,87,51,138,8386
29,29,0,0,87,51,138,8386
0,0,1,0,1,0,1,8387
1,1,0,0,1,0,1,8387
0,0,1,0,1,0,1,8388
1,1,1,0,2,0,2,8388
2,2,2,0,4,0,4,8388
3,3,1,0,5,0,5,8388
4,4,0,0,5,0,5,8388
0,0,1,0,1,0,1,8389
1,1,0,0,1,0,1,8389
0,0,1,0,1,0,1,8390
1,1,0,0,1,0,1,8390
0,0,1,0,1,0,1,8391
1,1,0,0,1,0,1,8391
0,0,1,0,1,0,1,8392
1,1,0,0,1,0,1,8392
0,0,1,0,1,0,1,8393
1,1,0,1,1,1,2,8393
2,2,0,0,1,1,2,8393
0,0,1,0,1,0,1,8394
1,1,0,0,1,0,1,8394
0,0,1,0,1,0,1,8395
1,1,0,0,1,0,1,8395
0,0,1,0,1,0,1,8396
1,1,0,0,1,0,1,8396
0,0,1,0,1,0,1,8397
1,1,0,0,1,0,1,8397
0,0,1,0,1,0,1,8398
1,1,1,1,2,1,3,8398
2,2,0,0,2,1,3,8398
0,0,1,0,1,0,1,8399
1,1,1,0,2,0,2,8399
2,2,0,0,2,0,2,8399
0,0,1,0,1,0,1,8400
1,1,0,0,1,0,1,8400
0,0,1,0,1,0,1,8401
1,1,1,0,2,0,2,8401
2,2,0,0,2,0,2,8401
0,0,1,0,1,0,1,8402
1,1,0,0,1,0,1,8402
0,0,1,0,1,0,1,8403
1,1,1,0,2,0,2,8403
2,2,1,1,3,1,4,8403
3,3,1,1,4,2,6,8403
4,4,3,0,7,2,9,8403
5,5,1,1,8,3,11,8403
6,6,2,0,10,3,13,8403
7,7,4,0,14,3,17,8403
8,8,2,0,16,3,19,8403
9,9,2,2,18,5,23,8403
10,10,1,2,19,7,26,8403
11,11,2,3,21,10,31,8403
12,12,3,1,24,11,35,8403
13,13,2,4,26,15,41,8403
14,14,2,2,28,17,45,8403
15,15,1,4,29,21,50,8403
16,16,3,5,32,26,58,8403
17,17,1,5,33,31,64,8403
18,18,1,6,34,37,71,8403
19,19,1,6,35,43,78,8403
20,20,0,5,35,48,83,8403
21,21,3,2,38,50,88,8403
22,22,0,1,38,51,89,8403
23,23,0,1,38,52,90,8403
24,24,0,1,38,53,91,8403
25,25,0,3,38,56,94,8403
26,26,0,3,38,59,97,8403
27,27,1,2,39,61,100,8403
28,28,1,1,40,62,102,8403
29,29,1,2,41,64,105,8403
30,30,0,1,41,65,106,8403
31,31,0,0,41,65,106,8403
0,0,1,0,1,0,1,8404
1,1,0,0,1,0,1,8404
0,0,1,0,1,0,1,8405
1,1,1,0,2,0,2,8405
2,2,0,0,2,0,2,8405
0,0,1,0,1,0,1,8406
1,1,2,0,3,0,3,8406
2,2,3,0,6,0,6,8406
3,3,3,0,9,0,9,8406
4,4,3,0,12,0,12,8406
5,5,2,1,14,1,15,8406
6,6,2,1,16,2,18,8406
7,7,1,1,17,3,20,8406
8,8,0,1,17,4,21,8406
9,9,0,1,17,5,22,8406
10,10,0,2,17,7,24,8406
11,11,0,3,17,10,27,8406
12,12,1,1,18,11,29,8406
13,13,1,1,19,12,31,8406
14,14,2,0,21,12,33,8406
15,15,1,1,22,13,35,8406
16,16,0,1,22,14,36,8406
17,17,0,0,22,14,36,8406
0,0,1,0,1,0,1,8407
1,1,1,0,2,0,2,8407
2,2,1,0,3,0,3,8407
3,3,1,0,4,0,4,8407
4,4,0,0,4,0,4,8407
0,0,1,0,1,0,1,8408
1,1,0,0,1,0,1,8408
0,0,1,0,1,0,1,8409
1,1,0,0,1,0,1,8409
0,0,1,0,1,0,1,8410
1,1,1,0,2,0,2,8410
2,2,0,0,2,0,2,8410
0,0,1,0,1,0,1,8411
1,1,0,0,1,0,1,8411
0,0,1,0,1,0,1,8412
1,1,2,0,3,0,3,8412
2,2,2,0,5,0,5,8412
3,3,1,1,6,1,7,8412
4,4,0,1,6,2,8,8412
5,5,0,2,6,4,10,8412
6,6,0,0,6,4,10,8412
0,0,1,0,1,0,1,8413
1,1,3,0,4,0,4,8413
2,2,3,0,7,0,7,8413
3,3,2,0,9,0,9,8413
4,4,1,0,10,0,10,8413
5,5,1,0,11,0,11,8413
6,6,0,0,11,0,11,8413
0,0,1,0,1,0,1,8414
1,1,0,1,1,1,2,8414
2,2,0,2,1,3,4,8414
3,3,1,0,2,3,5,8414
4,4,2,0,4,3,7,8414
5,5,2,1,6,4,10,8414
6,6,3,1,9,5,14,8414
7,7,2,0,11,5,16,8414
8,8,2,0,13,5,18,8414
9,9,1,0,14,5,19,8414
10,10,0,0,14,5,19,8414
0,0,1,0,1,0,1,8415
1,1,2,0,3,0,3,8415
2,2,0,0,3,0,3,8415
0,0,1,0,1,0,1,8416
1,1,1,0,2,0,2,8416
2,2,0,0,2,0,2,8416
0,0,1,0,1,0,1,8417
1,1,1,0,2,0,2,8417
2,2,0,0,2,0,2,8417
0,0,1,0,1,0,1,8418
1,1,1,0,2,0,2,8418
2,2,1,1,3,1,4,8418
3,3,0,0,3,1,4,8418
0,0,1,0,1,0,1,8419
1,1,0,0,1,0,1,8419
0,0,1,0,1,0,1,8420
1,1,0,0,1,0,1,8420
0,0,1,0,1,0,1,8421
1,1,0,0,1,0,1,8421
0,0,1,0,1,0,1,8422
1,1,1,0,2,0,2,8422
2,2,0,0,2,0,2,8422
0,0,1,0,1,0,1,8423
1,1,2,0,3,0,3,8423
2,2,1,1,4,1,5,8423
3,3,0,1,4,2,6,8423
4,4,0,0,4,2,6,8423
0,0,1,0,1,0,1,8424
1,1,1,0,2,0,2,8424
2,2,1,0,3,0,3,8424
3,3,1,0,4,0,4,8424
4,4,0,0,4,0,4,8424
0,0,1,0,1,0,1,8425
1,1,5,0,6,0,6,8425
2,2,4,0,10,0,10,8425
3,3,7,1,17,1,18,8425
4,4,4,5,21,6,27,8425
5,5,5,5,26,11,37,8425
6,6,6,0,32,11,43,8425
7,7,4,1,36,12,48,8425
8,8,5,0,41,12,53,8425
9,9,6,3,47,15,62,8425
10,10,6,7,53,22,75,8425
11,11,8,4,61,26,87,8425
12,12,8,4,69,30,99,8425
13,13,7,7,76,37,113,8425
14,14,6,6,82,43,125,8425
15,15,4,6,86,49,135,8425
16,16,3,0,89,49,138,8425
17,17,6,0,95,49,144,8425
18,18,5,1,100,50,150,8425
19,19,2,1,102,51,153,8425
20,20,2,2,104,53,157,8425
21,21,0,0,104,53,157,8425
0,0,1,0,1,0,1,8426
1,1,2,0,3,0,3,8426
2,2,1,1,4,1,5,8426
3,3,1,3,5,4,9,8426
4,4,1,1,6,5,11,8426
5,5,1,1,7,6,13,8426
6,6,1,1,8,7,15,8426
7,7,0,2,8,9,17,8426
8,8,1,0,9,9,18,8426
9,9,3,0,12,9,21,8426
10,10,1,0,13,9,22,8426
11,11,0,1,13,10,23,8426
12,12,0,1,13,11,24,8426
13,13,0,0,13,11,24,8426
0,0,1,0,1,0,1,8427
1,1,2,0,3,0,3,8427
2,2,2,0,5,0,5,8427
3,3,1,1,6,1,7,8427
4,4,3,2,9,3,12,8427
5,5,2,1,11,4,15,8427
6,6,0,0,11,4,15,8427
0,0,1,0,1,0,1,8428
1,1,0,0,1,0,1,8428
0,0,1,0,1,0,1,8429
1,1,1,0,2,0,2,8429
2,2,0,0,2,0,2,8429
0,0,1,0,1,0,1,8430
1,1,2,0,3,0,3,8430
2,2,0,0,3,0,3,8430
0,0,1,0,1,0,1,8431
1,1,1,0,2,0,2,8431
2,2,0,0,2,0,2,8431
0,0,1,0,1,0,1,8432
1,1,1,0,2,0,2,8432
2,2,0,0,2,0,2,8432
0,0,1,0,1,0,1,8433
1,1,0,1,1,1,2,8433
2,2,0,0,1,1,2,8433
0,0,1,0,1,0,1,8434
1,1,2,0,3,0,3,8434
2,2,3,0,6,0,6,8434
3,3,1,0,7,0,7,8434
4,4,0,0,7,0,7,8434
0,0,1,0,1,0,1,8435
1,1,0,0,1,0,1,8435
0,0,1,0,1,0,1,8436
1,1,1,0,2,0,2,8436
2,2,1,0,3,0,3,8436
3,3,0,0,3,0,3,8436
0,0,1,0,1,0,1,8437
1,1,0,0,1,0,1,8437
0,0,1,0,1,0,1,8438
1,1,3,0,4,0,4,8438
2,2,1,0,5,0,5,8438
3,3,0,1,5,1,6,8438
4,4,0,1,5,2,7,8438
5,5,0,0,5,2,7,8438
0,0,1,0,1,0,1,8439
1,1,1,0,2,0,2,8439
2,2,0,0,2,0,2,8439
0,0,1,0,1,0,1,8440
1,1,2,0,3,0,3,8440
2,2,2,1,5,1,6,8440
3,3,0,2,5,3,8,8440
4,4,1,1,6,4,10,8440
5,5,0,3,6,7,13,8440
6,6,1,2,7,9,16,8440
7,7,2,1,9,10,19,8440
8,8,0,0,9,10,19,8440
0,0,1,0,1,0,1,8441
1,1,0,0,1,0,1,8441
0,0,1,0,1,0,1,8442
1,1,0,0,1,0,1,8442
0,0,1,0,1,0,1,8443
1,1,0,0,1,0,1,8443
0,0,1,0,1,0,1,8444
1,1,0,0,1,0,1,8444
0,0,1,0,1,0,1,8445
1,1,1,1,2,1,3,8445
2,2,0,3,2,4,6,8445
3,3,0,1,2,5,7,8445
4,4,0,1,2,6,8,8445
5,5,0,0,2,6,8,8445
0,0,1,0,1,0,1,8446
1,1,0,0,1,0,1,8446
0,0,1,0,1,0,1,8447
1,1,0,0,1,0,1,8447
0,0,1,0,1,0,1,8448
1,1,0,0,1,0,1,8448
0,0,1,0,1,0,1,8449
1,1,1,0,2,0,2,8449
2,2,2,0,4,0,4,8449
3,3,2,0,6,0,6,8449
4,4,1,0,7,0,7,8449
5,5,2,0,9,0,9,8449
6,6,0,0,9,0,9,8449
0,0,1,0,1,0,1,8450
1,1,0,0,1,0,1,8450
0,0,1,0,1,0,1,8451
1,1,0,0,1,0,1,8451
0,0,1,0,1,0,1,8452
1,1,3,0,4,0,4,8452
2,2,1,1,5,1,6,8452
3,3,0,2,5,3,8,8452
4,4,0,3,5,6,11,8452
5,5,1,0,6,6,12,8452
6,6,0,0,6,6,12,8452
0,0,1,0,1,0,1,8453
1,1,2,2,3,2,5,8453
2,2,1,3,4,5,9,8453
3,3,0,4,4,9,13,8453
4,4,0,3,4,12,16,8453
5,5,0,0,4,12,16,8453
0,0,1,0,1,0,1,8454
1,1,1,2,2,2,4,8454
2,2,0,5,2,7,9,8454
3,3,0,8,2,15,17,8454
4,4,1,12,3,27,30,8454
5,5,1,10,4,37,41,8454
6,6,4,2,8,39,47,8454
7,7,6,3,14,42,56,8454
8,8,1,2,15,44,59,8454
9,9,0,4,15,48,63,8454
10,10,1,5,16,53,69,8454
11,11,0,3,16,56,72,8454
12,12,1,1,17,57,74,8454
13,13,2,0,19,57,76,8454
14,14,3,0,22,57,79,8454
15,15,2,1,24,58,82,8454
16,16,1,0,25,58,83,8454
17,17,1,0,26,58,84,8454
18,18,1,0,27,58,85,8454
19,19,0,1,27,59,86,8454
20,20,0,1,27,60,87,8454
21,21,0,0,27,60,87,8454
0,0,1,0,1,0,1,8455
1,1,0,0,1,0,1,8455
0,0,1,0,1,0,1,8456
1,1,0,0,1,0,1,8456
0,0,1,0,1,0,1,8457
1,1,1,0,2,0,2,8457
2,2,1,0,3,0,3,8457
3,3,1,1,4,1,5,8457
4,4,1,2,5,3,8,8457
5,5,2,3,7,6,13,8457
6,6,0,6,7,12,19,8457
7,7,1,9,8,21,29,8457
8,8,3,5,11,26,37,8457
9,9,3,5,14,31,45,8457
10,10,3,4,17,35,52,8457
11,11,7,2,24,37,61,8457
12,12,3,2,27,39,66,8457
13,13,1,1,28,40,68,8457
14,14,0,1,28,41,69,8457
15,15,0,1,28,42,70,8457
16,16,0,2,28,44,72,8457
17,17,0,2,28,46,74,8457
18,18,1,3,29,49,78,8457
19,19,0,1,29,50,79,8457
20,20,0,0,29,50,79,8457
0,0,1,0,1,0,1,8458
1,1,0,0,1,0,1,8458
0,0,1,0,1,0,1,8459
1,1,0,0,1,0,1,8459
0,0,1,0,1,0,1,8460
1,1,0,0,1,0,1,8460
0,0,1,0,1,0,1,8461
1,1,0,0,1,0,1,8461
0,0,1,0,1,0,1,8462
1,1,3,0,4,0,4,8462
2,2,1,1,5,1,6,8462
3,3,2,0,7,1,8,8462
4,4,1,0,8,1,9,8462
5,5,1,0,9,1,10,8462
6,6,0,0,9,1,10,8462
0,0,1,0,1,0,1,8463
1,1,1,0,2,0,2,8463
2,2,3,0,5,0,5,8463
3,3,4,0,9,0,9,8463
4,4,1,1,10,1,11,8463
5,5,0,1,10,2,12,8463
6,6,0,1,10,3,13,8463
7,7,0,1,10,4,14,8463
8,8,0,1,10,5,15,8463
9,9,1,0,11,5,16,8463
10,10,2,1,13,6,19,8463
11,11,1,0,14,6,20,8463
12,12,2,0,16,6,22,8463
13,13,2,0,18,6,24,8463
14,14,0,2,18,8,26,8463
15,15,0,1,18,9,27,8463
16,16,0,0,18,9,27,8463
0,0,1,0,1,0,1,8464
1,1,1,0,2,0,2,8464
2,2,2,0,4,0,4,8464
3,3,2,0,6,0,6,8464
4,4,1,0,7,0,7,8464
5,5,0,0,7,0,7,8464
0,0,1,0,1,0,1,8465
1,1,0,0,1,0,1,8465
0,0,1,0,1,0,1,8466
1,1,1,0,2,0,2,8466
2,2,3,0,5,0,5,8466
3,3,1,0,6,0,6,8466
4,4,1,0,7,0,7,8466
5,5,1,0,8,0,8,8466
6,6,0,0,8,0,8,8466
0,0,1,0,1,0,1,8467
1,1,0,0,1,0,1,8467
0,0,1,0,1,0,1,8468
1,1,1,1,2,1,3,8468
2,2,0,1,2,2,4,8468
3,3,0,1,2,3,5,8468
4,4,0,3,2,6,8,8468
5,5,1,3,3,9,12,8468
6,6,2,2,5,11,16,8468
7,7,2,0,7,11,18,8468
8,8,2,0,9,11,20,8468
9,9,1,0,10,11,21,8468
10,10,2,0,12,11,23,8468
11,11,1,0,13,11,24,8468
12,12,0,0,13,11,24,8468
0,0,1,0,1,0,1,8469
1,1,0,0,1,0,1,8469
0,0,1,0,1,0,1,8470
1,1,0,0,1,0,1,8470
0,0,1,0,1,0,1,8471
1,1,2,0,3,0,3,8471
2,2,2,0,5,0,5,8471
3,3,1,0,6,0,6,8471
4,4,2,0,8,0,8,8471
5,5,1,0,9,0,9,8471
6,6,0,0,9,0,9,8471
0,0,1,0,1,0,1,8472
1,1,1,0,2,0,2,8472
2,2,0,0,2,0,2,8472
0,0,1,0,1,0,1,8473
1,1,0,0,1,0,1,8473
0,0,1,0,1,0,1,8474
1,1,3,0,4,0,4,8474
2,2,2,0,6,0,6,8474
3,3,2,1,8,1,9,8474
4,4,0,1,8,2,10,8474
5,5,0,1,8,3,11,8474
6,6,0,0,8,3,11,8474
0,0,1,0,1,0,1,8475
1,1,0,0,1,0,1,8475
0,0,1,0,1,0,1,8476
1,1,2,0,3,0,3,8476
2,2,2,0,5,0,5,8476
3,3,1,0,6,0,6,8476
4,4,0,0,6,0,6,8476
0,0,1,0,1,0,1,8477
1,1,2,1,3,1,4,8477
2,2,1,0,4,1,5,8477
3,3,0,0,4,1,5,8477
0,0,1,0,1,0,1,8478
1,1,1,0,2,0,2,8478
2,2,1,1,3,1,4,8478
3,3,1,2,4,3,7,8478
4,4,2,1,6,4,10,8478
5,5,2,0,8,4,12,8478
6,6,3,0,11,4,15,8478
7,7,3,1,14,5,19,8478
8,8,4,3,18,8,26,8478
9,9,2,4,20,12,32,8478
10,10,1,3,21,15,36,8478
11,11,0,2,21,17,38,8478
12,12,2,3,23,20,43,8478
13,13,0,4,23,24,47,8478
14,14,0,5,23,29,52,8478
15,15,0,2,23,31,54,8478
16,16,0,3,23,34,57,8478
17,17,0,1,23,35,58,8478
18,18,0,1,23,36,59,8478
19,19,0,0,23,36,59,8478
0,0,1,0,1,0,1,8479
1,1,1,1,2,1,3,8479
2,2,0,0,2,1,3,8479
0,0,1,0,1,0,1,8480
1,1,0,0,1,0,1,8480
0,0,1,0,1,0,1,8481
1,1,1,0,2,0,2,8481
2,2,0,1,2,1,3,8481
3,3,1,1,3,2,5,8481
4,4,0,0,3,2,5,8481
0,0,1,0,1,0,1,8482
1,1,0,0,1,0,1,8482
0,0,1,0,1,0,1,8483
1,1,1,0,2,0,2,8483
2,2,2,1,4,1,5,8483
3,3,2,2,6,3,9,8483
4,4,3,1,9,4,13,8483
5,5,0,0,9,4,13,8483
0,0,1,0,1,0,1,8484
1,1,0,0,1,0,1,8484
0,0,1,0,1,0,1,8485
1,1,0,0,1,0,1,8485
0,0,1,0,1,0,1,8486
1,1,2,0,3,0,3,8486
2,2,1,1,4,1,5,8486
3,3,1,0,5,1,6,8486
4,4,1,0,6,1,7,8486
5,5,1,0,7,1,8,8486
6,6,0,0,7,1,8,8486
0,0,1,0,1,0,1,8487
1,1,0,0,1,0,1,8487
0,0,1,0,1,0,1,8488
1,1,1,0,2,0,2,8488
2,2,0,1,2,1,3,8488
3,3,2,0,4,1,5,8488
4,4,1,0,5,1,6,8488
5,5,0,0,5,1,6,8488
0,0,1,0,1,0,1,8489
1,1,0,0,1,0,1,8489
0,0,1,0,1,0,1,8490
1,1,1,0,2,0,2,8490
2,2,1,0,3,0,3,8490
3,3,1,0,4,0,4,8490
4,4,2,0,6,0,6,8490
5,5,1,0,7,0,7,8490
6,6,0,1,7,1,8,8490
7,7,1,0,8,1,9,8490
8,8,1,0,9,1,10,8490
9,9,1,1,10,2,12,8490
10,10,3,1,13,3,16,8490
11,11,2,1,15,4,19,8490
12,12,0,0,15,4,19,8490
0,0,1,0,1,0,1,8491
1,1,0,0,1,0,1,8491
0,0,1,0,1,0,1,8492
1,1,1,1,2,1,3,8492
2,2,1,2,3,3,6,8492
3,3,2,2,5,5,10,8492
4,4,2,1,7,6,13,8492
5,5,5,2,12,8,20,8492
6,6,3,1,15,9,24,8492
7,7,4,2,19,11,30,8492
8,8,3,4,22,15,37,8492
9,9,0,4,22,19,41,8492
10,10,0,3,22,22,44,8492
11,11,0,1,22,23,45,8492
12,12,0,1,22,24,46,8492
13,13,0,2,22,26,48,8492
14,14,0,0,22,26,48,8492
0,0,1,0,1,0,1,8493
1,1,0,0,1,0,1,8493
0,0,1,0,1,0,1,8494
1,1,1,0,2,0,2,8494
2,2,1,0,3,0,3,8494
3,3,0,0,3,0,3,8494
0,0,1,0,1,0,1,8495
1,1,0,1,1,1,2,8495
2,2,0,0,1,1,2,8495
0,0,1,0,1,0,1,8496
1,1,0,0,1,0,1,8496
0,0,1,0,1,0,1,8497
1,1,0,0,1,0,1,8497
0,0,1,0,1,0,1,8498
1,1,0,1,1,1,2,8498
2,2,0,0,1,1,2,8498
0,0,1,0,1,0,1,8499
1,1,0,0,1,0,1,8499
0,0,1,0,1,0,1,8500
1,1,2,0,3,0,3,8500
2,2,1,1,4,1,5,8500
3,3,0,1,4,2,6,8500
4,4,1,1,5,3,8,8500
5,5,1,0,6,3,9,8500
6,6,0,0,6,3,9,8500
0,0,1,0,1,0,1,8501
1,1,0,0,1,0,1,8501
0,0,1,0,1,0,1,8502
1,1,0,0,1,0,1,8502
0,0,1,0,1,0,1,8503
1,1,0,0,1,0,1,8503
0,0,1,0,1,0,1,8504
1,1,1,0,2,0,2,8504
2,2,0,0,2,0,2,8504
0,0,1,0,1,0,1,8505
1,1,1,0,2,0,2,8505
2,2,1,0,3,0,3,8505
3,3,0,0,3,0,3,8505
0,0,1,0,1,0,1,8506
1,1,0,1,1,1,2,8506
2,2,0,1,1,2,3,8506
3,3,1,0,2,2,4,8506
4,4,1,0,3,2,5,8506
5,5,0,0,3,2,5,8506
0,0,1,0,1,0,1,8507
1,1,0,0,1,0,1,8507
0,0,1,0,1,0,1,8508
1,1,1,0,2,0,2,8508
2,2,0,0,2,0,2,8508
0,0,1,0,1,0,1,8509
1,1,0,0,1,0,1,8509
0,0,1,0,1,0,1,8510
1,1,0,0,1,0,1,8510
0,0,1,0,1,0,1,8511
1,1,0,1,1,1,2,8511
2,2,0,0,1,1,2,8511
0,0,1,0,1,0,1,8512
1,1,1,0,2,0,2,8512
2,2,0,0,2,0,2,8512
0,0,1,0,1,0,1,8513
1,1,0,0,1,0,1,8513
0,0,1,0,1,0,1,8514
1,1,2,0,3,0,3,8514
2,2,1,0,4,0,4,8514
3,3,0,0,4,0,4,8514
0,0,1,0,1,0,1,8515
1,1,0,0,1,0,1,8515
0,0,1,0,1,0,1,8516
1,1,1,0,2,0,2,8516
2,2,0,0,2,0,2,8516
0,0,1,0,1,0,1,8517
1,1,1,2,2,2,4,8517
2,2,2,0,4,2,6,8517
3,3,2,0,6,2,8,8517
4,4,1,0,7,2,9,8517
5,5,0,0,7,2,9,8517
0,0,1,0,1,0,1,8518
1,1,0,0,1,0,1,8518
0,0,1,0,1,0,1,8519
1,1,0,0,1,0,1,8519
0,0,1,0,1,0,1,8520
1,1,0,0,1,0,1,8520
0,0,1,0,1,0,1,8521
1,1,2,0,3,0,3,8521
2,2,3,0,6,0,6,8521
3,3,3,0,9,0,9,8521
4,4,3,0,12,0,12,8521
5,5,5,0,17,0,17,8521
6,6,4,0,21,0,21,8521
7,7,1,1,22,1,23,8521
8,8,1,0,23,1,24,8521
9,9,0,0,23,1,24,8521
0,0,1,0,1,0,1,8522
1,1,0,0,1,0,1,8522
0,0,1,0,1,0,1,8523
1,1,0,0,1,0,1,8523
0,0,1,0,1,0,1,8524
1,1,2,0,3,0,3,8524
2,2,0,0,3,0,3,8524
0,0,1,0,1,0,1,8525
1,1,0,0,1,0,1,8525
0,0,1,0,1,0,1,8526
1,1,0,0,1,0,1,8526
0,0,1,0,1,0,1,8527
1,1,0,0,1,0,1,8527
0,0,1,0,1,0,1,8528
1,1,1,0,2,0,2,8528
2,2,1,0,3,0,3,8528
3,3,2,0,5,0,5,8528
4,4,2,0,7,0,7,8528
5,5,0,0,7,0,7,8528
0,0,1,0,1,0,1,8529
1,1,1,1,2,1,3,8529
2,2,0,1,2,2,4,8529
3,3,0,0,2,2,4,8529
0,0,1,0,1,0,1,8530
1,1,0,1,1,1,2,8530
2,2,0,0,1,1,2,8530
0,0,1,0,1,0,1,8531
1,1,0,0,1,0,1,8531
0,0,1,0,1,0,1,8532
1,1,2,1,3,1,4,8532
2,2,1,0,4,1,5,8532
3,3,1,1,5,2,7,8532
4,4,1,2,6,4,10,8532
5,5,0,3,6,7,13,8532
6,6,1,3,7,10,17,8532
7,7,0,1,7,11,18,8532
8,8,0,0,7,11,18,8532
0,0,1,0,1,0,1,8533
1,1,1,0,2,0,2,8533
2,2,2,0,4,0,4,8533
3,3,1,0,5,0,5,8533
4,4,0,0,5,0,5,8533
0,0,1,0,1,0,1,8534
1,1,3,0,4,0,4,8534
2,2,0,0,4,0,4,8534
0,0,1,0,1,0,1,8535
1,1,0,1,1,1,2,8535
2,2,0,3,1,4,5,8535
3,3,1,1,2,5,7,8535
4,4,0,2,2,7,9,8535
5,5,0,1,2,8,10,8535
6,6,0,1,2,9,11,8535
7,7,0,2,2,11,13,8535
8,8,0,2,2,13,15,8535
9,9,0,2,2,15,17,8535
10,10,1,1,3,16,19,8535
11,11,0,2,3,18,21,8535
12,12,1,3,4,21,25,8535
13,13,0,2,4,23,27,8535
14,14,0,1,4,24,28,8535
15,15,0,1,4,25,29,8535
16,16,0,0,4,25,29,8535
0,0,1,0,1,0,1,8536
1,1,1,0,2,0,2,8536
2,2,1,0,3,0,3,8536
3,3,0,0,3,0,3,8536
0,0,1,0,1,0,1,8537
1,1,1,0,2,0,2,8537
2,2,1,0,3,0,3,8537
3,3,1,0,4,0,4,8537
4,4,0,0,4,0,4,8537
0,0,1,0,1,0,1,8538
1,1,0,0,1,0,1,8538
0,0,1,0,1,0,1,8539
1,1,0,1,1,1,2,8539
2,2,0,2,1,3,4,8539
3,3,0,1,1,4,5,8539
4,4,0,1,1,5,6,8539
5,5,1,0,2,5,7,8539
6,6,1,1,3,6,9,8539
7,7,0,1,3,7,10,8539
8,8,0,1,3,8,11,8539
9,9,0,1,3,9,12,8539
10,10,0,0,3,9,12,8539
0,0,1,0,1,0,1,8540
1,1,1,0,2,0,2,8540
2,2,0,0,2,0,2,8540
0,0,1,0,1,0,1,8541
1,1,2,0,3,0,3,8541
2,2,1,0,4,0,4,8541
3,3,3,0,7,0,7,8541
4,4,1,1,8,1,9,8541
5,5,1,0,9,1,10,8541
6,6,0,1,9,2,11,8541
7,7,0,0,9,2,11,8541
0,0,1,0,1,0,1,8542
1,1,1,0,2,0,2,8542
2,2,1,0,3,0,3,8542
3,3,2,0,5,0,5,8542
4,4,3,1,8,1,9,8542
5,5,0,1,8,2,10,8542
6,6,0,1,8,3,11,8542
7,7,0,0,8,3,11,8542
0,0,1,0,1,0,1,8543
1,1,2,0,3,0,3,8543
2,2,0,0,3,0,3,8543
0,0,1,0,1,0,1,8544
1,1,0,0,1,0,1,8544
0,0,1,0,1,0,1,8545
1,1,3,0,4,0,4,8545
2,2,2,0,6,0,6,8545
3,3,1,1,7,1,8,8545
4,4,1,2,8,3,11,8545
5,5,0,4,8,7,15,8545
6,6,0,3,8,10,18,8545
7,7,1,1,9,11,20,8545
8,8,1,0,10,11,21,8545
9,9,0,0,10,11,21,8545
0,0,1,0,1,0,1,8546
1,1,0,0,1,0,1,8546
0,0,1,0,1,0,1,8547
1,1,0,1,1,1,2,8547
2,2,0,2,1,3,4,8547
3,3,0,1,1,4,5,8547
4,4,1,1,2,5,7,8547
5,5,2,1,4,6,10,8547
6,6,2,0,6,6,12,8547
7,7,3,1,9,7,16,8547
8,8,3,2,12,9,21,8547
9,9,5,0,17,9,26,8547
10,10,3,0,20,9,29,8547
11,11,2,0,22,9,31,8547
12,12,1,0,23,9,32,8547
13,13,2,0,25,9,34,8547
14,14,1,0,26,9,35,8547
15,15,0,0,26,9,35,8547
0,0,1,0,1,0,1,8548
1,1,2,0,3,0,3,8548
2,2,1,0,4,0,4,8548
3,3,1,1,5,1,6,8548
4,4,0,0,5,1,6,8548
0,0,1,0,1,0,1,8549
1,1,1,0,2,0,2,8549
2,2,0,1,2,1,3,8549
3,3,0,2,2,3,5,8549
4,4,0,2,2,5,7,8549
5,5,0,2,2,7,9,8549
6,6,1,1,3,8,11,8549
7,7,2,1,5,9,14,8549
8,8,1,0,6,9,15,8549
9,9,0,1,6,10,16,8549
10,10,0,0,6,10,16,8549
0,0,1,0,1,0,1,8550
1,1,0,1,1,1,2,8550
2,2,0,1,1,2,3,8550
3,3,0,1,1,3,4,8550
4,4,0,0,1,3,4,8550
0,0,1,0,1,0,1,8551
1,1,2,0,3,0,3,8551
2,2,1,0,4,0,4,8551
3,3,1,1,5,1,6,8551
4,4,0,2,5,3,8,8551
5,5,0,2,5,5,10,8551
6,6,0,3,5,8,13,8551
7,7,0,3,5,11,16,8551
8,8,0,2,5,13,18,8551
9,9,0,2,5,15,20,8551
10,10,0,1,5,16,21,8551
11,11,0,0,5,16,21,8551
0,0,1,0,1,0,1,8552
1,1,0,0,1,0,1,8552
0,0,1,0,1,0,1,8553
1,1,0,0,1,0,1,8553
0,0,1,0,1,0,1,8554
1,1,0,0,1,0,1,8554
0,0,1,0,1,0,1,8555
1,1,0,0,1,0,1,8555
0,0,1,0,1,0,1,8556
1,1,0,0,1,0,1,8556
0,0,1,0,1,0,1,8557
1,1,2,0,3,0,3,8557
2,2,1,1,4,1,5,8557
3,3,2,0,6,1,7,8557
4,4,1,0,7,1,8,8557
5,5,0,0,7,1,8,8557
0,0,1,0,1,0,1,8558
1,1,0,1,1,1,2,8558
2,2,0,0,1,1,2,8558
0,0,1,0,1,0,1,8559
1,1,0,0,1,0,1,8559
0,0,1,0,1,0,1,8560
1,1,0,0,1,0,1,8560
0,0,1,0,1,0,1,8561
1,1,3,0,4,0,4,8561
2,2,2,0,6,0,6,8561
3,3,1,0,7,0,7,8561
4,4,0,0,7,0,7,8561
0,0,1,0,1,0,1,8562
1,1,0,0,1,0,1,8562
0,0,1,0,1,0,1,8563
1,1,0,0,1,0,1,8563
0,0,1,0,1,0,1,8564
1,1,0,0,1,0,1,8564
0,0,1,0,1,0,1,8565
1,1,0,0,1,0,1,8565
0,0,1,0,1,0,1,8566
1,1,0,0,1,0,1,8566
0,0,1,0,1,0,1,8567
1,1,1,0,2,0,2,8567
2,2,0,0,2,0,2,8567
0,0,1,0,1,0,1,8568
1,1,0,0,1,0,1,8568
0,0,1,0,1,0,1,8569
1,1,2,0,3,0,3,8569
2,2,3,0,6,0,6,8569
3,3,2,0,8,0,8,8569
4,4,3,1,11,1,12,8569
5,5,3,3,14,4,18,8569
6,6,5,2,19,6,25,8569
7,7,1,5,20,11,31,8569
8,8,2,4,22,15,37,8569
9,9,4,4,26,19,45,8569
10,10,3,2,29,21,50,8569
11,11,0,4,29,25,54,8569
12,12,2,2,31,27,58,8569
13,13,1,4,32,31,63,8569
14,14,1,4,33,35,68,8569
15,15,1,5,34,40,74,8569
16,16,2,4,36,44,80,8569
17,17,2,4,38,48,86,8569
18,18,1,2,39,50,89,8569
19,19,3,2,42,52,94,8569
20,20,1,2,43,54,97,8569
21,21,1,4,44,58,102,8569
22,22,1,2,45,60,105,8569
23,23,0,1,45,61,106,8569
24,24,0,1,45,62,107,8569
25,25,0,1,45,63,108,8569
26,26,0,1,45,64,109,8569
27,27,0,0,45,64,109,8569
0,0,1,0,1,0,1,8570
1,1,1,0,2,0,2,8570
2,2,0,0,2,0,2,8570
0,0,1,0,1,0,1,8571
1,1,0,0,1,0,1,8571
0,0,1,0,1,0,1,8572
1,1,0,0,1,0,1,8572
0,0,1,0,1,0,1,8573
1,1,1,0,2,0,2,8573
2,2,0,0,2,0,2,8573
0,0,1,0,1,0,1,8574
1,1,0,0,1,0,1,8574
0,0,1,0,1,0,1,8575
1,1,2,0,3,0,3,8575
2,2,2,1,5,1,6,8575
3,3,0,0,5,1,6,8575
0,0,1,0,1,0,1,8576
1,1,2,0,3,0,3,8576
2,2,2,1,5,1,6,8576
3,3,5,2,10,3,13,8576
4,4,7,2,17,5,22,8576
5,5,3,2,20,7,27,8576
6,6,3,1,23,8,31,8576
7,7,3,2,26,10,36,8576
8,8,3,4,29,14,43,8576
9,9,2,3,31,17,48,8576
10,10,4,0,35,17,52,8576
11,11,1,0,36,17,53,8576
12,12,1,0,37,17,54,8576
13,13,0,0,37,17,54,8576
0,0,1,0,1,0,1,8577
1,1,0,0,1,0,1,8577
0,0,1,0,1,0,1,8578
1,1,3,0,4,0,4,8578
2,2,2,1,6,1,7,8578
3,3,2,0,8,1,9,8578
4,4,0,1,8,2,10,8578
5,5,0,1,8,3,11,8578
6,6,0,1,8,4,12,8578
7,7,1,1,9,5,14,8578
8,8,0,1,9,6,15,8578
9,9,0,0,9,6,15,8578
0,0,1,0,1,0,1,8579
1,1,1,1,2,1,3,8579
2,2,3,3,5,4,9,8579
3,3,3,5,8,9,17,8579
4,4,2,4,10,13,23,8579
5,5,4,1,14,14,28,8579
6,6,2,0,16,14,30,8579
7,7,1,0,17,14,31,8579
8,8,0,0,17,14,31,8579
0,0,1,0,1,0,1,8580
1,1,1,0,2,0,2,8580
2,2,0,0,2,0,2,8580
0,0,1,0,1,0,1,8581
1,1,2,0,3,0,3,8581
2,2,2,0,5,0,5,8581
3,3,0,0,5,0,5,8581
0,0,1,0,1,0,1,8582
1,1,0,0,1,0,1,8582
0,0,1,0,1,0,1,8583
1,1,0,0,1,0,1,8583
0,0,1,0,1,0,1,8584
1,1,1,0,2,0,2,8584
2,2,1,0,3,0,3,8584
3,3,0,0,3,0,3,8584
0,0,1,0,1,0,1,8585
1,1,0,0,1,0,1,8585
0,0,1,0,1,0,1,8586
1,1,1,0,2,0,2,8586
2,2,1,0,3,0,3,8586
3,3,1,0,4,0,4,8586
4,4,1,0,5,0,5,8586
5,5,0,0,5,0,5,8586
0,0,1,0,1,0,1,8587
1,1,0,0,1,0,1,8587
0,0,1,0,1,0,1,8588
1,1,0,0,1,0,1,8588
0,0,1,0,1,0,1,8589
1,1,0,1,1,1,2,8589
2,2,0,1,1,2,3,8589
3,3,0,0,1,2,3,8589
0,0,1,0,1,0,1,8590
1,1,1,0,2,0,2,8590
2,2,0,0,2,0,2,8590
0,0,1,0,1,0,1,8591
1,1,2,0,3,0,3,8591
2,2,1,1,4,1,5,8591
3,3,0,0,4,1,5,8591
0,0,1,0,1,0,1,8592
1,1,2,0,3,0,3,8592
2,2,3,0,6,0,6,8592
3,3,3,1,9,1,10,8592
4,4,4,2,13,3,16,8592
5,5,4,1,17,4,21,8592
6,6,3,2,20,6,26,8592
7,7,3,2,23,8,31,8592
8,8,3,4,26,12,38,8592
9,9,2,3,28,15,43,8592
10,10,3,3,31,18,49,8592
11,11,5,2,36,20,56,8592
12,12,2,4,38,24,62,8592
13,13,0,2,38,26,64,8592
14,14,0,1,38,27,65,8592
15,15,0,1,38,28,66,8592
16,16,0,2,38,30,68,8592
17,17,0,1,38,31,69,8592
18,18,0,0,38,31,69,8592
0,0,1,0,1,0,1,8593
1,1,0,0,1,0,1,8593
0,0,1,0,1,0,1,8594
1,1,1,0,2,0,2,8594
2,2,0,0,2,0,2,8594
0,0,1,0,1,0,1,8595
1,1,2,0,3,0,3,8595
2,2,1,1,4,1,5,8595
3,3,1,1,5,2,7,8595
4,4,0,1,5,3,8,8595
5,5,0,1,5,4,9,8595
6,6,0,1,5,5,10,8595
7,7,0,1,5,6,11,8595
8,8,0,0,5,6,11,8595
0,0,1,0,1,0,1,8596
1,1,0,2,1,2,3,8596
2,2,0,0,1,2,3,8596
0,0,1,0,1,0,1,8597
1,1,1,0,2,0,2,8597
2,2,1,0,3,0,3,8597
3,3,0,0,3,0,3,8597
0,0,1,0,1,0,1,8598
1,1,1,0,2,0,2,8598
2,2,0,0,2,0,2,8598
0,0,1,0,1,0,1,8599
1,1,0,0,1,0,1,8599
0,0,1,0,1,0,1,8600
1,1,1,0,2,0,2,8600
2,2,0,0,2,0,2,8600
0,0,1,0,1,0,1,8601
1,1,0,1,1,1,2,8601
2,2,0,0,1,1,2,8601
0,0,1,0,1,0,1,8602
1,1,2,0,3,0,3,8602
2,2,1,0,4,0,4,8602
3,3,0,1,4,1,5,8602
4,4,0,0,4,1,5,8602
0,0,1,0,1,0,1,8603
1,1,0,0,1,0,1,8603
0,0,1,0,1,0,1,8604
1,1,1,0,2,0,2,8604
2,2,1,0,3,0,3,8604
3,3,0,0,3,0,3,8604
0,0,1,0,1,0,1,8605
1,1,0,0,1,0,1,8605
0,0,1,0,1,0,1,8606
1,1,0,0,1,0,1,8606
0,0,1,0,1,0,1,8607
1,1,0,0,1,0,1,8607
0,0,1,0,1,0,1,8608
1,1,1,0,2,0,2,8608
2,2,1,0,3,0,3,8608
3,3,0,0,3,0,3,8608
0,0,1,0,1,0,1,8609
1,1,0,0,1,0,1,8609
0,0,1,0,1,0,1,8610
1,1,0,0,1,0,1,8610
0,0,1,0,1,0,1,8611
1,1,0,0,1,0,1,8611
0,0,1,0,1,0,1,8612
1,1,1,0,2,0,2,8612
2,2,0,0,2,0,2,8612
0,0,1,0,1,0,1,8613
1,1,1,0,2,0,2,8613
2,2,2,0,4,0,4,8613
3,3,3,0,7,0,7,8613
4,4,0,0,7,0,7,8613
0,0,1,0,1,0,1,8614
1,1,3,0,4,0,4,8614
2,2,1,1,5,1,6,8614
3,3,2,1,7,2,9,8614
4,4,3,0,10,2,12,8614
5,5,4,0,14,2,16,8614
6,6,3,0,17,2,19,8614
7,7,4,0,21,2,23,8614
8,8,2,1,23,3,26,8614
9,9,2,3,25,6,31,8614
10,10,4,3,29,9,38,8614
11,11,6,2,35,11,46,8614
12,12,3,0,38,11,49,8614
13,13,0,1,38,12,50,8614
14,14,0,0,38,12,50,8614
0,0,1,0,1,0,1,8615
1,1,0,1,1,1,2,8615
2,2,0,2,1,3,4,8615
3,3,1,1,2,4,6,8615
4,4,0,2,2,6,8,8615
5,5,1,0,3,6,9,8615
6,6,0,0,3,6,9,8615
0,0,1,0,1,0,1,8616
1,1,2,0,3,0,3,8616
2,2,0,0,3,0,3,8616
0,0,1,0,1,0,1,8617
1,1,1,1,2,1,3,8617
2,2,0,0,2,1,3,8617
0,0,1,0,1,0,1,8618
1,1,0,0,1,0,1,8618
0,0,1,0,1,0,1,8619
1,1,2,0,3,0,3,8619
2,2,1,0,4,0,4,8619
3,3,1,0,5,0,5,8619
4,4,0,1,5,1,6,8619
5,5,0,1,5,2,7,8619
6,6,0,2,5,4,9,8619
7,7,0,2,5,6,11,8619
8,8,0,1,5,7,12,8619
9,9,0,0,5,7,12,8619
0,0,1,0,1,0,1,8620
1,1,2,0,3,0,3,8620
2,2,0,0,3,0,3,8620
0,0,1,0,1,0,1,8621
1,1,1,0,2,0,2,8621
2,2,0,0,2,0,2,8621
0,0,1,0,1,0,1,8622
1,1,1,0,2,0,2,8622
2,2,1,0,3,0,3,8622
3,3,0,0,3,0,3,8622
0,0,1,0,1,0,1,8623
1,1,2,0,3,0,3,8623
2,2,7,1,10,1,11,8623
3,3,3,1,13,2,15,8623
4,4,4,0,17,2,19,8623
5,5,6,0,23,2,25,8623
6,6,6,1,29,3,32,8623
7,7,7,3,36,6,42,8623
8,8,6,2,42,8,50,8623
9,9,4,1,46,9,55,8623
10,10,4,1,50,10,60,8623
11,11,4,0,54,10,64,8623
12,12,7,1,61,11,72,8623
13,13,4,1,65,12,77,8623
14,14,4,2,69,14,83,8623
15,15,4,1,73,15,88,8623
16,16,1,0,74,15,89,8623
17,17,1,0,75,15,90,8623
18,18,0,1,75,16,91,8623
19,19,0,0,75,16,91,8623
0,0,1,0,1,0,1,8624
1,1,0,0,1,0,1,8624
0,0,1,0,1,0,1,8625
1,1,0,0,1,0,1,8625
0,0,1,0,1,0,1,8626
1,1,1,0,2,0,2,8626
2,2,2,0,4,0,4,8626
3,3,2,0,6,0,6,8626
4,4,4,0,10,0,10,8626
5,5,7,0,17,0,17,8626
6,6,1,1,18,1,19,8626
7,7,1,1,19,2,21,8626
8,8,0,0,19,2,21,8626
0,0,1,0,1,0,1,8627
1,1,1,1,2,1,3,8627
2,2,3,0,5,1,6,8627
3,3,1,0,6,1,7,8627
4,4,1,0,7,1,8,8627
5,5,0,0,7,1,8,8627
0,0,1,0,1,0,1,8628
1,1,0,0,1,0,1,8628
0,0,1,0,1,0,1,8629
1,1,0,0,1,0,1,8629
0,0,1,0,1,0,1,8630
1,1,0,0,1,0,1,8630
0,0,1,0,1,0,1,8631
1,1,1,0,2,0,2,8631
2,2,0,0,2,0,2,8631
0,0,1,0,1,0,1,8632
1,1,0,1,1,1,2,8632
2,2,0,0,1,1,2,8632
0,0,1,0,1,0,1,8633
1,1,0,0,1,0,1,8633
0,0,1,0,1,0,1,8634
1,1,1,0,2,0,2,8634
2,2,2,0,4,0,4,8634
3,3,2,1,6,1,7,8634
4,4,4,2,10,3,13,8634
5,5,4,6,14,9,23,8634
6,6,10,10,24,19,43,8634
7,7,5,10,29,29,58,8634
8,8,5,7,34,36,70,8634
9,9,2,9,36,45,81,8634
10,10,6,7,42,52,94,8634
11,11,8,4,50,56,106,8634
12,12,4,2,54,58,112,8634
13,13,6,3,60,61,121,8634
14,14,3,4,63,65,128,8634
15,15,1,4,64,69,133,8634
16,16,1,3,65,72,137,8634
17,17,0,3,65,75,140,8634
18,18,0,2,65,77,142,8634
19,19,0,1,65,78,143,8634
20,20,0,2,65,80,145,8634
21,21,0,1,65,81,146,8634
22,22,1,1,66,82,148,8634
23,23,0,2,66,84,150,8634
24,24,0,1,66,85,151,8634
25,25,0,1,66,86,152,8634
26,26,0,0,66,86,152,8634
0,0,1,0,1,0,1,8635
1,1,2,0,3,0,3,8635
2,2,1,0,4,0,4,8635
3,3,0,0,4,0,4,8635
0,0,1,0,1,0,1,8636
1,1,0,0,1,0,1,8636
0,0,1,0,1,0,1,8637
1,1,1,0,2,0,2,8637
2,2,1,0,3,0,3,8637
3,3,2,0,5,0,5,8637
4,4,1,0,6,0,6,8637
5,5,2,0,8,0,8,8637
6,6,2,0,10,0,10,8637
7,7,1,0,11,0,11,8637
8,8,1,0,12,0,12,8637
9,9,0,0,12,0,12,8637
0,0,1,0,1,0,1,8638
1,1,1,0,2,0,2,8638
2,2,0,0,2,0,2,8638
0,0,1,0,1,0,1,8639
1,1,2,0,3,0,3,8639
2,2,2,0,5,0,5,8639
3,3,1,0,6,0,6,8639
4,4,0,0,6,0,6,8639
0,0,1,0,1,0,1,8640
1,1,1,0,2,0,2,8640
2,2,1,2,3,2,5,8640
3,3,0,1,3,3,6,8640
4,4,0,0,3,3,6,8640
0,0,1,0,1,0,1,8641
1,1,0,1,1,1,2,8641
2,2,0,0,1,1,2,8641
0,0,1,0,1,0,1,8642
1,1,1,0,2,0,2,8642
2,2,1,0,3,0,3,8642
3,3,3,0,6,0,6,8642
4,4,3,1,9,1,10,8642
5,5,2,1,11,2,13,8642
6,6,3,2,14,4,18,8642
7,7,2,4,16,8,24,8642
8,8,2,0,18,8,26,8642
9,9,1,0,19,8,27,8642
10,10,2,0,21,8,29,8642
11,11,3,0,24,8,32,8642
12,12,3,0,27,8,35,8642
13,13,3,1,30,9,39,8642
14,14,1,3,31,12,43,8642
15,15,0,1,31,13,44,8642
16,16,0,1,31,14,45,8642
17,17,0,1,31,15,46,8642
18,18,1,0,32,15,47,8642
19,19,0,0,32,15,47,8642
0,0,1,0,1,0,1,8643
1,1,1,1,2,1,3,8643
2,2,1,1,3,2,5,8643
3,3,1,1,4,3,7,8643
4,4,0,0,4,3,7,8643
0,0,1,0,1,0,1,8644
1,1,0,0,1,0,1,8644
0,0,1,0,1,0,1,8645
1,1,0,1,1,1,2,8645
2,2,0,2,1,3,4,8645
3,3,0,0,1,3,4,8645
0,0,1,0,1,0,1,8646
1,1,0,0,1,0,1,8646
0,0,1,0,1,0,1,8647
1,1,0,0,1,0,1,8647
0,0,1,0,1,0,1,8648
1,1,1,0,2,0,2,8648
2,2,1,0,3,0,3,8648
3,3,3,0,6,0,6,8648
4,4,1,0,7,0,7,8648
5,5,0,0,7,0,7,8648
0,0,1,0,1,0,1,8649
1,1,0,1,1,1,2,8649
2,2,0,0,1,1,2,8649
0,0,1,0,1,0,1,8650
1,1,0,0,1,0,1,8650
0,0,1,0,1,0,1,8651
1,1,2,0,3,0,3,8651
2,2,0,0,3,0,3,8651
0,0,1,0,1,0,1,8652
1,1,1,0,2,0,2,8652
2,2,0,2,2,2,4,8652
3,3,0,0,2,2,4,8652
0,0,1,0,1,0,1,8653
1,1,1,0,2,0,2,8653
2,2,2,0,4,0,4,8653
3,3,1,1,5,1,6,8653
4,4,0,2,5,3,8,8653
5,5,1,1,6,4,10,8653
6,6,1,2,7,6,13,8653
7,7,1,2,8,8,16,8653
8,8,2,2,10,10,20,8653
9,9,3,5,13,15,28,8653
10,10,3,3,16,18,34,8653
11,11,3,3,19,21,40,8653
12,12,3,4,22,25,47,8653
13,13,3,5,25,30,55,8653
14,14,4,2,29,32,61,8653
15,15,5,3,34,35,69,8653
16,16,2,2,36,37,73,8653
17,17,3,2,39,39,78,8653
18,18,2,1,41,40,81,8653
19,19,2,1,43,41,84,8653
20,20,5,1,48,42,90,8653
21,21,1,3,49,45,94,8653
22,22,1,1,50,46,96,8653
23,23,0,1,50,47,97,8653
24,24,0,0,50,47,97,8653
0,0,1,0,1,0,1,8654
1,1,0,1,1,1,2,8654
2,2,0,0,1,1,2,8654
0,0,1,0,1,0,1,8655
1,1,1,0,2,0,2,8655
2,2,1,0,3,0,3,8655
3,3,0,0,3,0,3,8655
0,0,1,0,1,0,1,8656
1,1,1,1,2,1,3,8656
2,2,0,2,2,3,5,8656
3,3,1,1,3,4,7,8656
4,4,2,0,5,4,9,8656
5,5,0,0,5,4,9,8656
0,0,1,0,1,0,1,8657
1,1,1,0,2,0,2,8657
2,2,0,0,2,0,2,8657
0,0,1,0,1,0,1,8658
1,1,0,0,1,0,1,8658
0,0,1,0,1,0,1,8659
1,1,0,0,1,0,1,8659
0,0,1,0,1,0,1,8660
1,1,0,0,1,0,1,8660
0,0,1,0,1,0,1,8661
1,1,3,0,4,0,4,8661
2,2,3,0,7,0,7,8661
3,3,3,1,10,1,11,8661
4,4,2,4,12,5,17,8661
5,5,3,2,15,7,22,8661
6,6,2,3,17,10,27,8661
7,7,0,3,17,13,30,8661
8,8,0,3,17,16,33,8661
9,9,0,3,17,19,36,8661
10,10,0,2,17,21,38,8661
11,11,1,1,18,22,40,8661
12,12,0,0,18,22,40,8661
0,0,1,0,1,0,1,8662
1,1,2,0,3,0,3,8662
2,2,3,0,6,0,6,8662
3,3,2,0,8,0,8,8662
4,4,1,0,9,0,9,8662
5,5,0,0,9,0,9,8662
0,0,1,0,1,0,1,8663
1,1,1,1,2,1,3,8663
2,2,1,0,3,1,4,8663
3,3,0,0,3,1,4,8663
0,0,1,0,1,0,1,8664
1,1,1,0,2,0,2,8664
2,2,1,0,3,0,3,8664
3,3,1,0,4,0,4,8664
4,4,0,0,4,0,4,8664
0,0,1,0,1,0,1,8665
1,1,0,0,1,0,1,8665
0,0,1,0,1,0,1,8666
1,1,0,2,1,2,3,8666
2,2,0,0,1,2,3,8666
0,0,1,0,1,0,1,8667
1,1,0,0,1,0,1,8667
0,0,1,0,1,0,1,8668
1,1,1,0,2,0,2,8668
2,2,0,0,2,0,2,8668
0,0,1,0,1,0,1,8669
1,1,0,0,1,0,1,8669
0,0,1,0,1,0,1,8670
1,1,0,0,1,0,1,8670
0,0,1,0,1,0,1,8671
1,1,0,0,1,0,1,8671
0,0,1,0,1,0,1,8672
1,1,1,0,2,0,2,8672
2,2,0,0,2,0,2,8672
0,0,1,0,1,0,1,8673
1,1,1,0,2,0,2,8673
2,2,0,0,2,0,2,8673
0,0,1,0,1,0,1,8674
1,1,1,1,2,1,3,8674
2,2,1,2,3,3,6,8674
3,3,1,2,4,5,9,8674
4,4,0,3,4,8,12,8674
5,5,0,4,4,12,16,8674
6,6,3,2,7,14,21,8674
7,7,1,4,8,18,26,8674
8,8,0,2,8,20,28,8674
9,9,1,4,9,24,33,8674
10,10,0,5,9,29,38,8674
11,11,1,3,10,32,42,8674
12,12,0,1,10,33,43,8674
13,13,0,2,10,35,45,8674
14,14,0,3,10,38,48,8674
15,15,1,0,11,38,49,8674
16,16,0,0,11,38,49,8674
0,0,1,0,1,0,1,8675
1,1,3,0,4,0,4,8675
2,2,2,0,6,0,6,8675
3,3,1,0,7,0,7,8675
4,4,0,0,7,0,7,8675
0,0,1,0,1,0,1,8676
1,1,0,0,1,0,1,8676
0,0,1,0,1,0,1,8677
1,1,0,0,1,0,1,8677
0,0,1,0,1,0,1,8678
1,1,0,0,1,0,1,8678
0,0,1,0,1,0,1,8679
1,1,1,0,2,0,2,8679
2,2,0,0,2,0,2,8679
0,0,1,0,1,0,1,8680
1,1,2,1,3,1,4,8680
2,2,2,1,5,2,7,8680
3,3,1,0,6,2,8,8680
4,4,3,0,9,2,11,8680
5,5,2,0,11,2,13,8680
6,6,0,0,11,2,13,8680
0,0,1,0,1,0,1,8681
1,1,0,0,1,0,1,8681
0,0,1,0,1,0,1,8682
1,1,1,1,2,1,3,8682
2,2,1,0,3,1,4,8682
3,3,2,1,5,2,7,8682
4,4,1,1,6,3,9,8682
5,5,2,1,8,4,12,8682
6,6,3,0,11,4,15,8682
7,7,5,1,16,5,21,8682
8,8,3,2,19,7,26,8682
9,9,1,1,20,8,28,8682
10,10,0,2,20,10,30,8682
11,11,0,3,20,13,33,8682
12,12,0,2,20,15,35,8682
13,13,1,0,21,15,36,8682
14,14,1,0,22,15,37,8682
15,15,1,0,23,15,38,8682
16,16,1,0,24,15,39,8682
17,17,1,0,25,15,40,8682
18,18,0,0,25,15,40,8682
0,0,1,0,1,0,1,8683
1,1,2,0,3,0,3,8683
2,2,2,0,5,0,5,8683
3,3,1,0,6,0,6,8683
4,4,0,0,6,0,6,8683
0,0,1,0,1,0,1,8684
1,1,2,0,3,0,3,8684
2,2,1,1,4,1,5,8684
3,3,3,1,7,2,9,8684
4,4,2,2,9,4,13,8684
5,5,1,1,10,5,15,8684
6,6,1,0,11,5,16,8684
7,7,0,0,11,5,16,8684
0,0,1,0,1,0,1,8685
1,1,0,0,1,0,1,8685
0,0,1,0,1,0,1,8686
1,1,0,0,1,0,1,8686
0,0,1,0,1,0,1,8687
1,1,2,0,3,0,3,8687
2,2,1,1,4,1,5,8687
3,3,1,1,5,2,7,8687
4,4,1,2,6,4,10,8687
5,5,0,4,6,8,14,8687
6,6,0,2,6,10,16,8687
7,7,0,0,6,10,16,8687
0,0,1,0,1,0,1,8688
1,1,1,1,2,1,3,8688
2,2,3,1,5,2,7,8688
3,3,0,0,5,2,7,8688
0,0,1,0,1,0,1,8689
1,1,1,0,2,0,2,8689
2,2,2,0,4,0,4,8689
3,3,4,1,8,1,9,8689
4,4,2,1,10,2,12,8689
5,5,1,1,11,3,14,8689
6,6,2,0,13,3,16,8689
7,7,0,0,13,3,16,8689
0,0,1,0,1,0,1,8690
1,1,1,0,2,0,2,8690
2,2,0,0,2,0,2,8690
0,0,1,0,1,0,1,8691
1,1,0,1,1,1,2,8691
2,2,0,0,1,1,2,8691
0,0,1,0,1,0,1,8692
1,1,0,0,1,0,1,8692
0,0,1,0,1,0,1,8693
1,1,0,0,1,0,1,8693
0,0,1,0,1,0,1,8694
1,1,1,0,2,0,2,8694
2,2,0,1,2,1,3,8694
3,3,0,0,2,1,3,8694
0,0,1,0,1,0,1,8695
1,1,2,0,3,0,3,8695
2,2,1,0,4,0,4,8695
3,3,2,0,6,0,6,8695
4,4,0,0,6,0,6,8695
0,0,1,0,1,0,1,8696
1,1,1,0,2,0,2,8696
2,2,1,1,3,1,4,8696
3,3,2,0,5,1,6,8696
4,4,1,0,6,1,7,8696
5,5,2,0,8,1,9,8696
6,6,1,1,9,2,11,8696
7,7,1,0,10,2,12,8696
8,8,0,1,10,3,13,8696
9,9,0,2,10,5,15,8696
10,10,1,0,11,5,16,8696
11,11,2,0,13,5,18,8696
12,12,2,1,15,6,21,8696
13,13,2,0,17,6,23,8696
14,14,1,0,18,6,24,8696
15,15,2,0,20,6,26,8696
16,16,2,1,22,7,29,8696
17,17,1,0,23,7,30,8696
18,18,0,0,23,7,30,8696
0,0,1,0,1,0,1,8697
1,1,1,1,2,1,3,8697
2,2,0,0,2,1,3,8697
0,0,1,0,1,0,1,8698
1,1,1,0,2,0,2,8698
2,2,2,0,4,0,4,8698
3,3,3,0,7,0,7,8698
4,4,1,2,8,2,10,8698
5,5,1,1,9,3,12,8698
6,6,0,1,9,4,13,8698
7,7,0,0,9,4,13,8698
0,0,1,0,1,0,1,8699
1,1,1,0,2,0,2,8699
2,2,2,1,4,1,5,8699
3,3,2,2,6,3,9,8699
4,4,1,2,7,5,12,8699
5,5,2,5,9,10,19,8699
6,6,2,1,11,11,22,8699
7,7,1,1,12,12,24,8699
8,8,0,1,12,13,25,8699
9,9,0,0,12,13,25,8699
0,0,1,0,1,0,1,8700
1,1,1,1,2,1,3,8700
2,2,0,0,2,1,3,8700
0,0,1,0,1,0,1,8701
1,1,0,0,1,0,1,8701
0,0,1,0,1,0,1,8702
1,1,0,0,1,0,1,8702
0,0,1,0,1,0,1,8703
1,1,3,0,4,0,4,8703
2,2,5,1,9,1,10,8703
3,3,4,2,13,3,16,8703
4,4,4,3,17,6,23,8703
5,5,5,3,22,9,31,8703
6,6,3,2,25,11,36,8703
7,7,4,1,29,12,41,8703
8,8,3,0,32,12,44,8703
9,9,4,0,36,12,48,8703
10,10,2,1,38,13,51,8703
11,11,2,0,40,13,53,8703
12,12,2,0,42,13,55,8703
13,13,0,0,42,13,55,8703
0,0,1,0,1,0,1,8704
1,1,2,0,3,0,3,8704
2,2,2,0,5,0,5,8704
3,3,1,0,6,0,6,8704
4,4,1,0,7,0,7,8704
5,5,1,0,8,0,8,8704
6,6,0,0,8,0,8,8704
0,0,1,0,1,0,1,8705
1,1,0,1,1,1,2,8705
2,2,1,1,2,2,4,8705
3,3,0,2,2,4,6,8705
4,4,0,2,2,6,8,8705
5,5,0,0,2,6,8,8705
0,0,1,0,1,0,1,8706
1,1,0,0,1,0,1,8706
0,0,1,0,1,0,1,8707
1,1,0,0,1,0,1,8707
0,0,1,0,1,0,1,8708
1,1,2,0,3,0,3,8708
2,2,1,1,4,1,5,8708
3,3,0,2,4,3,7,8708
4,4,1,1,5,4,9,8708
5,5,2,1,7,5,12,8708
6,6,2,1,9,6,15,8708
7,7,1,2,10,8,18,8708
8,8,0,3,10,11,21,8708
9,9,0,2,10,13,23,8708
10,10,1,2,11,15,26,8708
11,11,0,2,11,17,28,8708
12,12,0,2,11,19,30,8708
13,13,0,1,11,20,31,8708
14,14,1,1,12,21,33,8708
15,15,1,0,13,21,34,8708
16,16,1,0,14,21,35,8708
17,17,0,0,14,21,35,8708
0,0,1,0,1,0,1,8709
1,1,1,0,2,0,2,8709
2,2,0,0,2,0,2,8709
0,0,1,0,1,0,1,8710
1,1,0,0,1,0,1,8710
0,0,1,0,1,0,1,8711
1,1,1,0,2,0,2,8711
2,2,1,0,3,0,3,8711
3,3,0,0,3,0,3,8711
0,0,1,0,1,0,1,8712
1,1,1,0,2,0,2,8712
2,2,1,1,3,1,4,8712
3,3,0,0,3,1,4,8712
0,0,1,0,1,0,1,8713
1,1,0,0,1,0,1,8713
0,0,1,0,1,0,1,8714
1,1,1,0,2,0,2,8714
2,2,1,0,3,0,3,8714
3,3,1,0,4,0,4,8714
4,4,2,1,6,1,7,8714
5,5,2,1,8,2,10,8714
6,6,2,0,10,2,12,8714
7,7,3,1,13,3,16,8714
8,8,2,1,15,4,19,8714
9,9,0,0,15,4,19,8714
0,0,1,0,1,0,1,8715
1,1,0,1,1,1,2,8715
2,2,0,0,1,1,2,8715
0,0,1,0,1,0,1,8716
1,1,1,0,2,0,2,8716
2,2,3,0,5,0,5,8716
3,3,3,0,8,0,8,8716
4,4,1,0,9,0,9,8716
5,5,3,1,12,1,13,8716
6,6,4,2,16,3,19,8716
7,7,3,0,19,3,22,8716
8,8,0,0,19,3,22,8716
0,0,1,0,1,0,1,8717
1,1,1,0,2,0,2,8717
2,2,1,1,3,1,4,8717
3,3,0,0,3,1,4,8717
0,0,1,0,1,0,1,8718
1,1,1,0,2,0,2,8718
2,2,0,0,2,0,2,8718
0,0,1,0,1,0,1,8719
1,1,1,0,2,0,2,8719
2,2,0,0,2,0,2,8719
0,0,1,0,1,0,1,8720
1,1,1,0,2,0,2,8720
2,2,2,0,4,0,4,8720
3,3,1,0,5,0,5,8720
4,4,2,0,7,0,7,8720
5,5,1,1,8,1,9,8720
6,6,0,1,8,2,10,8720
7,7,0,1,8,3,11,8720
8,8,0,0,8,3,11,8720
0,0,1,0,1,0,1,8721
1,1,1,1,2,1,3,8721
2,2,1,1,3,2,5,8721
3,3,3,1,6,3,9,8721
4,4,0,1,6,4,10,8721
5,5,0,1,6,5,11,8721
6,6,1,1,7,6,13,8721
7,7,3,0,10,6,16,8721
8,8,2,0,12,6,18,8721
9,9,1,1,13,7,20,8721
10,10,1,1,14,8,22,8721
11,11,1,0,15,8,23,8721
12,12,0,0,15,8,23,8721
0,0,1,0,1,0,1,8722
1,1,1,0,2,0,2,8722
2,2,1,0,3,0,3,8722
3,3,1,1,4,1,5,8722
4,4,2,0,6,1,7,8722
5,5,1,1,7,2,9,8722
6,6,2,0,9,2,11,8722
7,7,3,0,12,2,14,8722
8,8,2,0,14,2,16,8722
9,9,8,0,22,2,24,8722
10,10,8,1,30,3,33,8722
11,11,7,1,37,4,41,8722
12,12,3,3,40,7,47,8722
13,13,2,2,42,9,51,8722
14,14,1,1,43,10,53,8722
15,15,2,2,45,12,57,8722
16,16,2,0,47,12,59,8722
17,17,2,0,49,12,61,8722
18,18,3,0,52,12,64,8722
19,19,1,1,53,13,66,8722
20,20,3,0,56,13,69,8722
21,21,2,1,58,14,72,8722
22,22,2,1,60,15,75,8722
23,23,0,0,60,15,75,8722
0,0,1,0,1,0,1,8723
1,1,0,0,1,0,1,8723
0,0,1,0,1,0,1,8724
1,1,3,0,4,0,4,8724
2,2,3,0,7,0,7,8724
3,3,3,0,10,0,10,8724
4,4,1,0,11,0,11,8724
5,5,0,0,11,0,11,8724
0,0,1,0,1,0,1,8725
1,1,3,0,4,0,4,8725
2,2,2,1,6,1,7,8725
3,3,1,2,7,3,10,8725
4,4,1,1,8,4,12,8725
5,5,0,2,8,6,14,8725
6,6,0,2,8,8,16,8725
7,7,2,0,10,8,18,8725
8,8,4,0,14,8,22,8725
9,9,1,0,15,8,23,8725
10,10,0,0,15,8,23,8725
0,0,1,0,1,0,1,8726
1,1,0,1,1,1,2,8726
2,2,0,1,1,2,3,8726
3,3,1,0,2,2,4,8726
4,4,2,0,4,2,6,8726
5,5,4,0,8,2,10,8726
6,6,5,1,13,3,16,8726
7,7,4,0,17,3,20,8726
8,8,2,0,19,3,22,8726
9,9,3,0,22,3,25,8726
10,10,6,0,28,3,31,8726
11,11,6,0,34,3,37,8726
12,12,7,0,41,3,44,8726
13,13,8,2,49,5,54,8726
14,14,7,1,56,6,62,8726
15,15,4,1,60,7,67,8726
16,16,3,2,63,9,72,8726
17,17,0,3,63,12,75,8726
18,18,0,1,63,13,76,8726
19,19,0,1,63,14,77,8726
20,20,1,0,64,14,78,8726
21,21,1,0,65,14,79,8726
22,22,0,0,65,14,79,8726
0,0,1,0,1,0,1,8727
1,1,2,0,3,0,3,8727
2,2,3,0,6,0,6,8727
3,3,1,1,7,1,8,8727
4,4,1,0,8,1,9,8727
5,5,0,0,8,1,9,8727
0,0,1,0,1,0,1,8728
1,1,0,0,1,0,1,8728
0,0,1,0,1,0,1,8729
1,1,0,0,1,0,1,8729
0,0,1,0,1,0,1,8730
1,1,2,0,3,0,3,8730
2,2,1,0,4,0,4,8730
3,3,0,1,4,1,5,8730
4,4,0,0,4,1,5,8730
0,0,1,0,1,0,1,8731
1,1,0,0,1,0,1,8731
0,0,1,0,1,0,1,8732
1,1,0,0,1,0,1,8732
0,0,1,0,1,0,1,8733
1,1,0,1,1,1,2,8733
2,2,0,0,1,1,2,8733
0,0,1,0,1,0,1,8734
1,1,1,0,2,0,2,8734
2,2,0,0,2,0,2,8734
0,0,1,0,1,0,1,8735
1,1,0,0,1,0,1,8735
0,0,1,0,1,0,1,8736
1,1,1,0,2,0,2,8736
2,2,2,0,4,0,4,8736
3,3,1,0,5,0,5,8736
4,4,0,0,5,0,5,8736
0,0,1,0,1,0,1,8737
1,1,0,0,1,0,1,8737
0,0,1,0,1,0,1,8738
1,1,0,0,1,0,1,8738
0,0,1,0,1,0,1,8739
1,1,0,0,1,0,1,8739
0,0,1,0,1,0,1,8740
1,1,1,0,2,0,2,8740
2,2,0,0,2,0,2,8740
0,0,1,0,1,0,1,8741
1,1,0,0,1,0,1,8741
0,0,1,0,1,0,1,8742
1,1,0,0,1,0,1,8742
0,0,1,0,1,0,1,8743
1,1,1,0,2,0,2,8743
2,2,1,0,3,0,3,8743
3,3,1,1,4,1,5,8743
4,4,0,2,4,3,7,8743
5,5,1,2,5,5,10,8743
6,6,1,2,6,7,13,8743
7,7,2,1,8,8,16,8743
8,8,0,0,8,8,16,8743
0,0,1,0,1,0,1,8744
1,1,2,0,3,0,3,8744
2,2,2,0,5,0,5,8744
3,3,1,0,6,0,6,8744
4,4,0,0,6,0,6,8744
0,0,1,0,1,0,1,8745
1,1,2,2,3,2,5,8745
2,2,2,2,5,4,9,8745
3,3,2,4,7,8,15,8745
4,4,1,3,8,11,19,8745
5,5,0,4,8,15,23,8745
6,6,1,4,9,19,28,8745
7,7,1,5,10,24,34,8745
8,8,3,8,13,32,45,8745
9,9,0,6,13,38,51,8745
10,10,1,4,14,42,56,8745
11,11,2,6,16,48,64,8745
12,12,7,3,23,51,74,8745
13,13,7,1,30,52,82,8745
14,14,3,3,33,55,88,8745
15,15,1,3,34,58,92,8745
16,16,1,1,35,59,94,8745
17,17,0,1,35,60,95,8745
18,18,0,1,35,61,96,8745
19,19,0,1,35,62,97,8745
20,20,0,3,35,65,100,8745
21,21,0,5,35,70,105,8745
22,22,0,4,35,74,109,8745
23,23,0,4,35,78,113,8745
24,24,1,5,36,83,119,8745
25,25,1,5,37,88,125,8745
26,26,1,2,38,90,128,8745
27,27,1,3,39,93,132,8745
28,28,3,4,42,97,139,8745
29,29,1,4,43,101,144,8745
30,30,1,5,44,106,150,8745
31,31,1,4,45,110,155,8745
32,32,4,6,49,116,165,8745
33,33,4,4,53,120,173,8745
34,34,1,4,54,124,178,8745
35,35,0,4,54,128,182,8745
36,36,0,3,54,131,185,8745
37,37,0,0,54,131,185,8745
0,0,1,0,1,0,1,8746
1,1,0,0,1,0,1,8746
0,0,1,0,1,0,1,8747
1,1,0,1,1,1,2,8747
2,2,0,0,1,1,2,8747
0,0,1,0,1,0,1,8748
1,1,0,0,1,0,1,8748
0,0,1,0,1,0,1,8749
1,1,0,0,1,0,1,8749
0,0,1,0,1,0,1,8750
1,1,0,0,1,0,1,8750
0,0,1,0,1,0,1,8751
1,1,1,0,2,0,2,8751
2,2,0,1,2,1,3,8751
3,3,0,2,2,3,5,8751
4,4,0,3,2,6,8,8751
5,5,0,3,2,9,11,8751
6,6,1,1,3,10,13,8751
7,7,1,0,4,10,14,8751
8,8,2,1,6,11,17,8751
9,9,3,0,9,11,20,8751
10,10,1,0,10,11,21,8751
11,11,0,0,10,11,21,8751
0,0,1,0,1,0,1,8752
1,1,0,0,1,0,1,8752
0,0,1,0,1,0,1,8753
1,1,2,0,3,0,3,8753
2,2,1,0,4,0,4,8753
3,3,3,1,7,1,8,8753
4,4,0,1,7,2,9,8753
5,5,0,3,7,5,12,8753
6,6,0,1,7,6,13,8753
7,7,0,0,7,6,13,8753
0,0,1,0,1,0,1,8754
1,1,0,0,1,0,1,8754
0,0,1,0,1,0,1,8755
1,1,0,0,1,0,1,8755
0,0,1,0,1,0,1,8756
1,1,3,0,4,0,4,8756
2,2,3,0,7,0,7,8756
3,3,3,0,10,0,10,8756
4,4,3,0,13,0,13,8756
5,5,4,0,17,0,17,8756
6,6,1,2,18,2,20,8756
7,7,1,1,19,3,22,8756
8,8,2,0,21,3,24,8756
9,9,2,0,23,3,26,8756
10,10,0,1,23,4,27,8756
11,11,0,1,23,5,28,8756
12,12,0,1,23,6,29,8756
13,13,0,0,23,6,29,8756
0,0,1,0,1,0,1,8757
1,1,1,0,2,0,2,8757
2,2,1,0,3,0,3,8757
3,3,1,0,4,0,4,8757
4,4,1,1,5,1,6,8757
5,5,3,1,8,2,10,8757
6,6,4,0,12,2,14,8757
7,7,6,1,18,3,21,8757
8,8,7,3,25,6,31,8757
9,9,3,7,28,13,41,8757
10,10,1,4,29,17,46,8757
11,11,1,2,30,19,49,8757
12,12,2,1,32,20,52,8757
13,13,0,0,32,20,52,8757
0,0,1,0,1,0,1,8758
1,1,0,0,1,0,1,8758
0,0,1,0,1,0,1,8759
1,1,1,1,2,1,3,8759
2,2,0,2,2,3,5,8759
3,3,0,3,2,6,8,8759
4,4,1,2,3,8,11,8759
5,5,0,2,3,10,13,8759
6,6,2,1,5,11,16,8759
7,7,0,1,5,12,17,8759
8,8,0,1,5,13,18,8759
9,9,0,2,5,15,20,8759
10,10,0,2,5,17,22,8759
11,11,0,1,5,18,23,8759
12,12,1,0,6,18,24,8759
13,13,0,0,6,18,24,8759
0,0,1,0,1,0,1,8760
1,1,0,0,1,0,1,8760
0,0,1,0,1,0,1,8761
1,1,2,0,3,0,3,8761
2,2,4,0,7,0,7,8761
3,3,3,1,10,1,11,8761
4,4,0,2,10,3,13,8761
5,5,0,0,10,3,13,8761
0,0,1,0,1,0,1,8762
1,1,0,0,1,0,1,8762
0,0,1,0,1,0,1,8763
1,1,1,0,2,0,2,8763
2,2,3,0,5,0,5,8763
3,3,1,0,6,0,6,8763
4,4,1,1,7,1,8,8763
5,5,0,1,7,2,9,8763
6,6,0,0,7,2,9,8763
0,0,1,0,1,0,1,8764
1,1,0,0,1,0,1,8764
0,0,1,0,1,0,1,8765
1,1,0,0,1,0,1,8765
0,0,1,0,1,0,1,8766
1,1,1,1,2,1,3,8766
2,2,1,0,3,1,4,8766
3,3,0,0,3,1,4,8766
0,0,1,0,1,0,1,8767
1,1,1,0,2,0,2,8767
2,2,1,1,3,1,4,8767
3,3,2,0,5,1,6,8767
4,4,3,0,8,1,9,8767
5,5,1,1,9,2,11,8767
6,6,2,2,11,4,15,8767
7,7,0,3,11,7,18,8767
8,8,0,1,11,8,19,8767
9,9,0,3,11,11,22,8767
10,10,1,5,12,16,28,8767
11,11,1,1,13,17,30,8767
12,12,1,0,14,17,31,8767
13,13,0,0,14,17,31,8767
0,0,1,0,1,0,1,8768
1,1,0,0,1,0,1,8768
0,0,1,0,1,0,1,8769
1,1,2,0,3,0,3,8769
2,2,2,1,5,1,6,8769
3,3,3,1,8,2,10,8769
4,4,3,0,11,2,13,8769
5,5,5,0,16,2,18,8769
6,6,3,2,19,4,23,8769
7,7,2,1,21,5,26,8769
8,8,1,0,22,5,27,8769
9,9,0,0,22,5,27,8769
0,0,1,0,1,0,1,8770
1,1,1,0,2,0,2,8770
2,2,0,0,2,0,2,8770
0,0,1,0,1,0,1,8771
1,1,0,0,1,0,1,8771
0,0,1,0,1,0,1,8772
1,1,1,1,2,1,3,8772
2,2,1,1,3,2,5,8772
3,3,1,0,4,2,6,8772
4,4,3,0,7,2,9,8772
5,5,0,1,7,3,10,8772
6,6,1,0,8,3,11,8772
7,7,0,0,8,3,11,8772
0,0,1,0,1,0,1,8773
1,1,2,0,3,0,3,8773
2,2,2,1,5,1,6,8773
3,3,3,2,8,3,11,8773
4,4,1,1,9,4,13,8773
5,5,1,0,10,4,14,8773
6,6,2,0,12,4,16,8773
7,7,2,1,14,5,19,8773
8,8,2,0,16,5,21,8773
9,9,2,1,18,6,24,8773
10,10,2,1,20,7,27,8773
11,11,2,0,22,7,29,8773
12,12,4,0,26,7,33,8773
13,13,3,0,29,7,36,8773
14,14,3,1,32,8,40,8773
15,15,2,1,34,9,43,8773
16,16,2,1,36,10,46,8773
17,17,0,3,36,13,49,8773
18,18,1,4,37,17,54,8773
19,19,0,4,37,21,58,8773
20,20,0,2,37,23,60,8773
21,21,0,1,37,24,61,8773
22,22,0,1,37,25,62,8773
23,23,0,0,37,25,62,8773
0,0,1,0,1,0,1,8774
1,1,0,0,1,0,1,8774
0,0,1,0,1,0,1,8775
1,1,0,0,1,0,1,8775
0,0,1,0,1,0,1,8776
1,1,1,1,2,1,3,8776
2,2,1,1,3,2,5,8776
3,3,1,3,4,5,9,8776
4,4,0,2,4,7,11,8776
5,5,0,2,4,9,13,8776
6,6,1,1,5,10,15,8776
7,7,1,0,6,10,16,8776
8,8,2,0,8,10,18,8776
9,9,0,0,8,10,18,8776
0,0,1,0,1,0,1,8777
1,1,5,0,6,0,6,8777
2,2,4,1,10,1,11,8777
3,3,1,0,11,1,12,8777
4,4,1,3,12,4,16,8777
5,5,2,3,14,7,21,8777
6,6,3,2,17,9,26,8777
7,7,3,2,20,11,31,8777
8,8,5,2,25,13,38,8777
9,9,2,2,27,15,42,8777
10,10,0,2,27,17,44,8777
11,11,0,0,27,17,44,8777
0,0,1,0,1,0,1,8778
1,1,0,0,1,0,1,8778
0,0,1,0,1,0,1,8779
1,1,0,0,1,0,1,8779
0,0,1,0,1,0,1,8780
1,1,0,0,1,0,1,8780
0,0,1,0,1,0,1,8781
1,1,0,0,1,0,1,8781
0,0,1,0,1,0,1,8782
1,1,1,0,2,0,2,8782
2,2,1,0,3,0,3,8782
3,3,0,0,3,0,3,8782
0,0,1,0,1,0,1,8783
1,1,0,0,1,0,1,8783
0,0,1,0,1,0,1,8784
1,1,1,0,2,0,2,8784
2,2,0,1,2,1,3,8784
3,3,0,2,2,3,5,8784
4,4,0,1,2,4,6,8784
5,5,0,0,2,4,6,8784
0,0,1,0,1,0,1,8785
1,1,1,0,2,0,2,8785
2,2,0,0,2,0,2,8785
0,0,1,0,1,0,1,8786
1,1,2,0,3,0,3,8786
2,2,2,0,5,0,5,8786
3,3,0,0,5,0,5,8786
0,0,1,0,1,0,1,8787
1,1,1,0,2,0,2,8787
2,2,2,0,4,0,4,8787
3,3,1,2,5,2,7,8787
4,4,1,2,6,4,10,8787
5,5,3,0,9,4,13,8787
6,6,5,0,14,4,18,8787
7,7,4,0,18,4,22,8787
8,8,1,0,19,4,23,8787
9,9,0,0,19,4,23,8787
0,0,1,0,1,0,1,8788
1,1,1,0,2,0,2,8788
2,2,3,1,5,1,6,8788
3,3,4,0,9,1,10,8788
4,4,3,1,12,2,14,8788
5,5,3,2,15,4,19,8788
6,6,3,3,18,7,25,8788
7,7,8,2,26,9,35,8788
8,8,6,2,32,11,43,8788
9,9,6,2,38,13,51,8788
10,10,4,1,42,14,56,8788
11,11,4,0,46,14,60,8788
12,12,4,3,50,17,67,8788
13,13,3,2,53,19,72,8788
14,14,1,8,54,27,81,8788
15,15,1,3,55,30,85,8788
16,16,2,0,57,30,87,8788
17,17,1,0,58,30,88,8788
18,18,1,0,59,30,89,8788
19,19,1,0,60,30,90,8788
20,20,2,0,62,30,92,8788
21,21,2,0,64,30,94,8788
22,22,2,1,66,31,97,8788
23,23,0,0,66,31,97,8788
0,0,1,0,1,0,1,8789
1,1,0,2,1,2,3,8789
2,2,0,2,1,4,5,8789
3,3,0,2,1,6,7,8789
4,4,0,0,1,6,7,8789
0,0,1,0,1,0,1,8790
1,1,0,0,1,0,1,8790
0,0,1,0,1,0,1,8791
1,1,1,0,2,0,2,8791
2,2,0,0,2,0,2,8791
0,0,1,0,1,0,1,8792
1,1,0,1,1,1,2,8792
2,2,0,1,1,2,3,8792
3,3,0,0,1,2,3,8792
0,0,1,0,1,0,1,8793
1,1,3,1,4,1,5,8793
2,2,0,0,4,1,5,8793
0,0,1,0,1,0,1,8794
1,1,2,0,3,0,3,8794
2,2,0,0,3,0,3,8794
0,0,1,0,1,0,1,8795
1,1,1,0,2,0,2,8795
2,2,1,0,3,0,3,8795
3,3,1,2,4,2,6,8795
4,4,0,1,4,3,7,8795
5,5,0,0,4,3,7,8795
0,0,1,0,1,0,1,8796
1,1,1,1,2,1,3,8796
2,2,0,1,2,2,4,8796
3,3,0,0,2,2,4,8796
0,0,1,0,1,0,1,8797
1,1,0,0,1,0,1,8797
0,0,1,0,1,0,1,8798
1,1,1,0,2,0,2,8798
2,2,2,0,4,0,4,8798
3,3,1,0,5,0,5,8798
4,4,0,1,5,1,6,8798
5,5,0,1,5,2,7,8798
6,6,0,1,5,3,8,8798
7,7,1,0,6,3,9,8798
8,8,2,1,8,4,12,8798
9,9,3,2,11,6,17,8798
10,10,4,0,15,6,21,8798
11,11,4,1,19,7,26,8798
12,12,3,4,22,11,33,8798
13,13,0,1,22,12,34,8798
14,14,0,0,22,12,34,8798
0,0,1,0,1,0,1,8799
1,1,0,0,1,0,1,8799
0,0,1,0,1,0,1,8800
1,1,1,0,2,0,2,8800
2,2,0,1,2,1,3,8800
3,3,0,2,2,3,5,8800
4,4,0,2,2,5,7,8800
5,5,1,1,3,6,9,8800
6,6,2,0,5,6,11,8800
7,7,1,2,6,8,14,8800
8,8,0,1,6,9,15,8800
9,9,0,0,6,9,15,8800
0,0,1,0,1,0,1,8801
1,1,0,0,1,0,1,8801
0,0,1,0,1,0,1,8802
1,1,3,0,4,0,4,8802
2,2,2,1,6,1,7,8802
3,3,2,1,8,2,10,8802
4,4,2,2,10,4,14,8802
5,5,3,1,13,5,18,8802
6,6,1,1,14,6,20,8802
7,7,2,1,16,7,23,8802
8,8,0,4,16,11,27,8802
9,9,0,2,16,13,29,8802
10,10,1,1,17,14,31,8802
11,11,0,2,17,16,33,8802
12,12,0,1,17,17,34,8802
13,13,1,0,18,17,35,8802
14,14,0,0,18,17,35,8802
0,0,1,0,1,0,1,8803
1,1,0,0,1,0,1,8803
0,0,1,0,1,0,1,8804
1,1,1,0,2,0,2,8804
2,2,1,0,3,0,3,8804
3,3,0,1,3,1,4,8804
4,4,0,0,3,1,4,8804
0,0,1,0,1,0,1,8805
1,1,1,0,2,0,2,8805
2,2,0,0,2,0,2,8805
0,0,1,0,1,0,1,8806
1,1,2,2,3,2,5,8806
2,2,2,2,5,4,9,8806
3,3,0,0,5,4,9,8806
0,0,1,0,1,0,1,8807
1,1,2,1,3,1,4,8807
2,2,1,3,4,4,8,8807
3,3,3,4,7,8,15,8807
4,4,0,6,7,14,21,8807
5,5,1,3,8,17,25,8807
6,6,1,2,9,19,28,8807
7,7,3,4,12,23,35,8807
8,8,1,1,13,24,37,8807
9,9,2,2,15,26,41,8807
10,10,3,2,18,28,46,8807
11,11,1,2,19,30,49,8807
12,12,3,2,22,32,54,8807
13,13,5,2,27,34,61,8807
14,14,2,3,29,37,66,8807
15,15,4,2,33,39,72,8807
16,16,6,4,39,43,82,8807
17,17,5,7,44,50,94,8807
18,18,13,9,57,59,116,8807
19,19,9,12,66,71,137,8807
20,20,7,16,73,87,160,8807
21,21,8,7,81,94,175,8807
22,22,10,9,91,103,194,8807
23,23,14,10,105,113,218,8807
24,24,13,13,118,126,244,8807
25,25,17,13,135,139,274,8807
26,26,12,22,147,161,308,8807
27,27,21,16,168,177,345,8807
28,28,15,16,183,193,376,8807
29,29,20,13,203,206,409,8807
30,30,21,11,224,217,441,8807
31,31,28,11,252,228,480,8807
32,32,23,9,275,237,512,8807
33,33,19,13,294,250,544,8807
34,34,10,15,304,265,569,8807
35,35,5,11,309,276,585,8807
36,36,5,9,314,285,599,8807
37,37,6,8,320,293,613,8807
38,38,4,5,324,298,622,8807
39,39,1,3,325,301,626,8807
40,40,2,1,327,302,629,8807
41,41,1,0,328,302,630,8807
42,42,2,0,330,302,632,8807
43,43,1,0,331,302,633,8807
44,44,0,0,331,302,633,8807
0,0,1,0,1,0,1,8808
1,1,1,0,2,0,2,8808
2,2,1,0,3,0,3,8808
3,3,1,0,4,0,4,8808
4,4,0,0,4,0,4,8808
0,0,1,0,1,0,1,8809
1,1,2,0,3,0,3,8809
2,2,1,0,4,0,4,8809
3,3,1,0,5,0,5,8809
4,4,1,0,6,0,6,8809
5,5,1,1,7,1,8,8809
6,6,2,1,9,2,11,8809
7,7,0,0,9,2,11,8809
0,0,1,0,1,0,1,8810
1,1,1,1,2,1,3,8810
2,2,4,0,6,1,7,8810
3,3,3,0,9,1,10,8810
4,4,2,0,11,1,12,8810
5,5,2,1,13,2,15,8810
6,6,2,1,15,3,18,8810
7,7,3,0,18,3,21,8810
8,8,3,0,21,3,24,8810
9,9,2,1,23,4,27,8810
10,10,2,1,25,5,30,8810
11,11,1,0,26,5,31,8810
12,12,2,0,28,5,33,8810
13,13,0,0,28,5,33,8810
0,0,1,0,1,0,1,8811
1,1,2,0,3,0,3,8811
2,2,1,1,4,1,5,8811
3,3,2,1,6,2,8,8811
4,4,1,0,7,2,9,8811
5,5,1,0,8,2,10,8811
6,6,1,0,9,2,11,8811
7,7,1,1,10,3,13,8811
8,8,0,4,10,7,17,8811
9,9,0,7,10,14,24,8811
10,10,3,5,13,19,32,8811
11,11,5,4,18,23,41,8811
12,12,9,4,27,27,54,8811
13,13,5,7,32,34,66,8811
14,14,5,9,37,43,80,8811
15,15,8,5,45,48,93,8811
16,16,9,7,54,55,109,8811
17,17,6,10,60,65,125,8811
18,18,4,7,64,72,136,8811
19,19,4,6,68,78,146,8811
20,20,3,3,71,81,152,8811
21,21,10,2,81,83,164,8811
22,22,5,3,86,86,172,8811
23,23,4,2,90,88,178,8811
24,24,9,5,99,93,192,8811
25,25,8,4,107,97,204,8811
26,26,5,3,112,100,212,8811
27,27,0,5,112,105,217,8811
28,28,0,5,112,110,222,8811
29,29,1,3,113,113,226,8811
30,30,3,6,116,119,235,8811
31,31,2,4,118,123,241,8811
32,32,2,3,120,126,246,8811
33,33,4,1,124,127,251,8811
34,34,3,1,127,128,255,8811
35,35,5,0,132,128,260,8811
36,36,5,3,137,131,268,8811
37,37,2,5,139,136,275,8811
38,38,2,9,141,145,286,8811
39,39,4,5,145,150,295,8811
40,40,2,7,147,157,304,8811
41,41,3,1,150,158,308,8811
42,42,0,1,150,159,309,8811
43,43,0,0,150,159,309,8811
0,0,1,0,1,0,1,8812
1,1,3,0,4,0,4,8812
2,2,1,0,5,0,5,8812
3,3,1,0,6,0,6,8812
4,4,1,0,7,0,7,8812
5,5,2,0,9,0,9,8812
6,6,1,0,10,0,10,8812
7,7,2,0,12,0,12,8812
8,8,1,0,13,0,13,8812
9,9,0,0,13,0,13,8812
0,0,1,0,1,0,1,8813
1,1,1,0,2,0,2,8813
2,2,0,1,2,1,3,8813
3,3,0,1,2,2,4,8813
4,4,0,0,2,2,4,8813
0,0,1,0,1,0,1,8814
1,1,2,0,3,0,3,8814
2,2,2,0,5,0,5,8814
3,3,1,2,6,2,8,8814
4,4,1,3,7,5,12,8814
5,5,0,1,7,6,13,8814
6,6,0,0,7,6,13,8814
0,0,1,0,1,0,1,8815
1,1,1,1,2,1,3,8815
2,2,1,1,3,2,5,8815
3,3,0,0,3,2,5,8815
0,0,1,0,1,0,1,8816
1,1,0,0,1,0,1,8816
0,0,1,0,1,0,1,8817
1,1,1,0,2,0,2,8817
2,2,1,0,3,0,3,8817
3,3,0,1,3,1,4,8817
4,4,0,1,3,2,5,8817
5,5,0,0,3,2,5,8817
0,0,1,0,1,0,1,8818
1,1,0,0,1,0,1,8818
0,0,1,0,1,0,1,8819
1,1,3,0,4,0,4,8819
2,2,1,1,5,1,6,8819
3,3,0,1,5,2,7,8819
4,4,0,3,5,5,10,8819
5,5,0,2,5,7,12,8819
6,6,1,0,6,7,13,8819
7,7,1,0,7,7,14,8819
8,8,0,1,7,8,15,8819
9,9,0,0,7,8,15,8819
0,0,1,0,1,0,1,8820
1,1,0,0,1,0,1,8820
0,0,1,0,1,0,1,8821
1,1,0,0,1,0,1,8821
0,0,1,0,1,0,1,8822
1,1,1,0,2,0,2,8822
2,2,0,0,2,0,2,8822
0,0,1,0,1,0,1,8823
1,1,3,0,4,0,4,8823
2,2,0,1,4,1,5,8823
3,3,0,1,4,2,6,8823
4,4,0,1,4,3,7,8823
5,5,0,0,4,3,7,8823
0,0,1,0,1,0,1,8824
1,1,0,0,1,0,1,8824
0,0,1,0,1,0,1,8825
1,1,1,0,2,0,2,8825
2,2,1,0,3,0,3,8825
3,3,1,1,4,1,5,8825
4,4,0,0,4,1,5,8825
0,0,1,0,1,0,1,8826
1,1,1,0,2,0,2,8826
2,2,2,0,4,0,4,8826
3,3,2,1,6,1,7,8826
4,4,0,1,6,2,8,8826
5,5,0,0,6,2,8,8826
0,0,1,0,1,0,1,8827
1,1,1,0,2,0,2,8827
2,2,1,0,3,0,3,8827
3,3,1,0,4,0,4,8827
4,4,0,0,4,0,4,8827
0,0,1,0,1,0,1,8828
1,1,3,0,4,0,4,8828
2,2,2,0,6,0,6,8828
3,3,4,1,10,1,11,8828
4,4,1,0,11,1,12,8828
5,5,1,0,12,1,13,8828
6,6,1,0,13,1,14,8828
7,7,0,0,13,1,14,8828
0,0,1,0,1,0,1,8829
1,1,0,0,1,0,1,8829
0,0,1,0,1,0,1,8830
1,1,0,0,1,0,1,8830
0,0,1,0,1,0,1,8831
1,1,0,0,1,0,1,8831
0,0,1,0,1,0,1,8832
1,1,0,1,1,1,2,8832
2,2,0,1,1,2,3,8832
3,3,0,0,1,2,3,8832
0,0,1,0,1,0,1,8833
1,1,0,0,1,0,1,8833
0,0,1,0,1,0,1,8834
1,1,1,0,2,0,2,8834
2,2,1,0,3,0,3,8834
3,3,1,0,4,0,4,8834
4,4,0,0,4,0,4,8834
0,0,1,0,1,0,1,8835
1,1,2,0,3,0,3,8835
2,2,2,1,5,1,6,8835
3,3,4,4,9,5,14,8835
4,4,2,5,11,10,21,8835
5,5,1,6,12,16,28,8835
6,6,0,1,12,17,29,8835
7,7,0,2,12,19,31,8835
8,8,0,0,12,19,31,8835
0,0,1,0,1,0,1,8836
1,1,0,0,1,0,1,8836
0,0,1,0,1,0,1,8837
1,1,2,1,3,1,4,8837
2,2,2,0,5,1,6,8837
3,3,1,0,6,1,7,8837
4,4,0,0,6,1,7,8837
0,0,1,0,1,0,1,8838
1,1,1,0,2,0,2,8838
2,2,1,0,3,0,3,8838
3,3,0,1,3,1,4,8838
4,4,0,1,3,2,5,8838
5,5,2,0,5,2,7,8838
6,6,2,2,7,4,11,8838
7,7,1,0,8,4,12,8838
8,8,1,0,9,4,13,8838
9,9,2,0,11,4,15,8838
10,10,1,1,12,5,17,8838
11,11,0,1,12,6,18,8838
12,12,1,0,13,6,19,8838
13,13,0,0,13,6,19,8838
0,0,1,0,1,0,1,8839
1,1,0,0,1,0,1,8839
0,0,1,0,1,0,1,8840
1,1,2,0,3,0,3,8840
2,2,0,0,3,0,3,8840
0,0,1,0,1,0,1,8841
1,1,0,1,1,1,2,8841
2,2,0,1,1,2,3,8841
3,3,0,4,1,6,7,8841
4,4,3,3,4,9,13,8841
5,5,4,1,8,10,18,8841
6,6,7,1,15,11,26,8841
7,7,6,1,21,12,33,8841
8,8,5,3,26,15,41,8841
9,9,3,4,29,19,48,8841
10,10,2,2,31,21,52,8841
11,11,4,0,35,21,56,8841
12,12,3,1,38,22,60,8841
13,13,1,0,39,22,61,8841
14,14,0,0,39,22,61,8841
0,0,1,0,1,0,1,8842
1,1,1,0,2,0,2,8842
2,2,0,0,2,0,2,8842
0,0,1,0,1,0,1,8843
1,1,0,0,1,0,1,8843
0,0,1,0,1,0,1,8844
1,1,0,0,1,0,1,8844
0,0,1,0,1,0,1,8845
1,1,0,0,1,0,1,8845
0,0,1,0,1,0,1,8846
1,1,1,0,2,0,2,8846
2,2,1,0,3,0,3,8846
3,3,0,0,3,0,3,8846
0,0,1,0,1,0,1,8847
1,1,3,0,4,0,4,8847
2,2,4,2,8,2,10,8847
3,3,3,1,11,3,14,8847
4,4,1,3,12,6,18,8847
5,5,0,3,12,9,21,8847
6,6,0,3,12,12,24,8847
7,7,0,2,12,14,26,8847
8,8,0,1,12,15,27,8847
9,9,0,0,12,15,27,8847
0,0,1,0,1,0,1,8848
1,1,1,2,2,2,4,8848
2,2,1,0,3,2,5,8848
3,3,0,0,3,2,5,8848
0,0,1,0,1,0,1,8849
1,1,2,0,3,0,3,8849
2,2,1,3,4,3,7,8849
3,3,1,3,5,6,11,8849
4,4,1,3,6,9,15,8849
5,5,2,2,8,11,19,8849
6,6,1,6,9,17,26,8849
7,7,1,5,10,22,32,8849
8,8,1,4,11,26,37,8849
9,9,0,2,11,28,39,8849
10,10,0,4,11,32,43,8849
11,11,0,3,11,35,46,8849
12,12,0,5,11,40,51,8849
13,13,0,13,11,53,64,8849
14,14,4,5,15,58,73,8849
15,15,7,8,22,66,88,8849
16,16,5,3,27,69,96,8849
17,17,3,3,30,72,102,8849
18,18,2,2,32,74,106,8849
19,19,1,1,33,75,108,8849
20,20,0,0,33,75,108,8849
0,0,1,0,1,0,1,8850
1,1,0,0,1,0,1,8850
0,0,1,0,1,0,1,8851
1,1,1,0,2,0,2,8851
2,2,1,0,3,0,3,8851
3,3,0,0,3,0,3,8851
0,0,1,0,1,0,1,8852
1,1,0,0,1,0,1,8852
0,0,1,0,1,0,1,8853
1,1,2,0,3,0,3,8853
2,2,0,0,3,0,3,8853
0,0,1,0,1,0,1,8854
1,1,0,0,1,0,1,8854
0,0,1,0,1,0,1,8855
1,1,0,2,1,2,3,8855
2,2,1,1,2,3,5,8855
3,3,2,2,4,5,9,8855
4,4,4,2,8,7,15,8855
5,5,2,3,10,10,20,8855
6,6,2,1,12,11,23,8855
7,7,1,1,13,12,25,8855
8,8,1,2,14,14,28,8855
9,9,2,3,16,17,33,8855
10,10,3,3,19,20,39,8855
11,11,3,3,22,23,45,8855
12,12,6,2,28,25,53,8855
13,13,4,4,32,29,61,8855
14,14,3,7,35,36,71,8855
15,15,5,7,40,43,83,8855
16,16,5,12,45,55,100,8855
17,17,9,13,54,68,122,8855
18,18,13,18,67,86,153,8855
19,19,21,18,88,104,192,8855
20,20,9,13,97,117,214,8855
21,21,8,7,105,124,229,8855
22,22,4,10,109,134,243,8855
23,23,3,8,112,142,254,8855
24,24,4,10,116,152,268,8855
25,25,5,8,121,160,281,8855
26,26,7,4,128,164,292,8855
27,27,3,3,131,167,298,8855
28,28,7,2,138,169,307,8855
29,29,4,3,142,172,314,8855
30,30,2,8,144,180,324,8855
31,31,6,5,150,185,335,8855
32,32,4,3,154,188,342,8855
33,33,2,4,156,192,348,8855
34,34,1,4,157,196,353,8855
35,35,1,1,158,197,355,8855
36,36,1,1,159,198,357,8855
37,37,1,1,160,199,359,8855
38,38,0,0,160,199,359,8855
0,0,1,0,1,0,1,8856
1,1,2,0,3,0,3,8856
2,2,3,1,6,1,7,8856
3,3,4,1,10,2,12,8856
4,4,3,4,13,6,19,8856
5,5,3,4,16,10,26,8856
6,6,0,3,16,13,29,8856
7,7,0,2,16,15,31,8856
8,8,0,2,16,17,33,8856
9,9,0,1,16,18,34,8856
10,10,0,1,16,19,35,8856
11,11,0,0,16,19,35,8856
0,0,1,0,1,0,1,8857
1,1,1,0,2,0,2,8857
2,2,0,0,2,0,2,8857
0,0,1,0,1,0,1,8858
1,1,0,0,1,0,1,8858
0,0,1,0,1,0,1,8859
1,1,0,0,1,0,1,8859
0,0,1,0,1,0,1,8860
1,1,2,0,3,0,3,8860
2,2,0,0,3,0,3,8860
0,0,1,0,1,0,1,8861
1,1,2,0,3,0,3,8861
2,2,1,0,4,0,4,8861
3,3,3,0,7,0,7,8861
4,4,1,0,8,0,8,8861
5,5,0,1,8,1,9,8861
6,6,0,1,8,2,10,8861
7,7,0,0,8,2,10,8861
0,0,1,0,1,0,1,8862
1,1,0,0,1,0,1,8862
0,0,1,0,1,0,1,8863
1,1,1,0,2,0,2,8863
2,2,1,0,3,0,3,8863
3,3,0,0,3,0,3,8863
0,0,1,0,1,0,1,8864
1,1,0,0,1,0,1,8864
0,0,1,0,1,0,1,8865
1,1,1,0,2,0,2,8865
2,2,0,0,2,0,2,8865
0,0,1,0,1,0,1,8866
1,1,0,0,1,0,1,8866
0,0,1,0,1,0,1,8867
1,1,1,1,2,1,3,8867
2,2,2,1,4,2,6,8867
3,3,0,1,4,3,7,8867
4,4,0,0,4,3,7,8867
0,0,1,0,1,0,1,8868
1,1,0,0,1,0,1,8868
0,0,1,0,1,0,1,8869
1,1,0,0,1,0,1,8869
0,0,1,0,1,0,1,8870
1,1,0,0,1,0,1,8870
0,0,1,0,1,0,1,8871
1,1,1,0,2,0,2,8871
2,2,2,0,4,0,4,8871
3,3,1,0,5,0,5,8871
4,4,0,0,5,0,5,8871
0,0,1,0,1,0,1,8872
1,1,1,0,2,0,2,8872
2,2,1,1,3,1,4,8872
3,3,0,2,3,3,6,8872
4,4,0,2,3,5,8,8872
5,5,0,0,3,5,8,8872
0,0,1,0,1,0,1,8873
1,1,0,0,1,0,1,8873
0,0,1,0,1,0,1,8874
1,1,1,0,2,0,2,8874
2,2,2,0,4,0,4,8874
3,3,2,0,6,0,6,8874
4,4,2,0,8,0,8,8874
5,5,1,2,9,2,11,8874
6,6,0,0,9,2,11,8874
0,0,1,0,1,0,1,8875
1,1,1,0,2,0,2,8875
2,2,2,0,4,0,4,8875
3,3,5,1,9,1,10,8875
4,4,5,1,14,2,16,8875
5,5,3,1,17,3,20,8875
6,6,4,0,21,3,24,8875
7,7,0,3,21,6,27,8875
8,8,0,2,21,8,29,8875
9,9,0,0,21,8,29,8875
0,0,1,0,1,0,1,8876
1,1,2,0,3,0,3,8876
2,2,2,0,5,0,5,8876
3,3,1,0,6,0,6,8876
4,4,1,0,7,0,7,8876
5,5,0,1,7,1,8,8876
6,6,1,0,8,1,9,8876
7,7,2,0,10,1,11,8876
8,8,2,2,12,3,15,8876
9,9,1,2,13,5,18,8876
10,10,0,0,13,5,18,8876
0,0,1,0,1,0,1,8877
1,1,0,0,1,0,1,8877
0,0,1,0,1,0,1,8878
1,1,0,0,1,0,1,8878
0,0,1,0,1,0,1,8879
1,1,2,0,3,0,3,8879
2,2,3,0,6,0,6,8879
3,3,0,0,6,0,6,8879
0,0,1,0,1,0,1,8880
1,1,0,0,1,0,1,8880
0,0,1,0,1,0,1,8881
1,1,3,1,4,1,5,8881
2,2,2,2,6,3,9,8881
3,3,0,2,6,5,11,8881
4,4,1,3,7,8,15,8881
5,5,1,4,8,12,20,8881
6,6,0,1,8,13,21,8881
7,7,0,2,8,15,23,8881
8,8,0,0,8,15,23,8881
0,0,1,0,1,0,1,8882
1,1,0,0,1,0,1,8882
0,0,1,0,1,0,1,8883
1,1,0,0,1,0,1,8883
0,0,1,0,1,0,1,8884
1,1,0,0,1,0,1,8884
0,0,1,0,1,0,1,8885
1,1,1,0,2,0,2,8885
2,2,1,0,3,0,3,8885
3,3,0,0,3,0,3,8885
0,0,1,0,1,0,1,8886
1,1,1,0,2,0,2,8886
2,2,0,1,2,1,3,8886
3,3,0,0,2,1,3,8886
0,0,1,0,1,0,1,8887
1,1,2,0,3,0,3,8887
2,2,3,0,6,0,6,8887
3,3,3,1,9,1,10,8887
4,4,2,1,11,2,13,8887
5,5,1,0,12,2,14,8887
6,6,1,1,13,3,16,8887
7,7,0,0,13,3,16,8887
0,0,1,0,1,0,1,8888
1,1,1,0,2,0,2,8888
2,2,1,0,3,0,3,8888
3,3,2,0,5,0,5,8888
4,4,4,0,9,0,9,8888
5,5,4,4,13,4,17,8888
6,6,5,5,18,9,27,8888
7,7,2,6,20,15,35,8888
8,8,2,5,22,20,42,8888
9,9,4,3,26,23,49,8888
10,10,2,5,28,28,56,8888
11,11,2,1,30,29,59,8888
12,12,5,1,35,30,65,8888
13,13,4,3,39,33,72,8888
14,14,4,2,43,35,78,8888
15,15,5,0,48,35,83,8888
16,16,2,0,50,35,85,8888
17,17,1,1,51,36,87,8888
18,18,0,3,51,39,90,8888
19,19,1,2,52,41,93,8888
20,20,1,3,53,44,97,8888
21,21,2,4,55,48,103,8888
22,22,0,5,55,53,108,8888
23,23,2,4,57,57,114,8888
24,24,1,5,58,62,120,8888
25,25,1,4,59,66,125,8888
26,26,1,2,60,68,128,8888
27,27,1,1,61,69,130,8888
28,28,0,0,61,69,130,8888
0,0,1,0,1,0,1,8889
1,1,0,0,1,0,1,8889
0,0,1,0,1,0,1,8890
1,1,0,0,1,0,1,8890
0,0,1,0,1,0,1,8891
1,1,0,0,1,0,1,8891
0,0,1,0,1,0,1,8892
1,1,0,0,1,0,1,8892
0,0,1,0,1,0,1,8893
1,1,1,0,2,0,2,8893
2,2,1,0,3,0,3,8893
3,3,1,0,4,0,4,8893
4,4,2,2,6,2,8,8893
5,5,1,3,7,5,12,8893
6,6,1,1,8,6,14,8893
7,7,3,0,11,6,17,8893
8,8,1,1,12,7,19,8893
9,9,2,0,14,7,21,8893
10,10,1,0,15,7,22,8893
11,11,1,0,16,7,23,8893
12,12,0,1,16,8,24,8893
13,13,0,1,16,9,25,8893
14,14,0,0,16,9,25,8893
0,0,1,0,1,0,1,8894
1,1,1,0,2,0,2,8894
2,2,1,0,3,0,3,8894
3,3,1,1,4,1,5,8894
4,4,2,2,6,3,9,8894
5,5,1,1,7,4,11,8894
6,6,1,0,8,4,12,8894
7,7,1,0,9,4,13,8894
8,8,1,0,10,4,14,8894
9,9,0,0,10,4,14,8894
0,0,1,0,1,0,1,8895
1,1,2,0,3,0,3,8895
2,2,1,0,4,0,4,8895
3,3,0,1,4,1,5,8895
4,4,0,1,4,2,6,8895
5,5,0,0,4,2,6,8895
0,0,1,0,1,0,1,8896
1,1,0,0,1,0,1,8896
0,0,1,0,1,0,1,8897
1,1,1,0,2,0,2,8897
2,2,0,1,2,1,3,8897
3,3,0,0,2,1,3,8897
0,0,1,0,1,0,1,8898
1,1,2,0,3,0,3,8898
2,2,0,0,3,0,3,8898
0,0,1,0,1,0,1,8899
1,1,0,0,1,0,1,8899
0,0,1,0,1,0,1,8900
1,1,0,0,1,0,1,8900
0,0,1,0,1,0,1,8901
1,1,0,0,1,0,1,8901
0,0,1,0,1,0,1,8902
1,1,2,0,3,0,3,8902
2,2,0,0,3,0,3,8902
0,0,1,0,1,0,1,8903
1,1,1,1,2,1,3,8903
2,2,0,0,2,1,3,8903
0,0,1,0,1,0,1,8904
1,1,0,0,1,0,1,8904
0,0,1,0,1,0,1,8905
1,1,0,0,1,0,1,8905
0,0,1,0,1,0,1,8906
1,1,0,1,1,1,2,8906
2,2,0,1,1,2,3,8906
3,3,0,1,1,3,4,8906
4,4,0,0,1,3,4,8906
0,0,1,0,1,0,1,8907
1,1,0,0,1,0,1,8907
0,0,1,0,1,0,1,8908
1,1,2,1,3,1,4,8908
2,2,4,1,7,2,9,8908
3,3,6,2,13,4,17,8908
4,4,2,3,15,7,22,8908
5,5,0,2,15,9,24,8908
6,6,1,0,16,9,25,8908
7,7,0,0,16,9,25,8908
0,0,1,0,1,0,1,8909
1,1,4,0,5,0,5,8909
2,2,1,1,6,1,7,8909
3,3,0,0,6,1,7,8909
0,0,1,0,1,0,1,8910
1,1,0,0,1,0,1,8910
0,0,1,0,1,0,1,8911
1,1,0,0,1,0,1,8911
0,0,1,0,1,0,1,8912
1,1,0,0,1,0,1,8912
0,0,1,0,1,0,1,8913
1,1,0,0,1,0,1,8913
0,0,1,0,1,0,1,8914
1,1,0,0,1,0,1,8914
0,0,1,0,1,0,1,8915
1,1,2,0,3,0,3,8915
2,2,2,0,5,0,5,8915
3,3,2,0,7,0,7,8915
4,4,1,0,8,0,8,8915
5,5,1,0,9,0,9,8915
6,6,0,0,9,0,9,8915
0,0,1,0,1,0,1,8916
1,1,0,0,1,0,1,8916
0,0,1,0,1,0,1,8917
1,1,1,0,2,0,2,8917
2,2,0,0,2,0,2,8917
0,0,1,0,1,0,1,8918
1,1,0,1,1,1,2,8918
2,2,0,2,1,3,4,8918
3,3,2,2,3,5,8,8918
4,4,2,1,5,6,11,8918
5,5,2,0,7,6,13,8918
6,6,0,0,7,6,13,8918
0,0,1,0,1,0,1,8919
1,1,1,0,2,0,2,8919
2,2,0,0,2,0,2,8919
0,0,1,0,1,0,1,8920
1,1,2,0,3,0,3,8920
2,2,2,1,5,1,6,8920
3,3,1,0,6,1,7,8920
4,4,0,0,6,1,7,8920
0,0,1,0,1,0,1,8921
1,1,2,0,3,0,3,8921
2,2,1,0,4,0,4,8921
3,3,0,1,4,1,5,8921
4,4,0,1,4,2,6,8921
5,5,0,1,4,3,7,8921
6,6,0,0,4,3,7,8921
0,0,1,0,1,0,1,8922
1,1,0,0,1,0,1,8922
0,0,1,0,1,0,1,8923
1,1,0,1,1,1,2,8923
2,2,0,2,1,3,4,8923
3,3,0,2,1,5,6,8923
4,4,0,1,1,6,7,8923
5,5,0,1,1,7,8,8923
6,6,0,0,1,7,8,8923
0,0,1,0,1,0,1,8924
1,1,0,0,1,0,1,8924
0,0,1,0,1,0,1,8925
1,1,0,0,1,0,1,8925
0,0,1,0,1,0,1,8926
1,1,1,0,2,0,2,8926
2,2,1,0,3,0,3,8926
3,3,1,0,4,0,4,8926
4,4,0,0,4,0,4,8926
0,0,1,0,1,0,1,8927
1,1,1,0,2,0,2,8927
2,2,1,0,3,0,3,8927
3,3,0,1,3,1,4,8927
4,4,0,0,3,1,4,8927
0,0,1,0,1,0,1,8928
1,1,1,0,2,0,2,8928
2,2,0,0,2,0,2,8928
0,0,1,0,1,0,1,8929
1,1,0,0,1,0,1,8929
0,0,1,0,1,0,1,8930
1,1,2,0,3,0,3,8930
2,2,1,1,4,1,5,8930
3,3,0,1,4,2,6,8930
4,4,1,0,5,2,7,8930
5,5,0,0,5,2,7,8930
0,0,1,0,1,0,1,8931
1,1,0,1,1,1,2,8931
2,2,0,2,1,3,4,8931
3,3,0,2,1,5,6,8931
4,4,0,1,1,6,7,8931
5,5,0,0,1,6,7,8931
0,0,1,0,1,0,1,8932
1,1,0,0,1,0,1,8932
0,0,1,0,1,0,1,8933
1,1,0,0,1,0,1,8933
0,0,1,0,1,0,1,8934
1,1,0,0,1,0,1,8934
0,0,1,0,1,0,1,8935
1,1,1,0,2,0,2,8935
2,2,0,0,2,0,2,8935
0,0,1,0,1,0,1,8936
1,1,0,0,1,0,1,8936
0,0,1,0,1,0,1,8937
1,1,4,0,5,0,5,8937
2,2,1,2,6,2,8,8937
3,3,1,0,7,2,9,8937
4,4,1,0,8,2,10,8937
5,5,1,1,9,3,12,8937
6,6,2,0,11,3,14,8937
7,7,1,1,12,4,16,8937
8,8,1,1,13,5,18,8937
9,9,1,0,14,5,19,8937
10,10,2,0,16,5,21,8937
11,11,1,0,17,5,22,8937
12,12,1,0,18,5,23,8937
13,13,1,0,19,5,24,8937
14,14,0,1,19,6,25,8937
15,15,0,0,19,6,25,8937
0,0,1,0,1,0,1,8938
1,1,0,0,1,0,1,8938
0,0,1,0,1,0,1,8939
1,1,1,0,2,0,2,8939
2,2,0,0,2,0,2,8939
0,0,1,0,1,0,1,8940
1,1,0,0,1,0,1,8940
0,0,1,0,1,0,1,8941
1,1,0,0,1,0,1,8941
0,0,1,0,1,0,1,8942
1,1,1,1,2,1,3,8942
2,2,1,0,3,1,4,8942
3,3,1,0,4,1,5,8942
4,4,1,1,5,2,7,8942
5,5,2,0,7,2,9,8942
6,6,2,0,9,2,11,8942
7,7,2,1,11,3,14,8942
8,8,3,0,14,3,17,8942
9,9,3,0,17,3,20,8942
10,10,1,0,18,3,21,8942
11,11,0,1,18,4,22,8942
12,12,0,1,18,5,23,8942
13,13,0,1,18,6,24,8942
14,14,0,0,18,6,24,8942
0,0,1,0,1,0,1,8943
1,1,0,0,1,0,1,8943
0,0,1,0,1,0,1,8944
1,1,1,0,2,0,2,8944
2,2,1,0,3,0,3,8944
3,3,0,0,3,0,3,8944
0,0,1,0,1,0,1,8945
1,1,0,1,1,1,2,8945
2,2,0,1,1,2,3,8945
3,3,0,0,1,2,3,8945
0,0,1,0,1,0,1,8946
1,1,0,0,1,0,1,8946
0,0,1,0,1,0,1,8947
1,1,1,0,2,0,2,8947
2,2,0,0,2,0,2,8947
0,0,1,0,1,0,1,8948
1,1,2,0,3,0,3,8948
2,2,4,0,7,0,7,8948
3,3,4,1,11,1,12,8948
4,4,6,0,17,1,18,8948
5,5,2,2,19,3,22,8948
6,6,4,1,23,4,27,8948
7,7,3,2,26,6,32,8948
8,8,4,2,30,8,38,8948
9,9,1,5,31,13,44,8948
10,10,3,4,34,17,51,8948
11,11,3,0,37,17,54,8948
12,12,1,0,38,17,55,8948
13,13,0,0,38,17,55,8948
0,0,1,0,1,0,1,8949
1,1,2,0,3,0,3,8949
2,2,4,0,7,0,7,8949
3,3,1,0,8,0,8,8949
4,4,1,0,9,0,9,8949
5,5,0,1,9,1,10,8949
6,6,0,0,9,1,10,8949
0,0,1,0,1,0,1,8950
1,1,2,1,3,1,4,8950
2,2,2,1,5,2,7,8950
3,3,0,1,5,3,8,8950
4,4,0,0,5,3,8,8950
0,0,1,0,1,0,1,8951
1,1,0,0,1,0,1,8951
0,0,1,0,1,0,1,8952
1,1,0,0,1,0,1,8952
0,0,1,0,1,0,1,8953
1,1,0,0,1,0,1,8953
0,0,1,0,1,0,1,8954
1,1,2,0,3,0,3,8954
2,2,1,0,4,0,4,8954
3,3,0,0,4,0,4,8954
0,0,1,0,1,0,1,8955
1,1,0,0,1,0,1,8955
0,0,1,0,1,0,1,8956
1,1,0,0,1,0,1,8956
0,0,1,0,1,0,1,8957
1,1,0,0,1,0,1,8957
0,0,1,0,1,0,1,8958
1,1,1,0,2,0,2,8958
2,2,0,0,2,0,2,8958
0,0,1,0,1,0,1,8959
1,1,1,0,2,0,2,8959
2,2,3,0,5,0,5,8959
3,3,2,0,7,0,7,8959
4,4,2,1,9,1,10,8959
5,5,0,0,9,1,10,8959
0,0,1,0,1,0,1,8960
1,1,2,0,3,0,3,8960
2,2,1,0,4,0,4,8960
3,3,0,0,4,0,4,8960
0,0,1,0,1,0,1,8961
1,1,0,0,1,0,1,8961
0,0,1,0,1,0,1,8962
1,1,1,0,2,0,2,8962
2,2,2,0,4,0,4,8962
3,3,5,0,9,0,9,8962
4,4,1,1,10,1,11,8962
5,5,0,1,10,2,12,8962
6,6,0,2,10,4,14,8962
7,7,0,1,10,5,15,8962
8,8,0,0,10,5,15,8962
0,0,1,0,1,0,1,8963
1,1,2,0,3,0,3,8963
2,2,0,0,3,0,3,8963
0,0,1,0,1,0,1,8964
1,1,1,0,2,0,2,8964
2,2,0,0,2,0,2,8964
0,0,1,0,1,0,1,8965
1,1,1,0,2,0,2,8965
2,2,0,0,2,0,2,8965
0,0,1,0,1,0,1,8966
1,1,1,1,2,1,3,8966
2,2,1,1,3,2,5,8966
3,3,0,0,3,2,5,8966
0,0,1,0,1,0,1,8967
1,1,1,0,2,0,2,8967
2,2,2,0,4,0,4,8967
3,3,0,0,4,0,4,8967
0,0,1,0,1,0,1,8968
1,1,0,0,1,0,1,8968
0,0,1,0,1,0,1,8969
1,1,0,0,1,0,1,8969
0,0,1,0,1,0,1,8970
1,1,5,0,6,0,6,8970
2,2,2,1,8,1,9,8970
3,3,1,2,9,3,12,8970
4,4,3,4,12,7,19,8970
5,5,3,3,15,10,25,8970
6,6,0,4,15,14,29,8970
7,7,2,3,17,17,34,8970
8,8,3,1,20,18,38,8970
9,9,3,0,23,18,41,8970
10,10,5,1,28,19,47,8970
11,11,7,1,35,20,55,8970
12,12,2,1,37,21,58,8970
13,13,2,0,39,21,60,8970
14,14,0,2,39,23,62,8970
15,15,0,1,39,24,63,8970
16,16,0,1,39,25,64,8970
17,17,0,0,39,25,64,8970
0,0,1,0,1,0,1,8971
1,1,0,2,1,2,3,8971
2,2,1,1,2,3,5,8971
3,3,1,0,3,3,6,8971
4,4,0,0,3,3,6,8971
0,0,1,0,1,0,1,8972
1,1,0,0,1,0,1,8972
0,0,1,0,1,0,1,8973
1,1,0,0,1,0,1,8973
0,0,1,0,1,0,1,8974
1,1,4,1,5,1,6,8974
2,2,2,0,7,1,8,8974
3,3,3,1,10,2,12,8974
4,4,4,6,14,8,22,8974
5,5,2,6,16,14,30,8974
6,6,4,4,20,18,38,8974
7,7,3,4,23,22,45,8974
8,8,4,4,27,26,53,8974
9,9,5,1,32,27,59,8974
10,10,5,4,37,31,68,8974
11,11,4,5,41,36,77,8974
12,12,8,6,49,42,91,8974
13,13,8,6,57,48,105,8974
14,14,6,7,63,55,118,8974
15,15,3,8,66,63,129,8974
16,16,5,6,71,69,140,8974
17,17,6,6,77,75,152,8974
18,18,4,6,81,81,162,8974
19,19,6,3,87,84,171,8974
20,20,8,2,95,86,181,8974
21,21,7,8,102,94,196,8974
22,22,6,7,108,101,209,8974
23,23,7,6,115,107,222,8974
24,24,8,6,123,113,236,8974
25,25,7,5,130,118,248,8974
26,26,3,5,133,123,256,8974
27,27,5,6,138,129,267,8974
28,28,5,6,143,135,278,8974
29,29,8,1,151,136,287,8974
30,30,9,2,160,138,298,8974
31,31,5,3,165,141,306,8974
32,32,5,6,170,147,317,8974
33,33,4,1,174,148,322,8974
34,34,3,1,177,149,326,8974
35,35,1,0,178,149,327,8974
36,36,4,0,182,149,331,8974
37,37,1,2,183,151,334,8974
38,38,1,2,184,153,337,8974
39,39,3,0,187,153,340,8974
40,40,6,0,193,153,346,8974
41,41,7,1,200,154,354,8974
42,42,4,1,204,155,359,8974
43,43,2,1,206,156,362,8974
44,44,2,1,208,157,365,8974
45,45,3,0,211,157,368,8974
46,46,4,2,215,159,374,8974
47,47,6,0,221,159,380,8974
48,48,4,1,225,160,385,8974
49,49,4,2,229,162,391,8974
50,50,5,1,234,163,397,8974
51,51,2,0,236,163,399,8974
52,52,4,0,240,163,403,8974
53,53,4,0,244,163,407,8974
54,54,4,3,248,166,414,8974
55,55,3,2,251,168,419,8974
56,56,2,0,253,168,421,8974
57,57,4,0,257,168,425,8974
58,58,5,0,262,168,430,8974
59,59,5,0,267,168,435,8974
60,60,4,0,271,168,439,8974
61,61,2,2,273,170,443,8974
62,62,1,4,274,174,448,8974
63,63,1,3,275,177,452,8974
64,64,0,2,275,179,454,8974
65,65,0,1,275,180,455,8974
66,66,0,0,275,180,455,8974
0,0,1,0,1,0,1,8975
1,1,1,0,2,0,2,8975
2,2,2,0,4,0,4,8975
3,3,0,0,4,0,4,8975
0,0,1,0,1,0,1,8976
1,1,0,0,1,0,1,8976
0,0,1,0,1,0,1,8977
1,1,1,0,2,0,2,8977
2,2,0,0,2,0,2,8977
0,0,1,0,1,0,1,8978
1,1,2,0,3,0,3,8978
2,2,2,0,5,0,5,8978
3,3,0,0,5,0,5,8978
0,0,1,0,1,0,1,8979
1,1,1,0,2,0,2,8979
2,2,1,0,3,0,3,8979
3,3,1,0,4,0,4,8979
4,4,0,0,4,0,4,8979
0,0,1,0,1,0,1,8980
1,1,0,0,1,0,1,8980
0,0,1,0,1,0,1,8981
1,1,1,0,2,0,2,8981
2,2,0,0,2,0,2,8981
0,0,1,0,1,0,1,8982
1,1,3,0,4,0,4,8982
2,2,3,0,7,0,7,8982
3,3,1,1,8,1,9,8982
4,4,3,0,11,1,12,8982
5,5,2,2,13,3,16,8982
6,6,1,5,14,8,22,8982
7,7,1,4,15,12,27,8982
8,8,0,0,15,12,27,8982
0,0,1,0,1,0,1,8983
1,1,0,0,1,0,1,8983
0,0,1,0,1,0,1,8984
1,1,1,1,2,1,3,8984
2,2,0,1,2,2,4,8984
3,3,0,2,2,4,6,8984
4,4,0,0,2,4,6,8984
0,0,1,0,1,0,1,8985
1,1,0,0,1,0,1,8985
0,0,1,0,1,0,1,8986
1,1,1,0,2,0,2,8986
2,2,0,0,2,0,2,8986
0,0,1,0,1,0,1,8987
1,1,0,0,1,0,1,8987
0,0,1,0,1,0,1,8988
1,1,0,0,1,0,1,8988
0,0,1,0,1,0,1,8989
1,1,0,0,1,0,1,8989
0,0,1,0,1,0,1,8990
1,1,0,0,1,0,1,8990
0,0,1,0,1,0,1,8991
1,1,0,0,1,0,1,8991
0,0,1,0,1,0,1,8992
1,1,0,0,1,0,1,8992
0,0,1,0,1,0,1,8993
1,1,2,0,3,0,3,8993
2,2,2,0,5,0,5,8993
3,3,0,1,5,1,6,8993
4,4,0,0,5,1,6,8993
0,0,1,0,1,0,1,8994
1,1,0,0,1,0,1,8994
0,0,1,0,1,0,1,8995
1,1,1,0,2,0,2,8995
2,2,1,0,3,0,3,8995
3,3,2,0,5,0,5,8995
4,4,3,0,8,0,8,8995
5,5,3,1,11,1,12,8995
6,6,5,2,16,3,19,8995
7,7,3,2,19,5,24,8995
8,8,1,3,20,8,28,8995
9,9,0,2,20,10,30,8995
10,10,0,2,20,12,32,8995
11,11,0,1,20,13,33,8995
12,12,0,0,20,13,33,8995
0,0,1,0,1,0,1,8996
1,1,1,2,2,2,4,8996
2,2,1,0,3,2,5,8996
3,3,1,0,4,2,6,8996
4,4,2,0,6,2,8,8996
5,5,3,1,9,3,12,8996
6,6,1,2,10,5,15,8996
7,7,3,1,13,6,19,8996
8,8,2,1,15,7,22,8996
9,9,1,4,16,11,27,8996
10,10,0,4,16,15,31,8996
11,11,0,3,16,18,34,8996
12,12,2,3,18,21,39,8996
13,13,2,5,20,26,46,8996
14,14,1,2,21,28,49,8996
15,15,1,2,22,30,52,8996
16,16,0,1,22,31,53,8996
17,17,0,0,22,31,53,8996
0,0,1,0,1,0,1,8997
1,1,1,0,2,0,2,8997
2,2,0,0,2,0,2,8997
0,0,1,0,1,0,1,8998
1,1,0,0,1,0,1,8998
0,0,1,0,1,0,1,8999
1,1,0,0,1,0,1,8999
0,0,1,0,1,0,1,9000
1,1,0,1,1,1,2,9000
2,2,0,0,1,1,2,9000
0,0,1,0,1,0,1,9001
1,1,0,0,1,0,1,9001
0,0,1,0,1,0,1,9002
1,1,1,0,2,0,2,9002
2,2,1,1,3,1,4,9002
3,3,0,2,3,3,6,9002
4,4,0,1,3,4,7,9002
5,5,0,0,3,4,7,9002
0,0,1,0,1,0,1,9003
1,1,1,0,2,0,2,9003
2,2,2,0,4,0,4,9003
3,3,3,1,7,1,8,9003
4,4,1,0,8,1,9,9003
5,5,1,0,9,1,10,9003
6,6,0,0,9,1,10,9003
0,0,1,0,1,0,1,9004
1,1,2,0,3,0,3,9004
2,2,3,1,6,1,7,9004
3,3,2,1,8,2,10,9004
4,4,1,0,9,2,11,9004
5,5,1,0,10,2,12,9004
6,6,0,1,10,3,13,9004
7,7,0,0,10,3,13,9004
0,0,1,0,1,0,1,9005
1,1,1,1,2,1,3,9005
2,2,0,0,2,1,3,9005
0,0,1,0,1,0,1,9006
1,1,0,0,1,0,1,9006
0,0,1,0,1,0,1,9007
1,1,1,0,2,0,2,9007
2,2,1,0,3,0,3,9007
3,3,1,0,4,0,4,9007
4,4,0,0,4,0,4,9007
0,0,1,0,1,0,1,9008
1,1,1,1,2,1,3,9008
2,2,2,1,4,2,6,9008
3,3,1,0,5,2,7,9008
4,4,1,0,6,2,8,9008
5,5,0,0,6,2,8,9008
0,0,1,0,1,0,1,9009
1,1,2,0,3,0,3,9009
2,2,3,0,6,0,6,9009
3,3,3,0,9,0,9,9009
4,4,1,0,10,0,10,9009
5,5,0,1,10,1,11,9009
6,6,0,0,10,1,11,9009
0,0,1,0,1,0,1,9010
1,1,0,0,1,0,1,9010
0,0,1,0,1,0,1,9011
1,1,0,0,1,0,1,9011
0,0,1,0,1,0,1,9012
1,1,0,0,1,0,1,9012
0,0,1,0,1,0,1,9013
1,1,0,1,1,1,2,9013
2,2,0,0,1,1,2,9013
0,0,1,0,1,0,1,9014
1,1,1,0,2,0,2,9014
2,2,1,0,3,0,3,9014
3,3,0,1,3,1,4,9014
4,4,0,1,3,2,5,9014
5,5,0,1,3,3,6,9014
6,6,0,0,3,3,6,9014
0,0,1,0,1,0,1,9015
1,1,2,0,3,0,3,9015
2,2,1,1,4,1,5,9015
3,3,0,0,4,1,5,9015
0,0,1,0,1,0,1,9016
1,1,1,0,2,0,2,9016
2,2,0,0,2,0,2,9016
0,0,1,0,1,0,1,9017
1,1,1,0,2,0,2,9017
2,2,1,1,3,1,4,9017
3,3,1,0,4,1,5,9017
4,4,0,0,4,1,5,9017
0,0,1,0,1,0,1,9018
1,1,0,0,1,0,1,9018
0,0,1,0,1,0,1,9019
1,1,2,0,3,0,3,9019
2,2,3,0,6,0,6,9019
3,3,4,1,10,1,11,9019
4,4,3,1,13,2,15,9019
5,5,2,3,15,5,20,9019
6,6,0,6,15,11,26,9019
7,7,1,6,16,17,33,9019
8,8,1,4,17,21,38,9019
9,9,1,6,18,27,45,9019
10,10,2,4,20,31,51,9019
11,11,2,3,22,34,56,9019
12,12,1,4,23,38,61,9019
13,13,1,0,24,38,62,9019
14,14,1,1,25,39,64,9019
15,15,1,0,26,39,65,9019
16,16,2,0,28,39,67,9019
17,17,1,1,29,40,69,9019
18,18,2,2,31,42,73,9019
19,19,2,6,33,48,81,9019
20,20,4,7,37,55,92,9019
21,21,4,9,41,64,105,9019
22,22,5,6,46,70,116,9019
23,23,4,3,50,73,123,9019
24,24,8,1,58,74,132,9019
25,25,3,1,61,75,136,9019
26,26,3,2,64,77,141,9019
27,27,0,3,64,80,144,9019
28,28,0,3,64,83,147,9019
29,29,1,4,65,87,152,9019
30,30,2,2,67,89,156,9019
31,31,1,3,68,92,160,9019
32,32,0,3,68,95,163,9019
33,33,0,2,68,97,165,9019
34,34,1,1,69,98,167,9019
35,35,1,0,70,98,168,9019
36,36,2,1,72,99,171,9019
37,37,2,2,74,101,175,9019
38,38,0,1,74,102,176,9019
39,39,0,2,74,104,178,9019
40,40,1,2,75,106,181,9019
41,41,2,2,77,108,185,9019
42,42,1,1,78,109,187,9019
43,43,3,0,81,109,190,9019
44,44,3,1,84,110,194,9019
45,45,2,2,86,112,198,9019
46,46,2,0,88,112,200,9019
47,47,4,1,92,113,205,9019
48,48,2,1,94,114,208,9019
49,49,3,1,97,115,212,9019
50,50,0,1,97,116,213,9019
51,51,0,0,97,116,213,9019
0,0,1,0,1,0,1,9020
1,1,2,0,3,0,3,9020
2,2,0,0,3,0,3,9020
0,0,1,0,1,0,1,9021
1,1,0,0,1,0,1,9021
0,0,1,0,1,0,1,9022
1,1,1,0,2,0,2,9022
2,2,1,1,3,1,4,9022
3,3,0,1,3,2,5,9022
4,4,0,0,3,2,5,9022
0,0,1,0,1,0,1,9023
1,1,0,0,1,0,1,9023
0,0,1,0,1,0,1,9024
1,1,2,0,3,0,3,9024
2,2,2,0,5,0,5,9024
3,3,1,0,6,0,6,9024
4,4,0,0,6,0,6,9024
0,0,1,0,1,0,1,9025
1,1,0,0,1,0,1,9025
0,0,1,0,1,0,1,9026
1,1,0,1,1,1,2,9026
2,2,1,0,2,1,3,9026
3,3,1,0,3,1,4,9026
4,4,1,0,4,1,5,9026
5,5,0,0,4,1,5,9026
0,0,1,0,1,0,1,9027
1,1,1,0,2,0,2,9027
2,2,0,0,2,0,2,9027
0,0,1,0,1,0,1,9028
1,1,1,0,2,0,2,9028
2,2,1,1,3,1,4,9028
3,3,0,0,3,1,4,9028
0,0,1,0,1,0,1,9029
1,1,1,0,2,0,2,9029
2,2,1,1,3,1,4,9029
3,3,2,0,5,1,6,9029
4,4,1,0,6,1,7,9029
5,5,0,0,6,1,7,9029
0,0,1,0,1,0,1,9030
1,1,0,0,1,0,1,9030
0,0,1,0,1,0,1,9031
1,1,0,0,1,0,1,9031
0,0,1,0,1,0,1,9032
1,1,0,1,1,1,2,9032
2,2,0,0,1,1,2,9032
0,0,1,0,1,0,1,9033
1,1,1,0,2,0,2,9033
2,2,2,0,4,0,4,9033
3,3,1,0,5,0,5,9033
4,4,0,0,5,0,5,9033
0,0,1,0,1,0,1,9034
1,1,1,0,2,0,2,9034
2,2,1,0,3,0,3,9034
3,3,0,0,3,0,3,9034
0,0,1,0,1,0,1,9035
1,1,0,1,1,1,2,9035
2,2,0,2,1,3,4,9035
3,3,0,0,1,3,4,9035
0,0,1,0,1,0,1,9036
1,1,1,1,2,1,3,9036
2,2,1,0,3,1,4,9036
3,3,0,1,3,2,5,9036
4,4,0,0,3,2,5,9036
0,0,1,0,1,0,1,9037
1,1,0,0,1,0,1,9037
0,0,1,0,1,0,1,9038
1,1,1,0,2,0,2,9038
2,2,0,0,2,0,2,9038
0,0,1,0,1,0,1,9039
1,1,0,0,1,0,1,9039
0,0,1,0,1,0,1,9040
1,1,0,0,1,0,1,9040
0,0,1,0,1,0,1,9041
1,1,1,0,2,0,2,9041
2,2,1,2,3,2,5,9041
3,3,1,0,4,2,6,9041
4,4,1,0,5,2,7,9041
5,5,2,0,7,2,9,9041
6,6,2,1,9,3,12,9041
7,7,1,1,10,4,14,9041
8,8,1,1,11,5,16,9041
9,9,0,1,11,6,17,9041
10,10,0,0,11,6,17,9041
0,0,1,0,1,0,1,9042
1,1,0,0,1,0,1,9042
0,0,1,0,1,0,1,9043
1,1,0,0,1,0,1,9043
0,0,1,0,1,0,1,9044
1,1,1,1,2,1,3,9044
2,2,0,1,2,2,4,9044
3,3,0,0,2,2,4,9044
0,0,1,0,1,0,1,9045
1,1,0,0,1,0,1,9045
0,0,1,0,1,0,1,9046
1,1,0,0,1,0,1,9046
0,0,1,0,1,0,1,9047
1,1,1,0,2,0,2,9047
2,2,0,1,2,1,3,9047
3,3,1,1,3,2,5,9047
4,4,0,1,3,3,6,9047
5,5,0,1,3,4,7,9047
6,6,0,1,3,5,8,9047
7,7,1,2,4,7,11,9047
8,8,0,1,4,8,12,9047
9,9,0,0,4,8,12,9047
0,0,1,0,1,0,1,9048
1,1,2,1,3,1,4,9048
2,2,1,2,4,3,7,9048
3,3,1,1,5,4,9,9048
4,4,0,0,5,4,9,9048
0,0,1,0,1,0,1,9049
1,1,0,0,1,0,1,9049
0,0,1,0,1,0,1,9050
1,1,0,1,1,1,2,9050
2,2,0,0,1,1,2,9050
0,0,1,0,1,0,1,9051
1,1,0,0,1,0,1,9051
0,0,1,0,1,0,1,9052
1,1,0,0,1,0,1,9052
0,0,1,0,1,0,1,9053
1,1,0,0,1,0,1,9053
0,0,1,0,1,0,1,9054
1,1,1,1,2,1,3,9054
2,2,1,2,3,3,6,9054
3,3,1,1,4,4,8,9054
4,4,0,2,4,6,10,9054
5,5,1,2,5,8,13,9054
6,6,1,1,6,9,15,9054
7,7,1,2,7,11,18,9054
8,8,2,2,9,13,22,9054
9,9,0,1,9,14,23,9054
10,10,0,0,9,14,23,9054
0,0,1,0,1,0,1,9055
1,1,1,0,2,0,2,9055
2,2,0,1,2,1,3,9055
3,3,0,1,2,2,4,9055
4,4,0,2,2,4,6,9055
5,5,0,0,2,4,6,9055
0,0,1,0,1,0,1,9056
1,1,1,1,2,1,3,9056
2,2,2,1,4,2,6,9056
3,3,4,2,8,4,12,9056
4,4,1,1,9,5,14,9056
5,5,1,0,10,5,15,9056
6,6,1,2,11,7,18,9056
7,7,1,2,12,9,21,9056
8,8,5,2,17,11,28,9056
9,9,3,5,20,16,36,9056
10,10,3,4,23,20,43,9056
11,11,5,3,28,23,51,9056
12,12,3,3,31,26,57,9056
13,13,4,0,35,26,61,9056
14,14,5,2,40,28,68,9056
15,15,4,2,44,30,74,9056
16,16,0,2,44,32,76,9056
17,17,1,3,45,35,80,9056
18,18,2,0,47,35,82,9056
19,19,1,0,48,35,83,9056
20,20,0,1,48,36,84,9056
21,21,1,0,49,36,85,9056
22,22,0,0,49,36,85,9056
0,0,1,0,1,0,1,9057
1,1,0,1,1,1,2,9057
2,2,0,1,1,2,3,9057
3,3,1,2,2,4,6,9057
4,4,0,2,2,6,8,9057
5,5,0,4,2,10,12,9057
6,6,0,2,2,12,14,9057
7,7,2,0,4,12,16,9057
8,8,0,0,4,12,16,9057
0,0,1,0,1,0,1,9058
1,1,0,0,1,0,1,9058
0,0,1,0,1,0,1,9059
1,1,3,0,4,0,4,9059
2,2,3,2,7,2,9,9059
3,3,0,2,7,4,11,9059
4,4,0,0,7,4,11,9059
0,0,1,0,1,0,1,9060
1,1,2,0,3,0,3,9060
2,2,1,1,4,1,5,9060
3,3,0,1,4,2,6,9060
4,4,0,1,4,3,7,9060
5,5,0,3,4,6,10,9060
6,6,0,3,4,9,13,9060
7,7,2,1,6,10,16,9060
8,8,1,0,7,10,17,9060
9,9,1,0,8,10,18,9060
10,10,2,0,10,10,20,9060
11,11,2,0,12,10,22,9060
12,12,0,0,12,10,22,9060
0,0,1,0,1,0,1,9061
1,1,0,0,1,0,1,9061
0,0,1,0,1,0,1,9062
1,1,1,0,2,0,2,9062
2,2,2,2,4,2,6,9062
3,3,1,0,5,2,7,9062
4,4,0,1,5,3,8,9062
5,5,0,0,5,3,8,9062
0,0,1,0,1,0,1,9063
1,1,0,0,1,0,1,9063
0,0,1,0,1,0,1,9064
1,1,0,0,1,0,1,9064
0,0,1,0,1,0,1,9065
1,1,1,1,2,1,3,9065
2,2,0,1,2,2,4,9065
3,3,0,0,2,2,4,9065
0,0,1,0,1,0,1,9066
1,1,0,0,1,0,1,9066
0,0,1,0,1,0,1,9067
1,1,0,0,1,0,1,9067
0,0,1,0,1,0,1,9068
1,1,0,0,1,0,1,9068
0,0,1,0,1,0,1,9069
1,1,0,0,1,0,1,9069
0,0,1,0,1,0,1,9070
1,1,4,0,5,0,5,9070
2,2,4,2,9,2,11,9070
3,3,4,2,13,4,17,9070
4,4,0,1,13,5,18,9070
5,5,0,0,13,5,18,9070
0,0,1,0,1,0,1,9071
1,1,2,0,3,0,3,9071
2,2,3,0,6,0,6,9071
3,3,0,0,6,0,6,9071
0,0,1,0,1,0,1,9072
1,1,0,0,1,0,1,9072
0,0,1,0,1,0,1,9073
1,1,0,0,1,0,1,9073
0,0,1,0,1,0,1,9074
1,1,1,1,2,1,3,9074
2,2,0,0,2,1,3,9074
0,0,1,0,1,0,1,9075
1,1,2,0,3,0,3,9075
2,2,0,0,3,0,3,9075
0,0,1,0,1,0,1,9076
1,1,0,1,1,1,2,9076
2,2,0,0,1,1,2,9076
0,0,1,0,1,0,1,9077
1,1,1,1,2,1,3,9077
2,2,0,2,2,3,5,9077
3,3,2,0,4,3,7,9077
4,4,1,1,5,4,9,9077
5,5,2,0,7,4,11,9077
6,6,1,0,8,4,12,9077
7,7,3,0,11,4,15,9077
8,8,3,0,14,4,18,9077
9,9,2,2,16,6,22,9077
10,10,0,1,16,7,23,9077
11,11,0,1,16,8,24,9077
12,12,0,1,16,9,25,9077
13,13,0,0,16,9,25,9077
0,0,1,0,1,0,1,9078
1,1,0,0,1,0,1,9078
0,0,1,0,1,0,1,9079
1,1,0,0,1,0,1,9079
0,0,1,0,1,0,1,9080
1,1,2,0,3,0,3,9080
2,2,1,1,4,1,5,9080
3,3,1,0,5,1,6,9080
4,4,0,1,5,2,7,9080
5,5,0,0,5,2,7,9080
0,0,1,0,1,0,1,9081
1,1,0,0,1,0,1,9081
0,0,1,0,1,0,1,9082
1,1,1,0,2,0,2,9082
2,2,1,0,3,0,3,9082
3,3,1,0,4,0,4,9082
4,4,0,0,4,0,4,9082
0,0,1,0,1,0,1,9083
1,1,0,0,1,0,1,9083
0,0,1,0,1,0,1,9084
1,1,0,0,1,0,1,9084
0,0,1,0,1,0,1,9085
1,1,2,0,3,0,3,9085
2,2,2,1,5,1,6,9085
3,3,3,1,8,2,10,9085
4,4,0,2,8,4,12,9085
5,5,0,0,8,4,12,9085
0,0,1,0,1,0,1,9086
1,1,2,0,3,0,3,9086
2,2,2,1,5,1,6,9086
3,3,3,2,8,3,11,9086
4,4,1,2,9,5,14,9086
5,5,0,0,9,5,14,9086
0,0,1,0,1,0,1,9087
1,1,2,1,3,1,4,9087
2,2,2,1,5,2,7,9087
3,3,1,0,6,2,8,9087
4,4,1,0,7,2,9,9087
5,5,0,0,7,2,9,9087
0,0,1,0,1,0,1,9088
1,1,0,0,1,0,1,9088
0,0,1,0,1,0,1,9089
1,1,0,0,1,0,1,9089
0,0,1,0,1,0,1,9090
1,1,0,0,1,0,1,9090
0,0,1,0,1,0,1,9091
1,1,0,0,1,0,1,9091
0,0,1,0,1,0,1,9092
1,1,0,0,1,0,1,9092
0,0,1,0,1,0,1,9093
1,1,1,0,2,0,2,9093
2,2,2,0,4,0,4,9093
3,3,1,0,5,0,5,9093
4,4,0,0,5,0,5,9093
0,0,1,0,1,0,1,9094
1,1,1,0,2,0,2,9094
2,2,2,1,4,1,5,9094
3,3,2,1,6,2,8,9094
4,4,0,0,6,2,8,9094
0,0,1,0,1,0,1,9095
1,1,2,2,3,2,5,9095
2,2,2,0,5,2,7,9095
3,3,3,0,8,2,10,9095
4,4,1,0,9,2,11,9095
5,5,2,1,11,3,14,9095
6,6,3,5,14,8,22,9095
7,7,4,2,18,10,28,9095
8,8,2,4,20,14,34,9095
9,9,1,2,21,16,37,9095
10,10,0,1,21,17,38,9095
11,11,0,1,21,18,39,9095
12,12,0,2,21,20,41,9095
13,13,0,3,21,23,44,9095
14,14,0,1,21,24,45,9095
15,15,0,1,21,25,46,9095
16,16,0,0,21,25,46,9095
0,0,1,0,1,0,1,9096
1,1,2,0,3,0,3,9096
2,2,0,1,3,1,4,9096
3,3,0,0,3,1,4,9096
0,0,1,0,1,0,1,9097
1,1,1,0,2,0,2,9097
2,2,0,0,2,0,2,9097
0,0,1,0,1,0,1,9098
1,1,0,0,1,0,1,9098
0,0,1,0,1,0,1,9099
1,1,1,1,2,1,3,9099
2,2,0,1,2,2,4,9099
3,3,0,0,2,2,4,9099
0,0,1,0,1,0,1,9100
1,1,0,0,1,0,1,9100
0,0,1,0,1,0,1,9101
1,1,0,0,1,0,1,9101
0,0,1,0,1,0,1,9102
1,1,1,0,2,0,2,9102
2,2,2,0,4,0,4,9102
3,3,0,0,4,0,4,9102
0,0,1,0,1,0,1,9103
1,1,1,0,2,0,2,9103
2,2,1,1,3,1,4,9103
3,3,3,1,6,2,8,9103
4,4,3,0,9,2,11,9103
5,5,0,1,9,3,12,9103
6,6,0,1,9,4,13,9103
7,7,0,0,9,4,13,9103
0,0,1,0,1,0,1,9104
1,1,2,0,3,0,3,9104
2,2,3,0,6,0,6,9104
3,3,2,1,8,1,9,9104
4,4,0,0,8,1,9,9104
0,0,1,0,1,0,1,9105
1,1,0,0,1,0,1,9105
0,0,1,0,1,0,1,9106
1,1,0,0,1,0,1,9106
0,0,1,0,1,0,1,9107
1,1,3,1,4,1,5,9107
2,2,1,0,5,1,6,9107
3,3,3,0,8,1,9,9107
4,4,3,0,11,1,12,9107
5,5,2,1,13,2,15,9107
6,6,4,1,17,3,20,9107
7,7,2,1,19,4,23,9107
8,8,0,2,19,6,25,9107
9,9,1,1,20,7,27,9107
10,10,2,4,22,11,33,9107
11,11,6,2,28,13,41,9107
12,12,5,3,33,16,49,9107
13,13,2,2,35,18,53,9107
14,14,1,2,36,20,56,9107
15,15,1,1,37,21,58,9107
16,16,0,0,37,21,58,9107
0,0,1,0,1,0,1,9108
1,1,1,0,2,0,2,9108
2,2,0,0,2,0,2,9108
0,0,1,0,1,0,1,9109
1,1,1,1,2,1,3,9109
2,2,2,0,4,1,5,9109
3,3,1,0,5,1,6,9109
4,4,1,0,6,1,7,9109
5,5,0,0,6,1,7,9109
0,0,1,0,1,0,1,9110
1,1,1,0,2,0,2,9110
2,2,0,0,2,0,2,9110
0,0,1,0,1,0,1,9111
1,1,0,0,1,0,1,9111
0,0,1,0,1,0,1,9112
1,1,0,0,1,0,1,9112
0,0,1,0,1,0,1,9113
1,1,1,0,2,0,2,9113
2,2,1,1,3,1,4,9113
3,3,1,0,4,1,5,9113
4,4,0,0,4,1,5,9113
0,0,1,0,1,0,1,9114
1,1,0,1,1,1,2,9114
2,2,0,0,1,1,2,9114
0,0,1,0,1,0,1,9115
1,1,0,1,1,1,2,9115
2,2,0,1,1,2,3,9115
3,3,0,1,1,3,4,9115
4,4,0,1,1,4,5,9115
5,5,0,1,1,5,6,9115
6,6,0,0,1,5,6,9115
0,0,1,0,1,0,1,9116
1,1,1,1,2,1,3,9116
2,2,0,0,2,1,3,9116
0,0,1,0,1,0,1,9117
1,1,0,0,1,0,1,9117
0,0,1,0,1,0,1,9118
1,1,0,0,1,0,1,9118
0,0,1,0,1,0,1,9119
1,1,1,0,2,0,2,9119
2,2,0,0,2,0,2,9119
0,0,1,0,1,0,1,9120
1,1,0,0,1,0,1,9120
0,0,1,0,1,0,1,9121
1,1,0,0,1,0,1,9121
0,0,1,0,1,0,1,9122
1,1,1,0,2,0,2,9122
2,2,2,1,4,1,5,9122
3,3,1,0,5,1,6,9122
4,4,2,0,7,1,8,9122
5,5,2,2,9,3,12,9122
6,6,2,2,11,5,16,9122
7,7,2,1,13,6,19,9122
8,8,0,1,13,7,20,9122
9,9,0,2,13,9,22,9122
10,10,1,3,14,12,26,9122
11,11,0,2,14,14,28,9122
12,12,1,0,15,14,29,9122
13,13,2,0,17,14,31,9122
14,14,0,1,17,15,32,9122
15,15,0,0,17,15,32,9122
0,0,1,0,1,0,1,9123
1,1,0,0,1,0,1,9123
0,0,1,0,1,0,1,9124
1,1,0,0,1,0,1,9124
0,0,1,0,1,0,1,9125
1,1,1,0,2,0,2,9125
2,2,0,0,2,0,2,9125
0,0,1,0,1,0,1,9126
1,1,1,0,2,0,2,9126
2,2,2,0,4,0,4,9126
3,3,0,0,4,0,4,9126
0,0,1,0,1,0,1,9127
1,1,1,0,2,0,2,9127
2,2,3,0,5,0,5,9127
3,3,1,0,6,0,6,9127
4,4,0,0,6,0,6,9127
0,0,1,0,1,0,1,9128
1,1,2,0,3,0,3,9128
2,2,2,1,5,1,6,9128
3,3,1,0,6,1,7,9128
4,4,0,0,6,1,7,9128
0,0,1,0,1,0,1,9129
1,1,0,0,1,0,1,9129
0,0,1,0,1,0,1,9130
1,1,1,0,2,0,2,9130
2,2,1,0,3,0,3,9130
3,3,0,0,3,0,3,9130
0,0,1,0,1,0,1,9131
1,1,1,0,2,0,2,9131
2,2,2,0,4,0,4,9131
3,3,2,0,6,0,6,9131
4,4,1,0,7,0,7,9131
5,5,0,0,7,0,7,9131
0,0,1,0,1,0,1,9132
1,1,1,1,2,1,3,9132
2,2,1,0,3,1,4,9132
3,3,0,0,3,1,4,9132
0,0,1,0,1,0,1,9133
1,1,2,0,3,0,3,9133
2,2,1,0,4,0,4,9133
3,3,0,0,4,0,4,9133
0,0,1,0,1,0,1,9134
1,1,1,0,2,0,2,9134
2,2,0,0,2,0,2,9134
0,0,1,0,1,0,1,9135
1,1,0,0,1,0,1,9135
0,0,1,0,1,0,1,9136
1,1,1,0,2,0,2,9136
2,2,1,0,3,0,3,9136
3,3,0,0,3,0,3,9136
0,0,1,0,1,0,1,9137
1,1,0,0,1,0,1,9137
0,0,1,0,1,0,1,9138
1,1,3,0,4,0,4,9138
2,2,2,0,6,0,6,9138
3,3,2,0,8,0,8,9138
4,4,0,0,8,0,8,9138
0,0,1,0,1,0,1,9139
1,1,0,0,1,0,1,9139
0,0,1,0,1,0,1,9140
1,1,3,0,4,0,4,9140
2,2,2,1,6,1,7,9140
3,3,2,0,8,1,9,9140
4,4,1,0,9,1,10,9140
5,5,1,0,10,1,11,9140
6,6,0,0,10,1,11,9140
0,0,1,0,1,0,1,9141
1,1,1,0,2,0,2,9141
2,2,1,0,3,0,3,9141
3,3,0,0,3,0,3,9141
0,0,1,0,1,0,1,9142
1,1,0,0,1,0,1,9142
0,0,1,0,1,0,1,9143
1,1,3,0,4,0,4,9143
2,2,1,0,5,0,5,9143
3,3,1,0,6,0,6,9143
4,4,1,0,7,0,7,9143
5,5,1,0,8,0,8,9143
6,6,1,0,9,0,9,9143
7,7,0,0,9,0,9,9143
0,0,1,0,1,0,1,9144
1,1,0,0,1,0,1,9144
0,0,1,0,1,0,1,9145
1,1,0,0,1,0,1,9145
0,0,1,0,1,0,1,9146
1,1,2,0,3,0,3,9146
2,2,2,0,5,0,5,9146
3,3,0,0,5,0,5,9146
0,0,1,0,1,0,1,9147
1,1,1,0,2,0,2,9147
2,2,0,1,2,1,3,9147
3,3,0,1,2,2,4,9147
4,4,0,4,2,6,8,9147
5,5,3,5,5,11,16,9147
6,6,2,6,7,17,24,9147
7,7,2,4,9,21,30,9147
8,8,0,4,9,25,34,9147
9,9,1,2,10,27,37,9147
10,10,0,1,10,28,38,9147
11,11,0,1,10,29,39,9147
12,12,0,0,10,29,39,9147
0,0,1,0,1,0,1,9148
1,1,1,0,2,0,2,9148
2,2,0,1,2,1,3,9148
3,3,0,1,2,2,4,9148
4,4,0,0,2,2,4,9148
0,0,1,0,1,0,1,9149
1,1,3,0,4,0,4,9149
2,2,2,0,6,0,6,9149
3,3,1,0,7,0,7,9149
4,4,2,0,9,0,9,9149
5,5,1,0,10,0,10,9149
6,6,0,0,10,0,10,9149
0,0,1,0,1,0,1,9150
1,1,0,0,1,0,1,9150
0,0,1,0,1,0,1,9151
1,1,2,0,3,0,3,9151
2,2,0,0,3,0,3,9151
0,0,1,0,1,0,1,9152
1,1,1,0,2,0,2,9152
2,2,0,0,2,0,2,9152
0,0,1,0,1,0,1,9153
1,1,0,0,1,0,1,9153
0,0,1,0,1,0,1,9154
1,1,0,0,1,0,1,9154
0,0,1,0,1,0,1,9155
1,1,0,1,1,1,2,9155
2,2,0,0,1,1,2,9155
0,0,1,0,1,0,1,9156
1,1,0,0,1,0,1,9156
0,0,1,0,1,0,1,9157
1,1,3,0,4,0,4,9157
2,2,1,2,5,2,7,9157
3,3,0,1,5,3,8,9157
4,4,0,2,5,5,10,9157
5,5,0,0,5,5,10,9157
0,0,1,0,1,0,1,9158
1,1,1,0,2,0,2,9158
2,2,1,0,3,0,3,9158
3,3,0,0,3,0,3,9158
0,0,1,0,1,0,1,9159
1,1,0,0,1,0,1,9159
0,0,1,0,1,0,1,9160
1,1,0,0,1,0,1,9160
0,0,1,0,1,0,1,9161
1,1,0,0,1,0,1,9161
0,0,1,0,1,0,1,9162
1,1,1,0,2,0,2,9162
2,2,0,0,2,0,2,9162
0,0,1,0,1,0,1,9163
1,1,0,1,1,1,2,9163
2,2,0,0,1,1,2,9163
0,0,1,0,1,0,1,9164
1,1,3,0,4,0,4,9164
2,2,1,1,5,1,6,9164
3,3,4,0,9,1,10,9164
4,4,2,1,11,2,13,9164
5,5,3,0,14,2,16,9164
6,6,2,1,16,3,19,9164
7,7,2,0,18,3,21,9164
8,8,1,0,19,3,22,9164
9,9,0,0,19,3,22,9164
0,0,1,0,1,0,1,9165
1,1,0,2,1,2,3,9165
2,2,0,1,1,3,4,9165
3,3,0,0,1,3,4,9165
0,0,1,0,1,0,1,9166
1,1,0,0,1,0,1,9166
0,0,1,0,1,0,1,9167
1,1,0,0,1,0,1,9167
0,0,1,0,1,0,1,9168
1,1,0,0,1,0,1,9168
0,0,1,0,1,0,1,9169
1,1,1,0,2,0,2,9169
2,2,1,0,3,0,3,9169
3,3,3,0,6,0,6,9169
4,4,1,1,7,1,8,9169
5,5,0,1,7,2,9,9169
6,6,0,2,7,4,11,9169
7,7,0,1,7,5,12,9169
8,8,1,1,8,6,14,9169
9,9,0,0,8,6,14,9169
0,0,1,0,1,0,1,9170
1,1,0,0,1,0,1,9170
0,0,1,0,1,0,1,9171
1,1,2,1,3,1,4,9171
2,2,0,1,3,2,5,9171
3,3,0,0,3,2,5,9171
0,0,1,0,1,0,1,9172
1,1,0,0,1,0,1,9172
0,0,1,0,1,0,1,9173
1,1,0,2,1,2,3,9173
2,2,0,1,1,3,4,9173
3,3,0,0,1,3,4,9173
0,0,1,0,1,0,1,9174
1,1,1,0,2,0,2,9174
2,2,1,0,3,0,3,9174
3,3,1,0,4,0,4,9174
4,4,0,1,4,1,5,9174
5,5,0,1,4,2,6,9174
6,6,0,1,4,3,7,9174
7,7,0,0,4,3,7,9174
0,0,1,0,1,0,1,9175
1,1,0,0,1,0,1,9175
0,0,1,0,1,0,1,9176
1,1,1,0,2,0,2,9176
2,2,0,1,2,1,3,9176
3,3,0,2,2,3,5,9176
4,4,0,1,2,4,6,9176
5,5,0,1,2,5,7,9176
6,6,0,0,2,5,7,9176
0,0,1,0,1,0,1,9177
1,1,0,0,1,0,1,9177
0,0,1,0,1,0,1,9178
1,1,0,0,1,0,1,9178
0,0,1,0,1,0,1,9179
1,1,0,0,1,0,1,9179
0,0,1,0,1,0,1,9180
1,1,0,0,1,0,1,9180
0,0,1,0,1,0,1,9181
1,1,1,0,2,0,2,9181
2,2,1,0,3,0,3,9181
3,3,2,1,5,1,6,9181
4,4,2,1,7,2,9,9181
5,5,0,3,7,5,12,9181
6,6,2,2,9,7,16,9181
7,7,1,2,10,9,19,9181
8,8,1,2,11,11,22,9181
9,9,2,0,13,11,24,9181
10,10,1,0,14,11,25,9181
11,11,0,0,14,11,25,9181
0,0,1,0,1,0,1,9182
1,1,1,0,2,0,2,9182
2,2,0,0,2,0,2,9182
0,0,1,0,1,0,1,9183
1,1,0,0,1,0,1,9183
0,0,1,0,1,0,1,9184
1,1,0,0,1,0,1,9184
0,0,1,0,1,0,1,9185
1,1,0,0,1,0,1,9185
0,0,1,0,1,0,1,9186
1,1,0,1,1,1,2,9186
2,2,0,0,1,1,2,9186
0,0,1,0,1,0,1,9187
1,1,0,0,1,0,1,9187
0,0,1,0,1,0,1,9188
1,1,0,0,1,0,1,9188
0,0,1,0,1,0,1,9189
1,1,0,1,1,1,2,9189
2,2,0,0,1,1,2,9189
0,0,1,0,1,0,1,9190
1,1,1,0,2,0,2,9190
2,2,1,0,3,0,3,9190
3,3,0,0,3,0,3,9190
0,0,1,0,1,0,1,9191
1,1,0,0,1,0,1,9191
0,0,1,0,1,0,1,9192
1,1,0,0,1,0,1,9192
0,0,1,0,1,0,1,9193
1,1,1,0,2,0,2,9193
2,2,1,0,3,0,3,9193
3,3,0,0,3,0,3,9193
0,0,1,0,1,0,1,9194
1,1,1,0,2,0,2,9194
2,2,0,0,2,0,2,9194
0,0,1,0,1,0,1,9195
1,1,1,0,2,0,2,9195
2,2,1,0,3,0,3,9195
3,3,0,1,3,1,4,9195
4,4,0,0,3,1,4,9195
0,0,1,0,1,0,1,9196
1,1,0,0,1,0,1,9196
0,0,1,0,1,0,1,9197
1,1,0,0,1,0,1,9197
0,0,1,0,1,0,1,9198
1,1,0,0,1,0,1,9198
0,0,1,0,1,0,1,9199
1,1,1,0,2,0,2,9199
2,2,0,1,2,1,3,9199
3,3,0,1,2,2,4,9199
4,4,0,0,2,2,4,9199
0,0,1,0,1,0,1,9200
1,1,0,0,1,0,1,9200
0,0,1,0,1,0,1,9201
1,1,0,0,1,0,1,9201
0,0,1,0,1,0,1,9202
1,1,0,0,1,0,1,9202
0,0,1,0,1,0,1,9203
1,1,1,2,2,2,4,9203
2,2,1,2,3,4,7,9203
3,3,0,0,3,4,7,9203
0,0,1,0,1,0,1,9204
1,1,0,1,1,1,2,9204
2,2,0,0,1,1,2,9204
0,0,1,0,1,0,1,9205
1,1,1,0,2,0,2,9205
2,2,1,1,3,1,4,9205
3,3,1,1,4,2,6,9205
4,4,1,2,5,4,9,9205
5,5,0,2,5,6,11,9205
6,6,0,2,5,8,13,9205
7,7,0,3,5,11,16,9205
8,8,0,3,5,14,19,9205
9,9,0,3,5,17,22,9205
10,10,1,4,6,21,27,9205
11,11,1,3,7,24,31,9205
12,12,2,3,9,27,36,9205
13,13,1,1,10,28,38,9205
14,14,0,1,10,29,39,9205
15,15,0,1,10,30,40,9205
16,16,0,1,10,31,41,9205
17,17,1,1,11,32,43,9205
18,18,0,1,11,33,44,9205
19,19,0,0,11,33,44,9205
0,0,1,0,1,0,1,9206
1,1,1,0,2,0,2,9206
2,2,1,0,3,0,3,9206
3,3,1,1,4,1,5,9206
4,4,0,0,4,1,5,9206
0,0,1,0,1,0,1,9207
1,1,2,0,3,0,3,9207
2,2,0,0,3,0,3,9207
0,0,1,0,1,0,1,9208
1,1,2,0,3,0,3,9208
2,2,4,1,7,1,8,9208
3,3,6,3,13,4,17,9208
4,4,5,6,18,10,28,9208
5,5,8,5,26,15,41,9208
6,6,6,3,32,18,50,9208
7,7,3,5,35,23,58,9208
8,8,3,5,38,28,66,9208
9,9,0,5,38,33,71,9208
10,10,1,6,39,39,78,9208
11,11,1,2,40,41,81,9208
12,12,3,1,43,42,85,9208
13,13,2,1,45,43,88,9208
14,14,1,0,46,43,89,9208
15,15,0,0,46,43,89,9208
0,0,1,0,1,0,1,9209
1,1,0,0,1,0,1,9209
0,0,1,0,1,0,1,9210
1,1,2,0,3,0,3,9210
2,2,0,1,3,1,4,9210
3,3,0,0,3,1,4,9210
0,0,1,0,1,0,1,9211
1,1,1,0,2,0,2,9211
2,2,0,0,2,0,2,9211
0,0,1,0,1,0,1,9212
1,1,0,1,1,1,2,9212
2,2,0,1,1,2,3,9212
3,3,0,0,1,2,3,9212
0,0,1,0,1,0,1,9213
1,1,1,0,2,0,2,9213
2,2,0,0,2,0,2,9213
0,0,1,0,1,0,1,9214
1,1,0,0,1,0,1,9214
0,0,1,0,1,0,1,9215
1,1,2,0,3,0,3,9215
2,2,0,0,3,0,3,9215
0,0,1,0,1,0,1,9216
1,1,2,0,3,0,3,9216
2,2,2,0,5,0,5,9216
3,3,2,0,7,0,7,9216
4,4,0,1,7,1,8,9216
5,5,0,1,7,2,9,9216
6,6,0,0,7,2,9,9216
0,0,1,0,1,0,1,9217
1,1,1,0,2,0,2,9217
2,2,2,0,4,0,4,9217
3,3,3,0,7,0,7,9217
4,4,1,0,8,0,8,9217
5,5,0,0,8,0,8,9217
0,0,1,0,1,0,1,9218
1,1,0,0,1,0,1,9218
0,0,1,0,1,0,1,9219
1,1,0,0,1,0,1,9219
0,0,1,0,1,0,1,9220
1,1,2,0,3,0,3,9220
2,2,4,0,7,0,7,9220
3,3,2,0,9,0,9,9220
4,4,3,0,12,0,12,9220
5,5,1,0,13,0,13,9220
6,6,0,0,13,0,13,9220
0,0,1,0,1,0,1,9221
1,1,0,0,1,0,1,9221
0,0,1,0,1,0,1,9222
1,1,1,0,2,0,2,9222
2,2,2,0,4,0,4,9222
3,3,1,1,5,1,6,9222
4,4,1,1,6,2,8,9222
5,5,1,0,7,2,9,9222
6,6,0,0,7,2,9,9222
0,0,1,0,1,0,1,9223
1,1,0,0,1,0,1,9223
0,0,1,0,1,0,1,9224
1,1,0,0,1,0,1,9224
0,0,1,0,1,0,1,9225
1,1,0,0,1,0,1,9225
0,0,1,0,1,0,1,9226
1,1,0,1,1,1,2,9226
2,2,0,0,1,1,2,9226
0,0,1,0,1,0,1,9227
1,1,3,0,4,0,4,9227
2,2,3,3,7,3,10,9227
3,3,3,4,10,7,17,9227
4,4,2,5,12,12,24,9227
5,5,3,2,15,14,29,9227
6,6,4,1,19,15,34,9227
7,7,3,1,22,16,38,9227
8,8,3,3,25,19,44,9227
9,9,1,4,26,23,49,9227
10,10,1,7,27,30,57,9227
11,11,3,5,30,35,65,9227
12,12,6,5,36,40,76,9227
13,13,3,2,39,42,81,9227
14,14,7,1,46,43,89,9227
15,15,4,2,50,45,95,9227
16,16,5,2,55,47,102,9227
17,17,4,3,59,50,109,9227
18,18,4,4,63,54,117,9227
19,19,5,1,68,55,123,9227
20,20,3,2,71,57,128,9227
21,21,2,1,73,58,131,9227
22,22,0,0,73,58,131,9227
0,0,1,0,1,0,1,9228
1,1,1,0,2,0,2,9228
2,2,1,0,3,0,3,9228
3,3,2,0,5,0,5,9228
4,4,1,1,6,1,7,9228
5,5,0,1,6,2,8,9228
6,6,1,0,7,2,9,9228
7,7,0,0,7,2,9,9228
0,0,1,0,1,0,1,9229
1,1,1,1,2,1,3,9229
2,2,1,0,3,1,4,9229
3,3,0,0,3,1,4,9229
0,0,1,0,1,0,1,9230
1,1,0,0,1,0,1,9230
0,0,1,0,1,0,1,9231
1,1,0,1,1,1,2,9231
2,2,0,1,1,2,3,9231
3,3,0,1,1,3,4,9231
4,4,0,0,1,3,4,9231
0,0,1,0,1,0,1,9232
1,1,0,0,1,0,1,9232
0,0,1,0,1,0,1,9233
1,1,0,0,1,0,1,9233
0,0,1,0,1,0,1,9234
1,1,0,0,1,0,1,9234
0,0,1,0,1,0,1,9235
1,1,0,1,1,1,2,9235
2,2,0,0,1,1,2,9235
0,0,1,0,1,0,1,9236
1,1,1,0,2,0,2,9236
2,2,0,0,2,0,2,9236
0,0,1,0,1,0,1,9237
1,1,0,0,1,0,1,9237
0,0,1,0,1,0,1,9238
1,1,1,0,2,0,2,9238
2,2,0,0,2,0,2,9238
0,0,1,0,1,0,1,9239
1,1,1,0,2,0,2,9239
2,2,0,0,2,0,2,9239
0,0,1,0,1,0,1,9240
1,1,0,1,1,1,2,9240
2,2,0,0,1,1,2,9240
0,0,1,0,1,0,1,9241
1,1,0,0,1,0,1,9241
0,0,1,0,1,0,1,9242
1,1,0,0,1,0,1,9242
0,0,1,0,1,0,1,9243
1,1,1,0,2,0,2,9243
2,2,4,0,6,0,6,9243
3,3,4,1,10,1,11,9243
4,4,3,1,13,2,15,9243
5,5,1,3,14,5,19,9243
6,6,2,4,16,9,25,9243
7,7,1,4,17,13,30,9243
8,8,1,1,18,14,32,9243
9,9,1,2,19,16,35,9243
10,10,3,2,22,18,40,9243
11,11,3,4,25,22,47,9243
12,12,2,3,27,25,52,9243
13,13,2,3,29,28,57,9243
14,14,2,2,31,30,61,9243
15,15,1,1,32,31,63,9243
16,16,0,0,32,31,63,9243
0,0,1,0,1,0,1,9244
1,1,1,0,2,0,2,9244
2,2,0,0,2,0,2,9244
0,0,1,0,1,0,1,9245
1,1,1,1,2,1,3,9245
2,2,0,1,2,2,4,9245
3,3,0,2,2,4,6,9245
4,4,0,2,2,6,8,9245
5,5,1,2,3,8,11,9245
6,6,2,0,5,8,13,9245
7,7,2,2,7,10,17,9245
8,8,2,0,9,10,19,9245
9,9,2,0,11,10,21,9245
10,10,2,0,13,10,23,9245
11,11,2,1,15,11,26,9245
12,12,3,3,18,14,32,9245
13,13,0,2,18,16,34,9245
14,14,0,2,18,18,36,9245
15,15,0,5,18,23,41,9245
16,16,0,4,18,27,45,9245
17,17,2,4,20,31,51,9245
18,18,2,2,22,33,55,9245
19,19,0,2,22,35,57,9245
20,20,0,1,22,36,58,9245
21,21,0,1,22,37,59,9245
22,22,1,2,23,39,62,9245
23,23,1,0,24,39,63,9245
24,24,1,1,25,40,65,9245
25,25,0,1,25,41,66,9245
26,26,0,2,25,43,68,9245
27,27,2,2,27,45,72,9245
28,28,3,1,30,46,76,9245
29,29,1,0,31,46,77,9245
30,30,1,1,32,47,79,9245
31,31,1,1,33,48,81,9245
32,32,1,0,34,48,82,9245
33,33,0,1,34,49,83,9245
34,34,0,2,34,51,85,9245
35,35,1,0,35,51,86,9245
36,36,1,0,36,51,87,9245
37,37,0,0,36,51,87,9245
0,0,1,0,1,0,1,9246
1,1,2,0,3,0,3,9246
2,2,3,1,6,1,7,9246
3,3,0,1,6,2,8,9246
4,4,0,1,6,3,9,9246
5,5,1,0,7,3,10,9246
6,6,2,0,9,3,12,9246
7,7,0,0,9,3,12,9246
0,0,1,0,1,0,1,9247
1,1,0,0,1,0,1,9247
0,0,1,0,1,0,1,9248
1,1,0,1,1,1,2,9248
2,2,0,0,1,1,2,9248
0,0,1,0,1,0,1,9249
1,1,1,0,2,0,2,9249
2,2,0,0,2,0,2,9249
0,0,1,0,1,0,1,9250
1,1,2,0,3,0,3,9250
2,2,1,1,4,1,5,9250
3,3,1,0,5,1,6,9250
4,4,0,0,5,1,6,9250
0,0,1,0,1,0,1,9251
1,1,0,1,1,1,2,9251
2,2,0,0,1,1,2,9251
0,0,1,0,1,0,1,9252
1,1,1,0,2,0,2,9252
2,2,2,0,4,0,4,9252
3,3,1,0,5,0,5,9252
4,4,0,0,5,0,5,9252
0,0,1,0,1,0,1,9253
1,1,0,0,1,0,1,9253
0,0,1,0,1,0,1,9254
1,1,0,0,1,0,1,9254
0,0,1,0,1,0,1,9255
1,1,1,0,2,0,2,9255
2,2,2,0,4,0,4,9255
3,3,1,0,5,0,5,9255
4,4,0,0,5,0,5,9255
0,0,1,0,1,0,1,9256
1,1,1,0,2,0,2,9256
2,2,1,1,3,1,4,9256
3,3,0,0,3,1,4,9256
0,0,1,0,1,0,1,9257
1,1,0,0,1,0,1,9257
0,0,1,0,1,0,1,9258
1,1,1,0,2,0,2,9258
2,2,2,0,4,0,4,9258
3,3,2,1,6,1,7,9258
4,4,4,1,10,2,12,9258
5,5,2,3,12,5,17,9258
6,6,2,2,14,7,21,9258
7,7,2,1,16,8,24,9258
8,8,1,0,17,8,25,9258
9,9,1,1,18,9,27,9258
10,10,0,2,18,11,29,9258
11,11,0,2,18,13,31,9258
12,12,1,1,19,14,33,9258
13,13,1,1,20,15,35,9258
14,14,0,4,20,19,39,9258
15,15,0,2,20,21,41,9258
16,16,0,0,20,21,41,9258
0,0,1,0,1,0,1,9259
1,1,3,0,4,0,4,9259
2,2,1,0,5,0,5,9259
3,3,0,0,5,0,5,9259
0,0,1,0,1,0,1,9260
1,1,0,0,1,0,1,9260
0,0,1,0,1,0,1,9261
1,1,0,1,1,1,2,9261
2,2,0,1,1,2,3,9261
3,3,0,0,1,2,3,9261
0,0,1,0,1,0,1,9262
1,1,1,1,2,1,3,9262
2,2,0,2,2,3,5,9262
3,3,0,1,2,4,6,9262
4,4,0,0,2,4,6,9262
0,0,1,0,1,0,1,9263
1,1,0,0,1,0,1,9263
0,0,1,0,1,0,1,9264
1,1,0,0,1,0,1,9264
0,0,1,0,1,0,1,9265
1,1,1,0,2,0,2,9265
2,2,0,0,2,0,2,9265
0,0,1,0,1,0,1,9266
1,1,1,0,2,0,2,9266
2,2,1,1,3,1,4,9266
3,3,2,0,5,1,6,9266
4,4,3,0,8,1,9,9266
5,5,3,1,11,2,13,9266
6,6,4,0,15,2,17,9266
7,7,2,0,17,2,19,9266
8,8,1,0,18,2,20,9266
9,9,0,1,18,3,21,9266
10,10,0,0,18,3,21,9266
0,0,1,0,1,0,1,9267
1,1,0,0,1,0,1,9267
0,0,1,0,1,0,1,9268
1,1,1,0,2,0,2,9268
2,2,0,0,2,0,2,9268
0,0,1,0,1,0,1,9269
1,1,5,0,6,0,6,9269
2,2,2,1,8,1,9,9269
3,3,1,0,9,1,10,9269
4,4,0,0,9,1,10,9269
0,0,1,0,1,0,1,9270
1,1,1,0,2,0,2,9270
2,2,2,0,4,0,4,9270
3,3,0,1,4,1,5,9270
4,4,0,2,4,3,7,9270
5,5,0,1,4,4,8,9270
6,6,0,0,4,4,8,9270
0,0,1,0,1,0,1,9271
1,1,2,0,3,0,3,9271
2,2,1,0,4,0,4,9271
3,3,1,0,5,0,5,9271
4,4,0,0,5,0,5,9271
0,0,1,0,1,0,1,9272
1,1,0,1,1,1,2,9272
2,2,0,1,1,2,3,9272
3,3,0,0,1,2,3,9272
0,0,1,0,1,0,1,9273
1,1,3,0,4,0,4,9273
2,2,5,0,9,0,9,9273
3,3,2,0,11,0,11,9273
4,4,2,0,13,0,13,9273
5,5,1,0,14,0,14,9273
6,6,4,0,18,0,18,9273
7,7,2,1,20,1,21,9273
8,8,2,3,22,4,26,9273
9,9,3,4,25,8,33,9273
10,10,2,1,27,9,36,9273
11,11,3,1,30,10,40,9273
12,12,1,1,31,11,42,9273
13,13,0,0,31,11,42,9273
0,0,1,0,1,0,1,9274
1,1,1,0,2,0,2,9274
2,2,1,0,3,0,3,9274
3,3,1,1,4,1,5,9274
4,4,1,1,5,2,7,9274
5,5,1,3,6,5,11,9274
6,6,2,3,8,8,16,9274
7,7,5,2,13,10,23,9274
8,8,6,2,19,12,31,9274
9,9,1,2,20,14,34,9274
10,10,1,0,21,14,35,9274
11,11,0,0,21,14,35,9274
0,0,1,0,1,0,1,9275
1,1,1,1,2,1,3,9275
2,2,1,0,3,1,4,9275
3,3,2,1,5,2,7,9275
4,4,1,0,6,2,8,9275
5,5,0,0,6,2,8,9275
0,0,1,0,1,0,1,9276
1,1,1,0,2,0,2,9276
2,2,1,0,3,0,3,9276
3,3,0,0,3,0,3,9276
0,0,1,0,1,0,1,9277
1,1,0,0,1,0,1,9277
0,0,1,0,1,0,1,9278
1,1,1,0,2,0,2,9278
2,2,0,0,2,0,2,9278
0,0,1,0,1,0,1,9279
1,1,1,0,2,0,2,9279
2,2,0,1,2,1,3,9279
3,3,1,0,3,1,4,9279
4,4,0,1,3,2,5,9279
5,5,1,0,4,2,6,9279
6,6,1,0,5,2,7,9279
7,7,0,0,5,2,7,9279
0,0,1,0,1,0,1,9280
1,1,0,0,1,0,1,9280
0,0,1,0,1,0,1,9281
1,1,0,0,1,0,1,9281
0,0,1,0,1,0,1,9282
1,1,1,0,2,0,2,9282
2,2,0,0,2,0,2,9282
0,0,1,0,1,0,1,9283
1,1,0,0,1,0,1,9283
0,0,1,0,1,0,1,9284
1,1,0,1,1,1,2,9284
2,2,0,1,1,2,3,9284
3,3,0,0,1,2,3,9284
0,0,1,0,1,0,1,9285
1,1,1,0,2,0,2,9285
2,2,0,0,2,0,2,9285
0,0,1,0,1,0,1,9286
1,1,0,0,1,0,1,9286
0,0,1,0,1,0,1,9287
1,1,0,0,1,0,1,9287
0,0,1,0,1,0,1,9288
1,1,1,0,2,0,2,9288
2,2,0,0,2,0,2,9288
0,0,1,0,1,0,1,9289
1,1,0,0,1,0,1,9289
0,0,1,0,1,0,1,9290
1,1,1,0,2,0,2,9290
2,2,0,0,2,0,2,9290
0,0,1,0,1,0,1,9291
1,1,0,0,1,0,1,9291
0,0,1,0,1,0,1,9292
1,1,0,0,1,0,1,9292
0,0,1,0,1,0,1,9293
1,1,0,0,1,0,1,9293
0,0,1,0,1,0,1,9294
1,1,2,0,3,0,3,9294
2,2,2,1,5,1,6,9294
3,3,4,2,9,3,12,9294
4,4,5,1,14,4,18,9294
5,5,4,2,18,6,24,9294
6,6,4,5,22,11,33,9294
7,7,3,3,25,14,39,9294
8,8,1,1,26,15,41,9294
9,9,2,0,28,15,43,9294
10,10,1,0,29,15,44,9294
11,11,0,0,29,15,44,9294
0,0,1,0,1,0,1,9295
1,1,1,1,2,1,3,9295
2,2,1,0,3,1,4,9295
3,3,0,0,3,1,4,9295
0,0,1,0,1,0,1,9296
1,1,1,0,2,0,2,9296
2,2,1,0,3,0,3,9296
3,3,1,0,4,0,4,9296
4,4,0,0,4,0,4,9296
0,0,1,0,1,0,1,9297
1,1,2,0,3,0,3,9297
2,2,2,1,5,1,6,9297
3,3,0,0,5,1,6,9297
0,0,1,0,1,0,1,9298
1,1,0,0,1,0,1,9298
0,0,1,0,1,0,1,9299
1,1,1,0,2,0,2,9299
2,2,0,0,2,0,2,9299
0,0,1,0,1,0,1,9300
1,1,1,0,2,0,2,9300
2,2,0,0,2,0,2,9300
0,0,1,0,1,0,1,9301
1,1,0,0,1,0,1,9301
0,0,1,0,1,0,1,9302
1,1,1,0,2,0,2,9302
2,2,0,1,2,1,3,9302
3,3,0,0,2,1,3,9302
0,0,1,0,1,0,1,9303
1,1,0,0,1,0,1,9303
0,0,1,0,1,0,1,9304
1,1,0,0,1,0,1,9304
0,0,1,0,1,0,1,9305
1,1,1,0,2,0,2,9305
2,2,1,0,3,0,3,9305
3,3,0,0,3,0,3,9305
0,0,1,0,1,0,1,9306
1,1,1,0,2,0,2,9306
2,2,0,1,2,1,3,9306
3,3,0,0,2,1,3,9306
0,0,1,0,1,0,1,9307
1,1,0,0,1,0,1,9307
0,0,1,0,1,0,1,9308
1,1,4,0,5,0,5,9308
2,2,5,1,10,1,11,9308
3,3,2,4,12,5,17,9308
4,4,2,3,14,8,22,9308
5,5,2,1,16,9,25,9308
6,6,1,0,17,9,26,9308
7,7,1,0,18,9,27,9308
8,8,0,0,18,9,27,9308
0,0,1,0,1,0,1,9309
1,1,1,0,2,0,2,9309
2,2,0,1,2,1,3,9309
3,3,1,2,3,3,6,9309
4,4,2,2,5,5,10,9309
5,5,0,1,5,6,11,9309
6,6,1,2,6,8,14,9309
7,7,0,0,6,8,14,9309
0,0,1,0,1,0,1,9310
1,1,1,0,2,0,2,9310
2,2,1,0,3,0,3,9310
3,3,1,0,4,0,4,9310
4,4,0,0,4,0,4,9310
0,0,1,0,1,0,1,9311
1,1,2,0,3,0,3,9311
2,2,2,0,5,0,5,9311
3,3,1,0,6,0,6,9311
4,4,1,0,7,0,7,9311
5,5,1,0,8,0,8,9311
6,6,1,0,9,0,9,9311
7,7,0,0,9,0,9,9311
0,0,1,0,1,0,1,9312
1,1,1,0,2,0,2,9312
2,2,0,0,2,0,2,9312
0,0,1,0,1,0,1,9313
1,1,0,1,1,1,2,9313
2,2,0,0,1,1,2,9313
0,0,1,0,1,0,1,9314
1,1,1,0,2,0,2,9314
2,2,0,0,2,0,2,9314
0,0,1,0,1,0,1,9315
1,1,0,1,1,1,2,9315
2,2,1,0,2,1,3,9315
3,3,0,0,2,1,3,9315
0,0,1,0,1,0,1,9316
1,1,0,0,1,0,1,9316
0,0,1,0,1,0,1,9317
1,1,0,0,1,0,1,9317
0,0,1,0,1,0,1,9318
1,1,0,0,1,0,1,9318
0,0,1,0,1,0,1,9319
1,1,1,0,2,0,2,9319
2,2,2,0,4,0,4,9319
3,3,1,0,5,0,5,9319
4,4,1,0,6,0,6,9319
5,5,0,0,6,0,6,9319
0,0,1,0,1,0,1,9320
1,1,2,0,3,0,3,9320
2,2,2,0,5,0,5,9320
3,3,1,0,6,0,6,9320
4,4,0,0,6,0,6,9320
0,0,1,0,1,0,1,9321
1,1,1,0,2,0,2,9321
2,2,0,1,2,1,3,9321
3,3,1,1,3,2,5,9321
4,4,0,1,3,3,6,9321
5,5,0,2,3,5,8,9321
6,6,0,3,3,8,11,9321
7,7,1,1,4,9,13,9321
8,8,1,3,5,12,17,9321
9,9,0,3,5,15,20,9321
10,10,0,1,5,16,21,9321
11,11,0,0,5,16,21,9321
0,0,1,0,1,0,1,9322
1,1,1,0,2,0,2,9322
2,2,1,0,3,0,3,9322
3,3,1,0,4,0,4,9322
4,4,1,0,5,0,5,9322
5,5,0,0,5,0,5,9322
0,0,1,0,1,0,1,9323
1,1,0,0,1,0,1,9323
0,0,1,0,1,0,1,9324
1,1,1,0,2,0,2,9324
2,2,0,1,2,1,3,9324
3,3,0,0,2,1,3,9324
0,0,1,0,1,0,1,9325
1,1,1,0,2,0,2,9325
2,2,1,0,3,0,3,9325
3,3,1,0,4,0,4,9325
4,4,0,0,4,0,4,9325
0,0,1,0,1,0,1,9326
1,1,1,0,2,0,2,9326
2,2,0,0,2,0,2,9326
0,0,1,0,1,0,1,9327
1,1,0,0,1,0,1,9327
0,0,1,0,1,0,1,9328
1,1,0,0,1,0,1,9328
0,0,1,0,1,0,1,9329
1,1,1,0,2,0,2,9329
2,2,1,0,3,0,3,9329
3,3,1,1,4,1,5,9329
4,4,0,1,4,2,6,9329
5,5,0,2,4,4,8,9329
6,6,0,1,4,5,9,9329
7,7,0,1,4,6,10,9329
8,8,1,0,5,6,11,9329
9,9,0,0,5,6,11,9329
0,0,1,0,1,0,1,9330
1,1,1,0,2,0,2,9330
2,2,0,0,2,0,2,9330
0,0,1,0,1,0,1,9331
1,1,1,0,2,0,2,9331
2,2,2,0,4,0,4,9331
3,3,2,0,6,0,6,9331
4,4,1,0,7,0,7,9331
5,5,3,1,10,1,11,9331
6,6,6,1,16,2,18,9331
7,7,6,2,22,4,26,9331
8,8,8,2,30,6,36,9331
9,9,7,1,37,7,44,9331
10,10,8,3,45,10,55,9331
11,11,4,2,49,12,61,9331
12,12,2,1,51,13,64,9331
13,13,5,1,56,14,70,9331
14,14,6,2,62,16,78,9331
15,15,5,3,67,19,86,9331
16,16,2,6,69,25,94,9331
17,17,2,6,71,31,102,9331
18,18,6,5,77,36,113,9331
19,19,1,1,78,37,115,9331
20,20,1,1,79,38,117,9331
21,21,0,2,79,40,119,9331
22,22,0,0,79,40,119,9331
0,0,1,0,1,0,1,9332
1,1,0,0,1,0,1,9332
0,0,1,0,1,0,1,9333
1,1,0,0,1,0,1,9333
0,0,1,0,1,0,1,9334
1,1,0,0,1,0,1,9334
0,0,1,0,1,0,1,9335
1,1,2,0,3,0,3,9335
2,2,2,1,5,1,6,9335
3,3,1,2,6,3,9,9335
4,4,1,0,7,3,10,9335
5,5,0,0,7,3,10,9335
0,0,1,0,1,0,1,9336
1,1,1,0,2,0,2,9336
2,2,1,1,3,1,4,9336
3,3,1,0,4,1,5,9336
4,4,1,1,5,2,7,9336
5,5,2,0,7,2,9,9336
6,6,1,2,8,4,12,9336
7,7,1,2,9,6,15,9336
8,8,0,2,9,8,17,9336
9,9,1,2,10,10,20,9336
10,10,0,0,10,10,20,9336
0,0,1,0,1,0,1,9337
1,1,0,0,1,0,1,9337
0,0,1,0,1,0,1,9338
1,1,2,0,3,0,3,9338
2,2,0,0,3,0,3,9338
0,0,1,0,1,0,1,9339
1,1,0,0,1,0,1,9339
0,0,1,0,1,0,1,9340
1,1,0,2,1,2,3,9340
2,2,0,2,1,4,5,9340
3,3,1,1,2,5,7,9340
4,4,0,3,2,8,10,9340
5,5,0,2,2,10,12,9340
6,6,0,0,2,10,12,9340
0,0,1,0,1,0,1,9341
1,1,0,0,1,0,1,9341
0,0,1,0,1,0,1,9342
1,1,0,1,1,1,2,9342
2,2,0,0,1,1,2,9342
0,0,1,0,1,0,1,9343
1,1,2,0,3,0,3,9343
2,2,0,0,3,0,3,9343
0,0,1,0,1,0,1,9344
1,1,1,0,2,0,2,9344
2,2,0,0,2,0,2,9344
0,0,1,0,1,0,1,9345
1,1,0,1,1,1,2,9345
2,2,0,1,1,2,3,9345
3,3,0,0,1,2,3,9345
0,0,1,0,1,0,1,9346
1,1,0,0,1,0,1,9346
0,0,1,0,1,0,1,9347
1,1,3,0,4,0,4,9347
2,2,2,2,6,2,8,9347
3,3,2,2,8,4,12,9347
4,4,2,4,10,8,18,9347
5,5,2,2,12,10,22,9347
6,6,2,5,14,15,29,9347
7,7,1,5,15,20,35,9347
8,8,2,4,17,24,41,9347
9,9,6,1,23,25,48,9347
10,10,3,3,26,28,54,9347
11,11,1,6,27,34,61,9347
12,12,1,4,28,38,66,9347
13,13,0,3,28,41,69,9347
14,14,0,1,28,42,70,9347
15,15,0,0,28,42,70,9347
0,0,1,0,1,0,1,9348
1,1,0,0,1,0,1,9348
0,0,1,0,1,0,1,9349
1,1,1,1,2,1,3,9349
2,2,1,1,3,2,5,9349
3,3,2,0,5,2,7,9349
4,4,2,0,7,2,9,9349
5,5,2,0,9,2,11,9349
6,6,1,0,10,2,12,9349
7,7,2,1,12,3,15,9349
8,8,0,0,12,3,15,9349
0,0,1,0,1,0,1,9350
1,1,3,0,4,0,4,9350
2,2,4,2,8,2,10,9350
3,3,3,0,11,2,13,9350
4,4,1,0,12,2,14,9350
5,5,0,0,12,2,14,9350
0,0,1,0,1,0,1,9351
1,1,0,0,1,0,1,9351
0,0,1,0,1,0,1,9352
1,1,1,0,2,0,2,9352
2,2,0,0,2,0,2,9352
0,0,1,0,1,0,1,9353
1,1,0,1,1,1,2,9353
2,2,1,0,2,1,3,9353
3,3,0,0,2,1,3,9353
0,0,1,0,1,0,1,9354
1,1,1,1,2,1,3,9354
2,2,4,0,6,1,7,9354
3,3,1,2,7,3,10,9354
4,4,1,4,8,7,15,9354
5,5,0,2,8,9,17,9354
6,6,2,1,10,10,20,9354
7,7,0,2,10,12,22,9354
8,8,0,4,10,16,26,9354
9,9,1,4,11,20,31,9354
10,10,1,5,12,25,37,9354
11,11,1,5,13,30,43,9354
12,12,1,3,14,33,47,9354
13,13,0,3,14,36,50,9354
14,14,0,2,14,38,52,9354
15,15,0,2,14,40,54,9354
16,16,1,0,15,40,55,9354
17,17,0,0,15,40,55,9354
0,0,1,0,1,0,1,9355
1,1,0,0,1,0,1,9355
0,0,1,0,1,0,1,9356
1,1,0,0,1,0,1,9356
0,0,1,0,1,0,1,9357
1,1,0,0,1,0,1,9357
0,0,1,0,1,0,1,9358
1,1,0,0,1,0,1,9358
0,0,1,0,1,0,1,9359
1,1,1,0,2,0,2,9359
2,2,1,0,3,0,3,9359
3,3,0,1,3,1,4,9359
4,4,0,0,3,1,4,9359
0,0,1,0,1,0,1,9360
1,1,1,0,2,0,2,9360
2,2,0,0,2,0,2,9360
0,0,1,0,1,0,1,9361
1,1,1,1,2,1,3,9361
2,2,0,3,2,4,6,9361
3,3,1,1,3,5,8,9361
4,4,0,0,3,5,8,9361
0,0,1,0,1,0,1,9362
1,1,0,1,1,1,2,9362
2,2,0,0,1,1,2,9362
0,0,1,0,1,0,1,9363
1,1,0,1,1,1,2,9363
2,2,0,2,1,3,4,9363
3,3,0,3,1,6,7,9363
4,4,0,6,1,12,13,9363
5,5,0,6,1,18,19,9363
6,6,1,4,2,22,24,9363
7,7,1,3,3,25,28,9363
8,8,0,2,3,27,30,9363
9,9,0,1,3,28,31,9363
10,10,0,0,3,28,31,9363
0,0,1,0,1,0,1,9364
1,1,2,0,3,0,3,9364
2,2,2,0,5,0,5,9364
3,3,0,0,5,0,5,9364
0,0,1,0,1,0,1,9365
1,1,0,2,1,2,3,9365
2,2,1,1,2,3,5,9365
3,3,0,1,2,4,6,9365
4,4,1,2,3,6,9,9365
5,5,1,3,4,9,13,9365
6,6,3,3,7,12,19,9365
7,7,3,2,10,14,24,9365
8,8,3,1,13,15,28,9365
9,9,2,1,15,16,31,9365
10,10,3,0,18,16,34,9365
11,11,1,1,19,17,36,9365
12,12,1,2,20,19,39,9365
13,13,1,1,21,20,41,9365
14,14,2,1,23,21,44,9365
15,15,2,1,25,22,47,9365
16,16,1,0,26,22,48,9365
17,17,1,0,27,22,49,9365
18,18,2,0,29,22,51,9365
19,19,2,2,31,24,55,9365
20,20,2,1,33,25,58,9365
21,21,3,0,36,25,61,9365
22,22,4,1,40,26,66,9365
23,23,5,2,45,28,73,9365
24,24,3,4,48,32,80,9365
25,25,6,2,54,34,88,9365
26,26,4,1,58,35,93,9365
27,27,7,2,65,37,102,9365
28,28,9,1,74,38,112,9365
29,29,5,2,79,40,119,9365
30,30,1,3,80,43,123,9365
31,31,1,3,81,46,127,9365
32,32,1,1,82,47,129,9365
33,33,1,1,83,48,131,9365
34,34,0,0,83,48,131,9365
0,0,1,0,1,0,1,9366
1,1,0,0,1,0,1,9366
0,0,1,0,1,0,1,9367
1,1,0,0,1,0,1,9367
0,0,1,0,1,0,1,9368
1,1,0,0,1,0,1,9368
0,0,1,0,1,0,1,9369
1,1,1,0,2,0,2,9369
2,2,1,0,3,0,3,9369
3,3,2,0,5,0,5,9369
4,4,0,0,5,0,5,9369
0,0,1,0,1,0,1,9370
1,1,2,1,3,1,4,9370
2,2,0,0,3,1,4,9370
0,0,1,0,1,0,1,9371
1,1,1,0,2,0,2,9371
2,2,0,1,2,1,3,9371
3,3,0,0,2,1,3,9371
0,0,1,0,1,0,1,9372
1,1,0,0,1,0,1,9372
0,0,1,0,1,0,1,9373
1,1,1,1,2,1,3,9373
2,2,4,1,6,2,8,9373
3,3,4,1,10,3,13,9373
4,4,4,1,14,4,18,9373
5,5,5,1,19,5,24,9373
6,6,8,2,27,7,34,9373
7,7,7,4,34,11,45,9373
8,8,5,1,39,12,51,9373
9,9,3,2,42,14,56,9373
10,10,0,4,42,18,60,9373
11,11,1,4,43,22,65,9373
12,12,4,3,47,25,72,9373
13,13,3,5,50,30,80,9373
14,14,4,4,54,34,88,9373
15,15,1,3,55,37,92,9373
16,16,2,0,57,37,94,9373
17,17,2,1,59,38,97,9373
18,18,3,1,62,39,101,9373
19,19,3,0,65,39,104,9373
20,20,1,1,66,40,106,9373
21,21,0,0,66,40,106,9373
0,0,1,0,1,0,1,9374
1,1,3,1,4,1,5,9374
2,2,1,1,5,2,7,9374
3,3,1,2,6,4,10,9374
4,4,2,1,8,5,13,9374
5,5,3,2,11,7,18,9374
6,6,4,6,15,13,28,9374
7,7,4,4,19,17,36,9374
8,8,3,6,22,23,45,9374
9,9,3,2,25,25,50,9374
10,10,1,2,26,27,53,9374
11,11,1,3,27,30,57,9374
12,12,0,0,27,30,57,9374
0,0,1,0,1,0,1,9375
1,1,1,1,2,1,3,9375
2,2,1,2,3,3,6,9375
3,3,2,2,5,5,10,9375
4,4,3,2,8,7,15,9375
5,5,5,4,13,11,24,9375
6,6,2,8,15,19,34,9375
7,7,3,8,18,27,45,9375
8,8,2,5,20,32,52,9375
9,9,1,1,21,33,54,9375
10,10,1,0,22,33,55,9375
11,11,2,0,24,33,57,9375
12,12,0,0,24,33,57,9375
0,0,1,0,1,0,1,9376
1,1,0,0,1,0,1,9376
0,0,1,0,1,0,1,9377
1,1,1,0,2,0,2,9377
2,2,0,0,2,0,2,9377
0,0,1,0,1,0,1,9378
1,1,1,0,2,0,2,9378
2,2,1,0,3,0,3,9378
3,3,0,0,3,0,3,9378
0,0,1,0,1,0,1,9379
1,1,0,1,1,1,2,9379
2,2,0,0,1,1,2,9379
0,0,1,0,1,0,1,9380
1,1,2,1,3,1,4,9380
2,2,1,1,4,2,6,9380
3,3,0,0,4,2,6,9380
0,0,1,0,1,0,1,9381
1,1,2,0,3,0,3,9381
2,2,2,0,5,0,5,9381
3,3,2,1,7,1,8,9381
4,4,4,0,11,1,12,9381
5,5,2,0,13,1,14,9381
6,6,1,0,14,1,15,9381
7,7,0,0,14,1,15,9381
0,0,1,0,1,0,1,9382
1,1,3,0,4,0,4,9382
2,2,4,1,8,1,9,9382
3,3,2,1,10,2,12,9382
4,4,1,1,11,3,14,9382
5,5,1,1,12,4,16,9382
6,6,1,1,13,5,18,9382
7,7,2,1,15,6,21,9382
8,8,2,2,17,8,25,9382
9,9,0,0,17,8,25,9382
0,0,1,0,1,0,1,9383
1,1,1,0,2,0,2,9383
2,2,1,0,3,0,3,9383
3,3,1,0,4,0,4,9383
4,4,0,2,4,2,6,9383
5,5,0,4,4,6,10,9383
6,6,1,2,5,8,13,9383
7,7,0,0,5,8,13,9383
0,0,1,0,1,0,1,9384
1,1,1,0,2,0,2,9384
2,2,0,0,2,0,2,9384
0,0,1,0,1,0,1,9385
1,1,1,0,2,0,2,9385
2,2,0,1,2,1,3,9385
3,3,0,0,2,1,3,9385
0,0,1,0,1,0,1,9386
1,1,0,0,1,0,1,9386
0,0,1,0,1,0,1,9387
1,1,0,0,1,0,1,9387
0,0,1,0,1,0,1,9388
1,1,1,0,2,0,2,9388
2,2,3,1,5,1,6,9388
3,3,0,1,5,2,7,9388
4,4,0,0,5,2,7,9388
0,0,1,0,1,0,1,9389
1,1,1,0,2,0,2,9389
2,2,0,0,2,0,2,9389
0,0,1,0,1,0,1,9390
1,1,1,0,2,0,2,9390
2,2,0,0,2,0,2,9390
0,0,1,0,1,0,1,9391
1,1,0,0,1,0,1,9391
0,0,1,0,1,0,1,9392
1,1,1,0,2,0,2,9392
2,2,1,0,3,0,3,9392
3,3,1,0,4,0,4,9392
4,4,0,0,4,0,4,9392
0,0,1,0,1,0,1,9393
1,1,0,1,1,1,2,9393
2,2,0,0,1,1,2,9393
0,0,1,0,1,0,1,9394
1,1,0,0,1,0,1,9394
0,0,1,0,1,0,1,9395
1,1,0,0,1,0,1,9395
0,0,1,0,1,0,1,9396
1,1,0,0,1,0,1,9396
0,0,1,0,1,0,1,9397
1,1,1,0,2,0,2,9397
2,2,1,0,3,0,3,9397
3,3,0,0,3,0,3,9397
0,0,1,0,1,0,1,9398
1,1,0,0,1,0,1,9398
0,0,1,0,1,0,1,9399
1,1,0,0,1,0,1,9399
0,0,1,0,1,0,1,9400
1,1,1,0,2,0,2,9400
2,2,0,0,2,0,2,9400
0,0,1,0,1,0,1,9401
1,1,0,0,1,0,1,9401
0,0,1,0,1,0,1,9402
1,1,1,0,2,0,2,9402
2,2,1,0,3,0,3,9402
3,3,0,1,3,1,4,9402
4,4,0,2,3,3,6,9402
5,5,0,3,3,6,9,9402
6,6,0,1,3,7,10,9402
7,7,1,0,4,7,11,9402
8,8,0,0,4,7,11,9402
0,0,1,0,1,0,1,9403
1,1,0,1,1,1,2,9403
2,2,0,0,1,1,2,9403
0,0,1,0,1,0,1,9404
1,1,0,0,1,0,1,9404
0,0,1,0,1,0,1,9405
1,1,0,1,1,1,2,9405
2,2,1,0,2,1,3,9405
3,3,0,1,2,2,4,9405
4,4,0,1,2,3,5,9405
5,5,0,0,2,3,5,9405
0,0,1,0,1,0,1,9406
1,1,0,0,1,0,1,9406
0,0,1,0,1,0,1,9407
1,1,0,1,1,1,2,9407
2,2,0,0,1,1,2,9407
0,0,1,0,1,0,1,9408
1,1,0,0,1,0,1,9408
0,0,1,0,1,0,1,9409
1,1,0,0,1,0,1,9409
0,0,1,0,1,0,1,9410
1,1,1,0,2,0,2,9410
2,2,1,1,3,1,4,9410
3,3,2,2,5,3,8,9410
4,4,3,1,8,4,12,9410
5,5,1,1,9,5,14,9410
6,6,0,1,9,6,15,9410
7,7,0,0,9,6,15,9410
0,0,1,0,1,0,1,9411
1,1,1,0,2,0,2,9411
2,2,1,1,3,1,4,9411
3,3,0,2,3,3,6,9411
4,4,1,1,4,4,8,9411
5,5,0,1,4,5,9,9411
6,6,0,1,4,6,10,9411
7,7,0,3,4,9,13,9411
8,8,1,1,5,10,15,9411
9,9,0,1,5,11,16,9411
10,10,0,0,5,11,16,9411
0,0,1,0,1,0,1,9412
1,1,1,0,2,0,2,9412
2,2,0,0,2,0,2,9412
0,0,1,0,1,0,1,9413
1,1,1,1,2,1,3,9413
2,2,2,2,4,3,7,9413
3,3,1,1,5,4,9,9413
4,4,1,1,6,5,11,9413
5,5,0,0,6,5,11,9413
0,0,1,0,1,0,1,9414
1,1,1,0,2,0,2,9414
2,2,0,0,2,0,2,9414
0,0,1,0,1,0,1,9415
1,1,1,0,2,0,2,9415
2,2,2,0,4,0,4,9415
3,3,1,1,5,1,6,9415
4,4,1,1,6,2,8,9415
5,5,2,1,8,3,11,9415
6,6,1,2,9,5,14,9415
7,7,1,2,10,7,17,9415
8,8,0,0,10,7,17,9415
0,0,1,0,1,0,1,9416
1,1,1,0,2,0,2,9416
2,2,0,0,2,0,2,9416
0,0,1,0,1,0,1,9417
1,1,1,0,2,0,2,9417
2,2,2,0,4,0,4,9417
3,3,1,0,5,0,5,9417
4,4,1,0,6,0,6,9417
5,5,2,0,8,0,8,9417
6,6,1,0,9,0,9,9417
7,7,0,0,9,0,9,9417
0,0,1,0,1,0,1,9418
1,1,0,0,1,0,1,9418
0,0,1,0,1,0,1,9419
1,1,2,0,3,0,3,9419
2,2,0,0,3,0,3,9419
0,0,1,0,1,0,1,9420
1,1,0,0,1,0,1,9420
0,0,1,0,1,0,1,9421
1,1,1,0,2,0,2,9421
2,2,1,0,3,0,3,9421
3,3,0,0,3,0,3,9421
0,0,1,0,1,0,1,9422
1,1,0,0,1,0,1,9422
0,0,1,0,1,0,1,9423
1,1,0,0,1,0,1,9423
0,0,1,0,1,0,1,9424
1,1,1,0,2,0,2,9424
2,2,0,1,2,1,3,9424
3,3,0,0,2,1,3,9424
0,0,1,0,1,0,1,9425
1,1,1,0,2,0,2,9425
2,2,0,0,2,0,2,9425
0,0,1,0,1,0,1,9426
1,1,0,0,1,0,1,9426
0,0,1,0,1,0,1,9427
1,1,0,0,1,0,1,9427
0,0,1,0,1,0,1,9428
1,1,0,0,1,0,1,9428
0,0,1,0,1,0,1,9429
1,1,0,0,1,0,1,9429
0,0,1,0,1,0,1,9430
1,1,1,1,2,1,3,9430
2,2,0,1,2,2,4,9430
3,3,0,0,2,2,4,9430
0,0,1,0,1,0,1,9431
1,1,0,0,1,0,1,9431
0,0,1,0,1,0,1,9432
1,1,0,0,1,0,1,9432
0,0,1,0,1,0,1,9433
1,1,0,2,1,2,3,9433
2,2,1,2,2,4,6,9433
3,3,2,3,4,7,11,9433
4,4,0,4,4,11,15,9433
5,5,1,3,5,14,19,9433
6,6,2,1,7,15,22,9433
7,7,1,4,8,19,27,9433
8,8,3,6,11,25,36,9433
9,9,1,2,12,27,39,9433
10,10,0,1,12,28,40,9433
11,11,0,2,12,30,42,9433
12,12,0,0,12,30,42,9433
0,0,1,0,1,0,1,9434
1,1,2,0,3,0,3,9434
2,2,3,0,6,0,6,9434
3,3,1,0,7,0,7,9434
4,4,0,0,7,0,7,9434
0,0,1,0,1,0,1,9435
1,1,1,0,2,0,2,9435
2,2,2,1,4,1,5,9435
3,3,0,0,4,1,5,9435
0,0,1,0,1,0,1,9436
1,1,0,0,1,0,1,9436
0,0,1,0,1,0,1,9437
1,1,2,0,3,0,3,9437
2,2,1,0,4,0,4,9437
3,3,2,0,6,0,6,9437
4,4,1,0,7,0,7,9437
5,5,1,0,8,0,8,9437
6,6,2,0,10,0,10,9437
7,7,3,0,13,0,13,9437
8,8,2,0,15,0,15,9437
9,9,0,0,15,0,15,9437
0,0,1,0,1,0,1,9438
1,1,1,0,2,0,2,9438
2,2,1,0,3,0,3,9438
3,3,2,0,5,0,5,9438
4,4,1,0,6,0,6,9438
5,5,0,0,6,0,6,9438
0,0,1,0,1,0,1,9439
1,1,0,0,1,0,1,9439
0,0,1,0,1,0,1,9440
1,1,0,0,1,0,1,9440
0,0,1,0,1,0,1,9441
1,1,1,0,2,0,2,9441
2,2,1,1,3,1,4,9441
3,3,1,2,4,3,7,9441
4,4,1,5,5,8,13,9441
5,5,3,2,8,10,18,9441
6,6,3,0,11,10,21,9441
7,7,2,0,13,10,23,9441
8,8,5,0,18,10,28,9441
9,9,1,0,19,10,29,9441
10,10,1,0,20,10,30,9441
11,11,0,0,20,10,30,9441
0,0,1,0,1,0,1,9442
1,1,2,0,3,0,3,9442
2,2,1,0,4,0,4,9442
3,3,1,0,5,0,5,9442
4,4,0,0,5,0,5,9442
0,0,1,0,1,0,1,9443
1,1,0,0,1,0,1,9443
0,0,1,0,1,0,1,9444
1,1,1,0,2,0,2,9444
2,2,1,0,3,0,3,9444
3,3,1,0,4,0,4,9444
4,4,1,2,5,2,7,9444
5,5,1,1,6,3,9,9444
6,6,0,2,6,5,11,9444
7,7,1,1,7,6,13,9444
8,8,1,0,8,6,14,9444
9,9,0,0,8,6,14,9444
0,0,1,0,1,0,1,9445
1,1,2,0,3,0,3,9445
2,2,0,0,3,0,3,9445
0,0,1,0,1,0,1,9446
1,1,1,0,2,0,2,9446
2,2,1,0,3,0,3,9446
3,3,2,0,5,0,5,9446
4,4,0,1,5,1,6,9446
5,5,0,0,5,1,6,9446
0,0,1,0,1,0,1,9447
1,1,1,1,2,1,3,9447
2,2,1,0,3,1,4,9447
3,3,2,0,5,1,6,9447
4,4,1,0,6,1,7,9447
5,5,0,0,6,1,7,9447
0,0,1,0,1,0,1,9448
1,1,2,0,3,0,3,9448
2,2,2,0,5,0,5,9448
3,3,4,1,9,1,10,9448
4,4,0,0,9,1,10,9448
0,0,1,0,1,0,1,9449
1,1,2,0,3,0,3,9449
2,2,1,0,4,0,4,9449
3,3,0,0,4,0,4,9449
0,0,1,0,1,0,1,9450
1,1,3,0,4,0,4,9450
2,2,1,0,5,0,5,9450
3,3,0,2,5,2,7,9450
4,4,1,1,6,3,9,9450
5,5,0,3,6,6,12,9450
6,6,0,4,6,10,16,9450
7,7,0,3,6,13,19,9450
8,8,0,1,6,14,20,9450
9,9,0,3,6,17,23,9450
10,10,1,3,7,20,27,9450
11,11,1,2,8,22,30,9450
12,12,1,2,9,24,33,9450
13,13,0,2,9,26,35,9450
14,14,0,2,9,28,37,9450
15,15,1,1,10,29,39,9450
16,16,1,0,11,29,40,9450
17,17,1,1,12,30,42,9450
18,18,2,1,14,31,45,9450
19,19,3,1,17,32,49,9450
20,20,0,2,17,34,51,9450
21,21,0,0,17,34,51,9450
0,0,1,0,1,0,1,9451
1,1,0,0,1,0,1,9451
0,0,1,0,1,0,1,9452
1,1,1,0,2,0,2,9452
2,2,0,0,2,0,2,9452
0,0,1,0,1,0,1,9453
1,1,1,0,2,0,2,9453
2,2,0,1,2,1,3,9453
3,3,0,0,2,1,3,9453
0,0,1,0,1,0,1,9454
1,1,1,1,2,1,3,9454
2,2,1,1,3,2,5,9454
3,3,2,0,5,2,7,9454
4,4,1,0,6,2,8,9454
5,5,1,0,7,2,9,9454
6,6,3,0,10,2,12,9454
7,7,3,1,13,3,16,9454
8,8,5,1,18,4,22,9454
9,9,5,4,23,8,31,9454
10,10,2,3,25,11,36,9454
11,11,2,3,27,14,41,9454
12,12,3,1,30,15,45,9454
13,13,1,0,31,15,46,9454
14,14,1,0,32,15,47,9454
15,15,0,0,32,15,47,9454
0,0,1,0,1,0,1,9455
1,1,0,0,1,0,1,9455
0,0,1,0,1,0,1,9456
1,1,2,0,3,0,3,9456
2,2,0,1,3,1,4,9456
3,3,0,1,3,2,5,9456
4,4,0,1,3,3,6,9456
5,5,0,2,3,5,8,9456
6,6,0,4,3,9,12,9456
7,7,1,5,4,14,18,9456
8,8,2,3,6,17,23,9456
9,9,3,1,9,18,27,9456
10,10,1,1,10,19,29,9456
11,11,1,0,11,19,30,9456
12,12,1,0,12,19,31,9456
13,13,1,0,13,19,32,9456
14,14,1,0,14,19,33,9456
15,15,2,0,16,19,35,9456
16,16,0,2,16,21,37,9456
17,17,1,1,17,22,39,9456
18,18,0,1,17,23,40,9456
19,19,0,0,17,23,40,9456
0,0,1,0,1,0,1,9457
1,1,0,0,1,0,1,9457
0,0,1,0,1,0,1,9458
1,1,0,1,1,1,2,9458
2,2,0,2,1,3,4,9458
3,3,0,2,1,5,6,9458
4,4,0,2,1,7,8,9458
5,5,1,4,2,11,13,9458
6,6,2,2,4,13,17,9458
7,7,0,3,4,16,20,9458
8,8,0,3,4,19,23,9458
9,9,1,2,5,21,26,9458
10,10,1,2,6,23,29,9458
11,11,1,1,7,24,31,9458
12,12,1,0,8,24,32,9458
13,13,2,1,10,25,35,9458
14,14,0,1,10,26,36,9458
15,15,0,0,10,26,36,9458
0,0,1,0,1,0,1,9459
1,1,1,0,2,0,2,9459
2,2,0,0,2,0,2,9459
0,0,1,0,1,0,1,9460
1,1,0,0,1,0,1,9460
0,0,1,0,1,0,1,9461
1,1,2,0,3,0,3,9461
2,2,2,1,5,1,6,9461
3,3,4,1,9,2,11,9461
4,4,1,2,10,4,14,9461
5,5,0,0,10,4,14,9461
0,0,1,0,1,0,1,9462
1,1,1,0,2,0,2,9462
2,2,0,0,2,0,2,9462
0,0,1,0,1,0,1,9463
1,1,1,0,2,0,2,9463
2,2,1,0,3,0,3,9463
3,3,0,0,3,0,3,9463
0,0,1,0,1,0,1,9464
1,1,1,0,2,0,2,9464
2,2,1,0,3,0,3,9464
3,3,1,0,4,0,4,9464
4,4,0,0,4,0,4,9464
0,0,1,0,1,0,1,9465
1,1,3,0,4,0,4,9465
2,2,2,2,6,2,8,9465
3,3,2,1,8,3,11,9465
4,4,2,4,10,7,17,9465
5,5,4,2,14,9,23,9465
6,6,3,2,17,11,28,9465
7,7,3,1,20,12,32,9465
8,8,1,3,21,15,36,9465
9,9,0,2,21,17,38,9465
10,10,1,2,22,19,41,9465
11,11,2,3,24,22,46,9465
12,12,1,2,25,24,49,9465
13,13,1,1,26,25,51,9465
14,14,2,1,28,26,54,9465
15,15,2,3,30,29,59,9465
16,16,3,1,33,30,63,9465
17,17,3,0,36,30,66,9465
18,18,3,0,39,30,69,9465
19,19,2,1,41,31,72,9465
20,20,0,0,41,31,72,9465
0,0,1,0,1,0,1,9466
1,1,1,0,2,0,2,9466
2,2,0,1,2,1,3,9466
3,3,1,0,3,1,4,9466
4,4,0,0,3,1,4,9466
0,0,1,0,1,0,1,9467
1,1,2,0,3,0,3,9467
2,2,2,0,5,0,5,9467
3,3,0,1,5,1,6,9467
4,4,0,1,5,2,7,9467
5,5,0,0,5,2,7,9467
0,0,1,0,1,0,1,9468
1,1,0,0,1,0,1,9468
0,0,1,0,1,0,1,9469
1,1,3,0,4,0,4,9469
2,2,2,1,6,1,7,9469
3,3,2,0,8,1,9,9469
4,4,1,1,9,2,11,9469
5,5,0,0,9,2,11,9469
0,0,1,0,1,0,1,9470
1,1,2,0,3,0,3,9470
2,2,4,0,7,0,7,9470
3,3,4,1,11,1,12,9470
4,4,6,0,17,1,18,9470
5,5,1,1,18,2,20,9470
6,6,0,1,18,3,21,9470
7,7,0,0,18,3,21,9470
0,0,1,0,1,0,1,9471
1,1,1,0,2,0,2,9471
2,2,0,0,2,0,2,9471
0,0,1,0,1,0,1,9472
1,1,2,0,3,0,3,9472
2,2,2,0,5,0,5,9472
3,3,1,0,6,0,6,9472
4,4,1,0,7,0,7,9472
5,5,3,0,10,0,10,9472
6,6,4,0,14,0,14,9472
7,7,5,0,19,0,19,9472
8,8,5,0,24,0,24,9472
9,9,7,1,31,1,32,9472
10,10,6,1,37,2,39,9472
11,11,2,1,39,3,42,9472
12,12,3,2,42,5,47,9472
13,13,4,0,46,5,51,9472
14,14,6,1,52,6,58,9472
15,15,5,1,57,7,64,9472
16,16,9,1,66,8,74,9472
17,17,7,1,73,9,82,9472
18,18,10,1,83,10,93,9472
19,19,11,1,94,11,105,9472
20,20,14,4,108,15,123,9472
21,21,17,5,125,20,145,9472
22,22,19,4,144,24,168,9472
23,23,10,6,154,30,184,9472
24,24,5,5,159,35,194,9472
25,25,5,3,164,38,202,9472
26,26,2,2,166,40,206,9472
27,27,1,4,167,44,211,9472
28,28,1,3,168,47,215,9472
29,29,1,1,169,48,217,9472
30,30,0,0,169,48,217,9472
0,0,1,0,1,0,1,9473
1,1,1,0,2,0,2,9473
2,2,2,0,4,0,4,9473
3,3,1,0,5,0,5,9473
4,4,2,0,7,0,7,9473
5,5,1,0,8,0,8,9473
6,6,0,0,8,0,8,9473
0,0,1,0,1,0,1,9474
1,1,2,0,3,0,3,9474
2,2,2,0,5,0,5,9474
3,3,0,1,5,1,6,9474
4,4,0,2,5,3,8,9474
5,5,0,0,5,3,8,9474
0,0,1,0,1,0,1,9475
1,1,1,0,2,0,2,9475
2,2,0,0,2,0,2,9475
0,0,1,0,1,0,1,9476
1,1,0,0,1,0,1,9476
0,0,1,0,1,0,1,9477
1,1,0,0,1,0,1,9477
0,0,1,0,1,0,1,9478
1,1,0,1,1,1,2,9478
2,2,0,0,1,1,2,9478
0,0,1,0,1,0,1,9479
1,1,2,0,3,0,3,9479
2,2,2,0,5,0,5,9479
3,3,4,1,9,1,10,9479
4,4,1,1,10,2,12,9479
5,5,1,0,11,2,13,9479
6,6,1,0,12,2,14,9479
7,7,1,0,13,2,15,9479
8,8,0,1,13,3,16,9479
9,9,0,0,13,3,16,9479
0,0,1,0,1,0,1,9480
1,1,0,0,1,0,1,9480
0,0,1,0,1,0,1,9481
1,1,0,0,1,0,1,9481
0,0,1,0,1,0,1,9482
1,1,0,0,1,0,1,9482
0,0,1,0,1,0,1,9483
1,1,1,0,2,0,2,9483
2,2,2,0,4,0,4,9483
3,3,2,0,6,0,6,9483
4,4,0,1,6,1,7,9483
5,5,1,0,7,1,8,9483
6,6,3,0,10,1,11,9483
7,7,1,0,11,1,12,9483
8,8,0,0,11,1,12,9483
0,0,1,0,1,0,1,9484
1,1,0,0,1,0,1,9484
0,0,1,0,1,0,1,9485
1,1,1,0,2,0,2,9485
2,2,0,0,2,0,2,9485
0,0,1,0,1,0,1,9486
1,1,0,0,1,0,1,9486
0,0,1,0,1,0,1,9487
1,1,1,2,2,2,4,9487
2,2,4,2,6,4,10,9487
3,3,4,2,10,6,16,9487
4,4,2,3,12,9,21,9487
5,5,3,1,15,10,25,9487
6,6,1,3,16,13,29,9487
7,7,1,4,17,17,34,9487
8,8,0,2,17,19,36,9487
9,9,0,2,17,21,38,9487
10,10,1,2,18,23,41,9487
11,11,3,3,21,26,47,9487
12,12,2,2,23,28,51,9487
13,13,1,2,24,30,54,9487
14,14,4,1,28,31,59,9487
15,15,8,1,36,32,68,9487
16,16,6,1,42,33,75,9487
17,17,4,1,46,34,80,9487
18,18,5,3,51,37,88,9487
19,19,6,4,57,41,98,9487
20,20,7,1,64,42,106,9487
21,21,9,0,73,42,115,9487
22,22,5,2,78,44,122,9487
23,23,5,2,83,46,129,9487
24,24,5,4,88,50,138,9487
25,25,8,5,96,55,151,9487
26,26,6,7,102,62,164,9487
27,27,4,1,106,63,169,9487
28,28,3,0,109,63,172,9487
29,29,5,0,114,63,177,9487
30,30,5,0,119,63,182,9487
31,31,4,0,123,63,186,9487
32,32,5,1,128,64,192,9487
33,33,4,2,132,66,198,9487
34,34,2,2,134,68,202,9487
35,35,3,2,137,70,207,9487
36,36,2,2,139,72,211,9487
37,37,3,3,142,75,217,9487
38,38,5,0,147,75,222,9487
39,39,3,0,150,75,225,9487
40,40,0,0,150,75,225,9487
0,0,1,0,1,0,1,9488
1,1,1,0,2,0,2,9488
2,2,0,1,2,1,3,9488
3,3,0,0,2,1,3,9488
0,0,1,0,1,0,1,9489
1,1,0,0,1,0,1,9489
0,0,1,0,1,0,1,9490
1,1,0,0,1,0,1,9490
0,0,1,0,1,0,1,9491
1,1,2,0,3,0,3,9491
2,2,1,0,4,0,4,9491
3,3,0,1,4,1,5,9491
4,4,0,1,4,2,6,9491
5,5,0,1,4,3,7,9491
6,6,0,0,4,3,7,9491
0,0,1,0,1,0,1,9492
1,1,1,0,2,0,2,9492
2,2,2,1,4,1,5,9492
3,3,2,1,6,2,8,9492
4,4,4,0,10,2,12,9492
5,5,1,0,11,2,13,9492
6,6,0,0,11,2,13,9492
0,0,1,0,1,0,1,9493
1,1,1,1,2,1,3,9493
2,2,0,1,2,2,4,9493
3,3,0,1,2,3,5,9493
4,4,0,1,2,4,6,9493
5,5,0,1,2,5,7,9493
6,6,1,0,3,5,8,9493
7,7,2,0,5,5,10,9493
8,8,1,0,6,5,11,9493
9,9,1,0,7,5,12,9493
10,10,1,0,8,5,13,9493
11,11,1,0,9,5,14,9493
12,12,0,0,9,5,14,9493
0,0,1,0,1,0,1,9494
1,1,0,1,1,1,2,9494
2,2,1,2,2,3,5,9494
3,3,4,3,6,6,12,9494
4,4,6,1,12,7,19,9494
5,5,4,1,16,8,24,9494
6,6,5,1,21,9,30,9494
7,7,1,2,22,11,33,9494
8,8,3,0,25,11,36,9494
9,9,1,1,26,12,38,9494
10,10,2,1,28,13,41,9494
11,11,3,1,31,14,45,9494
12,12,1,0,32,14,46,9494
13,13,0,0,32,14,46,9494
0,0,1,0,1,0,1,9495
1,1,0,0,1,0,1,9495
0,0,1,0,1,0,1,9496
1,1,1,0,2,0,2,9496
2,2,0,0,2,0,2,9496
0,0,1,0,1,0,1,9497
1,1,2,0,3,0,3,9497
2,2,1,1,4,1,5,9497
3,3,2,0,6,1,7,9497
4,4,1,1,7,2,9,9497
5,5,3,1,10,3,13,9497
6,6,2,2,12,5,17,9497
7,7,1,2,13,7,20,9497
8,8,0,3,13,10,23,9497
9,9,0,2,13,12,25,9497
10,10,0,2,13,14,27,9497
11,11,1,0,14,14,28,9497
12,12,1,1,15,15,30,9497
13,13,1,0,16,15,31,9497
14,14,0,0,16,15,31,9497
0,0,1,0,1,0,1,9498
1,1,0,0,1,0,1,9498
0,0,1,0,1,0,1,9499
1,1,0,0,1,0,1,9499
0,0,1,0,1,0,1,9500
1,1,2,0,3,0,3,9500
2,2,2,1,5,1,6,9500
3,3,2,1,7,2,9,9500
4,4,2,0,9,2,11,9500
5,5,2,0,11,2,13,9500
6,6,3,0,14,2,16,9500
7,7,4,1,18,3,21,9500
8,8,3,4,21,7,28,9500
9,9,2,3,23,10,33,9500
10,10,3,4,26,14,40,9500
11,11,1,4,27,18,45,9500
12,12,1,6,28,24,52,9500
13,13,1,9,29,33,62,9500
14,14,3,9,32,42,74,9500
15,15,5,10,37,52,89,9500
16,16,5,11,42,63,105,9500
17,17,9,6,51,69,120,9500
18,18,12,5,63,74,137,9500
19,19,10,4,73,78,151,9500
20,20,10,3,83,81,164,9500
21,21,8,8,91,89,180,9500
22,22,8,11,99,100,199,9500
23,23,7,8,106,108,214,9500
24,24,7,6,113,114,227,9500
25,25,7,3,120,117,237,9500
26,26,7,3,127,120,247,9500
27,27,6,1,133,121,254,9500
28,28,2,2,135,123,258,9500
29,29,2,1,137,124,261,9500
30,30,3,2,140,126,266,9500
31,31,1,0,141,126,267,9500
32,32,0,0,141,126,267,9500
0,0,1,0,1,0,1,9501
1,1,0,0,1,0,1,9501
0,0,1,0,1,0,1,9502
1,1,0,0,1,0,1,9502
0,0,1,0,1,0,1,9503
1,1,0,0,1,0,1,9503
0,0,1,0,1,0,1,9504
1,1,1,1,2,1,3,9504
2,2,0,1,2,2,4,9504
3,3,0,0,2,2,4,9504
0,0,1,0,1,0,1,9505
1,1,0,0,1,0,1,9505
0,0,1,0,1,0,1,9506
1,1,2,0,3,0,3,9506
2,2,0,2,3,2,5,9506
3,3,0,1,3,3,6,9506
4,4,0,2,3,5,8,9506
5,5,0,3,3,8,11,9506
6,6,0,1,3,9,12,9506
7,7,0,0,3,9,12,9506
0,0,1,0,1,0,1,9507
1,1,0,0,1,0,1,9507
0,0,1,0,1,0,1,9508
1,1,0,0,1,0,1,9508
0,0,1,0,1,0,1,9509
1,1,0,0,1,0,1,9509
0,0,1,0,1,0,1,9510
1,1,1,0,2,0,2,9510
2,2,1,0,3,0,3,9510
3,3,1,0,4,0,4,9510
4,4,3,0,7,0,7,9510
5,5,3,0,10,0,10,9510
6,6,1,0,11,0,11,9510
7,7,1,0,12,0,12,9510
8,8,0,0,12,0,12,9510
0,0,1,0,1,0,1,9511
1,1,0,0,1,0,1,9511
0,0,1,0,1,0,1,9512
1,1,1,0,2,0,2,9512
2,2,0,0,2,0,2,9512
0,0,1,0,1,0,1,9513
1,1,1,0,2,0,2,9513
2,2,1,0,3,0,3,9513
3,3,2,0,5,0,5,9513
4,4,3,0,8,0,8,9513
5,5,2,0,10,0,10,9513
6,6,2,0,12,0,12,9513
7,7,0,0,12,0,12,9513
0,0,1,0,1,0,1,9514
1,1,0,0,1,0,1,9514
0,0,1,0,1,0,1,9515
1,1,1,0,2,0,2,9515
2,2,1,0,3,0,3,9515
3,3,0,0,3,0,3,9515
0,0,1,0,1,0,1,9516
1,1,0,0,1,0,1,9516
0,0,1,0,1,0,1,9517
1,1,0,1,1,1,2,9517
2,2,0,1,1,2,3,9517
3,3,0,0,1,2,3,9517
0,0,1,0,1,0,1,9518
1,1,1,0,2,0,2,9518
2,2,0,0,2,0,2,9518
0,0,1,0,1,0,1,9519
1,1,0,0,1,0,1,9519
0,0,1,0,1,0,1,9520
1,1,2,0,3,0,3,9520
2,2,0,1,3,1,4,9520
3,3,0,0,3,1,4,9520
0,0,1,0,1,0,1,9521
1,1,1,0,2,0,2,9521
2,2,0,0,2,0,2,9521
0,0,1,0,1,0,1,9522
1,1,0,0,1,0,1,9522
0,0,1,0,1,0,1,9523
1,1,2,0,3,0,3,9523
2,2,3,0,6,0,6,9523
3,3,3,0,9,0,9,9523
4,4,2,2,11,2,13,9523
5,5,1,1,12,3,15,9523
6,6,1,0,13,3,16,9523
7,7,3,2,16,5,21,9523
8,8,3,3,19,8,27,9523
9,9,2,0,21,8,29,9523
10,10,4,1,25,9,34,9523
11,11,0,1,25,10,35,9523
12,12,0,0,25,10,35,9523
0,0,1,0,1,0,1,9524
1,1,2,0,3,0,3,9524
2,2,1,1,4,1,5,9524
3,3,0,1,4,2,6,9524
4,4,0,2,4,4,8,9524
5,5,0,1,4,5,9,9524
6,6,0,0,4,5,9,9524
0,0,1,0,1,0,1,9525
1,1,0,1,1,1,2,9525
2,2,0,2,1,3,4,9525
3,3,0,1,1,4,5,9525
4,4,0,0,1,4,5,9525
0,0,1,0,1,0,1,9526
1,1,1,1,2,1,3,9526
2,2,0,1,2,2,4,9526
3,3,0,1,2,3,5,9526
4,4,0,2,2,5,7,9526
5,5,0,4,2,9,11,9526
6,6,1,3,3,12,15,9526
7,7,2,2,5,14,19,9526
8,8,2,2,7,16,23,9526
9,9,4,3,11,19,30,9526
10,10,7,4,18,23,41,9526
11,11,6,4,24,27,51,9526
12,12,3,6,27,33,60,9526
13,13,3,4,30,37,67,9526
14,14,3,4,33,41,74,9526
15,15,2,6,35,47,82,9526
16,16,3,10,38,57,95,9526
17,17,5,5,43,62,105,9526
18,18,5,8,48,70,118,9526
19,19,4,3,52,73,125,9526
20,20,5,1,57,74,131,9526
21,21,0,2,57,76,133,9526
22,22,1,4,58,80,138,9526
23,23,3,3,61,83,144,9526
24,24,1,2,62,85,147,9526
25,25,0,1,62,86,148,9526
26,26,0,2,62,88,150,9526
27,27,1,1,63,89,152,9526
28,28,2,1,65,90,155,9526
29,29,2,2,67,92,159,9526
30,30,3,0,70,92,162,9526
31,31,1,0,71,92,163,9526
32,32,1,0,72,92,164,9526
33,33,0,0,72,92,164,9526
0,0,1,0,1,0,1,9527
1,1,1,0,2,0,2,9527
2,2,0,1,2,1,3,9527
3,3,0,0,2,1,3,9527
0,0,1,0,1,0,1,9528
1,1,0,0,1,0,1,9528
0,0,1,0,1,0,1,9529
1,1,0,0,1,0,1,9529
0,0,1,0,1,0,1,9530
1,1,0,0,1,0,1,9530
0,0,1,0,1,0,1,9531
1,1,1,0,2,0,2,9531
2,2,0,0,2,0,2,9531
0,0,1,0,1,0,1,9532
1,1,0,0,1,0,1,9532
0,0,1,0,1,0,1,9533
1,1,1,0,2,0,2,9533
2,2,0,1,2,1,3,9533
3,3,0,4,2,5,7,9533
4,4,0,3,2,8,10,9533
5,5,2,6,4,14,18,9533
6,6,3,6,7,20,27,9533
7,7,1,6,8,26,34,9533
8,8,1,2,9,28,37,9533
9,9,1,0,10,28,38,9533
10,10,2,1,12,29,41,9533
11,11,1,3,13,32,45,9533
12,12,0,3,13,35,48,9533
13,13,0,4,13,39,52,9533
14,14,1,4,14,43,57,9533
15,15,0,6,14,49,63,9533
16,16,1,3,15,52,67,9533
17,17,2,2,17,54,71,9533
18,18,2,0,19,54,73,9533
19,19,0,1,19,55,74,9533
20,20,0,1,19,56,75,9533
21,21,0,0,19,56,75,9533
0,0,1,0,1,0,1,9534
1,1,0,0,1,0,1,9534
0,0,1,0,1,0,1,9535
1,1,0,1,1,1,2,9535
2,2,0,1,1,2,3,9535
3,3,0,1,1,3,4,9535
4,4,0,0,1,3,4,9535
0,0,1,0,1,0,1,9536
1,1,1,0,2,0,2,9536
2,2,1,0,3,0,3,9536
3,3,3,0,6,0,6,9536
4,4,3,2,9,2,11,9536
5,5,2,2,11,4,15,9536
6,6,1,1,12,5,17,9536
7,7,0,1,12,6,18,9536
8,8,0,1,12,7,19,9536
9,9,0,0,12,7,19,9536
0,0,1,0,1,0,1,9537
1,1,0,0,1,0,1,9537
0,0,1,0,1,0,1,9538
1,1,0,1,1,1,2,9538
2,2,2,0,3,1,4,9538
3,3,2,1,5,2,7,9538
4,4,1,2,6,4,10,9538
5,5,2,6,8,10,18,9538
6,6,1,4,9,14,23,9538
7,7,2,5,11,19,30,9538
8,8,0,6,11,25,36,9538
9,9,0,5,11,30,41,9538
10,10,1,1,12,31,43,9538
11,11,1,1,13,32,45,9538
12,12,0,0,13,32,45,9538
0,0,1,0,1,0,1,9539
1,1,1,1,2,1,3,9539
2,2,1,0,3,1,4,9539
3,3,0,0,3,1,4,9539
0,0,1,0,1,0,1,9540
1,1,0,0,1,0,1,9540
0,0,1,0,1,0,1,9541
1,1,0,0,1,0,1,9541
0,0,1,0,1,0,1,9542
1,1,0,0,1,0,1,9542
0,0,1,0,1,0,1,9543
1,1,0,1,1,1,2,9543
2,2,0,1,1,2,3,9543
3,3,0,1,1,3,4,9543
4,4,0,2,1,5,6,9543
5,5,1,0,2,5,7,9543
6,6,1,0,3,5,8,9543
7,7,0,0,3,5,8,9543
0,0,1,0,1,0,1,9544
1,1,0,0,1,0,1,9544
0,0,1,0,1,0,1,9545
1,1,1,0,2,0,2,9545
2,2,0,0,2,0,2,9545
0,0,1,0,1,0,1,9546
1,1,2,0,3,0,3,9546
2,2,2,0,5,0,5,9546
3,3,0,0,5,0,5,9546
0,0,1,0,1,0,1,9547
1,1,1,0,2,0,2,9547
2,2,1,0,3,0,3,9547
3,3,0,0,3,0,3,9547
0,0,1,0,1,0,1,9548
1,1,0,1,1,1,2,9548
2,2,0,2,1,3,4,9548
3,3,0,1,1,4,5,9548
4,4,0,0,1,4,5,9548
0,0,1,0,1,0,1,9549
1,1,0,0,1,0,1,9549
0,0,1,0,1,0,1,9550
1,1,0,0,1,0,1,9550
0,0,1,0,1,0,1,9551
1,1,0,0,1,0,1,9551
0,0,1,0,1,0,1,9552
1,1,0,2,1,2,3,9552
2,2,1,0,2,2,4,9552
3,3,3,0,5,2,7,9552
4,4,2,1,7,3,10,9552
5,5,4,0,11,3,14,9552
6,6,5,0,16,3,19,9552
7,7,2,0,18,3,21,9552
8,8,0,1,18,4,22,9552
9,9,0,1,18,5,23,9552
10,10,0,3,18,8,26,9552
11,11,0,2,18,10,28,9552
12,12,0,0,18,10,28,9552
0,0,1,0,1,0,1,9553
1,1,0,0,1,0,1,9553
0,0,1,0,1,0,1,9554
1,1,0,1,1,1,2,9554
2,2,0,1,1,2,3,9554
3,3,0,1,1,3,4,9554
4,4,0,0,1,3,4,9554
0,0,1,0,1,0,1,9555
1,1,0,1,1,1,2,9555
2,2,0,1,1,2,3,9555
3,3,0,0,1,2,3,9555
0,0,1,0,1,0,1,9556
1,1,1,0,2,0,2,9556
2,2,0,0,2,0,2,9556
0,0,1,0,1,0,1,9557
1,1,2,0,3,0,3,9557
2,2,1,0,4,0,4,9557
3,3,1,0,5,0,5,9557
4,4,0,1,5,1,6,9557
5,5,1,0,6,1,7,9557
6,6,0,0,6,1,7,9557
0,0,1,0,1,0,1,9558
1,1,1,0,2,0,2,9558
2,2,3,0,5,0,5,9558
3,3,3,1,8,1,9,9558
4,4,2,0,10,1,11,9558
5,5,2,0,12,1,13,9558
6,6,1,1,13,2,15,9558
7,7,0,2,13,4,17,9558
8,8,1,1,14,5,19,9558
9,9,1,0,15,5,20,9558
10,10,0,0,15,5,20,9558
0,0,1,0,1,0,1,9559
1,1,0,0,1,0,1,9559
0,0,1,0,1,0,1,9560
1,1,0,0,1,0,1,9560
0,0,1,0,1,0,1,9561
1,1,0,0,1,0,1,9561
0,0,1,0,1,0,1,9562
1,1,3,0,4,0,4,9562
2,2,4,1,8,1,9,9562
3,3,3,0,11,1,12,9562
4,4,4,0,15,1,16,9562
5,5,8,3,23,4,27,9562
6,6,6,3,29,7,36,9562
7,7,4,3,33,10,43,9562
8,8,5,2,38,12,50,9562
9,9,3,4,41,16,57,9562
10,10,5,2,46,18,64,9562
11,11,6,0,52,18,70,9562
12,12,6,1,58,19,77,9562
13,13,5,3,63,22,85,9562
14,14,5,2,68,24,92,9562
15,15,1,2,69,26,95,9562
16,16,0,1,69,27,96,9562
17,17,1,1,70,28,98,9562
18,18,1,1,71,29,100,9562
19,19,0,1,71,30,101,9562
20,20,0,0,71,30,101,9562
0,0,1,0,1,0,1,9563
1,1,1,0,2,0,2,9563
2,2,0,0,2,0,2,9563
0,0,1,0,1,0,1,9564
1,1,0,0,1,0,1,9564
0,0,1,0,1,0,1,9565
1,1,0,0,1,0,1,9565
0,0,1,0,1,0,1,9566
1,1,0,0,1,0,1,9566
0,0,1,0,1,0,1,9567
1,1,1,0,2,0,2,9567
2,2,0,0,2,0,2,9567
0,0,1,0,1,0,1,9568
1,1,1,0,2,0,2,9568
2,2,0,1,2,1,3,9568
3,3,1,2,3,3,6,9568
4,4,0,0,3,3,6,9568
0,0,1,0,1,0,1,9569
1,1,0,0,1,0,1,9569
0,0,1,0,1,0,1,9570
1,1,2,0,3,0,3,9570
2,2,3,0,6,0,6,9570
3,3,3,0,9,0,9,9570
4,4,2,1,11,1,12,9570
5,5,2,1,13,2,15,9570
6,6,2,0,15,2,17,9570
7,7,4,1,19,3,22,9570
8,8,5,0,24,3,27,9570
9,9,6,1,30,4,34,9570
10,10,6,1,36,5,41,9570
11,11,4,0,40,5,45,9570
12,12,2,0,42,5,47,9570
13,13,1,0,43,5,48,9570
14,14,0,0,43,5,48,9570
0,0,1,0,1,0,1,9571
1,1,0,0,1,0,1,9571
0,0,1,0,1,0,1,9572
1,1,0,0,1,0,1,9572
0,0,1,0,1,0,1,9573
1,1,0,0,1,0,1,9573
0,0,1,0,1,0,1,9574
1,1,1,0,2,0,2,9574
2,2,0,1,2,1,3,9574
3,3,0,0,2,1,3,9574
0,0,1,0,1,0,1,9575
1,1,0,1,1,1,2,9575
2,2,1,2,2,3,5,9575
3,3,1,0,3,3,6,9575
4,4,0,1,3,4,7,9575
5,5,0,1,3,5,8,9575
6,6,0,2,3,7,10,9575
7,7,0,1,3,8,11,9575
8,8,0,2,3,10,13,9575
9,9,0,0,3,10,13,9575
0,0,1,0,1,0,1,9576
1,1,0,0,1,0,1,9576
0,0,1,0,1,0,1,9577
1,1,1,0,2,0,2,9577
2,2,1,0,3,0,3,9577
3,3,0,0,3,0,3,9577
0,0,1,0,1,0,1,9578
1,1,0,0,1,0,1,9578
0,0,1,0,1,0,1,9579
1,1,1,1,2,1,3,9579
2,2,0,1,2,2,4,9579
3,3,1,1,3,3,6,9579
4,4,0,0,3,3,6,9579
0,0,1,0,1,0,1,9580
1,1,0,0,1,0,1,9580
0,0,1,0,1,0,1,9581
1,1,1,0,2,0,2,9581
2,2,1,0,3,0,3,9581
3,3,1,0,4,0,4,9581
4,4,0,1,4,1,5,9581
5,5,0,0,4,1,5,9581
0,0,1,0,1,0,1,9582
1,1,1,0,2,0,2,9582
2,2,0,1,2,1,3,9582
3,3,0,1,2,2,4,9582
4,4,0,0,2,2,4,9582
0,0,1,0,1,0,1,9583
1,1,1,0,2,0,2,9583
2,2,1,0,3,0,3,9583
3,3,0,0,3,0,3,9583
0,0,1,0,1,0,1,9584
1,1,1,0,2,0,2,9584
2,2,0,0,2,0,2,9584
0,0,1,0,1,0,1,9585
1,1,1,0,2,0,2,9585
2,2,0,0,2,0,2,9585
0,0,1,0,1,0,1,9586
1,1,0,0,1,0,1,9586
0,0,1,0,1,0,1,9587
1,1,0,0,1,0,1,9587
0,0,1,0,1,0,1,9588
1,1,1,1,2,1,3,9588
2,2,1,1,3,2,5,9588
3,3,0,1,3,3,6,9588
4,4,0,0,3,3,6,9588
0,0,1,0,1,0,1,9589
1,1,0,0,1,0,1,9589
0,0,1,0,1,0,1,9590
1,1,1,1,2,1,3,9590
2,2,0,0,2,1,3,9590
0,0,1,0,1,0,1,9591
1,1,1,0,2,0,2,9591
2,2,0,0,2,0,2,9591
0,0,1,0,1,0,1,9592
1,1,0,0,1,0,1,9592
0,0,1,0,1,0,1,9593
1,1,0,0,1,0,1,9593
0,0,1,0,1,0,1,9594
1,1,0,0,1,0,1,9594
0,0,1,0,1,0,1,9595
1,1,1,0,2,0,2,9595
2,2,0,0,2,0,2,9595
0,0,1,0,1,0,1,9596
1,1,1,0,2,0,2,9596
2,2,0,0,2,0,2,9596
0,0,1,0,1,0,1,9597
1,1,2,0,3,0,3,9597
2,2,1,0,4,0,4,9597
3,3,2,0,6,0,6,9597
4,4,0,0,6,0,6,9597
0,0,1,0,1,0,1,9598
1,1,1,0,2,0,2,9598
2,2,2,0,4,0,4,9598
3,3,1,1,5,1,6,9598
4,4,1,0,6,1,7,9598
5,5,0,0,6,1,7,9598
0,0,1,0,1,0,1,9599
1,1,1,0,2,0,2,9599
2,2,1,0,3,0,3,9599
3,3,3,1,6,1,7,9599
4,4,3,1,9,2,11,9599
5,5,1,4,10,6,16,9599
6,6,0,4,10,10,20,9599
7,7,0,2,10,12,22,9599
8,8,0,1,10,13,23,9599
9,9,0,1,10,14,24,9599
10,10,1,0,11,14,25,9599
11,11,0,0,11,14,25,9599
0,0,1,0,1,0,1,9600
1,1,0,1,1,1,2,9600
2,2,0,0,1,1,2,9600
0,0,1,0,1,0,1,9601
1,1,0,0,1,0,1,9601
0,0,1,0,1,0,1,9602
1,1,1,0,2,0,2,9602
2,2,0,0,2,0,2,9602
0,0,1,0,1,0,1,9603
1,1,0,0,1,0,1,9603
0,0,1,0,1,0,1,9604
1,1,0,0,1,0,1,9604
0,0,1,0,1,0,1,9605
1,1,2,0,3,0,3,9605
2,2,1,1,4,1,5,9605
3,3,1,3,5,4,9,9605
4,4,2,1,7,5,12,9605
5,5,1,1,8,6,14,9605
6,6,1,0,9,6,15,9605
7,7,3,1,12,7,19,9605
8,8,1,2,13,9,22,9605
9,9,2,1,15,10,25,9605
10,10,3,0,18,10,28,9605
11,11,4,0,22,10,32,9605
12,12,2,0,24,10,34,9605
13,13,2,0,26,10,36,9605
14,14,1,0,27,10,37,9605
15,15,2,0,29,10,39,9605
16,16,1,0,30,10,40,9605
17,17,0,0,30,10,40,9605
0,0,1,0,1,0,1,9606
1,1,0,0,1,0,1,9606
0,0,1,0,1,0,1,9607
1,1,1,0,2,0,2,9607
2,2,0,0,2,0,2,9607
0,0,1,0,1,0,1,9608
1,1,0,0,1,0,1,9608
0,0,1,0,1,0,1,9609
1,1,0,0,1,0,1,9609
0,0,1,0,1,0,1,9610
1,1,2,2,3,2,5,9610
2,2,4,1,7,3,10,9610
3,3,6,0,13,3,16,9610
4,4,7,1,20,4,24,9610
5,5,7,0,27,4,31,9610
6,6,4,1,31,5,36,9610
7,7,1,3,32,8,40,9610
8,8,0,2,32,10,42,9610
9,9,0,1,32,11,43,9610
10,10,0,1,32,12,44,9610
11,11,0,1,32,13,45,9610
12,12,0,0,32,13,45,9610
0,0,1,0,1,0,1,9611
1,1,2,0,3,0,3,9611
2,2,3,0,6,0,6,9611
3,3,2,0,8,0,8,9611
4,4,0,1,8,1,9,9611
5,5,0,2,8,3,11,9611
6,6,0,1,8,4,12,9611
7,7,0,0,8,4,12,9611
0,0,1,0,1,0,1,9612
1,1,1,0,2,0,2,9612
2,2,0,1,2,1,3,9612
3,3,0,3,2,4,6,9612
4,4,3,1,5,5,10,9612
5,5,1,0,6,5,11,9612
6,6,1,1,7,6,13,9612
7,7,1,0,8,6,14,9612
8,8,1,0,9,6,15,9612
9,9,0,1,9,7,16,9612
10,10,0,0,9,7,16,9612
0,0,1,0,1,0,1,9613
1,1,1,0,2,0,2,9613
2,2,0,1,2,1,3,9613
3,3,0,0,2,1,3,9613
0,0,1,0,1,0,1,9614
1,1,1,0,2,0,2,9614
2,2,0,0,2,0,2,9614
0,0,1,0,1,0,1,9615
1,1,0,3,1,3,4,9615
2,2,1,2,2,5,7,9615
3,3,0,0,2,5,7,9615
0,0,1,0,1,0,1,9616
1,1,1,0,2,0,2,9616
2,2,2,0,4,0,4,9616
3,3,5,0,9,0,9,9616
4,4,2,2,11,2,13,9616
5,5,2,2,13,4,17,9616
6,6,2,3,15,7,22,9616
7,7,1,4,16,11,27,9616
8,8,0,1,16,12,28,9616
9,9,0,1,16,13,29,9616
10,10,0,1,16,14,30,9616
11,11,0,0,16,14,30,9616
0,0,1,0,1,0,1,9617
1,1,1,1,2,1,3,9617
2,2,0,0,2,1,3,9617
0,0,1,0,1,0,1,9618
1,1,0,0,1,0,1,9618
0,0,1,0,1,0,1,9619
1,1,1,0,2,0,2,9619
2,2,0,0,2,0,2,9619
0,0,1,0,1,0,1,9620
1,1,0,0,1,0,1,9620
0,0,1,0,1,0,1,9621
1,1,1,0,2,0,2,9621
2,2,0,0,2,0,2,9621
0,0,1,0,1,0,1,9622
1,1,2,0,3,0,3,9622
2,2,1,0,4,0,4,9622
3,3,2,0,6,0,6,9622
4,4,3,0,9,0,9,9622
5,5,3,1,12,1,13,9622
6,6,4,3,16,4,20,9622
7,7,4,0,20,4,24,9622
8,8,4,0,24,4,28,9622
9,9,6,0,30,4,34,9622
10,10,4,0,34,4,38,9622
11,11,6,1,40,5,45,9622
12,12,5,1,45,6,51,9622
13,13,4,1,49,7,56,9622
14,14,1,0,50,7,57,9622
15,15,0,0,50,7,57,9622
0,0,1,0,1,0,1,9623
1,1,1,0,2,0,2,9623
2,2,0,1,2,1,3,9623
3,3,0,0,2,1,3,9623
0,0,1,0,1,0,1,9624
1,1,1,1,2,1,3,9624
2,2,0,3,2,4,6,9624
3,3,0,1,2,5,7,9624
4,4,0,1,2,6,8,9624
5,5,0,0,2,6,8,9624
0,0,1,0,1,0,1,9625
1,1,1,0,2,0,2,9625
2,2,0,0,2,0,2,9625
0,0,1,0,1,0,1,9626
1,1,2,0,3,0,3,9626
2,2,3,0,6,0,6,9626
3,3,1,2,7,2,9,9626
4,4,1,2,8,4,12,9626
5,5,0,1,8,5,13,9626
6,6,0,0,8,5,13,9626
0,0,1,0,1,0,1,9627
1,1,1,0,2,0,2,9627
2,2,0,0,2,0,2,9627
0,0,1,0,1,0,1,9628
1,1,2,0,3,0,3,9628
2,2,1,0,4,0,4,9628
3,3,0,0,4,0,4,9628
0,0,1,0,1,0,1,9629
1,1,0,0,1,0,1,9629
0,0,1,0,1,0,1,9630
1,1,0,0,1,0,1,9630
0,0,1,0,1,0,1,9631
1,1,0,1,1,1,2,9631
2,2,0,1,1,2,3,9631
3,3,0,1,1,3,4,9631
4,4,0,1,1,4,5,9631
5,5,0,0,1,4,5,9631
0,0,1,0,1,0,1,9632
1,1,0,0,1,0,1,9632
0,0,1,0,1,0,1,9633
1,1,0,0,1,0,1,9633
0,0,1,0,1,0,1,9634
1,1,1,0,2,0,2,9634
2,2,2,1,4,1,5,9634
3,3,3,2,7,3,10,9634
4,4,1,2,8,5,13,9634
5,5,1,0,9,5,14,9634
6,6,2,0,11,5,16,9634
7,7,0,0,11,5,16,9634
0,0,1,0,1,0,1,9635
1,1,2,0,3,0,3,9635
2,2,4,1,7,1,8,9635
3,3,4,3,11,4,15,9635
4,4,1,3,12,7,19,9635
5,5,1,3,13,10,23,9635
6,6,3,3,16,13,29,9635
7,7,6,0,22,13,35,9635
8,8,4,3,26,16,42,9635
9,9,4,4,30,20,50,9635
10,10,1,6,31,26,57,9635
11,11,3,0,34,26,60,9635
12,12,3,0,37,26,63,9635
13,13,3,0,40,26,66,9635
14,14,1,0,41,26,67,9635
15,15,1,0,42,26,68,9635
16,16,1,0,43,26,69,9635
17,17,0,0,43,26,69,9635
0,0,1,0,1,0,1,9636
1,1,0,0,1,0,1,9636
0,0,1,0,1,0,1,9637
1,1,1,0,2,0,2,9637
2,2,0,0,2,0,2,9637
0,0,1,0,1,0,1,9638
1,1,3,1,4,1,5,9638
2,2,2,0,6,1,7,9638
3,3,3,0,9,1,10,9638
4,4,3,0,12,1,13,9638
5,5,2,0,14,1,15,9638
6,6,2,0,16,1,17,9638
7,7,2,0,18,1,19,9638
8,8,1,0,19,1,20,9638
9,9,0,0,19,1,20,9638
0,0,1,0,1,0,1,9639
1,1,0,0,1,0,1,9639
0,0,1,0,1,0,1,9640
1,1,2,1,3,1,4,9640
2,2,0,0,3,1,4,9640
0,0,1,0,1,0,1,9641
1,1,1,0,2,0,2,9641
2,2,0,0,2,0,2,9641
0,0,1,0,1,0,1,9642
1,1,0,0,1,0,1,9642
0,0,1,0,1,0,1,9643
1,1,1,0,2,0,2,9643
2,2,0,0,2,0,2,9643
0,0,1,0,1,0,1,9644
1,1,0,0,1,0,1,9644
0,0,1,0,1,0,1,9645
1,1,0,0,1,0,1,9645
0,0,1,0,1,0,1,9646
1,1,2,0,3,0,3,9646
2,2,2,0,5,0,5,9646
3,3,0,3,5,3,8,9646
4,4,0,0,5,3,8,9646
0,0,1,0,1,0,1,9647
1,1,0,0,1,0,1,9647
0,0,1,0,1,0,1,9648
1,1,0,0,1,0,1,9648
0,0,1,0,1,0,1,9649
1,1,0,0,1,0,1,9649
0,0,1,0,1,0,1,9650
1,1,1,1,2,1,3,9650
2,2,1,2,3,3,6,9650
3,3,2,1,5,4,9,9650
4,4,1,0,6,4,10,9650
5,5,1,0,7,4,11,9650
6,6,4,0,11,4,15,9650
7,7,4,1,15,5,20,9650
8,8,1,2,16,7,23,9650
9,9,1,2,17,9,26,9650
10,10,1,3,18,12,30,9650
11,11,1,4,19,16,35,9650
12,12,2,3,21,19,40,9650
13,13,1,2,22,21,43,9650
14,14,2,3,24,24,48,9650
15,15,3,3,27,27,54,9650
16,16,4,3,31,30,61,9650
17,17,5,0,36,30,66,9650
18,18,0,0,36,30,66,9650
0,0,1,0,1,0,1,9651
1,1,0,0,1,0,1,9651
0,0,1,0,1,0,1,9652
1,1,1,0,2,0,2,9652
2,2,1,0,3,0,3,9652
3,3,1,1,4,1,5,9652
4,4,0,0,4,1,5,9652
0,0,1,0,1,0,1,9653
1,1,0,0,1,0,1,9653
0,0,1,0,1,0,1,9654
1,1,1,0,2,0,2,9654
2,2,1,0,3,0,3,9654
3,3,2,0,5,0,5,9654
4,4,4,1,9,1,10,9654
5,5,4,2,13,3,16,9654
6,6,12,2,25,5,30,9654
7,7,11,3,36,8,44,9654
8,8,8,3,44,11,55,9654
9,9,7,2,51,13,64,9654
10,10,5,1,56,14,70,9654
11,11,1,2,57,16,73,9654
12,12,0,3,57,19,76,9654
13,13,0,1,57,20,77,9654
14,14,0,0,57,20,77,9654
0,0,1,0,1,0,1,9655
1,1,1,0,2,0,2,9655
2,2,0,0,2,0,2,9655
0,0,1,0,1,0,1,9656
1,1,3,1,4,1,5,9656
2,2,2,0,6,1,7,9656
3,3,2,0,8,1,9,9656
4,4,2,1,10,2,12,9656
5,5,2,1,12,3,15,9656
6,6,1,3,13,6,19,9656
7,7,1,3,14,9,23,9656
8,8,3,1,17,10,27,9656
9,9,3,0,20,10,30,9656
10,10,4,2,24,12,36,9656
11,11,2,0,26,12,38,9656
12,12,3,1,29,13,42,9656
13,13,2,1,31,14,45,9656
14,14,1,0,32,14,46,9656
15,15,0,0,32,14,46,9656
0,0,1,0,1,0,1,9657
1,1,0,0,1,0,1,9657
0,0,1,0,1,0,1,9658
1,1,0,0,1,0,1,9658
0,0,1,0,1,0,1,9659
1,1,0,0,1,0,1,9659
0,0,1,0,1,0,1,9660
1,1,1,1,2,1,3,9660
2,2,1,0,3,1,4,9660
3,3,3,0,6,1,7,9660
4,4,1,0,7,1,8,9660
5,5,0,0,7,1,8,9660
0,0,1,0,1,0,1,9661
1,1,0,0,1,0,1,9661
0,0,1,0,1,0,1,9662
1,1,2,0,3,0,3,9662
2,2,1,1,4,1,5,9662
3,3,4,3,8,4,12,9662
4,4,4,4,12,8,20,9662
5,5,7,1,19,9,28,9662
6,6,3,2,22,11,33,9662
7,7,2,5,24,16,40,9662
8,8,5,6,29,22,51,9662
9,9,9,8,38,30,68,9662
10,10,5,9,43,39,82,9662
11,11,10,6,53,45,98,9662
12,12,5,4,58,49,107,9662
13,13,9,6,67,55,122,9662
14,14,3,9,70,64,134,9662
15,15,2,5,72,69,141,9662
16,16,3,5,75,74,149,9662
17,17,1,2,76,76,152,9662
18,18,3,0,79,76,155,9662
19,19,1,1,80,77,157,9662
20,20,1,1,81,78,159,9662
21,21,0,0,81,78,159,9662
0,0,1,0,1,0,1,9663
1,1,1,0,2,0,2,9663
2,2,0,0,2,0,2,9663
0,0,1,0,1,0,1,9664
1,1,0,0,1,0,1,9664
0,0,1,0,1,0,1,9665
1,1,1,0,2,0,2,9665
2,2,0,0,2,0,2,9665
0,0,1,0,1,0,1,9666
1,1,1,0,2,0,2,9666
2,2,0,0,2,0,2,9666
0,0,1,0,1,0,1,9667
1,1,2,0,3,0,3,9667
2,2,2,0,5,0,5,9667
3,3,0,0,5,0,5,9667
0,0,1,0,1,0,1,9668
1,1,1,0,2,0,2,9668
2,2,0,0,2,0,2,9668
0,0,1,0,1,0,1,9669
1,1,0,0,1,0,1,9669
0,0,1,0,1,0,1,9670
1,1,0,0,1,0,1,9670
0,0,1,0,1,0,1,9671
1,1,1,0,2,0,2,9671
2,2,0,0,2,0,2,9671
0,0,1,0,1,0,1,9672
1,1,0,0,1,0,1,9672
0,0,1,0,1,0,1,9673
1,1,0,1,1,1,2,9673
2,2,1,1,2,2,4,9673
3,3,1,1,3,3,6,9673
4,4,1,0,4,3,7,9673
5,5,1,1,5,4,9,9673
6,6,2,1,7,5,12,9673
7,7,1,0,8,5,13,9673
8,8,0,0,8,5,13,9673
0,0,1,0,1,0,1,9674
1,1,2,0,3,0,3,9674
2,2,1,0,4,0,4,9674
3,3,1,0,5,0,5,9674
4,4,0,0,5,0,5,9674
0,0,1,0,1,0,1,9675
1,1,0,0,1,0,1,9675
0,0,1,0,1,0,1,9676
1,1,0,0,1,0,1,9676
0,0,1,0,1,0,1,9677
1,1,1,0,2,0,2,9677
2,2,0,0,2,0,2,9677
0,0,1,0,1,0,1,9678
1,1,1,1,2,1,3,9678
2,2,0,0,2,1,3,9678
0,0,1,0,1,0,1,9679
1,1,3,1,4,1,5,9679
2,2,4,1,8,2,10,9679
3,3,4,2,12,4,16,9679
4,4,0,2,12,6,18,9679
5,5,0,1,12,7,19,9679
6,6,0,0,12,7,19,9679
0,0,1,0,1,0,1,9680
1,1,1,0,2,0,2,9680
2,2,2,0,4,0,4,9680
3,3,2,1,6,1,7,9680
4,4,1,0,7,1,8,9680
5,5,0,0,7,1,8,9680
0,0,1,0,1,0,1,9681
1,1,1,0,2,0,2,9681
2,2,0,0,2,0,2,9681
0,0,1,0,1,0,1,9682
1,1,1,0,2,0,2,9682
2,2,1,0,3,0,3,9682
3,3,1,0,4,0,4,9682
4,4,0,0,4,0,4,9682
0,0,1,0,1,0,1,9683
1,1,1,0,2,0,2,9683
2,2,4,0,6,0,6,9683
3,3,1,0,7,0,7,9683
4,4,1,0,8,0,8,9683
5,5,0,0,8,0,8,9683
0,0,1,0,1,0,1,9684
1,1,0,0,1,0,1,9684
0,0,1,0,1,0,1,9685
1,1,0,0,1,0,1,9685
0,0,1,0,1,0,1,9686
1,1,1,0,2,0,2,9686
2,2,1,0,3,0,3,9686
3,3,0,0,3,0,3,9686
0,0,1,0,1,0,1,9687
1,1,2,0,3,0,3,9687
2,2,0,1,3,1,4,9687
3,3,0,1,3,2,5,9687
4,4,1,0,4,2,6,9687
5,5,1,0,5,2,7,9687
6,6,1,0,6,2,8,9687
7,7,0,0,6,2,8,9687
0,0,1,0,1,0,1,9688
1,1,0,0,1,0,1,9688
0,0,1,0,1,0,1,9689
1,1,0,0,1,0,1,9689
0,0,1,0,1,0,1,9690
1,1,3,0,4,0,4,9690
2,2,4,3,8,3,11,9690
3,3,4,4,12,7,19,9690
4,4,4,3,16,10,26,9690
5,5,4,2,20,12,32,9690
6,6,2,6,22,18,40,9690
7,7,1,4,23,22,45,9690
8,8,0,2,23,24,47,9690
9,9,0,0,23,24,47,9690
0,0,1,0,1,0,1,9691
1,1,1,0,2,0,2,9691
2,2,1,0,3,0,3,9691
3,3,0,0,3,0,3,9691
0,0,1,0,1,0,1,9692
1,1,0,0,1,0,1,9692
0,0,1,0,1,0,1,9693
1,1,1,1,2,1,3,9693
2,2,2,0,4,1,5,9693
3,3,0,1,4,2,6,9693
4,4,0,1,4,3,7,9693
5,5,0,4,4,7,11,9693
6,6,2,2,6,9,15,9693
7,7,1,0,7,9,16,9693
8,8,1,0,8,9,17,9693
9,9,1,1,9,10,19,9693
10,10,2,1,11,11,22,9693
11,11,2,1,13,12,25,9693
12,12,3,1,16,13,29,9693
13,13,1,0,17,13,30,9693
14,14,1,0,18,13,31,9693
15,15,2,0,20,13,33,9693
16,16,1,1,21,14,35,9693
17,17,0,2,21,16,37,9693
18,18,0,1,21,17,38,9693
19,19,0,1,21,18,39,9693
20,20,1,0,22,18,40,9693
21,21,1,0,23,18,41,9693
22,22,1,0,24,18,42,9693
23,23,2,0,26,18,44,9693
24,24,2,1,28,19,47,9693
25,25,1,2,29,21,50,9693
26,26,2,0,31,21,52,9693
27,27,2,2,33,23,56,9693
28,28,2,3,35,26,61,9693
29,29,0,1,35,27,62,9693
30,30,1,0,36,27,63,9693
31,31,1,0,37,27,64,9693
32,32,0,0,37,27,64,9693
0,0,1,0,1,0,1,9694
1,1,0,0,1,0,1,9694
0,0,1,0,1,0,1,9695
1,1,0,0,1,0,1,9695
0,0,1,0,1,0,1,9696
1,1,1,0,2,0,2,9696
2,2,0,0,2,0,2,9696
0,0,1,0,1,0,1,9697
1,1,2,0,3,0,3,9697
2,2,0,1,3,1,4,9697
3,3,0,0,3,1,4,9697
0,0,1,0,1,0,1,9698
1,1,1,0,2,0,2,9698
2,2,0,0,2,0,2,9698
0,0,1,0,1,0,1,9699
1,1,0,1,1,1,2,9699
2,2,0,1,1,2,3,9699
3,3,1,0,2,2,4,9699
4,4,0,0,2,2,4,9699
0,0,1,0,1,0,1,9700
1,1,1,0,2,0,2,9700
2,2,1,0,3,0,3,9700
3,3,0,0,3,0,3,9700
0,0,1,0,1,0,1,9701
1,1,0,0,1,0,1,9701
0,0,1,0,1,0,1,9702
1,1,0,1,1,1,2,9702
2,2,0,2,1,3,4,9702
3,3,1,1,2,4,6,9702
4,4,0,1,2,5,7,9702
5,5,1,1,3,6,9,9702
6,6,2,0,5,6,11,9702
7,7,3,0,8,6,14,9702
8,8,4,0,12,6,18,9702
9,9,4,2,16,8,24,9702
10,10,3,2,19,10,29,9702
11,11,1,3,20,13,33,9702
12,12,2,1,22,14,36,9702
13,13,1,3,23,17,40,9702
14,14,0,2,23,19,42,9702
15,15,0,0,23,19,42,9702
0,0,1,0,1,0,1,9703
1,1,0,0,1,0,1,9703
0,0,1,0,1,0,1,9704
1,1,0,0,1,0,1,9704
0,0,1,0,1,0,1,9705
1,1,1,0,2,0,2,9705
2,2,1,0,3,0,3,9705
3,3,1,1,4,1,5,9705
4,4,0,1,4,2,6,9705
5,5,0,1,4,3,7,9705
6,6,0,1,4,4,8,9705
7,7,0,1,4,5,9,9705
8,8,0,1,4,6,10,9705
9,9,0,0,4,6,10,9705
0,0,1,0,1,0,1,9706
1,1,1,0,2,0,2,9706
2,2,2,0,4,0,4,9706
3,3,2,1,6,1,7,9706
4,4,1,1,7,2,9,9706
5,5,3,2,10,4,14,9706
6,6,3,3,13,7,20,9706
7,7,3,2,16,9,25,9706
8,8,2,2,18,11,29,9706
9,9,1,0,19,11,30,9706
10,10,1,0,20,11,31,9706
11,11,0,0,20,11,31,9706
0,0,1,0,1,0,1,9707
1,1,2,0,3,0,3,9707
2,2,0,1,3,1,4,9707
3,3,0,0,3,1,4,9707
0,0,1,0,1,0,1,9708
1,1,2,1,3,1,4,9708
2,2,1,0,4,1,5,9708
3,3,0,0,4,1,5,9708
0,0,1,0,1,0,1,9709
1,1,0,0,1,0,1,9709
0,0,1,0,1,0,1,9710
1,1,1,0,2,0,2,9710
2,2,1,0,3,0,3,9710
3,3,1,0,4,0,4,9710
4,4,0,0,4,0,4,9710
0,0,1,0,1,0,1,9711
1,1,3,0,4,0,4,9711
2,2,5,1,9,1,10,9711
3,3,7,2,16,3,19,9711
4,4,3,1,19,4,23,9711
5,5,2,1,21,5,26,9711
6,6,3,1,24,6,30,9711
7,7,1,1,25,7,32,9711
8,8,0,0,25,7,32,9711
0,0,1,0,1,0,1,9712
1,1,0,0,1,0,1,9712
0,0,1,0,1,0,1,9713
1,1,2,1,3,1,4,9713
2,2,2,1,5,2,7,9713
3,3,1,1,6,3,9,9713
4,4,1,3,7,6,13,9713
5,5,4,1,11,7,18,9713
6,6,1,0,12,7,19,9713
7,7,0,0,12,7,19,9713
0,0,1,0,1,0,1,9714
1,1,0,0,1,0,1,9714
0,0,1,0,1,0,1,9715
1,1,2,0,3,0,3,9715
2,2,2,1,5,1,6,9715
3,3,2,3,7,4,11,9715
4,4,3,3,10,7,17,9715
5,5,2,2,12,9,21,9715
6,6,1,2,13,11,24,9715
7,7,0,1,13,12,25,9715
8,8,0,1,13,13,26,9715
9,9,0,0,13,13,26,9715
0,0,1,0,1,0,1,9716
1,1,1,0,2,0,2,9716
2,2,1,0,3,0,3,9716
3,3,1,0,4,0,4,9716
4,4,1,1,5,1,6,9716
5,5,0,1,5,2,7,9716
6,6,0,0,5,2,7,9716
0,0,1,0,1,0,1,9717
1,1,4,0,5,0,5,9717
2,2,3,0,8,0,8,9717
3,3,2,0,10,0,10,9717
4,4,1,1,11,1,12,9717
5,5,1,0,12,1,13,9717
6,6,0,0,12,1,13,9717
0,0,1,0,1,0,1,9718
1,1,1,0,2,0,2,9718
2,2,1,0,3,0,3,9718
3,3,0,0,3,0,3,9718
0,0,1,0,1,0,1,9719
1,1,1,0,2,0,2,9719
2,2,1,0,3,0,3,9719
3,3,0,0,3,0,3,9719
0,0,1,0,1,0,1,9720
1,1,1,0,2,0,2,9720
2,2,1,0,3,0,3,9720
3,3,1,0,4,0,4,9720
4,4,1,0,5,0,5,9720
5,5,0,0,5,0,5,9720
0,0,1,0,1,0,1,9721
1,1,0,0,1,0,1,9721
0,0,1,0,1,0,1,9722
1,1,0,0,1,0,1,9722
0,0,1,0,1,0,1,9723
1,1,2,0,3,0,3,9723
2,2,1,0,4,0,4,9723
3,3,1,0,5,0,5,9723
4,4,0,0,5,0,5,9723
0,0,1,0,1,0,1,9724
1,1,2,0,3,0,3,9724
2,2,2,1,5,1,6,9724
3,3,1,0,6,1,7,9724
4,4,0,0,6,1,7,9724
0,0,1,0,1,0,1,9725
1,1,2,0,3,0,3,9725
2,2,2,1,5,1,6,9725
3,3,1,1,6,2,8,9725
4,4,0,2,6,4,10,9725
5,5,0,1,6,5,11,9725
6,6,0,1,6,6,12,9725
7,7,0,1,6,7,13,9725
8,8,0,1,6,8,14,9725
9,9,0,1,6,9,15,9725
10,10,0,2,6,11,17,9725
11,11,0,1,6,12,18,9725
12,12,0,1,6,13,19,9725
13,13,0,1,6,14,20,9725
14,14,0,2,6,16,22,9725
15,15,0,1,6,17,23,9725
16,16,2,2,8,19,27,9725
17,17,3,4,11,23,34,9725
18,18,1,3,12,26,38,9725
19,19,1,1,13,27,40,9725
20,20,0,2,13,29,42,9725
21,21,0,2,13,31,44,9725
22,22,0,2,13,33,46,9725
23,23,0,1,13,34,47,9725
24,24,0,0,13,34,47,9725
0,0,1,0,1,0,1,9726
1,1,0,0,1,0,1,9726
0,0,1,0,1,0,1,9727
1,1,2,0,3,0,3,9727
2,2,0,0,3,0,3,9727
0,0,1,0,1,0,1,9728
1,1,2,0,3,0,3,9728
2,2,1,1,4,1,5,9728
3,3,1,1,5,2,7,9728
4,4,3,2,8,4,12,9728
5,5,6,1,14,5,19,9728
6,6,4,2,18,7,25,9728
7,7,8,2,26,9,35,9728
8,8,5,4,31,13,44,9728
9,9,4,2,35,15,50,9728
10,10,5,2,40,17,57,9728
11,11,5,2,45,19,64,9728
12,12,6,2,51,21,72,9728
13,13,7,1,58,22,80,9728
14,14,3,2,61,24,85,9728
15,15,5,2,66,26,92,9728
16,16,3,7,69,33,102,9728
17,17,6,7,75,40,115,9728
18,18,5,10,80,50,130,9728
19,19,6,8,86,58,144,9728
20,20,8,5,94,63,157,9728
21,21,11,2,105,65,170,9728
22,22,7,3,112,68,180,9728
23,23,7,2,119,70,189,9728
24,24,7,6,126,76,202,9728
25,25,4,8,130,84,214,9728
26,26,3,5,133,89,222,9728
27,27,3,4,136,93,229,9728
28,28,3,3,139,96,235,9728
29,29,1,4,140,100,240,9728
30,30,1,2,141,102,243,9728
31,31,0,2,141,104,245,9728
32,32,1,1,142,105,247,9728
33,33,0,2,142,107,249,9728
34,34,0,1,142,108,250,9728
35,35,0,1,142,109,251,9728
36,36,0,1,142,110,252,9728
37,37,0,0,142,110,252,9728
0,0,1,0,1,0,1,9729
1,1,0,0,1,0,1,9729
0,0,1,0,1,0,1,9730
1,1,0,0,1,0,1,9730
0,0,1,0,1,0,1,9731
1,1,1,0,2,0,2,9731
2,2,1,0,3,0,3,9731
3,3,0,1,3,1,4,9731
4,4,2,0,5,1,6,9731
5,5,2,1,7,2,9,9731
6,6,0,0,7,2,9,9731
0,0,1,0,1,0,1,9732
1,1,1,0,2,0,2,9732
2,2,0,0,2,0,2,9732
0,0,1,0,1,0,1,9733
1,1,0,0,1,0,1,9733
0,0,1,0,1,0,1,9734
1,1,0,0,1,0,1,9734
0,0,1,0,1,0,1,9735
1,1,1,0,2,0,2,9735
2,2,4,0,6,0,6,9735
3,3,2,0,8,0,8,9735
4,4,3,1,11,1,12,9735
5,5,4,5,15,6,21,9735
6,6,4,4,19,10,29,9735
7,7,3,0,22,10,32,9735
8,8,0,0,22,10,32,9735
0,0,1,0,1,0,1,9736
1,1,0,0,1,0,1,9736
0,0,1,0,1,0,1,9737
1,1,0,0,1,0,1,9737
0,0,1,0,1,0,1,9738
1,1,0,0,1,0,1,9738
0,0,1,0,1,0,1,9739
1,1,3,0,4,0,4,9739
2,2,3,1,7,1,8,9739
3,3,0,1,7,2,9,9739
4,4,0,0,7,2,9,9739
0,0,1,0,1,0,1,9740
1,1,1,0,2,0,2,9740
2,2,0,0,2,0,2,9740
0,0,1,0,1,0,1,9741
1,1,0,0,1,0,1,9741
0,0,1,0,1,0,1,9742
1,1,3,0,4,0,4,9742
2,2,2,0,6,0,6,9742
3,3,3,0,9,0,9,9742
4,4,1,0,10,0,10,9742
5,5,1,1,11,1,12,9742
6,6,3,1,14,2,16,9742
7,7,8,2,22,4,26,9742
8,8,8,4,30,8,38,9742
9,9,4,4,34,12,46,9742
10,10,1,0,35,12,47,9742
11,11,0,0,35,12,47,9742
0,0,1,0,1,0,1,9743
1,1,1,0,2,0,2,9743
2,2,2,0,4,0,4,9743
3,3,3,0,7,0,7,9743
4,4,3,0,10,0,10,9743
5,5,0,0,10,0,10,9743
0,0,1,0,1,0,1,9744
1,1,1,1,2,1,3,9744
2,2,1,0,3,1,4,9744
3,3,1,0,4,1,5,9744
4,4,1,0,5,1,6,9744
5,5,2,0,7,1,8,9744
6,6,3,0,10,1,11,9744
7,7,1,1,11,2,13,9744
8,8,0,1,11,3,14,9744
9,9,0,0,11,3,14,9744
0,0,1,0,1,0,1,9745
1,1,0,1,1,1,2,9745
2,2,0,0,1,1,2,9745
0,0,1,0,1,0,1,9746
1,1,1,0,2,0,2,9746
2,2,1,1,3,1,4,9746
3,3,1,2,4,3,7,9746
4,4,1,2,5,5,10,9746
5,5,0,1,5,6,11,9746
6,6,0,0,5,6,11,9746
0,0,1,0,1,0,1,9747
1,1,0,0,1,0,1,9747
0,0,1,0,1,0,1,9748
1,1,1,0,2,0,2,9748
2,2,2,0,4,0,4,9748
3,3,2,1,6,1,7,9748
4,4,2,0,8,1,9,9748
5,5,1,0,9,1,10,9748
6,6,0,0,9,1,10,9748
0,0,1,0,1,0,1,9749
1,1,0,0,1,0,1,9749
0,0,1,0,1,0,1,9750
1,1,0,0,1,0,1,9750
0,0,1,0,1,0,1,9751
1,1,0,0,1,0,1,9751
0,0,1,0,1,0,1,9752
1,1,0,0,1,0,1,9752
0,0,1,0,1,0,1,9753
1,1,1,0,2,0,2,9753
2,2,1,0,3,0,3,9753
3,3,1,0,4,0,4,9753
4,4,1,0,5,0,5,9753
5,5,1,0,6,0,6,9753
6,6,0,0,6,0,6,9753
0,0,1,0,1,0,1,9754
1,1,0,0,1,0,1,9754
0,0,1,0,1,0,1,9755
1,1,0,0,1,0,1,9755
0,0,1,0,1,0,1,9756
1,1,0,0,1,0,1,9756
0,0,1,0,1,0,1,9757
1,1,1,0,2,0,2,9757
2,2,0,0,2,0,2,9757
0,0,1,0,1,0,1,9758
1,1,0,0,1,0,1,9758
0,0,1,0,1,0,1,9759
1,1,2,1,3,1,4,9759
2,2,1,1,4,2,6,9759
3,3,0,1,4,3,7,9759
4,4,0,1,4,4,8,9759
5,5,0,1,4,5,9,9759
6,6,0,1,4,6,10,9759
7,7,0,0,4,6,10,9759
0,0,1,0,1,0,1,9760
1,1,0,0,1,0,1,9760
0,0,1,0,1,0,1,9761
1,1,1,0,2,0,2,9761
2,2,1,0,3,0,3,9761
3,3,0,0,3,0,3,9761
0,0,1,0,1,0,1,9762
1,1,0,0,1,0,1,9762
0,0,1,0,1,0,1,9763
1,1,0,0,1,0,1,9763
0,0,1,0,1,0,1,9764
1,1,1,1,2,1,3,9764
2,2,1,0,3,1,4,9764
3,3,0,0,3,1,4,9764
0,0,1,0,1,0,1,9765
1,1,2,0,3,0,3,9765
2,2,1,1,4,1,5,9765
3,3,2,0,6,1,7,9765
4,4,1,0,7,1,8,9765
5,5,0,2,7,3,10,9765
6,6,0,3,7,6,13,9765
7,7,0,0,7,6,13,9765
0,0,1,0,1,0,1,9766
1,1,0,0,1,0,1,9766
0,0,1,0,1,0,1,9767
1,1,1,0,2,0,2,9767
2,2,1,0,3,0,3,9767
3,3,3,0,6,0,6,9767
4,4,1,0,7,0,7,9767
5,5,1,0,8,0,8,9767
6,6,1,0,9,0,9,9767
7,7,0,0,9,0,9,9767
0,0,1,0,1,0,1,9768
1,1,0,0,1,0,1,9768
0,0,1,0,1,0,1,9769
1,1,2,0,3,0,3,9769
2,2,1,0,4,0,4,9769
3,3,0,1,4,1,5,9769
4,4,0,0,4,1,5,9769
0,0,1,0,1,0,1,9770
1,1,0,0,1,0,1,9770
0,0,1,0,1,0,1,9771
1,1,1,0,2,0,2,9771
2,2,1,1,3,1,4,9771
3,3,3,1,6,2,8,9771
4,4,3,0,9,2,11,9771
5,5,3,1,12,3,15,9771
6,6,3,1,15,4,19,9771
7,7,1,2,16,6,22,9771
8,8,0,1,16,7,23,9771
9,9,0,2,16,9,25,9771
10,10,0,2,16,11,27,9771
11,11,1,2,17,13,30,9771
12,12,0,2,17,15,32,9771
13,13,0,3,17,18,35,9771
14,14,1,1,18,19,37,9771
15,15,0,2,18,21,39,9771
16,16,0,1,18,22,40,9771
17,17,0,0,18,22,40,9771
0,0,1,0,1,0,1,9772
1,1,1,0,2,0,2,9772
2,2,1,0,3,0,3,9772
3,3,1,0,4,0,4,9772
4,4,0,0,4,0,4,9772
0,0,1,0,1,0,1,9773
1,1,0,0,1,0,1,9773
0,0,1,0,1,0,1,9774
1,1,1,0,2,0,2,9774
2,2,0,1,2,1,3,9774
3,3,0,0,2,1,3,9774
0,0,1,0,1,0,1,9775
1,1,1,0,2,0,2,9775
2,2,1,0,3,0,3,9775
3,3,1,0,4,0,4,9775
4,4,2,0,6,0,6,9775
5,5,1,0,7,0,7,9775
6,6,1,0,8,0,8,9775
7,7,0,0,8,0,8,9775
0,0,1,0,1,0,1,9776
1,1,1,0,2,0,2,9776
2,2,0,0,2,0,2,9776
0,0,1,0,1,0,1,9777
1,1,0,0,1,0,1,9777
0,0,1,0,1,0,1,9778
1,1,0,0,1,0,1,9778
0,0,1,0,1,0,1,9779
1,1,1,0,2,0,2,9779
2,2,0,0,2,0,2,9779
0,0,1,0,1,0,1,9780
1,1,1,0,2,0,2,9780
2,2,3,0,5,0,5,9780
3,3,2,0,7,0,7,9780
4,4,2,2,9,2,11,9780
5,5,2,2,11,4,15,9780
6,6,2,1,13,5,18,9780
7,7,1,0,14,5,19,9780
8,8,0,1,14,6,20,9780
9,9,0,0,14,6,20,9780
0,0,1,0,1,0,1,9781
1,1,0,0,1,0,1,9781
0,0,1,0,1,0,1,9782
1,1,1,0,2,0,2,9782
2,2,0,0,2,0,2,9782
0,0,1,0,1,0,1,9783
1,1,1,0,2,0,2,9783
2,2,0,1,2,1,3,9783
3,3,0,0,2,1,3,9783
0,0,1,0,1,0,1,9784
1,1,0,0,1,0,1,9784
0,0,1,0,1,0,1,9785
1,1,0,0,1,0,1,9785
0,0,1,0,1,0,1,9786
1,1,1,0,2,0,2,9786
2,2,0,1,2,1,3,9786
3,3,0,3,2,4,6,9786
4,4,0,1,2,5,7,9786
5,5,0,0,2,5,7,9786
0,0,1,0,1,0,1,9787
1,1,0,0,1,0,1,9787
0,0,1,0,1,0,1,9788
1,1,0,0,1,0,1,9788
0,0,1,0,1,0,1,9789
1,1,0,0,1,0,1,9789
0,0,1,0,1,0,1,9790
1,1,0,1,1,1,2,9790
2,2,0,0,1,1,2,9790
0,0,1,0,1,0,1,9791
1,1,0,0,1,0,1,9791
0,0,1,0,1,0,1,9792
1,1,1,0,2,0,2,9792
2,2,0,0,2,0,2,9792
0,0,1,0,1,0,1,9793
1,1,0,0,1,0,1,9793
0,0,1,0,1,0,1,9794
1,1,0,0,1,0,1,9794
0,0,1,0,1,0,1,9795
1,1,1,0,2,0,2,9795
2,2,0,0,2,0,2,9795
0,0,1,0,1,0,1,9796
1,1,1,0,2,0,2,9796
2,2,0,0,2,0,2,9796
0,0,1,0,1,0,1,9797
1,1,1,0,2,0,2,9797
2,2,1,0,3,0,3,9797
3,3,0,0,3,0,3,9797
0,0,1,0,1,0,1,9798
1,1,1,0,2,0,2,9798
2,2,0,1,2,1,3,9798
3,3,1,2,3,3,6,9798
4,4,1,0,4,3,7,9798
5,5,0,0,4,3,7,9798
0,0,1,0,1,0,1,9799
1,1,1,0,2,0,2,9799
2,2,0,1,2,1,3,9799
3,3,0,0,2,1,3,9799
0,0,1,0,1,0,1,9800
1,1,1,0,2,0,2,9800
2,2,1,0,3,0,3,9800
3,3,0,0,3,0,3,9800
0,0,1,0,1,0,1,9801
1,1,1,0,2,0,2,9801
2,2,0,0,2,0,2,9801
0,0,1,0,1,0,1,9802
1,1,3,0,4,0,4,9802
2,2,4,0,8,0,8,9802
3,3,3,1,11,1,12,9802
4,4,3,1,14,2,16,9802
5,5,4,1,18,3,21,9802
6,6,5,0,23,3,26,9802
7,7,2,0,25,3,28,9802
8,8,3,0,28,3,31,9802
9,9,1,0,29,3,32,9802
10,10,0,0,29,3,32,9802
0,0,1,0,1,0,1,9803
1,1,1,1,2,1,3,9803
2,2,0,1,2,2,4,9803
3,3,0,0,2,2,4,9803
0,0,1,0,1,0,1,9804
1,1,0,0,1,0,1,9804
0,0,1,0,1,0,1,9805
1,1,0,0,1,0,1,9805
0,0,1,0,1,0,1,9806
1,1,2,0,3,0,3,9806
2,2,1,1,4,1,5,9806
3,3,0,1,4,2,6,9806
4,4,0,0,4,2,6,9806
0,0,1,0,1,0,1,9807
1,1,1,0,2,0,2,9807
2,2,0,0,2,0,2,9807
0,0,1,0,1,0,1,9808
1,1,0,0,1,0,1,9808
0,0,1,0,1,0,1,9809
1,1,1,0,2,0,2,9809
2,2,0,0,2,0,2,9809
0,0,1,0,1,0,1,9810
1,1,0,0,1,0,1,9810
0,0,1,0,1,0,1,9811
1,1,0,0,1,0,1,9811
0,0,1,0,1,0,1,9812
1,1,0,0,1,0,1,9812
0,0,1,0,1,0,1,9813
1,1,0,0,1,0,1,9813
0,0,1,0,1,0,1,9814
1,1,1,0,2,0,2,9814
2,2,1,0,3,0,3,9814
3,3,1,1,4,1,5,9814
4,4,1,0,5,1,6,9814
5,5,1,0,6,1,7,9814
6,6,0,0,6,1,7,9814
0,0,1,0,1,0,1,9815
1,1,0,0,1,0,1,9815
0,0,1,0,1,0,1,9816
1,1,3,0,4,0,4,9816
2,2,3,1,7,1,8,9816
3,3,4,3,11,4,15,9816
4,4,3,3,14,7,21,9816
5,5,1,4,15,11,26,9816
6,6,1,2,16,13,29,9816
7,7,0,2,16,15,31,9816
8,8,1,1,17,16,33,9816
9,9,0,1,17,17,34,9816
10,10,0,0,17,17,34,9816
0,0,1,0,1,0,1,9817
1,1,0,0,1,0,1,9817
0,0,1,0,1,0,1,9818
1,1,0,0,1,0,1,9818
0,0,1,0,1,0,1,9819
1,1,0,0,1,0,1,9819
0,0,1,0,1,0,1,9820
1,1,0,0,1,0,1,9820
0,0,1,0,1,0,1,9821
1,1,2,1,3,1,4,9821
2,2,1,1,4,2,6,9821
3,3,1,1,5,3,8,9821
4,4,1,1,6,4,10,9821
5,5,1,1,7,5,12,9821
6,6,1,0,8,5,13,9821
7,7,0,0,8,5,13,9821
0,0,1,0,1,0,1,9822
1,1,1,0,2,0,2,9822
2,2,0,0,2,0,2,9822
0,0,1,0,1,0,1,9823
1,1,1,0,2,0,2,9823
2,2,1,0,3,0,3,9823
3,3,2,1,5,1,6,9823
4,4,0,0,5,1,6,9823
0,0,1,0,1,0,1,9824
1,1,0,0,1,0,1,9824
0,0,1,0,1,0,1,9825
1,1,0,1,1,1,2,9825
2,2,0,0,1,1,2,9825
0,0,1,0,1,0,1,9826
1,1,0,0,1,0,1,9826
0,0,1,0,1,0,1,9827
1,1,0,0,1,0,1,9827
0,0,1,0,1,0,1,9828
1,1,2,2,3,2,5,9828
2,2,5,0,8,2,10,9828
3,3,2,2,10,4,14,9828
4,4,2,1,12,5,17,9828
5,5,1,1,13,6,19,9828
6,6,2,2,15,8,23,9828
7,7,1,2,16,10,26,9828
8,8,1,0,17,10,27,9828
9,9,0,0,17,10,27,9828
0,0,1,0,1,0,1,9829
1,1,3,1,4,1,5,9829
2,2,6,0,10,1,11,9829
3,3,5,0,15,1,16,9829
4,4,2,1,17,2,19,9829
5,5,1,0,18,2,20,9829
6,6,1,0,19,2,21,9829
7,7,0,0,19,2,21,9829
0,0,1,0,1,0,1,9830
1,1,1,0,2,0,2,9830
2,2,0,0,2,0,2,9830
0,0,1,0,1,0,1,9831
1,1,1,1,2,1,3,9831
2,2,0,0,2,1,3,9831
0,0,1,0,1,0,1,9832
1,1,0,0,1,0,1,9832
0,0,1,0,1,0,1,9833
1,1,0,0,1,0,1,9833
0,0,1,0,1,0,1,9834
1,1,2,1,3,1,4,9834
2,2,3,2,6,3,9,9834
3,3,1,1,7,4,11,9834
4,4,0,0,7,4,11,9834
0,0,1,0,1,0,1,9835
1,1,2,0,3,0,3,9835
2,2,0,0,3,0,3,9835
0,0,1,0,1,0,1,9836
1,1,0,0,1,0,1,9836
0,0,1,0,1,0,1,9837
1,1,1,0,2,0,2,9837
2,2,0,0,2,0,2,9837
0,0,1,0,1,0,1,9838
1,1,1,0,2,0,2,9838
2,2,0,0,2,0,2,9838
0,0,1,0,1,0,1,9839
1,1,0,0,1,0,1,9839
0,0,1,0,1,0,1,9840
1,1,0,0,1,0,1,9840
0,0,1,0,1,0,1,9841
1,1,1,0,2,0,2,9841
2,2,0,0,2,0,2,9841
0,0,1,0,1,0,1,9842
1,1,0,1,1,1,2,9842
2,2,1,2,2,3,5,9842
3,3,2,0,4,3,7,9842
4,4,1,0,5,3,8,9842
5,5,1,0,6,3,9,9842
6,6,0,1,6,4,10,9842
7,7,0,0,6,4,10,9842
0,0,1,0,1,0,1,9843
1,1,0,0,1,0,1,9843
0,0,1,0,1,0,1,9844
1,1,0,0,1,0,1,9844
0,0,1,0,1,0,1,9845
1,1,1,0,2,0,2,9845
2,2,0,0,2,0,2,9845
0,0,1,0,1,0,1,9846
1,1,0,0,1,0,1,9846
0,0,1,0,1,0,1,9847
1,1,0,0,1,0,1,9847
0,0,1,0,1,0,1,9848
1,1,1,0,2,0,2,9848
2,2,1,0,3,0,3,9848
3,3,0,1,3,1,4,9848
4,4,0,1,3,2,5,9848
5,5,0,0,3,2,5,9848
0,0,1,0,1,0,1,9849
1,1,1,0,2,0,2,9849
2,2,3,0,5,0,5,9849
3,3,1,1,6,1,7,9849
4,4,0,0,6,1,7,9849
0,0,1,0,1,0,1,9850
1,1,0,0,1,0,1,9850
0,0,1,0,1,0,1,9851
1,1,1,0,2,0,2,9851
2,2,1,0,3,0,3,9851
3,3,0,0,3,0,3,9851
0,0,1,0,1,0,1,9852
1,1,0,1,1,1,2,9852
2,2,0,0,1,1,2,9852
0,0,1,0,1,0,1,9853
1,1,0,1,1,1,2,9853
2,2,0,2,1,3,4,9853
3,3,2,3,3,6,9,9853
4,4,1,5,4,11,15,9853
5,5,2,5,6,16,22,9853
6,6,4,3,10,19,29,9853
7,7,4,4,14,23,37,9853
8,8,2,4,16,27,43,9853
9,9,0,2,16,29,45,9853
10,10,0,1,16,30,46,9853
11,11,0,1,16,31,47,9853
12,12,0,0,16,31,47,9853
0,0,1,0,1,0,1,9854
1,1,0,0,1,0,1,9854
0,0,1,0,1,0,1,9855
1,1,0,1,1,1,2,9855
2,2,1,2,2,3,5,9855
3,3,1,1,3,4,7,9855
4,4,1,3,4,7,11,9855
5,5,0,1,4,8,12,9855
6,6,0,0,4,8,12,9855
0,0,1,0,1,0,1,9856
1,1,0,1,1,1,2,9856
2,2,0,1,1,2,3,9856
3,3,0,1,1,3,4,9856
4,4,0,0,1,3,4,9856
0,0,1,0,1,0,1,9857
1,1,2,0,3,0,3,9857
2,2,1,0,4,0,4,9857
3,3,1,0,5,0,5,9857
4,4,1,0,6,0,6,9857
5,5,0,0,6,0,6,9857
0,0,1,0,1,0,1,9858
1,1,1,0,2,0,2,9858
2,2,0,0,2,0,2,9858
0,0,1,0,1,0,1,9859
1,1,0,0,1,0,1,9859
0,0,1,0,1,0,1,9860
1,1,0,0,1,0,1,9860
0,0,1,0,1,0,1,9861
1,1,1,2,2,2,4,9861
2,2,1,0,3,2,5,9861
3,3,1,0,4,2,6,9861
4,4,0,0,4,2,6,9861
0,0,1,0,1,0,1,9862
1,1,2,0,3,0,3,9862
2,2,2,0,5,0,5,9862
3,3,1,0,6,0,6,9862
4,4,0,1,6,1,7,9862
5,5,0,1,6,2,8,9862
6,6,0,2,6,4,10,9862
7,7,1,1,7,5,12,9862
8,8,1,0,8,5,13,9862
9,9,0,0,8,5,13,9862
0,0,1,0,1,0,1,9863
1,1,1,1,2,1,3,9863
2,2,1,1,3,2,5,9863
3,3,0,1,3,3,6,9863
4,4,0,0,3,3,6,9863
0,0,1,0,1,0,1,9864
1,1,1,0,2,0,2,9864
2,2,1,0,3,0,3,9864
3,3,1,1,4,1,5,9864
4,4,1,0,5,1,6,9864
5,5,0,0,5,1,6,9864
0,0,1,0,1,0,1,9865
1,1,1,0,2,0,2,9865
2,2,1,1,3,1,4,9865
3,3,1,0,4,1,5,9865
4,4,0,0,4,1,5,9865
0,0,1,0,1,0,1,9866
1,1,0,0,1,0,1,9866
0,0,1,0,1,0,1,9867
1,1,1,0,2,0,2,9867
2,2,0,0,2,0,2,9867
0,0,1,0,1,0,1,9868
1,1,0,0,1,0,1,9868
0,0,1,0,1,0,1,9869
1,1,0,0,1,0,1,9869
0,0,1,0,1,0,1,9870
1,1,0,0,1,0,1,9870
0,0,1,0,1,0,1,9871
1,1,0,0,1,0,1,9871
0,0,1,0,1,0,1,9872
1,1,0,0,1,0,1,9872
0,0,1,0,1,0,1,9873
1,1,1,0,2,0,2,9873
2,2,0,0,2,0,2,9873
0,0,1,0,1,0,1,9874
1,1,0,0,1,0,1,9874
0,0,1,0,1,0,1,9875
1,1,1,0,2,0,2,9875
2,2,0,0,2,0,2,9875
0,0,1,0,1,0,1,9876
1,1,0,0,1,0,1,9876
0,0,1,0,1,0,1,9877
1,1,1,0,2,0,2,9877
2,2,0,0,2,0,2,9877
0,0,1,0,1,0,1,9878
1,1,0,1,1,1,2,9878
2,2,0,3,1,4,5,9878
3,3,0,1,1,5,6,9878
4,4,2,1,3,6,9,9878
5,5,2,0,5,6,11,9878
6,6,1,1,6,7,13,9878
7,7,0,1,6,8,14,9878
8,8,0,0,6,8,14,9878
0,0,1,0,1,0,1,9879
1,1,0,0,1,0,1,9879
0,0,1,0,1,0,1,9880
1,1,1,0,2,0,2,9880
2,2,1,0,3,0,3,9880
3,3,2,0,5,0,5,9880
4,4,1,0,6,0,6,9880
5,5,1,1,7,1,8,9880
6,6,0,1,7,2,9,9880
7,7,0,0,7,2,9,9880
0,0,1,0,1,0,1,9881
1,1,0,0,1,0,1,9881
0,0,1,0,1,0,1,9882
1,1,1,0,2,0,2,9882
2,2,2,0,4,0,4,9882
3,3,2,0,6,0,6,9882
4,4,2,1,8,1,9,9882
5,5,1,1,9,2,11,9882
6,6,1,0,10,2,12,9882
7,7,2,1,12,3,15,9882
8,8,1,0,13,3,16,9882
9,9,1,0,14,3,17,9882
10,10,0,0,14,3,17,9882
0,0,1,0,1,0,1,9883
1,1,0,0,1,0,1,9883
0,0,1,0,1,0,1,9884
1,1,1,0,2,0,2,9884
2,2,1,0,3,0,3,9884
3,3,0,1,3,1,4,9884
4,4,1,2,4,3,7,9884
5,5,0,1,4,4,8,9884
6,6,0,1,4,5,9,9884
7,7,0,0,4,5,9,9884
0,0,1,0,1,0,1,9885
1,1,2,0,3,0,3,9885
2,2,1,1,4,1,5,9885
3,3,0,0,4,1,5,9885
0,0,1,0,1,0,1,9886
1,1,1,0,2,0,2,9886
2,2,1,1,3,1,4,9886
3,3,3,1,6,2,8,9886
4,4,5,2,11,4,15,9886
5,5,1,3,12,7,19,9886
6,6,1,3,13,10,23,9886
7,7,2,4,15,14,29,9886
8,8,5,3,20,17,37,9886
9,9,1,7,21,24,45,9886
10,10,1,4,22,28,50,9886
11,11,1,3,23,31,54,9886
12,12,3,4,26,35,61,9886
13,13,2,2,28,37,65,9886
14,14,0,2,28,39,67,9886
15,15,0,0,28,39,67,9886
0,0,1,0,1,0,1,9887
1,1,1,0,2,0,2,9887
2,2,0,0,2,0,2,9887
0,0,1,0,1,0,1,9888
1,1,1,0,2,0,2,9888
2,2,0,0,2,0,2,9888
0,0,1,0,1,0,1,9889
1,1,1,0,2,0,2,9889
2,2,0,0,2,0,2,9889
0,0,1,0,1,0,1,9890
1,1,3,0,4,0,4,9890
2,2,1,0,5,0,5,9890
3,3,2,2,7,2,9,9890
4,4,5,3,12,5,17,9890
5,5,2,1,14,6,20,9890
6,6,2,2,16,8,24,9890
7,7,1,2,17,10,27,9890
8,8,0,3,17,13,30,9890
9,9,1,1,18,14,32,9890
10,10,2,0,20,14,34,9890
11,11,2,0,22,14,36,9890
12,12,1,0,23,14,37,9890
13,13,0,0,23,14,37,9890
0,0,1,0,1,0,1,9891
1,1,1,0,2,0,2,9891
2,2,1,0,3,0,3,9891
3,3,0,0,3,0,3,9891
0,0,1,0,1,0,1,9892
1,1,1,0,2,0,2,9892
2,2,2,0,4,0,4,9892
3,3,0,0,4,0,4,9892
0,0,1,0,1,0,1,9893
1,1,0,0,1,0,1,9893
0,0,1,0,1,0,1,9894
1,1,0,1,1,1,2,9894
2,2,0,0,1,1,2,9894
0,0,1,0,1,0,1,9895
1,1,1,0,2,0,2,9895
2,2,0,0,2,0,2,9895
0,0,1,0,1,0,1,9896
1,1,1,1,2,1,3,9896
2,2,0,1,2,2,4,9896
3,3,0,0,2,2,4,9896
0,0,1,0,1,0,1,9897
1,1,3,0,4,0,4,9897
2,2,1,1,5,1,6,9897
3,3,3,0,8,1,9,9897
4,4,2,0,10,1,11,9897
5,5,1,0,11,1,12,9897
6,6,0,0,11,1,12,9897
0,0,1,0,1,0,1,9898
1,1,0,0,1,0,1,9898
0,0,1,0,1,0,1,9899
1,1,1,0,2,0,2,9899
2,2,0,0,2,0,2,9899
0,0,1,0,1,0,1,9900
1,1,0,0,1,0,1,9900
0,0,1,0,1,0,1,9901
1,1,1,1,2,1,3,9901
2,2,1,0,3,1,4,9901
3,3,2,0,5,1,6,9901
4,4,0,1,5,2,7,9901
5,5,0,1,5,3,8,9901
6,6,0,1,5,4,9,9901
7,7,0,0,5,4,9,9901
0,0,1,0,1,0,1,9902
1,1,1,0,2,0,2,9902
2,2,1,1,3,1,4,9902
3,3,1,0,4,1,5,9902
4,4,1,0,5,1,6,9902
5,5,0,0,5,1,6,9902
0,0,1,0,1,0,1,9903
1,1,1,1,2,1,3,9903
2,2,2,1,4,2,6,9903
3,3,1,1,5,3,8,9903
4,4,0,0,5,3,8,9903
0,0,1,0,1,0,1,9904
1,1,3,0,4,0,4,9904
2,2,3,0,7,0,7,9904
3,3,2,1,9,1,10,9904
4,4,1,0,10,1,11,9904
5,5,1,0,11,1,12,9904
6,6,1,0,12,1,13,9904
7,7,0,0,12,1,13,9904
0,0,1,0,1,0,1,9905
1,1,0,0,1,0,1,9905
0,0,1,0,1,0,1,9906
1,1,2,0,3,0,3,9906
2,2,2,0,5,0,5,9906
3,3,1,0,6,0,6,9906
4,4,0,0,6,0,6,9906
0,0,1,0,1,0,1,9907
1,1,1,0,2,0,2,9907
2,2,1,0,3,0,3,9907
3,3,0,0,3,0,3,9907
0,0,1,0,1,0,1,9908
1,1,0,0,1,0,1,9908
0,0,1,0,1,0,1,9909
1,1,0,0,1,0,1,9909
0,0,1,0,1,0,1,9910
1,1,0,0,1,0,1,9910
0,0,1,0,1,0,1,9911
1,1,1,1,2,1,3,9911
2,2,0,1,2,2,4,9911
3,3,1,0,3,2,5,9911
4,4,0,1,3,3,6,9911
5,5,0,0,3,3,6,9911
0,0,1,0,1,0,1,9912
1,1,0,0,1,0,1,9912
0,0,1,0,1,0,1,9913
1,1,0,0,1,0,1,9913
0,0,1,0,1,0,1,9914
1,1,0,0,1,0,1,9914
0,0,1,0,1,0,1,9915
1,1,0,0,1,0,1,9915
0,0,1,0,1,0,1,9916
1,1,3,0,4,0,4,9916
2,2,5,0,9,0,9,9916
3,3,5,3,14,3,17,9916
4,4,3,3,17,6,23,9916
5,5,4,4,21,10,31,9916
6,6,0,0,21,10,31,9916
0,0,1,0,1,0,1,9917
1,1,1,0,2,0,2,9917
2,2,1,0,3,0,3,9917
3,3,0,0,3,0,3,9917
0,0,1,0,1,0,1,9918
1,1,1,0,2,0,2,9918
2,2,1,0,3,0,3,9918
3,3,0,0,3,0,3,9918
0,0,1,0,1,0,1,9919
1,1,0,1,1,1,2,9919
2,2,0,0,1,1,2,9919
0,0,1,0,1,0,1,9920
1,1,0,0,1,0,1,9920
0,0,1,0,1,0,1,9921
1,1,1,0,2,0,2,9921
2,2,0,0,2,0,2,9921
0,0,1,0,1,0,1,9922
1,1,1,1,2,1,3,9922
2,2,0,1,2,2,4,9922
3,3,0,1,2,3,5,9922
4,4,0,0,2,3,5,9922
0,0,1,0,1,0,1,9923
1,1,1,0,2,0,2,9923
2,2,1,0,3,0,3,9923
3,3,1,0,4,0,4,9923
4,4,0,0,4,0,4,9923
0,0,1,0,1,0,1,9924
1,1,3,2,4,2,6,9924
2,2,2,2,6,4,10,9924
3,3,0,1,6,5,11,9924
4,4,0,2,6,7,13,9924
5,5,1,1,7,8,15,9924
6,6,2,0,9,8,17,9924
7,7,5,0,14,8,22,9924
8,8,4,1,18,9,27,9924
9,9,5,3,23,12,35,9924
10,10,6,3,29,15,44,9924
11,11,9,4,38,19,57,9924
12,12,12,1,50,20,70,9924
13,13,13,2,63,22,85,9924
14,14,10,1,73,23,96,9924
15,15,11,4,84,27,111,9924
16,16,4,16,88,43,131,9924
17,17,7,11,95,54,149,9924
18,18,7,9,102,63,165,9924
19,19,11,7,113,70,183,9924
20,20,3,8,116,78,194,9924
21,21,3,10,119,88,207,9924
22,22,5,14,124,102,226,9924
23,23,2,7,126,109,235,9924
24,24,3,4,129,113,242,9924
25,25,2,5,131,118,249,9924
26,26,2,2,133,120,253,9924
27,27,0,3,133,123,256,9924
28,28,1,5,134,128,262,9924
29,29,3,3,137,131,268,9924
30,30,0,1,137,132,269,9924
31,31,0,1,137,133,270,9924
32,32,0,0,137,133,270,9924
0,0,1,0,1,0,1,9925
1,1,0,0,1,0,1,9925
0,0,1,0,1,0,1,9926
1,1,0,0,1,0,1,9926
0,0,1,0,1,0,1,9927
1,1,1,0,2,0,2,9927
2,2,1,1,3,1,4,9927
3,3,0,0,3,1,4,9927
0,0,1,0,1,0,1,9928
1,1,1,0,2,0,2,9928
2,2,0,0,2,0,2,9928
0,0,1,0,1,0,1,9929
1,1,2,0,3,0,3,9929
2,2,0,0,3,0,3,9929
0,0,1,0,1,0,1,9930
1,1,0,0,1,0,1,9930
0,0,1,0,1,0,1,9931
1,1,0,0,1,0,1,9931
0,0,1,0,1,0,1,9932
1,1,2,0,3,0,3,9932
2,2,2,2,5,2,7,9932
3,3,0,1,5,3,8,9932
4,4,0,2,5,5,10,9932
5,5,0,1,5,6,11,9932
6,6,0,0,5,6,11,9932
0,0,1,0,1,0,1,9933
1,1,2,0,3,0,3,9933
2,2,2,0,5,0,5,9933
3,3,2,1,7,1,8,9933
4,4,2,0,9,1,10,9933
5,5,0,1,9,2,11,9933
6,6,1,1,10,3,13,9933
7,7,2,0,12,3,15,9933
8,8,3,1,15,4,19,9933
9,9,2,2,17,6,23,9933
10,10,3,1,20,7,27,9933
11,11,2,1,22,8,30,9933
12,12,1,1,23,9,32,9933
13,13,0,0,23,9,32,9933
0,0,1,0,1,0,1,9934
1,1,0,1,1,1,2,9934
2,2,0,0,1,1,2,9934
0,0,1,0,1,0,1,9935
1,1,1,0,2,0,2,9935
2,2,0,0,2,0,2,9935
0,0,1,0,1,0,1,9936
1,1,0,0,1,0,1,9936
0,0,1,0,1,0,1,9937
1,1,0,1,1,1,2,9937
2,2,0,0,1,1,2,9937
0,0,1,0,1,0,1,9938
1,1,0,0,1,0,1,9938
0,0,1,0,1,0,1,9939
1,1,0,0,1,0,1,9939
0,0,1,0,1,0,1,9940
1,1,0,0,1,0,1,9940
0,0,1,0,1,0,1,9941
1,1,2,0,3,0,3,9941
2,2,0,0,3,0,3,9941
0,0,1,0,1,0,1,9942
1,1,0,0,1,0,1,9942
0,0,1,0,1,0,1,9943
1,1,0,1,1,1,2,9943
2,2,1,1,2,2,4,9943
3,3,0,1,2,3,5,9943
4,4,0,2,2,5,7,9943
5,5,0,1,2,6,8,9943
6,6,0,1,2,7,9,9943
7,7,0,2,2,9,11,9943
8,8,0,1,2,10,12,9943
9,9,0,0,2,10,12,9943
0,0,1,0,1,0,1,9944
1,1,2,0,3,0,3,9944
2,2,3,0,6,0,6,9944
3,3,5,1,11,1,12,9944
4,4,9,0,20,1,21,9944
5,5,6,1,26,2,28,9944
6,6,6,2,32,4,36,9944
7,7,7,5,39,9,48,9944
8,8,4,7,43,16,59,9944
9,9,6,7,49,23,72,9944
10,10,3,8,52,31,83,9944
11,11,6,5,58,36,94,9944
12,12,5,3,63,39,102,9944
13,13,7,2,70,41,111,9944
14,14,2,4,72,45,117,9944
15,15,2,3,74,48,122,9944
16,16,3,4,77,52,129,9944
17,17,3,1,80,53,133,9944
18,18,4,0,84,53,137,9944
19,19,5,0,89,53,142,9944
20,20,2,0,91,53,144,9944
21,21,0,1,91,54,145,9944
22,22,0,0,91,54,145,9944
0,0,1,0,1,0,1,9945
1,1,2,0,3,0,3,9945
2,2,2,0,5,0,5,9945
3,3,1,1,6,1,7,9945
4,4,1,0,7,1,8,9945
5,5,2,1,9,2,11,9945
6,6,0,1,9,3,12,9945
7,7,0,1,9,4,13,9945
8,8,1,2,10,6,16,9945
9,9,3,1,13,7,20,9945
10,10,3,1,16,8,24,9945
11,11,5,1,21,9,30,9945
12,12,3,2,24,11,35,9945
13,13,2,2,26,13,39,9945
14,14,0,1,26,14,40,9945
15,15,0,1,26,15,41,9945
16,16,0,2,26,17,43,9945
17,17,0,1,26,18,44,9945
18,18,0,0,26,18,44,9945
0,0,1,0,1,0,1,9946
1,1,2,0,3,0,3,9946
2,2,3,0,6,0,6,9946
3,3,2,1,8,1,9,9946
4,4,2,0,10,1,11,9946
5,5,0,0,10,1,11,9946
0,0,1,0,1,0,1,9947
1,1,0,1,1,1,2,9947
2,2,0,0,1,1,2,9947
0,0,1,0,1,0,1,9948
1,1,0,0,1,0,1,9948
0,0,1,0,1,0,1,9949
1,1,0,0,1,0,1,9949
0,0,1,0,1,0,1,9950
1,1,2,0,3,0,3,9950
2,2,2,1,5,1,6,9950
3,3,3,0,8,1,9,9950
4,4,4,0,12,1,13,9950
5,5,2,1,14,2,16,9950
6,6,0,0,14,2,16,9950
0,0,1,0,1,0,1,9951
1,1,2,0,3,0,3,9951
2,2,1,0,4,0,4,9951
3,3,2,0,6,0,6,9951
4,4,0,0,6,0,6,9951
0,0,1,0,1,0,1,9952
1,1,0,0,1,0,1,9952
0,0,1,0,1,0,1,9953
1,1,2,0,3,0,3,9953
2,2,1,0,4,0,4,9953
3,3,0,0,4,0,4,9953
0,0,1,0,1,0,1,9954
1,1,0,0,1,0,1,9954
0,0,1,0,1,0,1,9955
1,1,1,0,2,0,2,9955
2,2,1,0,3,0,3,9955
3,3,0,0,3,0,3,9955
0,0,1,0,1,0,1,9956
1,1,0,1,1,1,2,9956
2,2,0,1,1,2,3,9956
3,3,0,0,1,2,3,9956
0,0,1,0,1,0,1,9957
1,1,0,0,1,0,1,9957
0,0,1,0,1,0,1,9958
1,1,2,0,3,0,3,9958
2,2,1,0,4,0,4,9958
3,3,1,0,5,0,5,9958
4,4,0,0,5,0,5,9958
0,0,1,0,1,0,1,9959
1,1,0,0,1,0,1,9959
0,0,1,0,1,0,1,9960
1,1,1,1,2,1,3,9960
2,2,2,1,4,2,6,9960
3,3,2,0,6,2,8,9960
4,4,3,0,9,2,11,9960
5,5,2,1,11,3,14,9960
6,6,6,2,17,5,22,9960
7,7,8,1,25,6,31,9960
8,8,7,3,32,9,41,9960
9,9,7,6,39,15,54,9960
10,10,4,5,43,20,63,9960
11,11,3,4,46,24,70,9960
12,12,4,4,50,28,78,9960
13,13,4,0,54,28,82,9960
14,14,1,1,55,29,84,9960
15,15,0,0,55,29,84,9960
0,0,1,0,1,0,1,9961
1,1,1,1,2,1,3,9961
2,2,2,0,4,1,5,9961
3,3,2,0,6,1,7,9961
4,4,1,0,7,1,8,9961
5,5,1,1,8,2,10,9961
6,6,3,0,11,2,13,9961
7,7,4,0,15,2,17,9961
8,8,3,1,18,3,21,9961
9,9,1,1,19,4,23,9961
10,10,0,1,19,5,24,9961
11,11,0,0,19,5,24,9961
0,0,1,0,1,0,1,9962
1,1,2,0,3,0,3,9962
2,2,0,2,3,2,5,9962
3,3,0,0,3,2,5,9962
0,0,1,0,1,0,1,9963
1,1,1,0,2,0,2,9963
2,2,2,0,4,0,4,9963
3,3,2,0,6,0,6,9963
4,4,1,2,7,2,9,9963
5,5,1,1,8,3,11,9963
6,6,0,0,8,3,11,9963
0,0,1,0,1,0,1,9964
1,1,1,0,2,0,2,9964
2,2,1,0,3,0,3,9964
3,3,0,0,3,0,3,9964
0,0,1,0,1,0,1,9965
1,1,0,0,1,0,1,9965
0,0,1,0,1,0,1,9966
1,1,0,0,1,0,1,9966
0,0,1,0,1,0,1,9967
1,1,1,0,2,0,2,9967
2,2,0,0,2,0,2,9967
0,0,1,0,1,0,1,9968
1,1,0,0,1,0,1,9968
0,0,1,0,1,0,1,9969
1,1,1,0,2,0,2,9969
2,2,0,0,2,0,2,9969
0,0,1,0,1,0,1,9970
1,1,1,0,2,0,2,9970
2,2,1,0,3,0,3,9970
3,3,0,0,3,0,3,9970
0,0,1,0,1,0,1,9971
1,1,0,0,1,0,1,9971
0,0,1,0,1,0,1,9972
1,1,0,0,1,0,1,9972
0,0,1,0,1,0,1,9973
1,1,2,0,3,0,3,9973
2,2,2,1,5,1,6,9973
3,3,0,0,5,1,6,9973
0,0,1,0,1,0,1,9974
1,1,1,1,2,1,3,9974
2,2,0,0,2,1,3,9974
0,0,1,0,1,0,1,9975
1,1,0,0,1,0,1,9975
0,0,1,0,1,0,1,9976
1,1,0,1,1,1,2,9976
2,2,1,1,2,2,4,9976
3,3,3,4,5,6,11,9976
4,4,4,4,9,10,19,9976
5,5,3,4,12,14,26,9976
6,6,5,2,17,16,33,9976
7,7,7,1,24,17,41,9976
8,8,5,1,29,18,47,9976
9,9,6,2,35,20,55,9976
10,10,1,1,36,21,57,9976
11,11,0,1,36,22,58,9976
12,12,0,0,36,22,58,9976
0,0,1,0,1,0,1,9977
1,1,0,0,1,0,1,9977
0,0,1,0,1,0,1,9978
1,1,0,0,1,0,1,9978
0,0,1,0,1,0,1,9979
1,1,0,0,1,0,1,9979
0,0,1,0,1,0,1,9980
1,1,1,0,2,0,2,9980
2,2,1,0,3,0,3,9980
3,3,1,0,4,0,4,9980
4,4,1,0,5,0,5,9980
5,5,2,0,7,0,7,9980
6,6,3,0,10,0,10,9980
7,7,1,0,11,0,11,9980
8,8,0,0,11,0,11,9980
0,0,1,0,1,0,1,9981
1,1,2,0,3,0,3,9981
2,2,0,0,3,0,3,9981
0,0,1,0,1,0,1,9982
1,1,0,0,1,0,1,9982
0,0,1,0,1,0,1,9983
1,1,0,0,1,0,1,9983
0,0,1,0,1,0,1,9984
1,1,1,0,2,0,2,9984
2,2,1,0,3,0,3,9984
3,3,0,0,3,0,3,9984
0,0,1,0,1,0,1,9985
1,1,0,1,1,1,2,9985
2,2,0,0,1,1,2,9985
0,0,1,0,1,0,1,9986
1,1,1,0,2,0,2,9986
2,2,1,0,3,0,3,9986
3,3,0,0,3,0,3,9986
0,0,1,0,1,0,1,9987
1,1,0,0,1,0,1,9987
0,0,1,0,1,0,1,9988
1,1,0,0,1,0,1,9988
0,0,1,0,1,0,1,9989
1,1,0,0,1,0,1,9989
0,0,1,0,1,0,1,9990
1,1,0,0,1,0,1,9990
0,0,1,0,1,0,1,9991
1,1,2,1,3,1,4,9991
2,2,2,2,5,3,8,9991
3,3,3,1,8,4,12,9991
4,4,2,0,10,4,14,9991
5,5,1,0,11,4,15,9991
6,6,0,0,11,4,15,9991
0,0,1,0,1,0,1,9992
1,1,0,0,1,0,1,9992
0,0,1,0,1,0,1,9993
1,1,2,0,3,0,3,9993
2,2,0,1,3,1,4,9993
3,3,1,1,4,2,6,9993
4,4,0,1,4,3,7,9993
5,5,0,0,4,3,7,9993
0,0,1,0,1,0,1,9994
1,1,0,0,1,0,1,9994
0,0,1,0,1,0,1,9995
1,1,2,1,3,1,4,9995
2,2,6,0,9,1,10,9995
3,3,4,0,13,1,14,9995
4,4,7,2,20,3,23,9995
5,5,8,5,28,8,36,9995
6,6,8,4,36,12,48,9995
7,7,6,4,42,16,58,9995
8,8,6,5,48,21,69,9995
9,9,8,4,56,25,81,9995
10,10,5,4,61,29,90,9995
11,11,3,4,64,33,97,9995
12,12,7,4,71,37,108,9995
13,13,3,6,74,43,117,9995
14,14,6,7,80,50,130,9995
15,15,6,8,86,58,144,9995
16,16,6,6,92,64,156,9995
17,17,8,3,100,67,167,9995
18,18,7,3,107,70,177,9995
19,19,3,3,110,73,183,9995
20,20,3,5,113,78,191,9995
21,21,5,0,118,78,196,9995
22,22,6,0,124,78,202,9995
23,23,4,2,128,80,208,9995
24,24,3,5,131,85,216,9995
25,25,2,4,133,89,222,9995
26,26,3,2,136,91,227,9995
27,27,3,3,139,94,233,9995
28,28,2,2,141,96,237,9995
29,29,1,3,142,99,241,9995
30,30,0,0,142,99,241,9995
0,0,1,0,1,0,1,9996
1,1,2,0,3,0,3,9996
2,2,4,0,7,0,7,9996
3,3,3,0,10,0,10,9996
4,4,2,1,12,1,13,9996
5,5,3,1,15,2,17,9996
6,6,0,1,15,3,18,9996
7,7,0,1,15,4,19,9996
8,8,0,0,15,4,19,9996
0,0,1,0,1,0,1,9997
1,1,0,0,1,0,1,9997
0,0,1,0,1,0,1,9998
1,1,1,0,2,0,2,9998
2,2,0,0,2,0,2,9998
0,0,1,0,1,0,1,9999
1,1,1,0,2,0,2,9999
2,2,1,0,3,0,3,9999
3,3,1,1,4,1,5,9999
4,4,0,1,4,2,6,9999
5,5,0,0,4,2,6,9999
