,generation,new_infections_1,new_infections_2,total_infections_1,total_infections_2,total_infections,simulation_id
0,0,1,0,1,0,1,0
1,1,0,0,1,0,1,0
0,0,1,0,1,0,1,1
1,1,1,0,2,0,2,1
2,2,2,1,4,1,5,1
3,3,3,1,7,2,9,1
4,4,2,3,9,5,14,1
5,5,1,2,10,7,17,1
6,6,1,1,11,8,19,1
7,7,1,1,12,9,21,1
8,8,1,1,13,10,23,1
9,9,0,1,13,11,24,1
10,10,0,0,13,11,24,1
0,0,1,0,1,0,1,2
1,1,1,0,2,0,2,2
2,2,0,0,2,0,2,2
0,0,1,0,1,0,1,3
1,1,0,0,1,0,1,3
0,0,1,0,1,0,1,4
1,1,1,1,2,1,3,4
2,2,1,0,3,1,4,4
3,3,2,1,5,2,7,4
4,4,3,1,8,3,11,4
5,5,3,0,11,3,14,4
6,6,3,0,14,3,17,4
7,7,1,2,15,5,20,4
8,8,1,3,16,8,24,4
9,9,2,2,18,10,28,4
10,10,3,1,21,11,32,4
11,11,3,1,24,12,36,4
12,12,0,0,24,12,36,4
0,0,1,0,1,0,1,5
1,1,1,0,2,0,2,5
2,2,0,1,2,1,3,5
3,3,0,0,2,1,3,5
0,0,1,0,1,0,1,6
1,1,0,1,1,1,2,6
2,2,0,1,1,2,3,6
3,3,0,0,1,2,3,6
0,0,1,0,1,0,1,7
1,1,1,0,2,0,2,7
2,2,0,0,2,0,2,7
0,0,1,0,1,0,1,8
1,1,0,0,1,0,1,8
0,0,1,0,1,0,1,9
1,1,1,0,2,0,2,9
2,2,0,1,2,1,3,9
3,3,0,0,2,1,3,9
0,0,1,0,1,0,1,10
1,1,1,0,2,0,2,10
2,2,0,0,2,0,2,10
0,0,1,0,1,0,1,11
1,1,1,2,2,2,4,11
2,2,0,2,2,4,6,11
3,3,0,1,2,5,7,11
4,4,0,0,2,5,7,11
0,0,1,0,1,0,1,12
1,1,0,0,1,0,1,12
0,0,1,0,1,0,1,13
1,1,1,0,2,0,2,13
2,2,0,0,2,0,2,13
0,0,1,0,1,0,1,14
1,1,2,1,3,1,4,14
2,2,0,2,3,3,6,14
3,3,0,3,3,6,9,14
4,4,1,1,4,7,11,14
5,5,2,0,6,7,13,14
6,6,0,0,6,7,13,14
0,0,1,0,1,0,1,15
1,1,0,1,1,1,2,15
2,2,0,2,1,3,4,15
3,3,0,0,1,3,4,15
0,0,1,0,1,0,1,16
1,1,0,1,1,1,2,16
2,2,0,0,1,1,2,16
0,0,1,0,1,0,1,17
1,1,1,0,2,0,2,17
2,2,1,1,3,1,4,17
3,3,0,1,3,2,5,17
4,4,0,0,3,2,5,17
0,0,1,0,1,0,1,18
1,1,0,0,1,0,1,18
0,0,1,0,1,0,1,19
1,1,0,1,1,1,2,19
2,2,0,0,1,1,2,19
0,0,1,0,1,0,1,20
1,1,0,0,1,0,1,20
0,0,1,0,1,0,1,21
1,1,0,0,1,0,1,21
0,0,1,0,1,0,1,22
1,1,0,0,1,0,1,22
0,0,1,0,1,0,1,23
1,1,1,0,2,0,2,23
2,2,0,0,2,0,2,23
0,0,1,0,1,0,1,24
1,1,1,0,2,0,2,24
2,2,1,0,3,0,3,24
3,3,1,0,4,0,4,24
4,4,0,0,4,0,4,24
0,0,1,0,1,0,1,25
1,1,0,0,1,0,1,25
0,0,1,0,1,0,1,26
1,1,0,0,1,0,1,26
0,0,1,0,1,0,1,27
1,1,2,0,3,0,3,27
2,2,2,0,5,0,5,27
3,3,1,0,6,0,6,27
4,4,0,0,6,0,6,27
0,0,1,0,1,0,1,28
1,1,1,0,2,0,2,28
2,2,5,0,7,0,7,28
3,3,3,0,10,0,10,28
4,4,1,2,11,2,13,28
5,5,1,1,12,3,15,28
6,6,0,2,12,5,17,28
7,7,1,2,13,7,20,28
8,8,1,1,14,8,22,28
9,9,0,0,14,8,22,28
0,0,1,0,1,0,1,29
1,1,2,0,3,0,3,29
2,2,3,0,6,0,6,29
3,3,4,1,10,1,11,29
4,4,1,1,11,2,13,29
5,5,0,2,11,4,15,29
6,6,0,2,11,6,17,29
7,7,0,1,11,7,18,29
8,8,0,0,11,7,18,29
0,0,1,0,1,0,1,30
1,1,1,0,2,0,2,30
2,2,0,1,2,1,3,30
3,3,0,1,2,2,4,30
4,4,0,1,2,3,5,30
5,5,0,3,2,6,8,30
6,6,1,3,3,9,12,30
7,7,0,3,3,12,15,30
8,8,1,1,4,13,17,30
9,9,1,0,5,13,18,30
10,10,0,0,5,13,18,30
0,0,1,0,1,0,1,31
1,1,1,0,2,0,2,31
2,2,1,0,3,0,3,31
3,3,0,1,3,1,4,31
4,4,0,1,3,2,5,31
5,5,0,0,3,2,5,31
0,0,1,0,1,0,1,32
1,1,1,2,2,2,4,32
2,2,2,1,4,3,7,32
3,3,1,0,5,3,8,32
4,4,0,0,5,3,8,32
0,0,1,0,1,0,1,33
1,1,1,0,2,0,2,33
2,2,0,0,2,0,2,33
0,0,1,0,1,0,1,34
1,1,1,0,2,0,2,34
2,2,1,0,3,0,3,34
3,3,1,0,4,0,4,34
4,4,1,0,5,0,5,34
5,5,3,0,8,0,8,34
6,6,3,1,11,1,12,34
7,7,1,2,12,3,15,34
8,8,0,1,12,4,16,34
9,9,0,0,12,4,16,34
0,0,1,0,1,0,1,35
1,1,2,0,3,0,3,35
2,2,1,0,4,0,4,35
3,3,1,0,5,0,5,35
4,4,1,0,6,0,6,35
5,5,0,0,6,0,6,35
0,0,1,0,1,0,1,36
1,1,1,0,2,0,2,36
2,2,1,1,3,1,4,36
3,3,2,1,5,2,7,36
4,4,1,0,6,2,8,36
5,5,0,1,6,3,9,36
6,6,0,2,6,5,11,36
7,7,1,3,7,8,15,36
8,8,1,3,8,11,19,36
9,9,1,3,9,14,23,36
10,10,0,2,9,16,25,36
11,11,0,1,9,17,26,36
12,12,0,2,9,19,28,36
13,13,2,0,11,19,30,36
14,14,0,0,11,19,30,36
0,0,1,0,1,0,1,37
1,1,2,0,3,0,3,37
2,2,0,0,3,0,3,37
0,0,1,0,1,0,1,38
1,1,0,0,1,0,1,38
0,0,1,0,1,0,1,39
1,1,0,1,1,1,2,39
2,2,0,2,1,3,4,39
3,3,0,1,1,4,5,39
4,4,0,1,1,5,6,39
5,5,0,1,1,6,7,39
6,6,0,2,1,8,9,39
7,7,0,0,1,8,9,39
0,0,1,0,1,0,1,40
1,1,0,0,1,0,1,40
0,0,1,0,1,0,1,41
1,1,1,0,2,0,2,41
2,2,0,0,2,0,2,41
0,0,1,0,1,0,1,42
1,1,1,0,2,0,2,42
2,2,1,0,3,0,3,42
3,3,1,0,4,0,4,42
4,4,2,0,6,0,6,42
5,5,1,0,7,0,7,42
6,6,0,0,7,0,7,42
0,0,1,0,1,0,1,43
1,1,1,0,2,0,2,43
2,2,2,0,4,0,4,43
3,3,1,0,5,0,5,43
4,4,0,0,5,0,5,43
0,0,1,0,1,0,1,44
1,1,0,0,1,0,1,44
0,0,1,0,1,0,1,45
1,1,1,0,2,0,2,45
2,2,0,0,2,0,2,45
0,0,1,0,1,0,1,46
1,1,1,0,2,0,2,46
2,2,0,0,2,0,2,46
0,0,1,0,1,0,1,47
1,1,0,0,1,0,1,47
0,0,1,0,1,0,1,48
1,1,0,0,1,0,1,48
0,0,1,0,1,0,1,49
1,1,2,0,3,0,3,49
2,2,0,0,3,0,3,49
0,0,1,0,1,0,1,50
1,1,0,0,1,0,1,50
0,0,1,0,1,0,1,51
1,1,0,0,1,0,1,51
0,0,1,0,1,0,1,52
1,1,3,1,4,1,5,52
2,2,2,3,6,4,10,52
3,3,1,1,7,5,12,52
4,4,0,0,7,5,12,52
0,0,1,0,1,0,1,53
1,1,0,0,1,0,1,53
0,0,1,0,1,0,1,54
1,1,0,0,1,0,1,54
0,0,1,0,1,0,1,55
1,1,2,1,3,1,4,55
2,2,1,1,4,2,6,55
3,3,1,1,5,3,8,55
4,4,2,0,7,3,10,55
5,5,1,3,8,6,14,55
6,6,1,2,9,8,17,55
7,7,0,2,9,10,19,55
8,8,0,2,9,12,21,55
9,9,1,2,10,14,24,55
10,10,0,0,10,14,24,55
0,0,1,0,1,0,1,56
1,1,1,0,2,0,2,56
2,2,0,0,2,0,2,56
0,0,1,0,1,0,1,57
1,1,2,0,3,0,3,57
2,2,0,0,3,0,3,57
0,0,1,0,1,0,1,58
1,1,1,0,2,0,2,58
2,2,3,0,5,0,5,58
3,3,1,2,6,2,8,58
4,4,0,0,6,2,8,58
0,0,1,0,1,0,1,59
1,1,0,1,1,1,2,59
2,2,0,1,1,2,3,59
3,3,0,1,1,3,4,59
4,4,0,3,1,6,7,59
5,5,1,4,2,10,12,59
6,6,3,2,5,12,17,59
7,7,5,4,10,16,26,59
8,8,4,5,14,21,35,59
9,9,6,3,20,24,44,59
10,10,6,1,26,25,51,59
11,11,5,1,31,26,57,59
12,12,8,3,39,29,68,59
13,13,8,4,47,33,80,59
14,14,2,2,49,35,84,59
15,15,1,0,50,35,85,59
16,16,1,0,51,35,86,59
17,17,2,0,53,35,88,59
18,18,1,2,54,37,91,59
19,19,1,0,55,37,92,59
20,20,0,0,55,37,92,59
0,0,1,0,1,0,1,60
1,1,0,0,1,0,1,60
0,0,1,0,1,0,1,61
1,1,1,0,2,0,2,61
2,2,2,2,4,2,6,61
3,3,1,1,5,3,8,61
4,4,1,2,6,5,11,61
5,5,2,1,8,6,14,61
6,6,2,0,10,6,16,61
7,7,1,0,11,6,17,61
8,8,1,0,12,6,18,61
9,9,0,0,12,6,18,61
0,0,1,0,1,0,1,62
1,1,1,0,2,0,2,62
2,2,1,0,3,0,3,62
3,3,2,0,5,0,5,62
4,4,2,0,7,0,7,62
5,5,2,1,9,1,10,62
6,6,1,0,10,1,11,62
7,7,2,1,12,2,14,62
8,8,5,1,17,3,20,62
9,9,2,1,19,4,23,62
10,10,0,1,19,5,24,62
11,11,0,0,19,5,24,62
0,0,1,0,1,0,1,63
1,1,1,0,2,0,2,63
2,2,0,0,2,0,2,63
0,0,1,0,1,0,1,64
1,1,1,0,2,0,2,64
2,2,1,0,3,0,3,64
3,3,1,0,4,0,4,64
4,4,1,0,5,0,5,64
5,5,1,1,6,1,7,64
6,6,2,0,8,1,9,64
7,7,2,0,10,1,11,64
8,8,2,0,12,1,13,64
9,9,1,0,13,1,14,64
10,10,1,0,14,1,15,64
11,11,0,0,14,1,15,64
0,0,1,0,1,0,1,65
1,1,1,0,2,0,2,65
2,2,0,0,2,0,2,65
0,0,1,0,1,0,1,66
1,1,0,0,1,0,1,66
0,0,1,0,1,0,1,67
1,1,2,1,3,1,4,67
2,2,0,0,3,1,4,67
0,0,1,0,1,0,1,68
1,1,0,0,1,0,1,68
0,0,1,0,1,0,1,69
1,1,0,0,1,0,1,69
0,0,1,0,1,0,1,70
1,1,0,0,1,0,1,70
0,0,1,0,1,0,1,71
1,1,0,1,1,1,2,71
2,2,0,1,1,2,3,71
3,3,1,2,2,4,6,71
4,4,1,2,3,6,9,71
5,5,1,2,4,8,12,71
6,6,3,1,7,9,16,71
7,7,3,2,10,11,21,71
8,8,0,1,10,12,22,71
9,9,0,0,10,12,22,71
0,0,1,0,1,0,1,72
1,1,0,0,1,0,1,72
0,0,1,0,1,0,1,73
1,1,1,0,2,0,2,73
2,2,1,0,3,0,3,73
3,3,0,0,3,0,3,73
0,0,1,0,1,0,1,74
1,1,0,1,1,1,2,74
2,2,0,1,1,2,3,74
3,3,0,1,1,3,4,74
4,4,1,0,2,3,5,74
5,5,0,0,2,3,5,74
0,0,1,0,1,0,1,75
1,1,0,0,1,0,1,75
0,0,1,0,1,0,1,76
1,1,1,0,2,0,2,76
2,2,0,0,2,0,2,76
0,0,1,0,1,0,1,77
1,1,0,1,1,1,2,77
2,2,0,2,1,3,4,77
3,3,0,2,1,5,6,77
4,4,0,2,1,7,8,77
5,5,0,3,1,10,11,77
6,6,1,1,2,11,13,77
7,7,1,0,3,11,14,77
8,8,0,0,3,11,14,77
0,0,1,0,1,0,1,78
1,1,1,0,2,0,2,78
2,2,0,0,2,0,2,78
0,0,1,0,1,0,1,79
1,1,1,0,2,0,2,79
2,2,1,0,3,0,3,79
3,3,0,0,3,0,3,79
0,0,1,0,1,0,1,80
1,1,0,0,1,0,1,80
0,0,1,0,1,0,1,81
1,1,1,0,2,0,2,81
2,2,0,0,2,0,2,81
0,0,1,0,1,0,1,82
1,1,1,1,2,1,3,82
2,2,1,3,3,4,7,82
3,3,0,1,3,5,8,82
4,4,0,2,3,7,10,82
5,5,0,0,3,7,10,82
0,0,1,0,1,0,1,83
1,1,1,0,2,0,2,83
2,2,2,0,4,0,4,83
3,3,3,0,7,0,7,83
4,4,2,0,9,0,9,83
5,5,1,0,10,0,10,83
6,6,1,1,11,1,12,83
7,7,2,2,13,3,16,83
8,8,2,3,15,6,21,83
9,9,1,7,16,13,29,83
10,10,0,4,16,17,33,83
11,11,0,3,16,20,36,83
12,12,0,1,16,21,37,83
13,13,0,0,16,21,37,83
0,0,1,0,1,0,1,84
1,1,1,1,2,1,3,84
2,2,2,1,4,2,6,84
3,3,3,0,7,2,9,84
4,4,1,1,8,3,11,84
5,5,2,0,10,3,13,84
6,6,1,0,11,3,14,84
7,7,0,0,11,3,14,84
0,0,1,0,1,0,1,85
1,1,1,0,2,0,2,85
2,2,1,0,3,0,3,85
3,3,1,0,4,0,4,85
4,4,0,0,4,0,4,85
0,0,1,0,1,0,1,86
1,1,1,0,2,0,2,86
2,2,1,0,3,0,3,86
3,3,1,0,4,0,4,86
4,4,1,0,5,0,5,86
5,5,1,0,6,0,6,86
6,6,0,0,6,0,6,86
0,0,1,0,1,0,1,87
1,1,0,1,1,1,2,87
2,2,1,1,2,2,4,87
3,3,2,1,4,3,7,87
4,4,1,1,5,4,9,87
5,5,1,2,6,6,12,87
6,6,4,1,10,7,17,87
7,7,4,0,14,7,21,87
8,8,7,0,21,7,28,87
9,9,2,0,23,7,30,87
10,10,1,0,24,7,31,87
11,11,1,0,25,7,32,87
12,12,1,0,26,7,33,87
13,13,0,0,26,7,33,87
0,0,1,0,1,0,1,88
1,1,1,0,2,0,2,88
2,2,0,0,2,0,2,88
0,0,1,0,1,0,1,89
1,1,0,0,1,0,1,89
0,0,1,0,1,0,1,90
1,1,1,1,2,1,3,90
2,2,3,1,5,2,7,90
3,3,4,1,9,3,12,90
4,4,2,1,11,4,15,90
5,5,1,0,12,4,16,90
6,6,1,1,13,5,18,90
7,7,1,2,14,7,21,90
8,8,1,0,15,7,22,90
9,9,0,0,15,7,22,90
0,0,1,0,1,0,1,91
1,1,1,0,2,0,2,91
2,2,2,0,4,0,4,91
3,3,1,1,5,1,6,91
4,4,0,1,5,2,7,91
5,5,0,0,5,2,7,91
0,0,1,0,1,0,1,92
1,1,0,0,1,0,1,92
0,0,1,0,1,0,1,93
1,1,0,2,1,2,3,93
2,2,0,2,1,4,5,93
3,3,0,4,1,8,9,93
4,4,1,5,2,13,15,93
5,5,3,4,5,17,22,93
6,6,6,7,11,24,35,93
7,7,9,5,20,29,49,93
8,8,5,1,25,30,55,93
9,9,3,3,28,33,61,93
10,10,3,3,31,36,67,93
11,11,4,3,35,39,74,93
12,12,4,2,39,41,80,93
13,13,4,3,43,44,87,93
14,14,6,6,49,50,99,93
15,15,8,1,57,51,108,93
16,16,13,0,70,51,121,93
17,17,15,3,85,54,139,93
18,18,10,5,95,59,154,93
19,19,10,6,105,65,170,93
20,20,7,3,112,68,180,93
21,21,1,2,113,70,183,93
22,22,0,5,113,75,188,93
23,23,1,6,114,81,195,93
24,24,1,9,115,90,205,93
25,25,1,5,116,95,211,93
26,26,0,3,116,98,214,93
27,27,0,2,116,100,216,93
28,28,0,2,116,102,218,93
29,29,0,0,116,102,218,93
0,0,1,0,1,0,1,94
1,1,0,0,1,0,1,94
0,0,1,0,1,0,1,95
1,1,0,0,1,0,1,95
0,0,1,0,1,0,1,96
1,1,3,1,4,1,5,96
2,2,1,1,5,2,7,96
3,3,1,0,6,2,8,96
4,4,0,0,6,2,8,96
0,0,1,0,1,0,1,97
1,1,1,0,2,0,2,97
2,2,2,0,4,0,4,97
3,3,3,0,7,0,7,97
4,4,3,0,10,0,10,97
5,5,2,0,12,0,12,97
6,6,2,2,14,2,16,97
7,7,0,1,14,3,17,97
8,8,0,1,14,4,18,97
9,9,1,0,15,4,19,97
10,10,1,0,16,4,20,97
11,11,1,0,17,4,21,97
12,12,0,0,17,4,21,97
0,0,1,0,1,0,1,98
1,1,1,1,2,1,3,98
2,2,2,1,4,2,6,98
3,3,2,1,6,3,9,98
4,4,3,0,9,3,12,98
5,5,1,0,10,3,13,98
6,6,2,0,12,3,15,98
7,7,0,1,12,4,16,98
8,8,0,2,12,6,18,98
9,9,0,1,12,7,19,98
10,10,0,1,12,8,20,98
11,11,0,1,12,9,21,98
12,12,0,0,12,9,21,98
0,0,1,0,1,0,1,99
1,1,0,0,1,0,1,99
0,0,1,0,1,0,1,100
1,1,1,0,2,0,2,100
2,2,1,0,3,0,3,100
3,3,1,0,4,0,4,100
4,4,1,0,5,0,5,100
5,5,1,0,6,0,6,100
6,6,0,0,6,0,6,100
0,0,1,0,1,0,1,101
1,1,0,0,1,0,1,101
0,0,1,0,1,0,1,102
1,1,0,0,1,0,1,102
0,0,1,0,1,0,1,103
1,1,0,0,1,0,1,103
0,0,1,0,1,0,1,104
1,1,0,1,1,1,2,104
2,2,0,0,1,1,2,104
0,0,1,0,1,0,1,105
1,1,1,0,2,0,2,105
2,2,1,0,3,0,3,105
3,3,1,2,4,2,6,105
4,4,2,1,6,3,9,105
5,5,2,0,8,3,11,105
6,6,1,0,9,3,12,105
7,7,1,0,10,3,13,105
8,8,1,0,11,3,14,105
9,9,0,0,11,3,14,105
0,0,1,0,1,0,1,106
1,1,0,0,1,0,1,106
0,0,1,0,1,0,1,107
1,1,1,0,2,0,2,107
2,2,0,2,2,2,4,107
3,3,1,1,3,3,6,107
4,4,1,3,4,6,10,107
5,5,1,1,5,7,12,107
6,6,0,1,5,8,13,107
7,7,0,1,5,9,14,107
8,8,0,0,5,9,14,107
0,0,1,0,1,0,1,108
1,1,0,0,1,0,1,108
0,0,1,0,1,0,1,109
1,1,0,0,1,0,1,109
0,0,1,0,1,0,1,110
1,1,0,0,1,0,1,110
0,0,1,0,1,0,1,111
1,1,3,0,4,0,4,111
2,2,7,1,11,1,12,111
3,3,3,1,14,2,16,111
4,4,3,0,17,2,19,111
5,5,3,0,20,2,22,111
6,6,1,0,21,2,23,111
7,7,1,0,22,2,24,111
8,8,0,0,22,2,24,111
0,0,1,0,1,0,1,112
1,1,1,0,2,0,2,112
2,2,0,0,2,0,2,112
0,0,1,0,1,0,1,113
1,1,0,0,1,0,1,113
0,0,1,0,1,0,1,114
1,1,0,0,1,0,1,114
0,0,1,0,1,0,1,115
1,1,0,0,1,0,1,115
0,0,1,0,1,0,1,116
1,1,2,1,3,1,4,116
2,2,2,1,5,2,7,116
3,3,3,0,8,2,10,116
4,4,1,0,9,2,11,116
5,5,0,0,9,2,11,116
0,0,1,0,1,0,1,117
1,1,1,1,2,1,3,117
2,2,0,2,2,3,5,117
3,3,2,2,4,5,9,117
4,4,2,1,6,6,12,117
5,5,4,0,10,6,16,117
6,6,4,0,14,6,20,117
7,7,7,1,21,7,28,117
8,8,2,2,23,9,32,117
9,9,3,0,26,9,35,117
10,10,3,0,29,9,38,117
11,11,5,1,34,10,44,117
12,12,4,3,38,13,51,117
13,13,11,2,49,15,64,117
14,14,4,3,53,18,71,117
15,15,3,3,56,21,77,117
16,16,3,5,59,26,85,117
17,17,4,3,63,29,92,117
18,18,2,1,65,30,95,117
19,19,1,4,66,34,100,117
20,20,0,3,66,37,103,117
21,21,0,2,66,39,105,117
22,22,0,1,66,40,106,117
23,23,0,0,66,40,106,117
0,0,1,0,1,0,1,118
1,1,0,0,1,0,1,118
0,0,1,0,1,0,1,119
1,1,1,0,2,0,2,119
2,2,2,0,4,0,4,119
3,3,1,0,5,0,5,119
4,4,0,0,5,0,5,119
0,0,1,0,1,0,1,120
1,1,1,0,2,0,2,120
2,2,2,0,4,0,4,120
3,3,1,0,5,0,5,120
4,4,1,1,6,1,7,120
5,5,0,1,6,2,8,120
6,6,0,0,6,2,8,120
0,0,1,0,1,0,1,121
1,1,1,0,2,0,2,121
2,2,0,0,2,0,2,121
0,0,1,0,1,0,1,122
1,1,1,0,2,0,2,122
2,2,1,0,3,0,3,122
3,3,0,0,3,0,3,122
0,0,1,0,1,0,1,123
1,1,2,0,3,0,3,123
2,2,0,1,3,1,4,123
3,3,0,0,3,1,4,123
0,0,1,0,1,0,1,124
1,1,0,0,1,0,1,124
0,0,1,0,1,0,1,125
1,1,0,0,1,0,1,125
0,0,1,0,1,0,1,126
1,1,0,0,1,0,1,126
0,0,1,0,1,0,1,127
1,1,1,0,2,0,2,127
2,2,1,0,3,0,3,127
3,3,1,0,4,0,4,127
4,4,1,1,5,1,6,127
5,5,1,0,6,1,7,127
6,6,0,0,6,1,7,127
0,0,1,0,1,0,1,128
1,1,1,0,2,0,2,128
2,2,1,0,3,0,3,128
3,3,1,0,4,0,4,128
4,4,2,0,6,0,6,128
5,5,1,2,7,2,9,128
6,6,2,2,9,4,13,128
7,7,3,3,12,7,19,128
8,8,1,1,13,8,21,128
9,9,3,1,16,9,25,128
10,10,5,0,21,9,30,128
11,11,1,1,22,10,32,128
12,12,0,0,22,10,32,128
0,0,1,0,1,0,1,129
1,1,2,0,3,0,3,129
2,2,0,0,3,0,3,129
0,0,1,0,1,0,1,130
1,1,1,1,2,1,3,130
2,2,0,1,2,2,4,130
3,3,1,0,3,2,5,130
4,4,0,0,3,2,5,130
0,0,1,0,1,0,1,131
1,1,0,0,1,0,1,131
0,0,1,0,1,0,1,132
1,1,0,0,1,0,1,132
0,0,1,0,1,0,1,133
1,1,1,0,2,0,2,133
2,2,0,1,2,1,3,133
3,3,0,0,2,1,3,133
0,0,1,0,1,0,1,134
1,1,0,1,1,1,2,134
2,2,1,0,2,1,3,134
3,3,3,0,5,1,6,134
4,4,2,1,7,2,9,134
5,5,1,2,8,4,12,134
6,6,1,0,9,4,13,134
7,7,0,0,9,4,13,134
0,0,1,0,1,0,1,135
1,1,1,0,2,0,2,135
2,2,0,2,2,2,4,135
3,3,0,1,2,3,5,135
4,4,1,0,3,3,6,135
5,5,3,0,6,3,9,135
6,6,1,1,7,4,11,135
7,7,0,0,7,4,11,135
0,0,1,0,1,0,1,136
1,1,1,1,2,1,3,136
2,2,2,1,4,2,6,136
3,3,3,1,7,3,10,136
4,4,2,2,9,5,14,136
5,5,2,1,11,6,17,136
6,6,1,1,12,7,19,136
7,7,0,1,12,8,20,136
8,8,0,1,12,9,21,136
9,9,0,1,12,10,22,136
10,10,1,0,13,10,23,136
11,11,1,0,14,10,24,136
12,12,2,0,16,10,26,136
13,13,1,0,17,10,27,136
14,14,1,0,18,10,28,136
15,15,0,0,18,10,28,136
0,0,1,0,1,0,1,137
1,1,0,0,1,0,1,137
0,0,1,0,1,0,1,138
1,1,0,0,1,0,1,138
0,0,1,0,1,0,1,139
1,1,0,0,1,0,1,139
0,0,1,0,1,0,1,140
1,1,1,0,2,0,2,140
2,2,2,0,4,0,4,140
3,3,3,0,7,0,7,140
4,4,2,0,9,0,9,140
5,5,0,1,9,1,10,140
6,6,0,0,9,1,10,140
0,0,1,0,1,0,1,141
1,1,1,1,2,1,3,141
2,2,3,3,5,4,9,141
3,3,3,5,8,9,17,141
4,4,3,8,11,17,28,141
5,5,1,3,12,20,32,141
6,6,4,2,16,22,38,141
7,7,1,3,17,25,42,141
8,8,2,2,19,27,46,141
9,9,3,0,22,27,49,141
10,10,0,2,22,29,51,141
11,11,0,1,22,30,52,141
12,12,0,0,22,30,52,141
0,0,1,0,1,0,1,142
1,1,0,0,1,0,1,142
0,0,1,0,1,0,1,143
1,1,2,0,3,0,3,143
2,2,0,0,3,0,3,143
0,0,1,0,1,0,1,144
1,1,1,1,2,1,3,144
2,2,1,1,3,2,5,144
3,3,3,0,6,2,8,144
4,4,1,0,7,2,9,144
5,5,1,0,8,2,10,144
6,6,1,0,9,2,11,144
7,7,0,0,9,2,11,144
0,0,1,0,1,0,1,145
1,1,2,0,3,0,3,145
2,2,0,0,3,0,3,145
0,0,1,0,1,0,1,146
1,1,0,1,1,1,2,146
2,2,0,0,1,1,2,146
0,0,1,0,1,0,1,147
1,1,0,0,1,0,1,147
0,0,1,0,1,0,1,148
1,1,0,0,1,0,1,148
0,0,1,0,1,0,1,149
1,1,2,0,3,0,3,149
2,2,0,2,3,2,5,149
3,3,0,1,3,3,6,149
4,4,0,1,3,4,7,149
5,5,1,2,4,6,10,149
6,6,0,2,4,8,12,149
7,7,0,2,4,10,14,149
8,8,0,4,4,14,18,149
9,9,0,3,4,17,21,149
10,10,1,2,5,19,24,149
11,11,2,1,7,20,27,149
12,12,4,2,11,22,33,149
13,13,3,1,14,23,37,149
14,14,2,2,16,25,41,149
15,15,1,4,17,29,46,149
16,16,2,4,19,33,52,149
17,17,3,6,22,39,61,149
18,18,4,7,26,46,72,149
19,19,4,8,30,54,84,149
20,20,6,8,36,62,98,149
21,21,11,6,47,68,115,149
22,22,12,3,59,71,130,149
23,23,3,9,62,80,142,149
24,24,7,9,69,89,158,149
25,25,11,11,80,100,180,149
26,26,13,12,93,112,205,149
27,27,9,5,102,117,219,149
28,28,7,11,109,128,237,149
29,29,7,6,116,134,250,149
30,30,7,6,123,140,263,149
31,31,5,5,128,145,273,149
32,32,2,2,130,147,277,149
33,33,3,1,133,148,281,149
34,34,3,2,136,150,286,149
35,35,3,3,139,153,292,149
36,36,2,0,141,153,294,149
37,37,0,0,141,153,294,149
0,0,1,0,1,0,1,150
1,1,1,0,2,0,2,150
2,2,1,0,3,0,3,150
3,3,1,0,4,0,4,150
4,4,1,0,5,0,5,150
5,5,1,0,6,0,6,150
6,6,0,0,6,0,6,150
0,0,1,0,1,0,1,151
1,1,1,0,2,0,2,151
2,2,0,0,2,0,2,151
0,0,1,0,1,0,1,152
1,1,0,0,1,0,1,152
0,0,1,0,1,0,1,153
1,1,1,1,2,1,3,153
2,2,2,2,4,3,7,153
3,3,0,2,4,5,9,153
4,4,0,1,4,6,10,153
5,5,0,0,4,6,10,153
0,0,1,0,1,0,1,154
1,1,0,0,1,0,1,154
0,0,1,0,1,0,1,155
1,1,1,0,2,0,2,155
2,2,1,0,3,0,3,155
3,3,2,0,5,0,5,155
4,4,1,0,6,0,6,155
5,5,0,1,6,1,7,155
6,6,0,2,6,3,9,155
7,7,1,2,7,5,12,155
8,8,1,1,8,6,14,155
9,9,1,3,9,9,18,155
10,10,0,5,9,14,23,155
11,11,2,2,11,16,27,155
12,12,2,1,13,17,30,155
13,13,4,1,17,18,35,155
14,14,3,1,20,19,39,155
15,15,4,1,24,20,44,155
16,16,7,0,31,20,51,155
17,17,7,2,38,22,60,155
18,18,3,3,41,25,66,155
19,19,2,1,43,26,69,155
20,20,2,0,45,26,71,155
21,21,3,1,48,27,75,155
22,22,3,1,51,28,79,155
23,23,5,1,56,29,85,155
24,24,2,0,58,29,87,155
25,25,0,1,58,30,88,155
26,26,0,0,58,30,88,155
0,0,1,0,1,0,1,156
1,1,1,1,2,1,3,156
2,2,2,2,4,3,7,156
3,3,7,2,11,5,16,156
4,4,8,0,19,5,24,156
5,5,10,0,29,5,34,156
6,6,6,1,35,6,41,156
7,7,4,0,39,6,45,156
8,8,4,0,43,6,49,156
9,9,4,0,47,6,53,156
10,10,2,1,49,7,56,156
11,11,1,1,50,8,58,156
12,12,0,1,50,9,59,156
13,13,0,1,50,10,60,156
14,14,0,3,50,13,63,156
15,15,0,1,50,14,64,156
16,16,0,2,50,16,66,156
17,17,0,2,50,18,68,156
18,18,0,2,50,20,70,156
19,19,0,0,50,20,70,156
0,0,1,0,1,0,1,157
1,1,2,0,3,0,3,157
2,2,2,0,5,0,5,157
3,3,1,0,6,0,6,157
4,4,0,0,6,0,6,157
0,0,1,0,1,0,1,158
1,1,0,0,1,0,1,158
0,0,1,0,1,0,1,159
1,1,1,1,2,1,3,159
2,2,1,1,3,2,5,159
3,3,0,1,3,3,6,159
4,4,0,3,3,6,9,159
5,5,0,2,3,8,11,159
6,6,0,1,3,9,12,159
7,7,0,0,3,9,12,159
0,0,1,0,1,0,1,160
1,1,0,0,1,0,1,160
0,0,1,0,1,0,1,161
1,1,2,0,3,0,3,161
2,2,2,1,5,1,6,161
3,3,1,0,6,1,7,161
4,4,0,0,6,1,7,161
0,0,1,0,1,0,1,162
1,1,0,0,1,0,1,162
0,0,1,0,1,0,1,163
1,1,2,0,3,0,3,163
2,2,0,0,3,0,3,163
0,0,1,0,1,0,1,164
1,1,0,0,1,0,1,164
0,0,1,0,1,0,1,165
1,1,0,1,1,1,2,165
2,2,1,2,2,3,5,165
3,3,1,1,3,4,7,165
4,4,0,0,3,4,7,165
0,0,1,0,1,0,1,166
1,1,2,1,3,1,4,166
2,2,1,1,4,2,6,166
3,3,2,1,6,3,9,166
4,4,2,0,8,3,11,166
5,5,3,0,11,3,14,166
6,6,4,1,15,4,19,166
7,7,3,0,18,4,22,166
8,8,0,2,18,6,24,166
9,9,0,4,18,10,28,166
10,10,1,0,19,10,29,166
11,11,0,0,19,10,29,166
0,0,1,0,1,0,1,167
1,1,3,0,4,0,4,167
2,2,0,2,4,2,6,167
3,3,1,1,5,3,8,167
4,4,1,1,6,4,10,167
5,5,1,0,7,4,11,167
6,6,1,1,8,5,13,167
7,7,0,0,8,5,13,167
0,0,1,0,1,0,1,168
1,1,1,0,2,0,2,168
2,2,1,0,3,0,3,168
3,3,1,1,4,1,5,168
4,4,1,0,5,1,6,168
5,5,1,0,6,1,7,168
6,6,1,0,7,1,8,168
7,7,1,1,8,2,10,168
8,8,0,1,8,3,11,168
9,9,0,2,8,5,13,168
10,10,1,2,9,7,16,168
11,11,2,0,11,7,18,168
12,12,1,0,12,7,19,168
13,13,1,1,13,8,21,168
14,14,1,1,14,9,23,168
15,15,0,2,14,11,25,168
16,16,0,0,14,11,25,168
0,0,1,0,1,0,1,169
1,1,0,0,1,0,1,169
0,0,1,0,1,0,1,170
1,1,0,0,1,0,1,170
0,0,1,0,1,0,1,171
1,1,1,0,2,0,2,171
2,2,1,0,3,0,3,171
3,3,0,0,3,0,3,171
0,0,1,0,1,0,1,172
1,1,0,0,1,0,1,172
0,0,1,0,1,0,1,173
1,1,0,0,1,0,1,173
0,0,1,0,1,0,1,174
1,1,1,0,2,0,2,174
2,2,0,0,2,0,2,174
0,0,1,0,1,0,1,175
1,1,0,1,1,1,2,175
2,2,0,1,1,2,3,175
3,3,0,0,1,2,3,175
0,0,1,0,1,0,1,176
1,1,1,0,2,0,2,176
2,2,0,0,2,0,2,176
0,0,1,0,1,0,1,177
1,1,0,0,1,0,1,177
0,0,1,0,1,0,1,178
1,1,1,1,2,1,3,178
2,2,1,0,3,1,4,178
3,3,1,1,4,2,6,178
4,4,2,0,6,2,8,178
5,5,0,1,6,3,9,178
6,6,0,1,6,4,10,178
7,7,0,0,6,4,10,178
0,0,1,0,1,0,1,179
1,1,2,0,3,0,3,179
2,2,0,0,3,0,3,179
0,0,1,0,1,0,1,180
1,1,1,0,2,0,2,180
2,2,0,1,2,1,3,180
3,3,0,1,2,2,4,180
4,4,0,0,2,2,4,180
0,0,1,0,1,0,1,181
1,1,1,0,2,0,2,181
2,2,0,0,2,0,2,181
0,0,1,0,1,0,1,182
1,1,0,2,1,2,3,182
2,2,0,2,1,4,5,182
3,3,2,2,3,6,9,182
4,4,2,5,5,11,16,182
5,5,3,6,8,17,25,182
6,6,2,5,10,22,32,182
7,7,2,3,12,25,37,182
8,8,2,5,14,30,44,182
9,9,0,5,14,35,49,182
10,10,1,4,15,39,54,182
11,11,1,3,16,42,58,182
12,12,1,2,17,44,61,182
13,13,0,1,17,45,62,182
14,14,0,2,17,47,64,182
15,15,1,2,18,49,67,182
16,16,2,2,20,51,71,182
17,17,5,1,25,52,77,182
18,18,1,2,26,54,80,182
19,19,2,1,28,55,83,182
20,20,1,2,29,57,86,182
21,21,0,1,29,58,87,182
22,22,1,0,30,58,88,182
23,23,0,0,30,58,88,182
0,0,1,0,1,0,1,183
1,1,1,0,2,0,2,183
2,2,2,0,4,0,4,183
3,3,3,0,7,0,7,183
4,4,0,0,7,0,7,183
0,0,1,0,1,0,1,184
1,1,2,0,3,0,3,184
2,2,0,2,3,2,5,184
3,3,0,1,3,3,6,184
4,4,0,0,3,3,6,184
0,0,1,0,1,0,1,185
1,1,1,0,2,0,2,185
2,2,1,0,3,0,3,185
3,3,0,1,3,1,4,185
4,4,0,2,3,3,6,185
5,5,1,1,4,4,8,185
6,6,1,0,5,4,9,185
7,7,0,0,5,4,9,185
0,0,1,0,1,0,1,186
1,1,0,0,1,0,1,186
0,0,1,0,1,0,1,187
1,1,0,0,1,0,1,187
0,0,1,0,1,0,1,188
1,1,0,1,1,1,2,188
2,2,1,3,2,4,6,188
3,3,0,2,2,6,8,188
4,4,0,0,2,6,8,188
0,0,1,0,1,0,1,189
1,1,1,0,2,0,2,189
2,2,0,0,2,0,2,189
0,0,1,0,1,0,1,190
1,1,0,1,1,1,2,190
2,2,0,1,1,2,3,190
3,3,0,0,1,2,3,190
0,0,1,0,1,0,1,191
1,1,0,0,1,0,1,191
0,0,1,0,1,0,1,192
1,1,1,0,2,0,2,192
2,2,1,0,3,0,3,192
3,3,1,0,4,0,4,192
4,4,0,0,4,0,4,192
0,0,1,0,1,0,1,193
1,1,0,0,1,0,1,193
0,0,1,0,1,0,1,194
1,1,0,0,1,0,1,194
0,0,1,0,1,0,1,195
1,1,3,0,4,0,4,195
2,2,3,1,7,1,8,195
3,3,4,1,11,2,13,195
4,4,3,2,14,4,18,195
5,5,3,1,17,5,22,195
6,6,2,1,19,6,25,195
7,7,1,0,20,6,26,195
8,8,0,0,20,6,26,195
0,0,1,0,1,0,1,196
1,1,1,0,2,0,2,196
2,2,1,0,3,0,3,196
3,3,1,0,4,0,4,196
4,4,0,0,4,0,4,196
0,0,1,0,1,0,1,197
1,1,1,1,2,1,3,197
2,2,1,2,3,3,6,197
3,3,0,4,3,7,10,197
4,4,1,3,4,10,14,197
5,5,3,1,7,11,18,197
6,6,2,1,9,12,21,197
7,7,0,1,9,13,22,197
8,8,0,1,9,14,23,197
9,9,0,0,9,14,23,197
0,0,1,0,1,0,1,198
1,1,2,0,3,0,3,198
2,2,3,0,6,0,6,198
3,3,1,0,7,0,7,198
4,4,3,1,10,1,11,198
5,5,0,2,10,3,13,198
6,6,0,1,10,4,14,198
7,7,1,1,11,5,16,198
8,8,0,1,11,6,17,198
9,9,0,2,11,8,19,198
10,10,0,2,11,10,21,198
11,11,0,1,11,11,22,198
12,12,0,1,11,12,23,198
13,13,0,0,11,12,23,198
0,0,1,0,1,0,1,199
1,1,1,0,2,0,2,199
2,2,0,0,2,0,2,199
0,0,1,0,1,0,1,200
1,1,0,0,1,0,1,200
0,0,1,0,1,0,1,201
1,1,0,0,1,0,1,201
0,0,1,0,1,0,1,202
1,1,1,0,2,0,2,202
2,2,2,1,4,1,5,202
3,3,0,0,4,1,5,202
0,0,1,0,1,0,1,203
1,1,0,0,1,0,1,203
0,0,1,0,1,0,1,204
1,1,1,0,2,0,2,204
2,2,1,0,3,0,3,204
3,3,4,0,7,0,7,204
4,4,2,2,9,2,11,204
5,5,1,1,10,3,13,204
6,6,0,0,10,3,13,204
0,0,1,0,1,0,1,205
1,1,3,0,4,0,4,205
2,2,1,1,5,1,6,205
3,3,3,0,8,1,9,205
4,4,3,2,11,3,14,205
5,5,5,0,16,3,19,205
6,6,3,1,19,4,23,205
7,7,4,0,23,4,27,205
8,8,4,0,27,4,31,205
9,9,6,1,33,5,38,205
10,10,8,5,41,10,51,205
11,11,5,3,46,13,59,205
12,12,6,3,52,16,68,205
13,13,4,3,56,19,75,205
14,14,3,1,59,20,79,205
15,15,5,1,64,21,85,205
16,16,1,0,65,21,86,205
17,17,0,0,65,21,86,205
0,0,1,0,1,0,1,206
1,1,0,0,1,0,1,206
0,0,1,0,1,0,1,207
1,1,0,0,1,0,1,207
0,0,1,0,1,0,1,208
1,1,0,0,1,0,1,208
0,0,1,0,1,0,1,209
1,1,1,0,2,0,2,209
2,2,0,0,2,0,2,209
0,0,1,0,1,0,1,210
1,1,2,1,3,1,4,210
2,2,1,0,4,1,5,210
3,3,1,0,5,1,6,210
4,4,1,0,6,1,7,210
5,5,0,1,6,2,8,210
6,6,0,2,6,4,10,210
7,7,1,0,7,4,11,210
8,8,1,1,8,5,13,210
9,9,1,2,9,7,16,210
10,10,0,4,9,11,20,210
11,11,1,3,10,14,24,210
12,12,1,0,11,14,25,210
13,13,2,1,13,15,28,210
14,14,0,0,13,15,28,210
0,0,1,0,1,0,1,211
1,1,1,0,2,0,2,211
2,2,1,0,3,0,3,211
3,3,3,0,6,0,6,211
4,4,2,0,8,0,8,211
5,5,2,0,10,0,10,211
6,6,3,2,13,2,15,211
7,7,4,1,17,3,20,211
8,8,4,1,21,4,25,211
9,9,3,0,24,4,28,211
10,10,3,1,27,5,32,211
11,11,0,1,27,6,33,211
12,12,0,0,27,6,33,211
0,0,1,0,1,0,1,212
1,1,1,0,2,0,2,212
2,2,0,0,2,0,2,212
0,0,1,0,1,0,1,213
1,1,0,0,1,0,1,213
0,0,1,0,1,0,1,214
1,1,0,1,1,1,2,214
2,2,1,0,2,1,3,214
3,3,0,0,2,1,3,214
0,0,1,0,1,0,1,215
1,1,0,0,1,0,1,215
0,0,1,0,1,0,1,216
1,1,1,0,2,0,2,216
2,2,1,0,3,0,3,216
3,3,1,0,4,0,4,216
4,4,2,1,6,1,7,216
5,5,3,0,9,1,10,216
6,6,3,1,12,2,14,216
7,7,4,2,16,4,20,216
8,8,0,0,16,4,20,216
0,0,1,0,1,0,1,217
1,1,0,0,1,0,1,217
0,0,1,0,1,0,1,218
1,1,1,0,2,0,2,218
2,2,0,0,2,0,2,218
0,0,1,0,1,0,1,219
1,1,0,0,1,0,1,219
0,0,1,0,1,0,1,220
1,1,1,0,2,0,2,220
2,2,2,1,4,1,5,220
3,3,4,2,8,3,11,220
4,4,2,1,10,4,14,220
5,5,0,1,10,5,15,220
6,6,0,1,10,6,16,220
7,7,0,0,10,6,16,220
0,0,1,0,1,0,1,221
1,1,0,0,1,0,1,221
0,0,1,0,1,0,1,222
1,1,1,0,2,0,2,222
2,2,0,1,2,1,3,222
3,3,0,1,2,2,4,222
4,4,0,2,2,4,6,222
5,5,0,2,2,6,8,222
6,6,0,3,2,9,11,222
7,7,1,4,3,13,16,222
8,8,0,1,3,14,17,222
9,9,0,2,3,16,19,222
10,10,0,1,3,17,20,222
11,11,0,1,3,18,21,222
12,12,1,0,4,18,22,222
13,13,0,0,4,18,22,222
0,0,1,0,1,0,1,223
1,1,0,0,1,0,1,223
0,0,1,0,1,0,1,224
1,1,2,0,3,0,3,224
2,2,3,1,6,1,7,224
3,3,4,2,10,3,13,224
4,4,2,1,12,4,16,224
5,5,1,0,13,4,17,224
6,6,0,0,13,4,17,224
0,0,1,0,1,0,1,225
1,1,0,0,1,0,1,225
0,0,1,0,1,0,1,226
1,1,2,1,3,1,4,226
2,2,2,1,5,2,7,226
3,3,1,1,6,3,9,226
4,4,0,2,6,5,11,226
5,5,0,1,6,6,12,226
6,6,0,0,6,6,12,226
0,0,1,0,1,0,1,227
1,1,2,0,3,0,3,227
2,2,1,0,4,0,4,227
3,3,0,0,4,0,4,227
0,0,1,0,1,0,1,228
1,1,1,0,2,0,2,228
2,2,1,0,3,0,3,228
3,3,0,0,3,0,3,228
0,0,1,0,1,0,1,229
1,1,1,2,2,2,4,229
2,2,1,2,3,4,7,229
3,3,1,1,4,5,9,229
4,4,0,1,4,6,10,229
5,5,1,0,5,6,11,229
6,6,0,0,5,6,11,229
0,0,1,0,1,0,1,230
1,1,0,1,1,1,2,230
2,2,0,1,1,2,3,230
3,3,0,1,1,3,4,230
4,4,0,1,1,4,5,230
5,5,0,0,1,4,5,230
0,0,1,0,1,0,1,231
1,1,2,0,3,0,3,231
2,2,1,0,4,0,4,231
3,3,2,0,6,0,6,231
4,4,1,1,7,1,8,231
5,5,0,0,7,1,8,231
0,0,1,0,1,0,1,232
1,1,1,0,2,0,2,232
2,2,0,0,2,0,2,232
0,0,1,0,1,0,1,233
1,1,0,0,1,0,1,233
0,0,1,0,1,0,1,234
1,1,1,0,2,0,2,234
2,2,1,0,3,0,3,234
3,3,0,0,3,0,3,234
0,0,1,0,1,0,1,235
1,1,0,0,1,0,1,235
0,0,1,0,1,0,1,236
1,1,0,1,1,1,2,236
2,2,0,0,1,1,2,236
0,0,1,0,1,0,1,237
1,1,1,0,2,0,2,237
2,2,0,0,2,0,2,237
0,0,1,0,1,0,1,238
1,1,0,0,1,0,1,238
0,0,1,0,1,0,1,239
1,1,0,0,1,0,1,239
0,0,1,0,1,0,1,240
1,1,0,0,1,0,1,240
0,0,1,0,1,0,1,241
1,1,0,0,1,0,1,241
0,0,1,0,1,0,1,242
1,1,2,0,3,0,3,242
2,2,1,2,4,2,6,242
3,3,0,3,4,5,9,242
4,4,1,3,5,8,13,242
5,5,6,4,11,12,23,242
6,6,4,6,15,18,33,242
7,7,5,5,20,23,43,242
8,8,4,5,24,28,52,242
9,9,4,5,28,33,61,242
10,10,2,5,30,38,68,242
11,11,3,2,33,40,73,242
12,12,3,1,36,41,77,242
13,13,1,3,37,44,81,242
14,14,2,3,39,47,86,242
15,15,2,1,41,48,89,242
16,16,1,2,42,50,92,242
17,17,0,1,42,51,93,242
18,18,0,1,42,52,94,242
19,19,0,0,42,52,94,242
0,0,1,0,1,0,1,243
1,1,1,0,2,0,2,243
2,2,1,0,3,0,3,243
3,3,1,0,4,0,4,243
4,4,0,0,4,0,4,243
0,0,1,0,1,0,1,244
1,1,1,0,2,0,2,244
2,2,0,1,2,1,3,244
3,3,0,0,2,1,3,244
0,0,1,0,1,0,1,245
1,1,1,0,2,0,2,245
2,2,0,0,2,0,2,245
0,0,1,0,1,0,1,246
1,1,2,2,3,2,5,246
2,2,1,0,4,2,6,246
3,3,1,0,5,2,7,246
4,4,0,0,5,2,7,246
0,0,1,0,1,0,1,247
1,1,1,0,2,0,2,247
2,2,1,0,3,0,3,247
3,3,1,1,4,1,5,247
4,4,0,1,4,2,6,247
5,5,1,0,5,2,7,247
6,6,1,0,6,2,8,247
7,7,1,0,7,2,9,247
8,8,0,0,7,2,9,247
0,0,1,0,1,0,1,248
1,1,0,0,1,0,1,248
0,0,1,0,1,0,1,249
1,1,0,1,1,1,2,249
2,2,0,1,1,2,3,249
3,3,0,0,1,2,3,249
0,0,1,0,1,0,1,250
1,1,0,1,1,1,2,250
2,2,0,0,1,1,2,250
0,0,1,0,1,0,1,251
1,1,1,0,2,0,2,251
2,2,2,0,4,0,4,251
3,3,0,0,4,0,4,251
0,0,1,0,1,0,1,252
1,1,0,0,1,0,1,252
0,0,1,0,1,0,1,253
1,1,0,0,1,0,1,253
0,0,1,0,1,0,1,254
1,1,2,0,3,0,3,254
2,2,2,2,5,2,7,254
3,3,1,2,6,4,10,254
4,4,0,1,6,5,11,254
5,5,0,0,6,5,11,254
0,0,1,0,1,0,1,255
1,1,1,0,2,0,2,255
2,2,0,0,2,0,2,255
0,0,1,0,1,0,1,256
1,1,2,0,3,0,3,256
2,2,1,1,4,1,5,256
3,3,1,3,5,4,9,256
4,4,3,2,8,6,14,256
5,5,4,3,12,9,21,256
6,6,4,2,16,11,27,256
7,7,1,2,17,13,30,256
8,8,0,3,17,16,33,256
9,9,1,4,18,20,38,256
10,10,0,1,18,21,39,256
11,11,1,0,19,21,40,256
12,12,1,0,20,21,41,256
13,13,0,0,20,21,41,256
0,0,1,0,1,0,1,257
1,1,3,1,4,1,5,257
2,2,3,1,7,2,9,257
3,3,2,1,9,3,12,257
4,4,4,0,13,3,16,257
5,5,3,1,16,4,20,257
6,6,2,1,18,5,23,257
7,7,3,1,21,6,27,257
8,8,2,2,23,8,31,257
9,9,1,1,24,9,33,257
10,10,3,0,27,9,36,257
11,11,2,1,29,10,39,257
12,12,1,1,30,11,41,257
13,13,1,0,31,11,42,257
14,14,1,0,32,11,43,257
15,15,2,0,34,11,45,257
16,16,1,0,35,11,46,257
17,17,2,1,37,12,49,257
18,18,5,1,42,13,55,257
19,19,2,1,44,14,58,257
20,20,2,2,46,16,62,257
21,21,3,5,49,21,70,257
22,22,6,3,55,24,79,257
23,23,5,3,60,27,87,257
24,24,10,2,70,29,99,257
25,25,9,3,79,32,111,257
26,26,4,2,83,34,117,257
27,27,2,5,85,39,124,257
28,28,2,4,87,43,130,257
29,29,1,6,88,49,137,257
30,30,3,5,91,54,145,257
31,31,4,6,95,60,155,257
32,32,3,8,98,68,166,257
33,33,6,6,104,74,178,257
34,34,4,5,108,79,187,257
35,35,1,0,109,79,188,257
36,36,2,0,111,79,190,257
37,37,1,0,112,79,191,257
38,38,0,1,112,80,192,257
39,39,0,0,112,80,192,257
0,0,1,0,1,0,1,258
1,1,1,0,2,0,2,258
2,2,0,0,2,0,2,258
0,0,1,0,1,0,1,259
1,1,0,0,1,0,1,259
0,0,1,0,1,0,1,260
1,1,1,0,2,0,2,260
2,2,0,1,2,1,3,260
3,3,0,1,2,2,4,260
4,4,0,1,2,3,5,260
5,5,1,3,3,6,9,260
6,6,0,7,3,13,16,260
7,7,1,8,4,21,25,260
8,8,0,3,4,24,28,260
9,9,0,3,4,27,31,260
10,10,2,1,6,28,34,260
11,11,2,2,8,30,38,260
12,12,1,2,9,32,41,260
13,13,1,4,10,36,46,260
14,14,3,0,13,36,49,260
15,15,1,1,14,37,51,260
16,16,1,0,15,37,52,260
17,17,0,0,15,37,52,260
0,0,1,0,1,0,1,261
1,1,0,0,1,0,1,261
0,0,1,0,1,0,1,262
1,1,1,0,2,0,2,262
2,2,0,0,2,0,2,262
0,0,1,0,1,0,1,263
1,1,0,1,1,1,2,263
2,2,0,2,1,3,4,263
3,3,0,2,1,5,6,263
4,4,1,1,2,6,8,263
5,5,2,2,4,8,12,263
6,6,1,0,5,8,13,263
7,7,1,0,6,8,14,263
8,8,0,0,6,8,14,263
0,0,1,0,1,0,1,264
1,1,1,1,2,1,3,264
2,2,0,1,2,2,4,264
3,3,0,1,2,3,5,264
4,4,1,0,3,3,6,264
5,5,2,0,5,3,8,264
6,6,1,0,6,3,9,264
7,7,1,0,7,3,10,264
8,8,2,0,9,3,12,264
9,9,1,0,10,3,13,264
10,10,0,0,10,3,13,264
0,0,1,0,1,0,1,265
1,1,0,1,1,1,2,265
2,2,0,0,1,1,2,265
0,0,1,0,1,0,1,266
1,1,1,0,2,0,2,266
2,2,0,0,2,0,2,266
0,0,1,0,1,0,1,267
1,1,2,0,3,0,3,267
2,2,2,0,5,0,5,267
3,3,1,0,6,0,6,267
4,4,0,0,6,0,6,267
0,0,1,0,1,0,1,268
1,1,1,0,2,0,2,268
2,2,1,0,3,0,3,268
3,3,1,0,4,0,4,268
4,4,0,0,4,0,4,268
0,0,1,0,1,0,1,269
1,1,0,0,1,0,1,269
0,0,1,0,1,0,1,270
1,1,0,0,1,0,1,270
0,0,1,0,1,0,1,271
1,1,1,0,2,0,2,271
2,2,2,0,4,0,4,271
3,3,1,0,5,0,5,271
4,4,0,0,5,0,5,271
0,0,1,0,1,0,1,272
1,1,1,0,2,0,2,272
2,2,2,0,4,0,4,272
3,3,0,0,4,0,4,272
0,0,1,0,1,0,1,273
1,1,1,0,2,0,2,273
2,2,0,1,2,1,3,273
3,3,0,0,2,1,3,273
0,0,1,0,1,0,1,274
1,1,1,1,2,1,3,274
2,2,1,0,3,1,4,274
3,3,0,0,3,1,4,274
0,0,1,0,1,0,1,275
1,1,1,1,2,1,3,275
2,2,1,2,3,3,6,275
3,3,1,2,4,5,9,275
4,4,2,1,6,6,12,275
5,5,2,2,8,8,16,275
6,6,0,2,8,10,18,275
7,7,0,4,8,14,22,275
8,8,0,2,8,16,24,275
9,9,0,0,8,16,24,275
0,0,1,0,1,0,1,276
1,1,1,0,2,0,2,276
2,2,2,0,4,0,4,276
3,3,2,0,6,0,6,276
4,4,1,0,7,0,7,276
5,5,1,0,8,0,8,276
6,6,0,0,8,0,8,276
0,0,1,0,1,0,1,277
1,1,0,0,1,0,1,277
0,0,1,0,1,0,1,278
1,1,0,0,1,0,1,278
0,0,1,0,1,0,1,279
1,1,1,1,2,1,3,279
2,2,1,2,3,3,6,279
3,3,1,0,4,3,7,279
4,4,2,0,6,3,9,279
5,5,0,0,6,3,9,279
0,0,1,0,1,0,1,280
1,1,1,0,2,0,2,280
2,2,1,1,3,1,4,280
3,3,1,0,4,1,5,280
4,4,0,0,4,1,5,280
0,0,1,0,1,0,1,281
1,1,0,0,1,0,1,281
0,0,1,0,1,0,1,282
1,1,0,0,1,0,1,282
0,0,1,0,1,0,1,283
1,1,0,0,1,0,1,283
0,0,1,0,1,0,1,284
1,1,1,0,2,0,2,284
2,2,0,0,2,0,2,284
0,0,1,0,1,0,1,285
1,1,2,0,3,0,3,285
2,2,0,0,3,0,3,285
0,0,1,0,1,0,1,286
1,1,1,0,2,0,2,286
2,2,1,0,3,0,3,286
3,3,2,0,5,0,5,286
4,4,0,0,5,0,5,286
0,0,1,0,1,0,1,287
1,1,0,0,1,0,1,287
0,0,1,0,1,0,1,288
1,1,0,0,1,0,1,288
0,0,1,0,1,0,1,289
1,1,1,0,2,0,2,289
2,2,0,0,2,0,2,289
0,0,1,0,1,0,1,290
1,1,0,0,1,0,1,290
0,0,1,0,1,0,1,291
1,1,1,0,2,0,2,291
2,2,1,0,3,0,3,291
3,3,0,1,3,1,4,291
4,4,1,0,4,1,5,291
5,5,2,0,6,1,7,291
6,6,1,0,7,1,8,291
7,7,0,0,7,1,8,291
0,0,1,0,1,0,1,292
1,1,0,0,1,0,1,292
0,0,1,0,1,0,1,293
1,1,0,0,1,0,1,293
0,0,1,0,1,0,1,294
1,1,0,0,1,0,1,294
0,0,1,0,1,0,1,295
1,1,0,0,1,0,1,295
0,0,1,0,1,0,1,296
1,1,2,0,3,0,3,296
2,2,2,0,5,0,5,296
3,3,2,0,7,0,7,296
4,4,1,0,8,0,8,296
5,5,1,0,9,0,9,296
6,6,0,0,9,0,9,296
0,0,1,0,1,0,1,297
1,1,0,0,1,0,1,297
0,0,1,0,1,0,1,298
1,1,0,0,1,0,1,298
0,0,1,0,1,0,1,299
1,1,1,0,2,0,2,299
2,2,0,0,2,0,2,299
0,0,1,0,1,0,1,300
1,1,1,1,2,1,3,300
2,2,0,0,2,1,3,300
0,0,1,0,1,0,1,301
1,1,0,0,1,0,1,301
0,0,1,0,1,0,1,302
1,1,1,1,2,1,3,302
2,2,2,0,4,1,5,302
3,3,0,0,4,1,5,302
0,0,1,0,1,0,1,303
1,1,3,0,4,0,4,303
2,2,3,1,7,1,8,303
3,3,3,0,10,1,11,303
4,4,2,0,12,1,13,303
5,5,1,0,13,1,14,303
6,6,0,1,13,2,15,303
7,7,0,1,13,3,16,303
8,8,0,0,13,3,16,303
0,0,1,0,1,0,1,304
1,1,1,0,2,0,2,304
2,2,0,0,2,0,2,304
0,0,1,0,1,0,1,305
1,1,0,0,1,0,1,305
0,0,1,0,1,0,1,306
1,1,0,0,1,0,1,306
0,0,1,0,1,0,1,307
1,1,1,0,2,0,2,307
2,2,1,0,3,0,3,307
3,3,0,0,3,0,3,307
0,0,1,0,1,0,1,308
1,1,0,1,1,1,2,308
2,2,0,0,1,1,2,308
0,0,1,0,1,0,1,309
1,1,0,0,1,0,1,309
0,0,1,0,1,0,1,310
1,1,0,0,1,0,1,310
0,0,1,0,1,0,1,311
1,1,1,0,2,0,2,311
2,2,0,0,2,0,2,311
0,0,1,0,1,0,1,312
1,1,1,0,2,0,2,312
2,2,2,0,4,0,4,312
3,3,0,1,4,1,5,312
4,4,0,0,4,1,5,312
0,0,1,0,1,0,1,313
1,1,0,0,1,0,1,313
0,0,1,0,1,0,1,314
1,1,0,0,1,0,1,314
0,0,1,0,1,0,1,315
1,1,0,0,1,0,1,315
0,0,1,0,1,0,1,316
1,1,2,0,3,0,3,316
2,2,2,0,5,0,5,316
3,3,3,0,8,0,8,316
4,4,0,0,8,0,8,316
0,0,1,0,1,0,1,317
1,1,0,0,1,0,1,317
0,0,1,0,1,0,1,318
1,1,2,1,3,1,4,318
2,2,4,1,7,2,9,318
3,3,3,2,10,4,14,318
4,4,2,0,12,4,16,318
5,5,1,0,13,4,17,318
6,6,3,0,16,4,20,318
7,7,2,1,18,5,23,318
8,8,1,1,19,6,25,318
9,9,1,0,20,6,26,318
10,10,0,0,20,6,26,318
0,0,1,0,1,0,1,319
1,1,0,0,1,0,1,319
0,0,1,0,1,0,1,320
1,1,0,1,1,1,2,320
2,2,0,1,1,2,3,320
3,3,0,1,1,3,4,320
4,4,0,0,1,3,4,320
0,0,1,0,1,0,1,321
1,1,1,0,2,0,2,321
2,2,1,0,3,0,3,321
3,3,0,0,3,0,3,321
0,0,1,0,1,0,1,322
1,1,0,0,1,0,1,322
0,0,1,0,1,0,1,323
1,1,3,0,4,0,4,323
2,2,3,1,7,1,8,323
3,3,3,0,10,1,11,323
4,4,0,0,10,1,11,323
0,0,1,0,1,0,1,324
1,1,0,0,1,0,1,324
0,0,1,0,1,0,1,325
1,1,0,0,1,0,1,325
0,0,1,0,1,0,1,326
1,1,1,0,2,0,2,326
2,2,0,1,2,1,3,326
3,3,0,2,2,3,5,326
4,4,1,2,3,5,8,326
5,5,3,2,6,7,13,326
6,6,0,1,6,8,14,326
7,7,0,1,6,9,15,326
8,8,0,1,6,10,16,326
9,9,0,0,6,10,16,326
0,0,1,0,1,0,1,327
1,1,0,0,1,0,1,327
0,0,1,0,1,0,1,328
1,1,1,0,2,0,2,328
2,2,1,0,3,0,3,328
3,3,0,0,3,0,3,328
0,0,1,0,1,0,1,329
1,1,1,0,2,0,2,329
2,2,0,0,2,0,2,329
0,0,1,0,1,0,1,330
1,1,0,0,1,0,1,330
0,0,1,0,1,0,1,331
1,1,1,0,2,0,2,331
2,2,0,0,2,0,2,331
0,0,1,0,1,0,1,332
1,1,2,0,3,0,3,332
2,2,0,1,3,1,4,332
3,3,0,0,3,1,4,332
0,0,1,0,1,0,1,333
1,1,1,0,2,0,2,333
2,2,0,0,2,0,2,333
0,0,1,0,1,0,1,334
1,1,0,1,1,1,2,334
2,2,0,1,1,2,3,334
3,3,0,0,1,2,3,334
0,0,1,0,1,0,1,335
1,1,1,0,2,0,2,335
2,2,1,1,3,1,4,335
3,3,0,1,3,2,5,335
4,4,0,2,3,4,7,335
5,5,0,2,3,6,9,335
6,6,0,0,3,6,9,335
0,0,1,0,1,0,1,336
1,1,0,0,1,0,1,336
0,0,1,0,1,0,1,337
1,1,1,0,2,0,2,337
2,2,0,0,2,0,2,337
0,0,1,0,1,0,1,338
1,1,0,1,1,1,2,338
2,2,0,0,1,1,2,338
0,0,1,0,1,0,1,339
1,1,1,0,2,0,2,339
2,2,1,0,3,0,3,339
3,3,1,0,4,0,4,339
4,4,1,0,5,0,5,339
5,5,2,0,7,0,7,339
6,6,2,0,9,0,9,339
7,7,1,0,10,0,10,339
8,8,1,0,11,0,11,339
9,9,0,0,11,0,11,339
0,0,1,0,1,0,1,340
1,1,0,0,1,0,1,340
0,0,1,0,1,0,1,341
1,1,0,0,1,0,1,341
0,0,1,0,1,0,1,342
1,1,0,0,1,0,1,342
0,0,1,0,1,0,1,343
1,1,2,0,3,0,3,343
2,2,1,0,4,0,4,343
3,3,0,0,4,0,4,343
0,0,1,0,1,0,1,344
1,1,0,0,1,0,1,344
0,0,1,0,1,0,1,345
1,1,0,0,1,0,1,345
0,0,1,0,1,0,1,346
1,1,2,0,3,0,3,346
2,2,2,0,5,0,5,346
3,3,1,1,6,1,7,346
4,4,1,4,7,5,12,346
5,5,3,1,10,6,16,346
6,6,2,1,12,7,19,346
7,7,0,0,12,7,19,346
0,0,1,0,1,0,1,347
1,1,1,0,2,0,2,347
2,2,0,0,2,0,2,347
0,0,1,0,1,0,1,348
1,1,0,0,1,0,1,348
0,0,1,0,1,0,1,349
1,1,1,0,2,0,2,349
2,2,2,0,4,0,4,349
3,3,1,0,5,0,5,349
4,4,2,0,7,0,7,349
5,5,1,0,8,0,8,349
6,6,1,0,9,0,9,349
7,7,1,0,10,0,10,349
8,8,2,0,12,0,12,349
9,9,2,0,14,0,14,349
10,10,2,0,16,0,16,349
11,11,1,0,17,0,17,349
12,12,1,0,18,0,18,349
13,13,0,0,18,0,18,349
0,0,1,0,1,0,1,350
1,1,1,0,2,0,2,350
2,2,3,0,5,0,5,350
3,3,0,1,5,1,6,350
4,4,0,4,5,5,10,350
5,5,0,1,5,6,11,350
6,6,0,1,5,7,12,350
7,7,0,0,5,7,12,350
0,0,1,0,1,0,1,351
1,1,0,0,1,0,1,351
0,0,1,0,1,0,1,352
1,1,1,0,2,0,2,352
2,2,0,0,2,0,2,352
0,0,1,0,1,0,1,353
1,1,0,0,1,0,1,353
0,0,1,0,1,0,1,354
1,1,1,0,2,0,2,354
2,2,2,0,4,0,4,354
3,3,1,0,5,0,5,354
4,4,0,0,5,0,5,354
0,0,1,0,1,0,1,355
1,1,1,0,2,0,2,355
2,2,1,0,3,0,3,355
3,3,1,0,4,0,4,355
4,4,0,0,4,0,4,355
0,0,1,0,1,0,1,356
1,1,0,0,1,0,1,356
0,0,1,0,1,0,1,357
1,1,0,1,1,1,2,357
2,2,0,1,1,2,3,357
3,3,0,2,1,4,5,357
4,4,0,0,1,4,5,357
0,0,1,0,1,0,1,358
1,1,2,0,3,0,3,358
2,2,3,0,6,0,6,358
3,3,4,0,10,0,10,358
4,4,3,0,13,0,13,358
5,5,4,0,17,0,17,358
6,6,5,0,22,0,22,358
7,7,6,0,28,0,28,358
8,8,7,2,35,2,37,358
9,9,4,2,39,4,43,358
10,10,4,0,43,4,47,358
11,11,4,1,47,5,52,358
12,12,3,2,50,7,57,358
13,13,4,4,54,11,65,358
14,14,6,2,60,13,73,358
15,15,6,2,66,15,81,358
16,16,3,2,69,17,86,358
17,17,2,3,71,20,91,358
18,18,1,1,72,21,93,358
19,19,3,0,75,21,96,358
20,20,0,1,75,22,97,358
21,21,0,1,75,23,98,358
22,22,0,1,75,24,99,358
23,23,0,0,75,24,99,358
0,0,1,0,1,0,1,359
1,1,0,0,1,0,1,359
0,0,1,0,1,0,1,360
1,1,1,0,2,0,2,360
2,2,2,0,4,0,4,360
3,3,0,1,4,1,5,360
4,4,0,0,4,1,5,360
0,0,1,0,1,0,1,361
1,1,0,0,1,0,1,361
0,0,1,0,1,0,1,362
1,1,3,0,4,0,4,362
2,2,0,0,4,0,4,362
0,0,1,0,1,0,1,363
1,1,1,0,2,0,2,363
2,2,1,0,3,0,3,363
3,3,1,0,4,0,4,363
4,4,0,0,4,0,4,363
0,0,1,0,1,0,1,364
1,1,1,0,2,0,2,364
2,2,1,1,3,1,4,364
3,3,0,4,3,5,8,364
4,4,0,1,3,6,9,364
5,5,0,0,3,6,9,364
0,0,1,0,1,0,1,365
1,1,0,0,1,0,1,365
0,0,1,0,1,0,1,366
1,1,2,0,3,0,3,366
2,2,2,1,5,1,6,366
3,3,1,0,6,1,7,366
4,4,0,0,6,1,7,366
0,0,1,0,1,0,1,367
1,1,0,0,1,0,1,367
0,0,1,0,1,0,1,368
1,1,0,0,1,0,1,368
0,0,1,0,1,0,1,369
1,1,4,0,5,0,5,369
2,2,4,0,9,0,9,369
3,3,5,0,14,0,14,369
4,4,5,1,19,1,20,369
5,5,3,3,22,4,26,369
6,6,3,3,25,7,32,369
7,7,6,0,31,7,38,369
8,8,4,0,35,7,42,369
9,9,2,0,37,7,44,369
10,10,5,1,42,8,50,369
11,11,1,2,43,10,53,369
12,12,2,0,45,10,55,369
13,13,2,0,47,10,57,369
14,14,0,0,47,10,57,369
0,0,1,0,1,0,1,370
1,1,0,0,1,0,1,370
0,0,1,0,1,0,1,371
1,1,0,0,1,0,1,371
0,0,1,0,1,0,1,372
1,1,1,1,2,1,3,372
2,2,2,2,4,3,7,372
3,3,2,2,6,5,11,372
4,4,2,2,8,7,15,372
5,5,1,3,9,10,19,372
6,6,0,3,9,13,22,372
7,7,0,0,9,13,22,372
0,0,1,0,1,0,1,373
1,1,1,0,2,0,2,373
2,2,0,0,2,0,2,373
0,0,1,0,1,0,1,374
1,1,3,0,4,0,4,374
2,2,0,0,4,0,4,374
0,0,1,0,1,0,1,375
1,1,0,0,1,0,1,375
0,0,1,0,1,0,1,376
1,1,0,0,1,0,1,376
0,0,1,0,1,0,1,377
1,1,0,0,1,0,1,377
0,0,1,0,1,0,1,378
1,1,0,0,1,0,1,378
0,0,1,0,1,0,1,379
1,1,0,0,1,0,1,379
0,0,1,0,1,0,1,380
1,1,0,0,1,0,1,380
0,0,1,0,1,0,1,381
1,1,0,0,1,0,1,381
0,0,1,0,1,0,1,382
1,1,3,0,4,0,4,382
2,2,0,2,4,2,6,382
3,3,0,1,4,3,7,382
4,4,1,0,5,3,8,382
5,5,0,0,5,3,8,382
0,0,1,0,1,0,1,383
1,1,1,0,2,0,2,383
2,2,1,1,3,1,4,383
3,3,1,1,4,2,6,383
4,4,1,0,5,2,7,383
5,5,0,1,5,3,8,383
6,6,0,0,5,3,8,383
0,0,1,0,1,0,1,384
1,1,0,0,1,0,1,384
0,0,1,0,1,0,1,385
1,1,0,1,1,1,2,385
2,2,0,1,1,2,3,385
3,3,1,0,2,2,4,385
4,4,1,0,3,2,5,385
5,5,1,0,4,2,6,385
6,6,1,0,5,2,7,385
7,7,1,0,6,2,8,385
8,8,0,0,6,2,8,385
0,0,1,0,1,0,1,386
1,1,0,0,1,0,1,386
0,0,1,0,1,0,1,387
1,1,0,1,1,1,2,387
2,2,0,0,1,1,2,387
0,0,1,0,1,0,1,388
1,1,1,1,2,1,3,388
2,2,2,0,4,1,5,388
3,3,0,0,4,1,5,388
0,0,1,0,1,0,1,389
1,1,0,0,1,0,1,389
0,0,1,0,1,0,1,390
1,1,0,0,1,0,1,390
0,0,1,0,1,0,1,391
1,1,1,1,2,1,3,391
2,2,3,2,5,3,8,391
3,3,2,0,7,3,10,391
4,4,0,0,7,3,10,391
0,0,1,0,1,0,1,392
1,1,0,0,1,0,1,392
0,0,1,0,1,0,1,393
1,1,1,0,2,0,2,393
2,2,0,0,2,0,2,393
0,0,1,0,1,0,1,394
1,1,0,0,1,0,1,394
0,0,1,0,1,0,1,395
1,1,1,0,2,0,2,395
2,2,1,0,3,0,3,395
3,3,0,0,3,0,3,395
0,0,1,0,1,0,1,396
1,1,1,0,2,0,2,396
2,2,0,1,2,1,3,396
3,3,2,1,4,2,6,396
4,4,1,1,5,3,8,396
5,5,1,0,6,3,9,396
6,6,0,1,6,4,10,396
7,7,0,1,6,5,11,396
8,8,0,1,6,6,12,396
9,9,0,0,6,6,12,396
0,0,1,0,1,0,1,397
1,1,0,0,1,0,1,397
0,0,1,0,1,0,1,398
1,1,0,1,1,1,2,398
2,2,0,3,1,4,5,398
3,3,0,1,1,5,6,398
4,4,1,1,2,6,8,398
5,5,3,0,5,6,11,398
6,6,2,0,7,6,13,398
7,7,1,0,8,6,14,398
8,8,0,1,8,7,15,398
9,9,0,1,8,8,16,398
10,10,0,3,8,11,19,398
11,11,1,2,9,13,22,398
12,12,1,1,10,14,24,398
13,13,0,1,10,15,25,398
14,14,0,2,10,17,27,398
15,15,1,1,11,18,29,398
16,16,1,0,12,18,30,398
17,17,1,0,13,18,31,398
18,18,1,0,14,18,32,398
19,19,1,0,15,18,33,398
20,20,0,0,15,18,33,398
0,0,1,0,1,0,1,399
1,1,0,0,1,0,1,399
0,0,1,0,1,0,1,400
1,1,0,0,1,0,1,400
0,0,1,0,1,0,1,401
1,1,0,2,1,2,3,401
2,2,1,0,2,2,4,401
3,3,2,0,4,2,6,401
4,4,1,1,5,3,8,401
5,5,1,2,6,5,11,401
6,6,0,2,6,7,13,401
7,7,0,1,6,8,14,401
8,8,1,0,7,8,15,401
9,9,0,0,7,8,15,401
0,0,1,0,1,0,1,402
1,1,0,0,1,0,1,402
0,0,1,0,1,0,1,403
1,1,0,1,1,1,2,403
2,2,0,0,1,1,2,403
0,0,1,0,1,0,1,404
1,1,1,0,2,0,2,404
2,2,0,0,2,0,2,404
0,0,1,0,1,0,1,405
1,1,1,1,2,1,3,405
2,2,0,0,2,1,3,405
0,0,1,0,1,0,1,406
1,1,0,0,1,0,1,406
0,0,1,0,1,0,1,407
1,1,1,0,2,0,2,407
2,2,0,0,2,0,2,407
0,0,1,0,1,0,1,408
1,1,0,1,1,1,2,408
2,2,0,0,1,1,2,408
0,0,1,0,1,0,1,409
1,1,1,0,2,0,2,409
2,2,1,1,3,1,4,409
3,3,0,0,3,1,4,409
0,0,1,0,1,0,1,410
1,1,0,0,1,0,1,410
0,0,1,0,1,0,1,411
1,1,0,0,1,0,1,411
0,0,1,0,1,0,1,412
1,1,0,0,1,0,1,412
0,0,1,0,1,0,1,413
1,1,1,1,2,1,3,413
2,2,0,1,2,2,4,413
3,3,0,1,2,3,5,413
4,4,0,2,2,5,7,413
5,5,0,1,2,6,8,413
6,6,0,1,2,7,9,413
7,7,0,1,2,8,10,413
8,8,0,1,2,9,11,413
9,9,0,1,2,10,12,413
10,10,0,0,2,10,12,413
0,0,1,0,1,0,1,414
1,1,2,0,3,0,3,414
2,2,3,3,6,3,9,414
3,3,3,0,9,3,12,414
4,4,0,0,9,3,12,414
0,0,1,0,1,0,1,415
1,1,0,0,1,0,1,415
0,0,1,0,1,0,1,416
1,1,1,0,2,0,2,416
2,2,0,0,2,0,2,416
0,0,1,0,1,0,1,417
1,1,1,0,2,0,2,417
2,2,0,0,2,0,2,417
0,0,1,0,1,0,1,418
1,1,0,0,1,0,1,418
0,0,1,0,1,0,1,419
1,1,0,0,1,0,1,419
0,0,1,0,1,0,1,420
1,1,0,0,1,0,1,420
0,0,1,0,1,0,1,421
1,1,0,1,1,1,2,421
2,2,1,2,2,3,5,421
3,3,1,1,3,4,7,421
4,4,0,1,3,5,8,421
5,5,0,3,3,8,11,421
6,6,0,2,3,10,13,421
7,7,2,0,5,10,15,421
8,8,1,0,6,10,16,421
9,9,0,0,6,10,16,421
0,0,1,0,1,0,1,422
1,1,0,0,1,0,1,422
0,0,1,0,1,0,1,423
1,1,2,0,3,0,3,423
2,2,2,1,5,1,6,423
3,3,4,0,9,1,10,423
4,4,3,0,12,1,13,423
5,5,2,0,14,1,15,423
6,6,2,0,16,1,17,423
7,7,1,0,17,1,18,423
8,8,0,0,17,1,18,423
0,0,1,0,1,0,1,424
1,1,0,0,1,0,1,424
0,0,1,0,1,0,1,425
1,1,0,0,1,0,1,425
0,0,1,0,1,0,1,426
1,1,0,1,1,1,2,426
2,2,0,1,1,2,3,426
3,3,0,0,1,2,3,426
0,0,1,0,1,0,1,427
1,1,1,0,2,0,2,427
2,2,1,0,3,0,3,427
3,3,2,0,5,0,5,427
4,4,1,0,6,0,6,427
5,5,0,0,6,0,6,427
0,0,1,0,1,0,1,428
1,1,1,0,2,0,2,428
2,2,1,0,3,0,3,428
3,3,0,0,3,0,3,428
0,0,1,0,1,0,1,429
1,1,0,0,1,0,1,429
0,0,1,0,1,0,1,430
1,1,1,0,2,0,2,430
2,2,2,0,4,0,4,430
3,3,0,0,4,0,4,430
0,0,1,0,1,0,1,431
1,1,2,0,3,0,3,431
2,2,1,1,4,1,5,431
3,3,0,1,4,2,6,431
4,4,0,1,4,3,7,431
5,5,0,1,4,4,8,431
6,6,0,0,4,4,8,431
0,0,1,0,1,0,1,432
1,1,0,1,1,1,2,432
2,2,0,0,1,1,2,432
0,0,1,0,1,0,1,433
1,1,1,0,2,0,2,433
2,2,0,0,2,0,2,433
0,0,1,0,1,0,1,434
1,1,1,0,2,0,2,434
2,2,0,0,2,0,2,434
0,0,1,0,1,0,1,435
1,1,0,0,1,0,1,435
0,0,1,0,1,0,1,436
1,1,0,1,1,1,2,436
2,2,0,2,1,3,4,436
3,3,1,1,2,4,6,436
4,4,1,1,3,5,8,436
5,5,0,1,3,6,9,436
6,6,1,0,4,6,10,436
7,7,0,1,4,7,11,436
8,8,0,0,4,7,11,436
0,0,1,0,1,0,1,437
1,1,0,0,1,0,1,437
0,0,1,0,1,0,1,438
1,1,1,0,2,0,2,438
2,2,0,0,2,0,2,438
0,0,1,0,1,0,1,439
1,1,1,0,2,0,2,439
2,2,1,1,3,1,4,439
3,3,0,1,3,2,5,439
4,4,0,2,3,4,7,439
5,5,0,3,3,7,10,439
6,6,2,3,5,10,15,439
7,7,1,4,6,14,20,439
8,8,0,2,6,16,22,439
9,9,1,0,7,16,23,439
10,10,1,0,8,16,24,439
11,11,1,0,9,16,25,439
12,12,1,0,10,16,26,439
13,13,1,0,11,16,27,439
14,14,0,0,11,16,27,439
0,0,1,0,1,0,1,440
1,1,0,0,1,0,1,440
0,0,1,0,1,0,1,441
1,1,1,0,2,0,2,441
2,2,1,0,3,0,3,441
3,3,0,0,3,0,3,441
0,0,1,0,1,0,1,442
1,1,1,1,2,1,3,442
2,2,1,3,3,4,7,442
3,3,1,3,4,7,11,442
4,4,1,4,5,11,16,442
5,5,2,2,7,13,20,442
6,6,3,0,10,13,23,442
7,7,3,1,13,14,27,442
8,8,0,2,13,16,29,442
9,9,0,1,13,17,30,442
10,10,0,0,13,17,30,442
0,0,1,0,1,0,1,443
1,1,2,0,3,0,3,443
2,2,1,0,4,0,4,443
3,3,1,0,5,0,5,443
4,4,2,0,7,0,7,443
5,5,1,0,8,0,8,443
6,6,2,1,10,1,11,443
7,7,0,0,10,1,11,443
0,0,1,0,1,0,1,444
1,1,3,0,4,0,4,444
2,2,1,0,5,0,5,444
3,3,3,0,8,0,8,444
4,4,2,2,10,2,12,444
5,5,2,2,12,4,16,444
6,6,2,1,14,5,19,444
7,7,1,2,15,7,22,444
8,8,2,1,17,8,25,444
9,9,0,1,17,9,26,444
10,10,0,1,17,10,27,444
11,11,0,0,17,10,27,444
0,0,1,0,1,0,1,445
1,1,2,0,3,0,3,445
2,2,2,0,5,0,5,445
3,3,1,0,6,0,6,445
4,4,1,0,7,0,7,445
5,5,1,0,8,0,8,445
6,6,0,0,8,0,8,445
0,0,1,0,1,0,1,446
1,1,0,0,1,0,1,446
0,0,1,0,1,0,1,447
1,1,1,0,2,0,2,447
2,2,0,0,2,0,2,447
0,0,1,0,1,0,1,448
1,1,1,1,2,1,3,448
2,2,2,3,4,4,8,448
3,3,2,1,6,5,11,448
4,4,1,2,7,7,14,448
5,5,0,1,7,8,15,448
6,6,1,0,8,8,16,448
7,7,0,0,8,8,16,448
0,0,1,0,1,0,1,449
1,1,1,0,2,0,2,449
2,2,1,0,3,0,3,449
3,3,2,1,5,1,6,449
4,4,2,1,7,2,9,449
5,5,1,0,8,2,10,449
6,6,1,0,9,2,11,449
7,7,0,0,9,2,11,449
0,0,1,0,1,0,1,450
1,1,0,0,1,0,1,450
0,0,1,0,1,0,1,451
1,1,0,0,1,0,1,451
0,0,1,0,1,0,1,452
1,1,0,0,1,0,1,452
0,0,1,0,1,0,1,453
1,1,3,0,4,0,4,453
2,2,3,1,7,1,8,453
3,3,0,4,7,5,12,453
4,4,0,2,7,7,14,453
5,5,0,2,7,9,16,453
6,6,0,0,7,9,16,453
0,0,1,0,1,0,1,454
1,1,1,0,2,0,2,454
2,2,1,0,3,0,3,454
3,3,1,0,4,0,4,454
4,4,2,0,6,0,6,454
5,5,1,0,7,0,7,454
6,6,1,0,8,0,8,454
7,7,3,0,11,0,11,454
8,8,4,1,15,1,16,454
9,9,2,2,17,3,20,454
10,10,2,0,19,3,22,454
11,11,1,0,20,3,23,454
12,12,0,0,20,3,23,454
0,0,1,0,1,0,1,455
1,1,2,0,3,0,3,455
2,2,1,0,4,0,4,455
3,3,0,0,4,0,4,455
0,0,1,0,1,0,1,456
1,1,0,0,1,0,1,456
0,0,1,0,1,0,1,457
1,1,3,0,4,0,4,457
2,2,1,0,5,0,5,457
3,3,0,0,5,0,5,457
0,0,1,0,1,0,1,458
1,1,2,0,3,0,3,458
2,2,1,0,4,0,4,458
3,3,2,1,6,1,7,458
4,4,1,0,7,1,8,458
5,5,3,0,10,1,11,458
6,6,0,0,10,1,11,458
0,0,1,0,1,0,1,459
1,1,0,1,1,1,2,459
2,2,0,0,1,1,2,459
0,0,1,0,1,0,1,460
1,1,0,0,1,0,1,460
0,0,1,0,1,0,1,461
1,1,0,0,1,0,1,461
0,0,1,0,1,0,1,462
1,1,1,0,2,0,2,462
2,2,0,0,2,0,2,462
0,0,1,0,1,0,1,463
1,1,2,0,3,0,3,463
2,2,2,0,5,0,5,463
3,3,1,0,6,0,6,463
4,4,0,1,6,1,7,463
5,5,0,2,6,3,9,463
6,6,0,1,6,4,10,463
7,7,1,0,7,4,11,463
8,8,1,0,8,4,12,463
9,9,0,1,8,5,13,463
10,10,0,0,8,5,13,463
0,0,1,0,1,0,1,464
1,1,2,0,3,0,3,464
2,2,3,0,6,0,6,464
3,3,2,0,8,0,8,464
4,4,0,0,8,0,8,464
0,0,1,0,1,0,1,465
1,1,0,1,1,1,2,465
2,2,0,3,1,4,5,465
3,3,1,2,2,6,8,465
4,4,0,2,2,8,10,465
5,5,0,3,2,11,13,465
6,6,0,1,2,12,14,465
7,7,0,2,2,14,16,465
8,8,0,1,2,15,17,465
9,9,1,0,3,15,18,465
10,10,1,0,4,15,19,465
11,11,2,0,6,15,21,465
12,12,0,0,6,15,21,465
0,0,1,0,1,0,1,466
1,1,1,0,2,0,2,466
2,2,0,0,2,0,2,466
0,0,1,0,1,0,1,467
1,1,1,0,2,0,2,467
2,2,0,0,2,0,2,467
0,0,1,0,1,0,1,468
1,1,1,0,2,0,2,468
2,2,2,1,4,1,5,468
3,3,1,1,5,2,7,468
4,4,2,0,7,2,9,468
5,5,1,1,8,3,11,468
6,6,0,1,8,4,12,468
7,7,1,2,9,6,15,468
8,8,2,2,11,8,19,468
9,9,1,3,12,11,23,468
10,10,1,2,13,13,26,468
11,11,2,1,15,14,29,468
12,12,0,1,15,15,30,468
13,13,0,0,15,15,30,468
0,0,1,0,1,0,1,469
1,1,1,0,2,0,2,469
2,2,2,0,4,0,4,469
3,3,0,0,4,0,4,469
0,0,1,0,1,0,1,470
1,1,0,0,1,0,1,470
0,0,1,0,1,0,1,471
1,1,0,0,1,0,1,471
0,0,1,0,1,0,1,472
1,1,1,0,2,0,2,472
2,2,0,0,2,0,2,472
0,0,1,0,1,0,1,473
1,1,0,0,1,0,1,473
0,0,1,0,1,0,1,474
1,1,1,1,2,1,3,474
2,2,1,0,3,1,4,474
3,3,1,0,4,1,5,474
4,4,0,0,4,1,5,474
0,0,1,0,1,0,1,475
1,1,0,0,1,0,1,475
0,0,1,0,1,0,1,476
1,1,2,1,3,1,4,476
2,2,3,2,6,3,9,476
3,3,3,2,9,5,14,476
4,4,1,4,10,9,19,476
5,5,1,2,11,11,22,476
6,6,1,3,12,14,26,476
7,7,1,3,13,17,30,476
8,8,0,1,13,18,31,476
9,9,1,2,14,20,34,476
10,10,1,2,15,22,37,476
11,11,3,2,18,24,42,476
12,12,4,0,22,24,46,476
13,13,1,0,23,24,47,476
14,14,2,1,25,25,50,476
15,15,1,1,26,26,52,476
16,16,0,0,26,26,52,476
0,0,1,0,1,0,1,477
1,1,2,1,3,1,4,477
2,2,1,0,4,1,5,477
3,3,2,0,6,1,7,477
4,4,4,1,10,2,12,477
5,5,6,2,16,4,20,477
6,6,7,2,23,6,29,477
7,7,0,2,23,8,31,477
8,8,1,1,24,9,33,477
9,9,3,2,27,11,38,477
10,10,5,0,32,11,43,477
11,11,4,0,36,11,47,477
12,12,4,2,40,13,53,477
13,13,6,2,46,15,61,477
14,14,3,2,49,17,66,477
15,15,1,0,50,17,67,477
16,16,1,0,51,17,68,477
17,17,2,0,53,17,70,477
18,18,1,0,54,17,71,477
19,19,0,2,54,19,73,477
20,20,1,2,55,21,76,477
21,21,3,1,58,22,80,477
22,22,2,1,60,23,83,477
23,23,0,0,60,23,83,477
0,0,1,0,1,0,1,478
1,1,1,0,2,0,2,478
2,2,1,1,3,1,4,478
3,3,1,0,4,1,5,478
4,4,1,0,5,1,6,478
5,5,1,0,6,1,7,478
6,6,2,0,8,1,9,478
7,7,1,0,9,1,10,478
8,8,0,0,9,1,10,478
0,0,1,0,1,0,1,479
1,1,3,1,4,1,5,479
2,2,1,2,5,3,8,479
3,3,0,1,5,4,9,479
4,4,1,1,6,5,11,479
5,5,0,0,6,5,11,479
0,0,1,0,1,0,1,480
1,1,1,0,2,0,2,480
2,2,0,0,2,0,2,480
0,0,1,0,1,0,1,481
1,1,0,0,1,0,1,481
0,0,1,0,1,0,1,482
1,1,0,1,1,1,2,482
2,2,0,1,1,2,3,482
3,3,0,0,1,2,3,482
0,0,1,0,1,0,1,483
1,1,0,0,1,0,1,483
0,0,1,0,1,0,1,484
1,1,0,1,1,1,2,484
2,2,0,0,1,1,2,484
0,0,1,0,1,0,1,485
1,1,0,0,1,0,1,485
0,0,1,0,1,0,1,486
1,1,0,0,1,0,1,486
0,0,1,0,1,0,1,487
1,1,1,1,2,1,3,487
2,2,0,2,2,3,5,487
3,3,1,1,3,4,7,487
4,4,2,0,5,4,9,487
5,5,1,0,6,4,10,487
6,6,0,0,6,4,10,487
0,0,1,0,1,0,1,488
1,1,0,0,1,0,1,488
0,0,1,0,1,0,1,489
1,1,0,1,1,1,2,489
2,2,0,2,1,3,4,489
3,3,1,2,2,5,7,489
4,4,0,1,2,6,8,489
5,5,1,1,3,7,10,489
6,6,0,2,3,9,12,489
7,7,1,3,4,12,16,489
8,8,2,3,6,15,21,489
9,9,2,4,8,19,27,489
10,10,3,1,11,20,31,489
11,11,2,2,13,22,35,489
12,12,2,0,15,22,37,489
13,13,2,1,17,23,40,489
14,14,1,1,18,24,42,489
15,15,0,1,18,25,43,489
16,16,0,1,18,26,44,489
17,17,0,1,18,27,45,489
18,18,0,1,18,28,46,489
19,19,1,4,19,32,51,489
20,20,1,6,20,38,58,489
21,21,1,5,21,43,64,489
22,22,2,1,23,44,67,489
23,23,1,1,24,45,69,489
24,24,0,1,24,46,70,489
25,25,0,1,24,47,71,489
26,26,0,0,24,47,71,489
0,0,1,0,1,0,1,490
1,1,0,0,1,0,1,490
0,0,1,0,1,0,1,491
1,1,1,0,2,0,2,491
2,2,0,0,2,0,2,491
0,0,1,0,1,0,1,492
1,1,1,0,2,0,2,492
2,2,0,0,2,0,2,492
0,0,1,0,1,0,1,493
1,1,0,0,1,0,1,493
0,0,1,0,1,0,1,494
1,1,2,0,3,0,3,494
2,2,2,0,5,0,5,494
3,3,2,2,7,2,9,494
4,4,4,1,11,3,14,494
5,5,2,2,13,5,18,494
6,6,2,3,15,8,23,494
7,7,3,4,18,12,30,494
8,8,5,5,23,17,40,494
9,9,4,3,27,20,47,494
10,10,5,3,32,23,55,494
11,11,3,3,35,26,61,494
12,12,5,2,40,28,68,494
13,13,4,4,44,32,76,494
14,14,4,5,48,37,85,494
15,15,2,3,50,40,90,494
16,16,2,2,52,42,94,494
17,17,5,2,57,44,101,494
18,18,0,5,57,49,106,494
19,19,0,4,57,53,110,494
20,20,0,2,57,55,112,494
21,21,0,2,57,57,114,494
22,22,0,2,57,59,116,494
23,23,0,1,57,60,117,494
24,24,0,1,57,61,118,494
25,25,0,1,57,62,119,494
26,26,0,1,57,63,120,494
27,27,0,3,57,66,123,494
28,28,0,4,57,70,127,494
29,29,0,2,57,72,129,494
30,30,0,1,57,73,130,494
31,31,0,2,57,75,132,494
32,32,0,3,57,78,135,494
33,33,1,2,58,80,138,494
34,34,3,2,61,82,143,494
35,35,1,2,62,84,146,494
36,36,1,0,63,84,147,494
37,37,1,0,64,84,148,494
38,38,0,1,64,85,149,494
39,39,0,0,64,85,149,494
0,0,1,0,1,0,1,495
1,1,1,0,2,0,2,495
2,2,0,1,2,1,3,495
3,3,0,2,2,3,5,495
4,4,0,0,2,3,5,495
0,0,1,0,1,0,1,496
1,1,3,0,4,0,4,496
2,2,2,0,6,0,6,496
3,3,3,0,9,0,9,496
4,4,5,0,14,0,14,496
5,5,1,1,15,1,16,496
6,6,2,1,17,2,19,496
7,7,2,0,19,2,21,496
8,8,1,0,20,2,22,496
9,9,2,0,22,2,24,496
10,10,1,0,23,2,25,496
11,11,0,0,23,2,25,496
0,0,1,0,1,0,1,497
1,1,1,0,2,0,2,497
2,2,0,0,2,0,2,497
0,0,1,0,1,0,1,498
1,1,2,0,3,0,3,498
2,2,1,0,4,0,4,498
3,3,0,1,4,1,5,498
4,4,0,0,4,1,5,498
0,0,1,0,1,0,1,499
1,1,0,1,1,1,2,499
2,2,0,1,1,2,3,499
3,3,0,1,1,3,4,499
4,4,0,2,1,5,6,499
5,5,0,2,1,7,8,499
6,6,0,0,1,7,8,499
0,0,1,0,1,0,1,500
1,1,1,0,2,0,2,500
2,2,1,1,3,1,4,500
3,3,1,1,4,2,6,500
4,4,0,0,4,2,6,500
0,0,1,0,1,0,1,501
1,1,1,0,2,0,2,501
2,2,1,0,3,0,3,501
3,3,0,1,3,1,4,501
4,4,1,1,4,2,6,501
5,5,1,1,5,3,8,501
6,6,1,0,6,3,9,501
7,7,1,0,7,3,10,501
8,8,2,0,9,3,12,501
9,9,1,1,10,4,14,501
10,10,0,1,10,5,15,501
11,11,1,2,11,7,18,501
12,12,1,3,12,10,22,501
13,13,0,1,12,11,23,501
14,14,0,1,12,12,24,501
15,15,0,0,12,12,24,501
0,0,1,0,1,0,1,502
1,1,1,0,2,0,2,502
2,2,2,0,4,0,4,502
3,3,1,0,5,0,5,502
4,4,1,0,6,0,6,502
5,5,0,0,6,0,6,502
0,0,1,0,1,0,1,503
1,1,3,0,4,0,4,503
2,2,3,0,7,0,7,503
3,3,4,0,11,0,11,503
4,4,3,0,14,0,14,503
5,5,3,1,17,1,18,503
6,6,3,0,20,1,21,503
7,7,0,0,20,1,21,503
0,0,1,0,1,0,1,504
1,1,0,1,1,1,2,504
2,2,0,1,1,2,3,504
3,3,0,0,1,2,3,504
0,0,1,0,1,0,1,505
1,1,1,0,2,0,2,505
2,2,1,0,3,0,3,505
3,3,1,0,4,0,4,505
4,4,1,1,5,1,6,505
5,5,0,3,5,4,9,505
6,6,2,4,7,8,15,505
7,7,4,2,11,10,21,505
8,8,1,4,12,14,26,505
9,9,0,2,12,16,28,505
10,10,1,0,13,16,29,505
11,11,0,0,13,16,29,505
0,0,1,0,1,0,1,506
1,1,0,0,1,0,1,506
0,0,1,0,1,0,1,507
1,1,0,0,1,0,1,507
0,0,1,0,1,0,1,508
1,1,0,0,1,0,1,508
0,0,1,0,1,0,1,509
1,1,0,0,1,0,1,509
0,0,1,0,1,0,1,510
1,1,2,0,3,0,3,510
2,2,0,0,3,0,3,510
0,0,1,0,1,0,1,511
1,1,0,0,1,0,1,511
0,0,1,0,1,0,1,512
1,1,1,0,2,0,2,512
2,2,2,0,4,0,4,512
3,3,2,1,6,1,7,512
4,4,2,0,8,1,9,512
5,5,1,0,9,1,10,512
6,6,0,1,9,2,11,512
7,7,0,0,9,2,11,512
0,0,1,0,1,0,1,513
1,1,1,0,2,0,2,513
2,2,1,1,3,1,4,513
3,3,0,3,3,4,7,513
4,4,1,1,4,5,9,513
5,5,1,0,5,5,10,513
6,6,0,0,5,5,10,513
0,0,1,0,1,0,1,514
1,1,0,0,1,0,1,514
0,0,1,0,1,0,1,515
1,1,0,0,1,0,1,515
0,0,1,0,1,0,1,516
1,1,0,1,1,1,2,516
2,2,0,2,1,3,4,516
3,3,0,2,1,5,6,516
4,4,0,1,1,6,7,516
5,5,0,0,1,6,7,516
0,0,1,0,1,0,1,517
1,1,2,0,3,0,3,517
2,2,2,0,5,0,5,517
3,3,6,0,11,0,11,517
4,4,1,1,12,1,13,517
5,5,0,3,12,4,16,517
6,6,0,3,12,7,19,517
7,7,0,2,12,9,21,517
8,8,0,1,12,10,22,517
9,9,0,0,12,10,22,517
0,0,1,0,1,0,1,518
1,1,0,0,1,0,1,518
0,0,1,0,1,0,1,519
1,1,0,0,1,0,1,519
0,0,1,0,1,0,1,520
1,1,1,0,2,0,2,520
2,2,0,0,2,0,2,520
0,0,1,0,1,0,1,521
1,1,1,0,2,0,2,521
2,2,0,0,2,0,2,521
0,0,1,0,1,0,1,522
1,1,0,0,1,0,1,522
0,0,1,0,1,0,1,523
1,1,0,0,1,0,1,523
0,0,1,0,1,0,1,524
1,1,1,0,2,0,2,524
2,2,1,0,3,0,3,524
3,3,0,0,3,0,3,524
0,0,1,0,1,0,1,525
1,1,0,0,1,0,1,525
0,0,1,0,1,0,1,526
1,1,1,0,2,0,2,526
2,2,0,1,2,1,3,526
3,3,1,0,3,1,4,526
4,4,0,0,3,1,4,526
0,0,1,0,1,0,1,527
1,1,0,0,1,0,1,527
0,0,1,0,1,0,1,528
1,1,1,0,2,0,2,528
2,2,0,1,2,1,3,528
3,3,1,1,3,2,5,528
4,4,1,0,4,2,6,528
5,5,0,0,4,2,6,528
0,0,1,0,1,0,1,529
1,1,0,1,1,1,2,529
2,2,0,1,1,2,3,529
3,3,0,0,1,2,3,529
0,0,1,0,1,0,1,530
1,1,1,0,2,0,2,530
2,2,1,0,3,0,3,530
3,3,2,0,5,0,5,530
4,4,0,1,5,1,6,530
5,5,0,0,5,1,6,530
0,0,1,0,1,0,1,531
1,1,0,0,1,0,1,531
0,0,1,0,1,0,1,532
1,1,1,0,2,0,2,532
2,2,0,0,2,0,2,532
0,0,1,0,1,0,1,533
1,1,2,0,3,0,3,533
2,2,1,0,4,0,4,533
3,3,1,0,5,0,5,533
4,4,0,0,5,0,5,533
0,0,1,0,1,0,1,534
1,1,1,0,2,0,2,534
2,2,0,0,2,0,2,534
0,0,1,0,1,0,1,535
1,1,1,1,2,1,3,535
2,2,1,2,3,3,6,535
3,3,0,2,3,5,8,535
4,4,0,2,3,7,10,535
5,5,0,3,3,10,13,535
6,6,0,0,3,10,13,535
0,0,1,0,1,0,1,536
1,1,1,0,2,0,2,536
2,2,2,0,4,0,4,536
3,3,1,0,5,0,5,536
4,4,2,0,7,0,7,536
5,5,0,1,7,1,8,536
6,6,0,0,7,1,8,536
0,0,1,0,1,0,1,537
1,1,0,0,1,0,1,537
0,0,1,0,1,0,1,538
1,1,1,0,2,0,2,538
2,2,0,0,2,0,2,538
0,0,1,0,1,0,1,539
1,1,0,0,1,0,1,539
0,0,1,0,1,0,1,540
1,1,0,1,1,1,2,540
2,2,0,0,1,1,2,540
0,0,1,0,1,0,1,541
1,1,0,0,1,0,1,541
0,0,1,0,1,0,1,542
1,1,3,1,4,1,5,542
2,2,1,2,5,3,8,542
3,3,0,1,5,4,9,542
4,4,0,0,5,4,9,542
0,0,1,0,1,0,1,543
1,1,3,0,4,0,4,543
2,2,2,1,6,1,7,543
3,3,0,2,6,3,9,543
4,4,0,2,6,5,11,543
5,5,0,4,6,9,15,543
6,6,1,2,7,11,18,543
7,7,2,1,9,12,21,543
8,8,2,1,11,13,24,543
9,9,1,1,12,14,26,543
10,10,2,1,14,15,29,543
11,11,1,0,15,15,30,543
12,12,2,0,17,15,32,543
13,13,0,3,17,18,35,543
14,14,0,2,17,20,37,543
15,15,0,0,17,20,37,543
0,0,1,0,1,0,1,544
1,1,0,1,1,1,2,544
2,2,0,0,1,1,2,544
0,0,1,0,1,0,1,545
1,1,0,1,1,1,2,545
2,2,0,1,1,2,3,545
3,3,1,0,2,2,4,545
4,4,1,0,3,2,5,545
5,5,2,0,5,2,7,545
6,6,2,0,7,2,9,545
7,7,0,2,7,4,11,545
8,8,0,4,7,8,15,545
9,9,1,1,8,9,17,545
10,10,0,0,8,9,17,545
0,0,1,0,1,0,1,546
1,1,0,0,1,0,1,546
0,0,1,0,1,0,1,547
1,1,2,0,3,0,3,547
2,2,1,1,4,1,5,547
3,3,0,1,4,2,6,547
4,4,0,2,4,4,8,547
5,5,2,0,6,4,10,547
6,6,0,2,6,6,12,547
7,7,2,0,8,6,14,547
8,8,3,0,11,6,17,547
9,9,1,0,12,6,18,547
10,10,0,0,12,6,18,547
0,0,1,0,1,0,1,548
1,1,0,0,1,0,1,548
0,0,1,0,1,0,1,549
1,1,0,0,1,0,1,549
0,0,1,0,1,0,1,550
1,1,1,0,2,0,2,550
2,2,1,0,3,0,3,550
3,3,0,0,3,0,3,550
0,0,1,0,1,0,1,551
1,1,2,0,3,0,3,551
2,2,1,1,4,1,5,551
3,3,0,2,4,3,7,551
4,4,0,1,4,4,8,551
5,5,0,1,4,5,9,551
6,6,0,1,4,6,10,551
7,7,0,3,4,9,13,551
8,8,1,1,5,10,15,551
9,9,1,1,6,11,17,551
10,10,1,2,7,13,20,551
11,11,1,0,8,13,21,551
12,12,1,0,9,13,22,551
13,13,2,0,11,13,24,551
14,14,1,1,12,14,26,551
15,15,0,0,12,14,26,551
0,0,1,0,1,0,1,552
1,1,2,0,3,0,3,552
2,2,1,1,4,1,5,552
3,3,1,0,5,1,6,552
4,4,3,0,8,1,9,552
5,5,3,0,11,1,12,552
6,6,2,0,13,1,14,552
7,7,1,0,14,1,15,552
8,8,3,0,17,1,18,552
9,9,2,0,19,1,20,552
10,10,3,0,22,1,23,552
11,11,2,0,24,1,25,552
12,12,3,0,27,1,28,552
13,13,3,0,30,1,31,552
14,14,1,0,31,1,32,552
15,15,1,1,32,2,34,552
16,16,0,1,32,3,35,552
17,17,0,1,32,4,36,552
18,18,0,1,32,5,37,552
19,19,0,0,32,5,37,552
0,0,1,0,1,0,1,553
1,1,1,0,2,0,2,553
2,2,1,1,3,1,4,553
3,3,0,0,3,1,4,553
0,0,1,0,1,0,1,554
1,1,0,0,1,0,1,554
0,0,1,0,1,0,1,555
1,1,1,0,2,0,2,555
2,2,1,0,3,0,3,555
3,3,2,0,5,0,5,555
4,4,1,0,6,0,6,555
5,5,0,0,6,0,6,555
0,0,1,0,1,0,1,556
1,1,1,0,2,0,2,556
2,2,0,0,2,0,2,556
0,0,1,0,1,0,1,557
1,1,2,0,3,0,3,557
2,2,1,1,4,1,5,557
3,3,1,2,5,3,8,557
4,4,3,2,8,5,13,557
5,5,4,2,12,7,19,557
6,6,2,1,14,8,22,557
7,7,2,0,16,8,24,557
8,8,2,0,18,8,26,557
9,9,2,0,20,8,28,557
10,10,1,0,21,8,29,557
11,11,0,0,21,8,29,557
0,0,1,0,1,0,1,558
1,1,0,0,1,0,1,558
0,0,1,0,1,0,1,559
1,1,0,0,1,0,1,559
0,0,1,0,1,0,1,560
1,1,1,0,2,0,2,560
2,2,1,0,3,0,3,560
3,3,0,0,3,0,3,560
0,0,1,0,1,0,1,561
1,1,0,0,1,0,1,561
0,0,1,0,1,0,1,562
1,1,1,0,2,0,2,562
2,2,0,0,2,0,2,562
0,0,1,0,1,0,1,563
1,1,2,0,3,0,3,563
2,2,1,0,4,0,4,563
3,3,2,0,6,0,6,563
4,4,6,0,12,0,12,563
5,5,3,1,15,1,16,563
6,6,2,2,17,3,20,563
7,7,3,1,20,4,24,563
8,8,4,2,24,6,30,563
9,9,1,4,25,10,35,563
10,10,3,2,28,12,40,563
11,11,1,4,29,16,45,563
12,12,4,4,33,20,53,563
13,13,2,2,35,22,57,563
14,14,1,2,36,24,60,563
15,15,2,0,38,24,62,563
16,16,0,0,38,24,62,563
0,0,1,0,1,0,1,564
1,1,0,1,1,1,2,564
2,2,0,1,1,2,3,564
3,3,1,1,2,3,5,564
4,4,1,2,3,5,8,564
5,5,0,2,3,7,10,564
6,6,0,1,3,8,11,564
7,7,1,0,4,8,12,564
8,8,0,0,4,8,12,564
0,0,1,0,1,0,1,565
1,1,0,0,1,0,1,565
0,0,1,0,1,0,1,566
1,1,0,0,1,0,1,566
0,0,1,0,1,0,1,567
1,1,1,0,2,0,2,567
2,2,0,0,2,0,2,567
0,0,1,0,1,0,1,568
1,1,0,1,1,1,2,568
2,2,0,1,1,2,3,568
3,3,0,2,1,4,5,568
4,4,0,0,1,4,5,568
0,0,1,0,1,0,1,569
1,1,1,0,2,0,2,569
2,2,1,1,3,1,4,569
3,3,0,0,3,1,4,569
0,0,1,0,1,0,1,570
1,1,0,1,1,1,2,570
2,2,0,2,1,3,4,570
3,3,1,1,2,4,6,570
4,4,1,0,3,4,7,570
5,5,1,0,4,4,8,570
6,6,2,0,6,4,10,570
7,7,4,0,10,4,14,570
8,8,3,0,13,4,17,570
9,9,2,0,15,4,19,570
10,10,0,1,15,5,20,570
11,11,0,1,15,6,21,570
12,12,0,1,15,7,22,570
13,13,1,0,16,7,23,570
14,14,0,0,16,7,23,570
0,0,1,0,1,0,1,571
1,1,1,2,2,2,4,571
2,2,0,2,2,4,6,571
3,3,0,1,2,5,7,571
4,4,0,1,2,6,8,571
5,5,0,0,2,6,8,571
0,0,1,0,1,0,1,572
1,1,0,0,1,0,1,572
0,0,1,0,1,0,1,573
1,1,1,0,2,0,2,573
2,2,0,0,2,0,2,573
0,0,1,0,1,0,1,574
1,1,0,0,1,0,1,574
0,0,1,0,1,0,1,575
1,1,1,0,2,0,2,575
2,2,2,0,4,0,4,575
3,3,0,0,4,0,4,575
0,0,1,0,1,0,1,576
1,1,0,0,1,0,1,576
0,0,1,0,1,0,1,577
1,1,0,0,1,0,1,577
0,0,1,0,1,0,1,578
1,1,1,0,2,0,2,578
2,2,1,0,3,0,3,578
3,3,0,0,3,0,3,578
0,0,1,0,1,0,1,579
1,1,1,1,2,1,3,579
2,2,0,2,2,3,5,579
3,3,0,0,2,3,5,579
0,0,1,0,1,0,1,580
1,1,1,0,2,0,2,580
2,2,0,0,2,0,2,580
0,0,1,0,1,0,1,581
1,1,3,0,4,0,4,581
2,2,0,0,4,0,4,581
0,0,1,0,1,0,1,582
1,1,0,1,1,1,2,582
2,2,0,1,1,2,3,582
3,3,0,0,1,2,3,582
0,0,1,0,1,0,1,583
1,1,1,0,2,0,2,583
2,2,2,0,4,0,4,583
3,3,0,0,4,0,4,583
0,0,1,0,1,0,1,584
1,1,1,0,2,0,2,584
2,2,4,1,6,1,7,584
3,3,6,2,12,3,15,584
4,4,2,2,14,5,19,584
5,5,2,2,16,7,23,584
6,6,2,3,18,10,28,584
7,7,0,3,18,13,31,584
8,8,1,2,19,15,34,584
9,9,0,3,19,18,37,584
10,10,0,2,19,20,39,584
11,11,0,1,19,21,40,584
12,12,0,0,19,21,40,584
0,0,1,0,1,0,1,585
1,1,1,0,2,0,2,585
2,2,1,1,3,1,4,585
3,3,0,2,3,3,6,585
4,4,0,3,3,6,9,585
5,5,1,3,4,9,13,585
6,6,2,2,6,11,17,585
7,7,3,2,9,13,22,585
8,8,5,3,14,16,30,585
9,9,2,1,16,17,33,585
10,10,1,1,17,18,35,585
11,11,0,0,17,18,35,585
0,0,1,0,1,0,1,586
1,1,0,0,1,0,1,586
0,0,1,0,1,0,1,587
1,1,0,0,1,0,1,587
0,0,1,0,1,0,1,588
1,1,0,0,1,0,1,588
0,0,1,0,1,0,1,589
1,1,0,0,1,0,1,589
0,0,1,0,1,0,1,590
1,1,2,0,3,0,3,590
2,2,0,0,3,0,3,590
0,0,1,0,1,0,1,591
1,1,0,0,1,0,1,591
0,0,1,0,1,0,1,592
1,1,0,0,1,0,1,592
0,0,1,0,1,0,1,593
1,1,1,0,2,0,2,593
2,2,2,0,4,0,4,593
3,3,1,0,5,0,5,593
4,4,0,0,5,0,5,593
0,0,1,0,1,0,1,594
1,1,0,0,1,0,1,594
0,0,1,0,1,0,1,595
1,1,1,0,2,0,2,595
2,2,0,0,2,0,2,595
0,0,1,0,1,0,1,596
1,1,1,0,2,0,2,596
2,2,0,0,2,0,2,596
0,0,1,0,1,0,1,597
1,1,2,0,3,0,3,597
2,2,2,0,5,0,5,597
3,3,3,1,8,1,9,597
4,4,1,3,9,4,13,597
5,5,1,5,10,9,19,597
6,6,2,5,12,14,26,597
7,7,0,2,12,16,28,597
8,8,2,2,14,18,32,597
9,9,2,4,16,22,38,597
10,10,0,7,16,29,45,597
11,11,0,4,16,33,49,597
12,12,0,1,16,34,50,597
13,13,0,0,16,34,50,597
0,0,1,0,1,0,1,598
1,1,0,0,1,0,1,598
0,0,1,0,1,0,1,599
1,1,1,0,2,0,2,599
2,2,1,0,3,0,3,599
3,3,0,0,3,0,3,599
0,0,1,0,1,0,1,600
1,1,1,0,2,0,2,600
2,2,1,0,3,0,3,600
3,3,1,1,4,1,5,600
4,4,0,0,4,1,5,600
0,0,1,0,1,0,1,601
1,1,2,0,3,0,3,601
2,2,0,0,3,0,3,601
0,0,1,0,1,0,1,602
1,1,0,0,1,0,1,602
0,0,1,0,1,0,1,603
1,1,1,0,2,0,2,603
2,2,0,1,2,1,3,603
3,3,0,0,2,1,3,603
0,0,1,0,1,0,1,604
1,1,0,1,1,1,2,604
2,2,0,3,1,4,5,604
3,3,0,1,1,5,6,604
4,4,0,0,1,5,6,604
0,0,1,0,1,0,1,605
1,1,0,0,1,0,1,605
0,0,1,0,1,0,1,606
1,1,1,0,2,0,2,606
2,2,2,0,4,0,4,606
3,3,1,0,5,0,5,606
4,4,1,0,6,0,6,606
5,5,0,0,6,0,6,606
0,0,1,0,1,0,1,607
1,1,1,0,2,0,2,607
2,2,4,1,6,1,7,607
3,3,2,0,8,1,9,607
4,4,3,0,11,1,12,607
5,5,2,1,13,2,15,607
6,6,0,0,13,2,15,607
0,0,1,0,1,0,1,608
1,1,1,0,2,0,2,608
2,2,0,0,2,0,2,608
0,0,1,0,1,0,1,609
1,1,1,1,2,1,3,609
2,2,0,1,2,2,4,609
3,3,0,0,2,2,4,609
0,0,1,0,1,0,1,610
1,1,0,0,1,0,1,610
0,0,1,0,1,0,1,611
1,1,0,0,1,0,1,611
0,0,1,0,1,0,1,612
1,1,1,0,2,0,2,612
2,2,0,0,2,0,2,612
0,0,1,0,1,0,1,613
1,1,0,0,1,0,1,613
0,0,1,0,1,0,1,614
1,1,1,1,2,1,3,614
2,2,2,1,4,2,6,614
3,3,2,3,6,5,11,614
4,4,1,4,7,9,16,614
5,5,3,4,10,13,23,614
6,6,4,5,14,18,32,614
7,7,3,4,17,22,39,614
8,8,3,4,20,26,46,614
9,9,4,3,24,29,53,614
10,10,1,3,25,32,57,614
11,11,1,1,26,33,59,614
12,12,0,1,26,34,60,614
13,13,0,0,26,34,60,614
0,0,1,0,1,0,1,615
1,1,0,0,1,0,1,615
0,0,1,0,1,0,1,616
1,1,0,1,1,1,2,616
2,2,0,0,1,1,2,616
0,0,1,0,1,0,1,617
1,1,0,0,1,0,1,617
0,0,1,0,1,0,1,618
1,1,1,0,2,0,2,618
2,2,0,0,2,0,2,618
0,0,1,0,1,0,1,619
1,1,2,0,3,0,3,619
2,2,1,0,4,0,4,619
3,3,1,0,5,0,5,619
4,4,0,1,5,1,6,619
5,5,0,0,5,1,6,619
0,0,1,0,1,0,1,620
1,1,2,0,3,0,3,620
2,2,1,0,4,0,4,620
3,3,0,1,4,1,5,620
4,4,0,1,4,2,6,620
5,5,0,0,4,2,6,620
0,0,1,0,1,0,1,621
1,1,0,0,1,0,1,621
0,0,1,0,1,0,1,622
1,1,2,0,3,0,3,622
2,2,1,1,4,1,5,622
3,3,1,0,5,1,6,622
4,4,0,0,5,1,6,622
0,0,1,0,1,0,1,623
1,1,2,0,3,0,3,623
2,2,0,0,3,0,3,623
0,0,1,0,1,0,1,624
1,1,1,0,2,0,2,624
2,2,0,1,2,1,3,624
3,3,0,1,2,2,4,624
4,4,0,1,2,3,5,624
5,5,2,2,4,5,9,624
6,6,0,3,4,8,12,624
7,7,0,0,4,8,12,624
0,0,1,0,1,0,1,625
1,1,1,0,2,0,2,625
2,2,3,0,5,0,5,625
3,3,5,0,10,0,10,625
4,4,2,1,12,1,13,625
5,5,2,1,14,2,16,625
6,6,1,0,15,2,17,625
7,7,0,1,15,3,18,625
8,8,0,0,15,3,18,625
0,0,1,0,1,0,1,626
1,1,0,0,1,0,1,626
0,0,1,0,1,0,1,627
1,1,1,1,2,1,3,627
2,2,1,1,3,2,5,627
3,3,1,0,4,2,6,627
4,4,1,0,5,2,7,627
5,5,1,0,6,2,8,627
6,6,1,0,7,2,9,627
7,7,0,0,7,2,9,627
0,0,1,0,1,0,1,628
1,1,0,0,1,0,1,628
0,0,1,0,1,0,1,629
1,1,0,0,1,0,1,629
0,0,1,0,1,0,1,630
1,1,3,0,4,0,4,630
2,2,2,1,6,1,7,630
3,3,1,1,7,2,9,630
4,4,4,1,11,3,14,630
5,5,2,1,13,4,17,630
6,6,0,1,13,5,18,630
7,7,0,0,13,5,18,630
0,0,1,0,1,0,1,631
1,1,2,0,3,0,3,631
2,2,0,0,3,0,3,631
0,0,1,0,1,0,1,632
1,1,0,0,1,0,1,632
0,0,1,0,1,0,1,633
1,1,0,0,1,0,1,633
0,0,1,0,1,0,1,634
1,1,0,0,1,0,1,634
0,0,1,0,1,0,1,635
1,1,0,0,1,0,1,635
0,0,1,0,1,0,1,636
1,1,2,1,3,1,4,636
2,2,4,0,7,1,8,636
3,3,1,0,8,1,9,636
4,4,1,0,9,1,10,636
5,5,1,0,10,1,11,636
6,6,0,0,10,1,11,636
0,0,1,0,1,0,1,637
1,1,0,0,1,0,1,637
0,0,1,0,1,0,1,638
1,1,0,0,1,0,1,638
0,0,1,0,1,0,1,639
1,1,0,0,1,0,1,639
0,0,1,0,1,0,1,640
1,1,3,0,4,0,4,640
2,2,1,0,5,0,5,640
3,3,0,0,5,0,5,640
0,0,1,0,1,0,1,641
1,1,0,0,1,0,1,641
0,0,1,0,1,0,1,642
1,1,0,0,1,0,1,642
0,0,1,0,1,0,1,643
1,1,1,0,2,0,2,643
2,2,0,0,2,0,2,643
0,0,1,0,1,0,1,644
1,1,0,0,1,0,1,644
0,0,1,0,1,0,1,645
1,1,0,0,1,0,1,645
0,0,1,0,1,0,1,646
1,1,1,0,2,0,2,646
2,2,1,0,3,0,3,646
3,3,0,0,3,0,3,646
0,0,1,0,1,0,1,647
1,1,1,0,2,0,2,647
2,2,1,0,3,0,3,647
3,3,0,0,3,0,3,647
0,0,1,0,1,0,1,648
1,1,0,0,1,0,1,648
0,0,1,0,1,0,1,649
1,1,0,0,1,0,1,649
0,0,1,0,1,0,1,650
1,1,0,0,1,0,1,650
0,0,1,0,1,0,1,651
1,1,1,0,2,0,2,651
2,2,1,0,3,0,3,651
3,3,1,0,4,0,4,651
4,4,0,0,4,0,4,651
0,0,1,0,1,0,1,652
1,1,1,2,2,2,4,652
2,2,1,0,3,2,5,652
3,3,1,0,4,2,6,652
4,4,0,0,4,2,6,652
0,0,1,0,1,0,1,653
1,1,1,0,2,0,2,653
2,2,1,0,3,0,3,653
3,3,2,3,5,3,8,653
4,4,3,1,8,4,12,653
5,5,1,0,9,4,13,653
6,6,1,0,10,4,14,653
7,7,1,0,11,4,15,653
8,8,0,0,11,4,15,653
0,0,1,0,1,0,1,654
1,1,2,0,3,0,3,654
2,2,2,1,5,1,6,654
3,3,2,1,7,2,9,654
4,4,1,0,8,2,10,654
5,5,2,0,10,2,12,654
6,6,0,1,10,3,13,654
7,7,0,1,10,4,14,654
8,8,0,0,10,4,14,654
0,0,1,0,1,0,1,655
1,1,2,1,3,1,4,655
2,2,0,2,3,3,6,655
3,3,0,1,3,4,7,655
4,4,0,1,3,5,8,655
5,5,0,2,3,7,10,655
6,6,1,3,4,10,14,655
7,7,0,0,4,10,14,655
0,0,1,0,1,0,1,656
1,1,1,0,2,0,2,656
2,2,0,0,2,0,2,656
0,0,1,0,1,0,1,657
1,1,1,0,2,0,2,657
2,2,0,0,2,0,2,657
0,0,1,0,1,0,1,658
1,1,1,0,2,0,2,658
2,2,1,0,3,0,3,658
3,3,0,0,3,0,3,658
0,0,1,0,1,0,1,659
1,1,2,1,3,1,4,659
2,2,2,2,5,3,8,659
3,3,1,1,6,4,10,659
4,4,1,0,7,4,11,659
5,5,1,0,8,4,12,659
6,6,1,0,9,4,13,659
7,7,0,0,9,4,13,659
0,0,1,0,1,0,1,660
1,1,0,0,1,0,1,660
0,0,1,0,1,0,1,661
1,1,0,0,1,0,1,661
0,0,1,0,1,0,1,662
1,1,0,0,1,0,1,662
0,0,1,0,1,0,1,663
1,1,1,1,2,1,3,663
2,2,0,0,2,1,3,663
0,0,1,0,1,0,1,664
1,1,1,0,2,0,2,664
2,2,1,0,3,0,3,664
3,3,0,0,3,0,3,664
0,0,1,0,1,0,1,665
1,1,1,0,2,0,2,665
2,2,1,0,3,0,3,665
3,3,0,0,3,0,3,665
0,0,1,0,1,0,1,666
1,1,0,0,1,0,1,666
0,0,1,0,1,0,1,667
1,1,0,0,1,0,1,667
0,0,1,0,1,0,1,668
1,1,2,0,3,0,3,668
2,2,2,0,5,0,5,668
3,3,0,0,5,0,5,668
0,0,1,0,1,0,1,669
1,1,0,0,1,0,1,669
0,0,1,0,1,0,1,670
1,1,2,0,3,0,3,670
2,2,0,0,3,0,3,670
0,0,1,0,1,0,1,671
1,1,1,0,2,0,2,671
2,2,1,3,3,3,6,671
3,3,0,1,3,4,7,671
4,4,0,1,3,5,8,671
5,5,0,0,3,5,8,671
0,0,1,0,1,0,1,672
1,1,1,0,2,0,2,672
2,2,0,0,2,0,2,672
0,0,1,0,1,0,1,673
1,1,0,0,1,0,1,673
0,0,1,0,1,0,1,674
1,1,0,0,1,0,1,674
0,0,1,0,1,0,1,675
1,1,1,0,2,0,2,675
2,2,1,0,3,0,3,675
3,3,1,0,4,0,4,675
4,4,3,0,7,0,7,675
5,5,1,0,8,0,8,675
6,6,0,0,8,0,8,675
0,0,1,0,1,0,1,676
1,1,2,0,3,0,3,676
2,2,1,1,4,1,5,676
3,3,1,2,5,3,8,676
4,4,0,1,5,4,9,676
5,5,0,0,5,4,9,676
0,0,1,0,1,0,1,677
1,1,1,0,2,0,2,677
2,2,0,0,2,0,2,677
0,0,1,0,1,0,1,678
1,1,1,0,2,0,2,678
2,2,1,1,3,1,4,678
3,3,3,1,6,2,8,678
4,4,0,0,6,2,8,678
0,0,1,0,1,0,1,679
1,1,0,1,1,1,2,679
2,2,0,1,1,2,3,679
3,3,0,4,1,6,7,679
4,4,1,4,2,10,12,679
5,5,0,3,2,13,15,679
6,6,1,1,3,14,17,679
7,7,0,1,3,15,18,679
8,8,0,0,3,15,18,679
0,0,1,0,1,0,1,680
1,1,1,0,2,0,2,680
2,2,1,0,3,0,3,680
3,3,3,0,6,0,6,680
4,4,2,0,8,0,8,680
5,5,0,0,8,0,8,680
0,0,1,0,1,0,1,681
1,1,1,0,2,0,2,681
2,2,1,0,3,0,3,681
3,3,0,0,3,0,3,681
0,0,1,0,1,0,1,682
1,1,0,0,1,0,1,682
0,0,1,0,1,0,1,683
1,1,1,1,2,1,3,683
2,2,0,2,2,3,5,683
3,3,0,3,2,6,8,683
4,4,0,2,2,8,10,683
5,5,0,1,2,9,11,683
6,6,0,2,2,11,13,683
7,7,0,1,2,12,14,683
8,8,0,2,2,14,16,683
9,9,1,1,3,15,18,683
10,10,1,1,4,16,20,683
11,11,0,1,4,17,21,683
12,12,0,0,4,17,21,683
0,0,1,0,1,0,1,684
1,1,1,0,2,0,2,684
2,2,1,0,3,0,3,684
3,3,2,0,5,0,5,684
4,4,5,2,10,2,12,684
5,5,2,2,12,4,16,684
6,6,0,0,12,4,16,684
0,0,1,0,1,0,1,685
1,1,1,0,2,0,2,685
2,2,0,0,2,0,2,685
0,0,1,0,1,0,1,686
1,1,2,0,3,0,3,686
2,2,1,0,4,0,4,686
3,3,0,2,4,2,6,686
4,4,0,1,4,3,7,686
5,5,1,0,5,3,8,686
6,6,0,0,5,3,8,686
0,0,1,0,1,0,1,687
1,1,2,0,3,0,3,687
2,2,3,0,6,0,6,687
3,3,0,1,6,1,7,687
4,4,0,0,6,1,7,687
0,0,1,0,1,0,1,688
1,1,2,0,3,0,3,688
2,2,1,1,4,1,5,688
3,3,1,1,5,2,7,688
4,4,0,0,5,2,7,688
0,0,1,0,1,0,1,689
1,1,2,0,3,0,3,689
2,2,3,1,6,1,7,689
3,3,2,1,8,2,10,689
4,4,3,0,11,2,13,689
5,5,1,1,12,3,15,689
6,6,2,1,14,4,18,689
7,7,2,1,16,5,21,689
8,8,2,0,18,5,23,689
9,9,2,0,20,5,25,689
10,10,1,0,21,5,26,689
11,11,2,0,23,5,28,689
12,12,3,1,26,6,32,689
13,13,5,1,31,7,38,689
14,14,6,5,37,12,49,689
15,15,5,3,42,15,57,689
16,16,5,3,47,18,65,689
17,17,7,4,54,22,76,689
18,18,4,4,58,26,84,689
19,19,4,2,62,28,90,689
20,20,7,3,69,31,100,689
21,21,5,2,74,33,107,689
22,22,6,3,80,36,116,689
23,23,7,3,87,39,126,689
24,24,9,2,96,41,137,689
25,25,6,4,102,45,147,689
26,26,2,4,104,49,153,689
27,27,5,4,109,53,162,689
28,28,2,5,111,58,169,689
29,29,2,4,113,62,175,689
30,30,2,10,115,72,187,689
31,31,2,8,117,80,197,689
32,32,3,6,120,86,206,689
33,33,7,3,127,89,216,689
34,34,6,2,133,91,224,689
35,35,5,2,138,93,231,689
36,36,1,0,139,93,232,689
37,37,2,0,141,93,234,689
38,38,2,0,143,93,236,689
39,39,1,0,144,93,237,689
40,40,1,1,145,94,239,689
41,41,2,2,147,96,243,689
42,42,1,3,148,99,247,689
43,43,1,3,149,102,251,689
44,44,1,2,150,104,254,689
45,45,0,1,150,105,255,689
46,46,0,0,150,105,255,689
0,0,1,0,1,0,1,690
1,1,1,0,2,0,2,690
2,2,0,0,2,0,2,690
0,0,1,0,1,0,1,691
1,1,0,1,1,1,2,691
2,2,0,1,1,2,3,691
3,3,0,1,1,3,4,691
4,4,0,1,1,4,5,691
5,5,0,0,1,4,5,691
0,0,1,0,1,0,1,692
1,1,1,0,2,0,2,692
2,2,1,0,3,0,3,692
3,3,1,0,4,0,4,692
4,4,1,0,5,0,5,692
5,5,1,0,6,0,6,692
6,6,1,0,7,0,7,692
7,7,2,0,9,0,9,692
8,8,2,1,11,1,12,692
9,9,1,1,12,2,14,692
10,10,3,0,15,2,17,692
11,11,2,0,17,2,19,692
12,12,0,0,17,2,19,692
0,0,1,0,1,0,1,693
1,1,1,0,2,0,2,693
2,2,1,2,3,2,5,693
3,3,1,3,4,5,9,693
4,4,2,2,6,7,13,693
5,5,1,2,7,9,16,693
6,6,2,2,9,11,20,693
7,7,5,3,14,14,28,693
8,8,9,3,23,17,40,693
9,9,8,5,31,22,53,693
10,10,6,6,37,28,65,693
11,11,5,3,42,31,73,693
12,12,7,4,49,35,84,693
13,13,7,3,56,38,94,693
14,14,6,2,62,40,102,693
15,15,4,5,66,45,111,693
16,16,6,5,72,50,122,693
17,17,6,4,78,54,132,693
18,18,3,2,81,56,137,693
19,19,3,0,84,56,140,693
20,20,2,0,86,56,142,693
21,21,4,0,90,56,146,693
22,22,4,1,94,57,151,693
23,23,2,2,96,59,155,693
24,24,1,1,97,60,157,693
25,25,0,0,97,60,157,693
0,0,1,0,1,0,1,694
1,1,0,0,1,0,1,694
0,0,1,0,1,0,1,695
1,1,0,0,1,0,1,695
0,0,1,0,1,0,1,696
1,1,1,0,2,0,2,696
2,2,2,0,4,0,4,696
3,3,1,2,5,2,7,696
4,4,1,1,6,3,9,696
5,5,0,3,6,6,12,696
6,6,2,1,8,7,15,696
7,7,0,0,8,7,15,696
0,0,1,0,1,0,1,697
1,1,0,0,1,0,1,697
0,0,1,0,1,0,1,698
1,1,0,0,1,0,1,698
0,0,1,0,1,0,1,699
1,1,1,0,2,0,2,699
2,2,0,1,2,1,3,699
3,3,0,0,2,1,3,699
0,0,1,0,1,0,1,700
1,1,0,0,1,0,1,700
0,0,1,0,1,0,1,701
1,1,0,0,1,0,1,701
0,0,1,0,1,0,1,702
1,1,2,0,3,0,3,702
2,2,3,0,6,0,6,702
3,3,2,1,8,1,9,702
4,4,1,0,9,1,10,702
5,5,0,0,9,1,10,702
0,0,1,0,1,0,1,703
1,1,0,0,1,0,1,703
0,0,1,0,1,0,1,704
1,1,0,0,1,0,1,704
0,0,1,0,1,0,1,705
1,1,0,0,1,0,1,705
0,0,1,0,1,0,1,706
1,1,1,0,2,0,2,706
2,2,2,0,4,0,4,706
3,3,2,0,6,0,6,706
4,4,2,0,8,0,8,706
5,5,2,1,10,1,11,706
6,6,1,4,11,5,16,706
7,7,1,7,12,12,24,706
8,8,3,7,15,19,34,706
9,9,2,2,17,21,38,706
10,10,0,0,17,21,38,706
0,0,1,0,1,0,1,707
1,1,2,0,3,0,3,707
2,2,2,2,5,2,7,707
3,3,0,1,5,3,8,707
4,4,0,0,5,3,8,707
0,0,1,0,1,0,1,708
1,1,0,1,1,1,2,708
2,2,0,2,1,3,4,708
3,3,0,1,1,4,5,708
4,4,0,0,1,4,5,708
0,0,1,0,1,0,1,709
1,1,1,0,2,0,2,709
2,2,2,0,4,0,4,709
3,3,4,0,8,0,8,709
4,4,2,1,10,1,11,709
5,5,2,0,12,1,13,709
6,6,2,1,14,2,16,709
7,7,2,0,16,2,18,709
8,8,1,0,17,2,19,709
9,9,1,0,18,2,20,709
10,10,1,0,19,2,21,709
11,11,1,0,20,2,22,709
12,12,1,0,21,2,23,709
13,13,0,0,21,2,23,709
0,0,1,0,1,0,1,710
1,1,1,1,2,1,3,710
2,2,0,1,2,2,4,710
3,3,1,0,3,2,5,710
4,4,0,0,3,2,5,710
0,0,1,0,1,0,1,711
1,1,0,0,1,0,1,711
0,0,1,0,1,0,1,712
1,1,0,0,1,0,1,712
0,0,1,0,1,0,1,713
1,1,0,0,1,0,1,713
0,0,1,0,1,0,1,714
1,1,1,0,2,0,2,714
2,2,0,0,2,0,2,714
0,0,1,0,1,0,1,715
1,1,0,0,1,0,1,715
0,0,1,0,1,0,1,716
1,1,0,0,1,0,1,716
0,0,1,0,1,0,1,717
1,1,1,0,2,0,2,717
2,2,0,0,2,0,2,717
0,0,1,0,1,0,1,718
1,1,0,1,1,1,2,718
2,2,1,0,2,1,3,718
3,3,0,0,2,1,3,718
0,0,1,0,1,0,1,719
1,1,0,0,1,0,1,719
0,0,1,0,1,0,1,720
1,1,3,0,4,0,4,720
2,2,1,0,5,0,5,720
3,3,2,0,7,0,7,720
4,4,0,1,7,1,8,720
5,5,0,0,7,1,8,720
0,0,1,0,1,0,1,721
1,1,0,0,1,0,1,721
0,0,1,0,1,0,1,722
1,1,1,0,2,0,2,722
2,2,2,0,4,0,4,722
3,3,3,0,7,0,7,722
4,4,0,0,7,0,7,722
0,0,1,0,1,0,1,723
1,1,0,0,1,0,1,723
0,0,1,0,1,0,1,724
1,1,1,0,2,0,2,724
2,2,0,0,2,0,2,724
0,0,1,0,1,0,1,725
1,1,2,1,3,1,4,725
2,2,1,1,4,2,6,725
3,3,0,0,4,2,6,725
0,0,1,0,1,0,1,726
1,1,1,0,2,0,2,726
2,2,0,0,2,0,2,726
0,0,1,0,1,0,1,727
1,1,2,0,3,0,3,727
2,2,0,0,3,0,3,727
0,0,1,0,1,0,1,728
1,1,1,0,2,0,2,728
2,2,0,0,2,0,2,728
0,0,1,0,1,0,1,729
1,1,1,0,2,0,2,729
2,2,0,0,2,0,2,729
0,0,1,0,1,0,1,730
1,1,0,2,1,2,3,730
2,2,1,3,2,5,7,730
3,3,3,3,5,8,13,730
4,4,7,2,12,10,22,730
5,5,6,1,18,11,29,730
6,6,6,2,24,13,37,730
7,7,4,2,28,15,43,730
8,8,2,7,30,22,52,730
9,9,3,7,33,29,62,730
10,10,4,7,37,36,73,730
11,11,6,8,43,44,87,730
12,12,5,3,48,47,95,730
13,13,4,5,52,52,104,730
14,14,3,4,55,56,111,730
15,15,0,2,55,58,113,730
16,16,0,0,55,58,113,730
0,0,1,0,1,0,1,731
1,1,1,0,2,0,2,731
2,2,1,1,3,1,4,731
3,3,0,3,3,4,7,731
4,4,1,1,4,5,9,731
5,5,1,0,5,5,10,731
6,6,0,0,5,5,10,731
0,0,1,0,1,0,1,732
1,1,2,0,3,0,3,732
2,2,2,0,5,0,5,732
3,3,0,0,5,0,5,732
0,0,1,0,1,0,1,733
1,1,1,1,2,1,3,733
2,2,1,2,3,3,6,733
3,3,1,3,4,6,10,733
4,4,2,1,6,7,13,733
5,5,2,0,8,7,15,733
6,6,2,0,10,7,17,733
7,7,1,0,11,7,18,733
8,8,1,0,12,7,19,733
9,9,0,0,12,7,19,733
0,0,1,0,1,0,1,734
1,1,0,1,1,1,2,734
2,2,0,1,1,2,3,734
3,3,0,2,1,4,5,734
4,4,1,0,2,4,6,734
5,5,1,0,3,4,7,734
6,6,0,1,3,5,8,734
7,7,0,1,3,6,9,734
8,8,0,1,3,7,10,734
9,9,0,1,3,8,11,734
10,10,0,0,3,8,11,734
0,0,1,0,1,0,1,735
1,1,0,0,1,0,1,735
0,0,1,0,1,0,1,736
1,1,0,0,1,0,1,736
0,0,1,0,1,0,1,737
1,1,0,0,1,0,1,737
0,0,1,0,1,0,1,738
1,1,0,1,1,1,2,738
2,2,1,0,2,1,3,738
3,3,0,0,2,1,3,738
0,0,1,0,1,0,1,739
1,1,0,0,1,0,1,739
0,0,1,0,1,0,1,740
1,1,0,1,1,1,2,740
2,2,0,2,1,3,4,740
3,3,0,4,1,7,8,740
4,4,0,2,1,9,10,740
5,5,0,3,1,12,13,740
6,6,1,2,2,14,16,740
7,7,2,3,4,17,21,740
8,8,0,4,4,21,25,740
9,9,0,3,4,24,28,740
10,10,0,1,4,25,29,740
11,11,1,0,5,25,30,740
12,12,0,0,5,25,30,740
0,0,1,0,1,0,1,741
1,1,2,0,3,0,3,741
2,2,1,0,4,0,4,741
3,3,0,0,4,0,4,741
0,0,1,0,1,0,1,742
1,1,0,0,1,0,1,742
0,0,1,0,1,0,1,743
1,1,0,2,1,2,3,743
2,2,0,3,1,5,6,743
3,3,0,2,1,7,8,743
4,4,1,0,2,7,9,743
5,5,1,1,3,8,11,743
6,6,1,1,4,9,13,743
7,7,0,1,4,10,14,743
8,8,1,2,5,12,17,743
9,9,2,1,7,13,20,743
10,10,2,0,9,13,22,743
11,11,0,0,9,13,22,743
0,0,1,0,1,0,1,744
1,1,0,0,1,0,1,744
0,0,1,0,1,0,1,745
1,1,0,0,1,0,1,745
0,0,1,0,1,0,1,746
1,1,0,0,1,0,1,746
0,0,1,0,1,0,1,747
1,1,1,0,2,0,2,747
2,2,0,0,2,0,2,747
0,0,1,0,1,0,1,748
1,1,1,0,2,0,2,748
2,2,0,0,2,0,2,748
0,0,1,0,1,0,1,749
1,1,2,0,3,0,3,749
2,2,1,0,4,0,4,749
3,3,0,0,4,0,4,749
0,0,1,0,1,0,1,750
1,1,1,1,2,1,3,750
2,2,1,0,3,1,4,750
3,3,0,0,3,1,4,750
0,0,1,0,1,0,1,751
1,1,0,0,1,0,1,751
0,0,1,0,1,0,1,752
1,1,0,0,1,0,1,752
0,0,1,0,1,0,1,753
1,1,2,1,3,1,4,753
2,2,1,1,4,2,6,753
3,3,1,0,5,2,7,753
4,4,1,0,6,2,8,753
5,5,0,0,6,2,8,753
0,0,1,0,1,0,1,754
1,1,0,0,1,0,1,754
0,0,1,0,1,0,1,755
1,1,0,0,1,0,1,755
0,0,1,0,1,0,1,756
1,1,1,1,2,1,3,756
2,2,1,1,3,2,5,756
3,3,1,1,4,3,7,756
4,4,1,2,5,5,10,756
5,5,1,3,6,8,14,756
6,6,1,0,7,8,15,756
7,7,1,0,8,8,16,756
8,8,1,0,9,8,17,756
9,9,0,0,9,8,17,756
0,0,1,0,1,0,1,757
1,1,0,0,1,0,1,757
0,0,1,0,1,0,1,758
1,1,1,0,2,0,2,758
2,2,1,1,3,1,4,758
3,3,0,1,3,2,5,758
4,4,0,1,3,3,6,758
5,5,0,1,3,4,7,758
6,6,0,1,3,5,8,758
7,7,0,0,3,5,8,758
0,0,1,0,1,0,1,759
1,1,1,0,2,0,2,759
2,2,0,0,2,0,2,759
0,0,1,0,1,0,1,760
1,1,0,0,1,0,1,760
0,0,1,0,1,0,1,761
1,1,0,0,1,0,1,761
0,0,1,0,1,0,1,762
1,1,0,1,1,1,2,762
2,2,0,0,1,1,2,762
0,0,1,0,1,0,1,763
1,1,2,1,3,1,4,763
2,2,0,1,3,2,5,763
3,3,0,1,3,3,6,763
4,4,0,1,3,4,7,763
5,5,0,0,3,4,7,763
0,0,1,0,1,0,1,764
1,1,2,0,3,0,3,764
2,2,1,2,4,2,6,764
3,3,3,0,7,2,9,764
4,4,6,0,13,2,15,764
5,5,6,2,19,4,23,764
6,6,6,3,25,7,32,764
7,7,0,3,25,10,35,764
8,8,0,1,25,11,36,764
9,9,0,2,25,13,38,764
10,10,0,0,25,13,38,764
0,0,1,0,1,0,1,765
1,1,1,0,2,0,2,765
2,2,2,0,4,0,4,765
3,3,2,0,6,0,6,765
4,4,1,0,7,0,7,765
5,5,2,0,9,0,9,765
6,6,2,0,11,0,11,765
7,7,1,0,12,0,12,765
8,8,0,1,12,1,13,765
9,9,1,2,13,3,16,765
10,10,2,1,15,4,19,765
11,11,1,4,16,8,24,765
12,12,2,2,18,10,28,765
13,13,5,2,23,12,35,765
14,14,3,2,26,14,40,765
15,15,2,0,28,14,42,765
16,16,1,1,29,15,44,765
17,17,0,0,29,15,44,765
0,0,1,0,1,0,1,766
1,1,1,0,2,0,2,766
2,2,2,0,4,0,4,766
3,3,1,0,5,0,5,766
4,4,1,0,6,0,6,766
5,5,0,1,6,1,7,766
6,6,1,1,7,2,9,766
7,7,2,1,9,3,12,766
8,8,1,1,10,4,14,766
9,9,0,0,10,4,14,766
0,0,1,0,1,0,1,767
1,1,0,0,1,0,1,767
0,0,1,0,1,0,1,768
1,1,1,1,2,1,3,768
2,2,0,2,2,3,5,768
3,3,1,1,3,4,7,768
4,4,0,1,3,5,8,768
5,5,0,0,3,5,8,768
0,0,1,0,1,0,1,769
1,1,0,0,1,0,1,769
0,0,1,0,1,0,1,770
1,1,2,0,3,0,3,770
2,2,2,1,5,1,6,770
3,3,1,1,6,2,8,770
4,4,0,1,6,3,9,770
5,5,1,1,7,4,11,770
6,6,0,2,7,6,13,770
7,7,0,0,7,6,13,770
0,0,1,0,1,0,1,771
1,1,0,0,1,0,1,771
0,0,1,0,1,0,1,772
1,1,1,1,2,1,3,772
2,2,0,0,2,1,3,772
0,0,1,0,1,0,1,773
1,1,0,0,1,0,1,773
0,0,1,0,1,0,1,774
1,1,0,0,1,0,1,774
0,0,1,0,1,0,1,775
1,1,1,1,2,1,3,775
2,2,0,1,2,2,4,775
3,3,0,0,2,2,4,775
0,0,1,0,1,0,1,776
1,1,0,1,1,1,2,776
2,2,2,1,3,2,5,776
3,3,4,1,7,3,10,776
4,4,3,2,10,5,15,776
5,5,0,2,10,7,17,776
6,6,0,1,10,8,18,776
7,7,0,1,10,9,19,776
8,8,0,0,10,9,19,776
0,0,1,0,1,0,1,777
1,1,0,0,1,0,1,777
0,0,1,0,1,0,1,778
1,1,1,0,2,0,2,778
2,2,0,0,2,0,2,778
0,0,1,0,1,0,1,779
1,1,0,0,1,0,1,779
0,0,1,0,1,0,1,780
1,1,1,0,2,0,2,780
2,2,2,1,4,1,5,780
3,3,1,2,5,3,8,780
4,4,1,5,6,8,14,780
5,5,1,3,7,11,18,780
6,6,0,3,7,14,21,780
7,7,0,2,7,16,23,780
8,8,0,1,7,17,24,780
9,9,0,1,7,18,25,780
10,10,0,0,7,18,25,780
0,0,1,0,1,0,1,781
1,1,0,1,1,1,2,781
2,2,0,0,1,1,2,781
0,0,1,0,1,0,1,782
1,1,0,0,1,0,1,782
0,0,1,0,1,0,1,783
1,1,1,0,2,0,2,783
2,2,1,0,3,0,3,783
3,3,0,0,3,0,3,783
0,0,1,0,1,0,1,784
1,1,0,0,1,0,1,784
0,0,1,0,1,0,1,785
1,1,0,0,1,0,1,785
0,0,1,0,1,0,1,786
1,1,2,0,3,0,3,786
2,2,1,0,4,0,4,786
3,3,1,0,5,0,5,786
4,4,0,0,5,0,5,786
0,0,1,0,1,0,1,787
1,1,2,0,3,0,3,787
2,2,1,0,4,0,4,787
3,3,2,0,6,0,6,787
4,4,4,0,10,0,10,787
5,5,2,1,12,1,13,787
6,6,0,2,12,3,15,787
7,7,0,2,12,5,17,787
8,8,0,1,12,6,18,787
9,9,0,0,12,6,18,787
0,0,1,0,1,0,1,788
1,1,4,1,5,1,6,788
2,2,6,3,11,4,15,788
3,3,5,3,16,7,23,788
4,4,3,4,19,11,30,788
5,5,6,5,25,16,41,788
6,6,6,3,31,19,50,788
7,7,6,5,37,24,61,788
8,8,6,8,43,32,75,788
9,9,9,6,52,38,90,788
10,10,6,5,58,43,101,788
11,11,9,4,67,47,114,788
12,12,10,6,77,53,130,788
13,13,4,6,81,59,140,788
14,14,8,6,89,65,154,788
15,15,10,7,99,72,171,788
16,16,12,4,111,76,187,788
17,17,12,6,123,82,205,788
18,18,11,5,134,87,221,788
19,19,12,4,146,91,237,788
20,20,11,3,157,94,251,788
21,21,8,2,165,96,261,788
22,22,4,5,169,101,270,788
23,23,4,4,173,105,278,788
24,24,4,6,177,111,288,788
25,25,5,5,182,116,298,788
26,26,8,5,190,121,311,788
27,27,6,4,196,125,321,788
28,28,6,6,202,131,333,788
29,29,6,7,208,138,346,788
30,30,8,4,216,142,358,788
31,31,8,5,224,147,371,788
32,32,10,7,234,154,388,788
33,33,12,6,246,160,406,788
34,34,13,9,259,169,428,788
35,35,15,9,274,178,452,788
36,36,8,9,282,187,469,788
37,37,7,5,289,192,481,788
38,38,9,3,298,195,493,788
39,39,4,2,302,197,499,788
40,40,3,0,305,197,502,788
41,41,1,1,306,198,504,788
42,42,0,1,306,199,505,788
43,43,0,1,306,200,506,788
44,44,0,0,306,200,506,788
0,0,1,0,1,0,1,789
1,1,2,0,3,0,3,789
2,2,1,0,4,0,4,789
3,3,0,0,4,0,4,789
0,0,1,0,1,0,1,790
1,1,0,0,1,0,1,790
0,0,1,0,1,0,1,791
1,1,0,1,1,1,2,791
2,2,0,1,1,2,3,791
3,3,0,0,1,2,3,791
0,0,1,0,1,0,1,792
1,1,1,0,2,0,2,792
2,2,1,0,3,0,3,792
3,3,1,0,4,0,4,792
4,4,1,0,5,0,5,792
5,5,1,0,6,0,6,792
6,6,1,0,7,0,7,792
7,7,0,0,7,0,7,792
0,0,1,0,1,0,1,793
1,1,0,0,1,0,1,793
0,0,1,0,1,0,1,794
1,1,1,1,2,1,3,794
2,2,2,1,4,2,6,794
3,3,1,1,5,3,8,794
4,4,1,2,6,5,11,794
5,5,1,2,7,7,14,794
6,6,2,0,9,7,16,794
7,7,6,2,15,9,24,794
8,8,8,1,23,10,33,794
9,9,6,1,29,11,40,794
10,10,4,2,33,13,46,794
11,11,5,2,38,15,53,794
12,12,3,2,41,17,58,794
13,13,2,1,43,18,61,794
14,14,2,0,45,18,63,794
15,15,1,0,46,18,64,794
16,16,1,0,47,18,65,794
17,17,0,0,47,18,65,794
0,0,1,0,1,0,1,795
1,1,0,0,1,0,1,795
0,0,1,0,1,0,1,796
1,1,1,1,2,1,3,796
2,2,1,0,3,1,4,796
3,3,0,0,3,1,4,796
0,0,1,0,1,0,1,797
1,1,0,0,1,0,1,797
0,0,1,0,1,0,1,798
1,1,0,0,1,0,1,798
0,0,1,0,1,0,1,799
1,1,2,0,3,0,3,799
2,2,1,0,4,0,4,799
3,3,2,0,6,0,6,799
4,4,4,0,10,0,10,799
5,5,4,2,14,2,16,799
6,6,2,5,16,7,23,799
7,7,4,4,20,11,31,799
8,8,4,4,24,15,39,799
9,9,5,1,29,16,45,799
10,10,5,1,34,17,51,799
11,11,2,1,36,18,54,799
12,12,0,2,36,20,56,799
13,13,0,1,36,21,57,799
14,14,0,1,36,22,58,799
15,15,0,0,36,22,58,799
0,0,1,0,1,0,1,800
1,1,0,0,1,0,1,800
0,0,1,0,1,0,1,801
1,1,0,0,1,0,1,801
0,0,1,0,1,0,1,802
1,1,0,0,1,0,1,802
0,0,1,0,1,0,1,803
1,1,2,0,3,0,3,803
2,2,2,0,5,0,5,803
3,3,2,1,7,1,8,803
4,4,0,2,7,3,10,803
5,5,1,0,8,3,11,803
6,6,0,0,8,3,11,803
0,0,1,0,1,0,1,804
1,1,0,0,1,0,1,804
0,0,1,0,1,0,1,805
1,1,1,0,2,0,2,805
2,2,0,0,2,0,2,805
0,0,1,0,1,0,1,806
1,1,1,1,2,1,3,806
2,2,1,0,3,1,4,806
3,3,1,0,4,1,5,806
4,4,2,0,6,1,7,806
5,5,0,0,6,1,7,806
0,0,1,0,1,0,1,807
1,1,0,0,1,0,1,807
0,0,1,0,1,0,1,808
1,1,0,0,1,0,1,808
0,0,1,0,1,0,1,809
1,1,1,0,2,0,2,809
2,2,2,0,4,0,4,809
3,3,5,0,9,0,9,809
4,4,0,0,9,0,9,809
0,0,1,0,1,0,1,810
1,1,0,0,1,0,1,810
0,0,1,0,1,0,1,811
1,1,0,1,1,1,2,811
2,2,0,0,1,1,2,811
0,0,1,0,1,0,1,812
1,1,0,0,1,0,1,812
0,0,1,0,1,0,1,813
1,1,1,0,2,0,2,813
2,2,2,0,4,0,4,813
3,3,1,0,5,0,5,813
4,4,1,0,6,0,6,813
5,5,0,0,6,0,6,813
0,0,1,0,1,0,1,814
1,1,2,0,3,0,3,814
2,2,1,0,4,0,4,814
3,3,0,0,4,0,4,814
0,0,1,0,1,0,1,815
1,1,0,0,1,0,1,815
0,0,1,0,1,0,1,816
1,1,1,2,2,2,4,816
2,2,3,0,5,2,7,816
3,3,5,0,10,2,12,816
4,4,5,0,15,2,17,816
5,5,2,0,17,2,19,816
6,6,1,0,18,2,20,816
7,7,0,1,18,3,21,816
8,8,0,0,18,3,21,816
0,0,1,0,1,0,1,817
1,1,0,0,1,0,1,817
0,0,1,0,1,0,1,818
1,1,0,0,1,0,1,818
0,0,1,0,1,0,1,819
1,1,1,2,2,2,4,819
2,2,1,2,3,4,7,819
3,3,0,0,3,4,7,819
0,0,1,0,1,0,1,820
1,1,1,0,2,0,2,820
2,2,1,0,3,0,3,820
3,3,1,1,4,1,5,820
4,4,1,0,5,1,6,820
5,5,0,0,5,1,6,820
0,0,1,0,1,0,1,821
1,1,0,0,1,0,1,821
0,0,1,0,1,0,1,822
1,1,1,0,2,0,2,822
2,2,0,0,2,0,2,822
0,0,1,0,1,0,1,823
1,1,2,0,3,0,3,823
2,2,3,0,6,0,6,823
3,3,2,1,8,1,9,823
4,4,2,0,10,1,11,823
5,5,1,1,11,2,13,823
6,6,1,2,12,4,16,823
7,7,0,2,12,6,18,823
8,8,0,1,12,7,19,823
9,9,1,1,13,8,21,823
10,10,0,2,13,10,23,823
11,11,0,1,13,11,24,823
12,12,0,0,13,11,24,823
0,0,1,0,1,0,1,824
1,1,1,0,2,0,2,824
2,2,1,0,3,0,3,824
3,3,0,0,3,0,3,824
0,0,1,0,1,0,1,825
1,1,1,0,2,0,2,825
2,2,0,0,2,0,2,825
0,0,1,0,1,0,1,826
1,1,0,0,1,0,1,826
0,0,1,0,1,0,1,827
1,1,0,1,1,1,2,827
2,2,2,0,3,1,4,827
3,3,1,0,4,1,5,827
4,4,0,0,4,1,5,827
0,0,1,0,1,0,1,828
1,1,3,1,4,1,5,828
2,2,2,2,6,3,9,828
3,3,0,1,6,4,10,828
4,4,0,2,6,6,12,828
5,5,0,2,6,8,14,828
6,6,1,0,7,8,15,828
7,7,2,0,9,8,17,828
8,8,0,0,9,8,17,828
0,0,1,0,1,0,1,829
1,1,1,1,2,1,3,829
2,2,1,1,3,2,5,829
3,3,1,2,4,4,8,829
4,4,1,1,5,5,10,829
5,5,0,1,5,6,11,829
6,6,1,0,6,6,12,829
7,7,0,1,6,7,13,829
8,8,0,3,6,10,16,829
9,9,1,4,7,14,21,829
10,10,2,2,9,16,25,829
11,11,2,1,11,17,28,829
12,12,5,2,16,19,35,829
13,13,3,3,19,22,41,829
14,14,2,2,21,24,45,829
15,15,2,5,23,29,52,829
16,16,2,5,25,34,59,829
17,17,5,5,30,39,69,829
18,18,1,5,31,44,75,829
19,19,3,2,34,46,80,829
20,20,0,3,34,49,83,829
21,21,0,2,34,51,85,829
22,22,0,0,34,51,85,829
0,0,1,0,1,0,1,830
1,1,1,1,2,1,3,830
2,2,0,0,2,1,3,830
0,0,1,0,1,0,1,831
1,1,0,0,1,0,1,831
0,0,1,0,1,0,1,832
1,1,0,1,1,1,2,832
2,2,0,3,1,4,5,832
3,3,0,0,1,4,5,832
0,0,1,0,1,0,1,833
1,1,0,0,1,0,1,833
0,0,1,0,1,0,1,834
1,1,4,0,5,0,5,834
2,2,3,1,8,1,9,834
3,3,0,1,8,2,10,834
4,4,0,1,8,3,11,834
5,5,0,0,8,3,11,834
0,0,1,0,1,0,1,835
1,1,1,0,2,0,2,835
2,2,0,0,2,0,2,835
0,0,1,0,1,0,1,836
1,1,0,1,1,1,2,836
2,2,0,1,1,2,3,836
3,3,0,1,1,3,4,836
4,4,0,0,1,3,4,836
0,0,1,0,1,0,1,837
1,1,0,0,1,0,1,837
0,0,1,0,1,0,1,838
1,1,1,0,2,0,2,838
2,2,0,0,2,0,2,838
0,0,1,0,1,0,1,839
1,1,0,0,1,0,1,839
0,0,1,0,1,0,1,840
1,1,0,0,1,0,1,840
0,0,1,0,1,0,1,841
1,1,0,0,1,0,1,841
0,0,1,0,1,0,1,842
1,1,0,0,1,0,1,842
0,0,1,0,1,0,1,843
1,1,2,0,3,0,3,843
2,2,1,0,4,0,4,843
3,3,1,0,5,0,5,843
4,4,2,0,7,0,7,843
5,5,4,1,11,1,12,843
6,6,4,2,15,3,18,843
7,7,3,2,18,5,23,843
8,8,4,3,22,8,30,843
9,9,3,3,25,11,36,843
10,10,0,2,25,13,38,843
11,11,0,0,25,13,38,843
0,0,1,0,1,0,1,844
1,1,0,0,1,0,1,844
0,0,1,0,1,0,1,845
1,1,0,0,1,0,1,845
0,0,1,0,1,0,1,846
1,1,0,0,1,0,1,846
0,0,1,0,1,0,1,847
1,1,1,0,2,0,2,847
2,2,0,0,2,0,2,847
0,0,1,0,1,0,1,848
1,1,1,0,2,0,2,848
2,2,0,0,2,0,2,848
0,0,1,0,1,0,1,849
1,1,1,0,2,0,2,849
2,2,1,0,3,0,3,849
3,3,1,1,4,1,5,849
4,4,0,2,4,3,7,849
5,5,0,0,4,3,7,849
0,0,1,0,1,0,1,850
1,1,0,0,1,0,1,850
0,0,1,0,1,0,1,851
1,1,0,0,1,0,1,851
0,0,1,0,1,0,1,852
1,1,1,1,2,1,3,852
2,2,1,1,3,2,5,852
3,3,2,0,5,2,7,852
4,4,1,3,6,5,11,852
5,5,2,1,8,6,14,852
6,6,2,2,10,8,18,852
7,7,2,1,12,9,21,852
8,8,1,2,13,11,24,852
9,9,0,1,13,12,25,852
10,10,0,0,13,12,25,852
0,0,1,0,1,0,1,853
1,1,1,0,2,0,2,853
2,2,0,0,2,0,2,853
0,0,1,0,1,0,1,854
1,1,1,1,2,1,3,854
2,2,1,0,3,1,4,854
3,3,1,0,4,1,5,854
4,4,0,1,4,2,6,854
5,5,0,0,4,2,6,854
0,0,1,0,1,0,1,855
1,1,2,1,3,1,4,855
2,2,0,1,3,2,5,855
3,3,0,3,3,5,8,855
4,4,0,1,3,6,9,855
5,5,0,1,3,7,10,855
6,6,0,1,3,8,11,855
7,7,0,2,3,10,13,855
8,8,0,1,3,11,14,855
9,9,0,2,3,13,16,855
10,10,0,1,3,14,17,855
11,11,1,0,4,14,18,855
12,12,1,0,5,14,19,855
13,13,0,0,5,14,19,855
0,0,1,0,1,0,1,856
1,1,1,0,2,0,2,856
2,2,0,0,2,0,2,856
0,0,1,0,1,0,1,857
1,1,1,0,2,0,2,857
2,2,1,0,3,0,3,857
3,3,0,0,3,0,3,857
0,0,1,0,1,0,1,858
1,1,0,0,1,0,1,858
0,0,1,0,1,0,1,859
1,1,1,0,2,0,2,859
2,2,1,1,3,1,4,859
3,3,0,2,3,3,6,859
4,4,0,1,3,4,7,859
5,5,0,0,3,4,7,859
0,0,1,0,1,0,1,860
1,1,0,0,1,0,1,860
0,0,1,0,1,0,1,861
1,1,0,0,1,0,1,861
0,0,1,0,1,0,1,862
1,1,0,1,1,1,2,862
2,2,0,0,1,1,2,862
0,0,1,0,1,0,1,863
1,1,0,0,1,0,1,863
0,0,1,0,1,0,1,864
1,1,0,0,1,0,1,864
0,0,1,0,1,0,1,865
1,1,1,0,2,0,2,865
2,2,1,0,3,0,3,865
3,3,1,0,4,0,4,865
4,4,1,0,5,0,5,865
5,5,1,1,6,1,7,865
6,6,3,1,9,2,11,865
7,7,1,0,10,2,12,865
8,8,1,0,11,2,13,865
9,9,1,0,12,2,14,865
10,10,1,0,13,2,15,865
11,11,1,0,14,2,16,865
12,12,1,0,15,2,17,865
13,13,2,0,17,2,19,865
14,14,0,0,17,2,19,865
0,0,1,0,1,0,1,866
1,1,1,0,2,0,2,866
2,2,2,0,4,0,4,866
3,3,2,0,6,0,6,866
4,4,1,0,7,0,7,866
5,5,0,0,7,0,7,866
0,0,1,0,1,0,1,867
1,1,0,0,1,0,1,867
0,0,1,0,1,0,1,868
1,1,0,1,1,1,2,868
2,2,0,1,1,2,3,868
3,3,0,0,1,2,3,868
0,0,1,0,1,0,1,869
1,1,3,0,4,0,4,869
2,2,2,1,6,1,7,869
3,3,1,1,7,2,9,869
4,4,1,1,8,3,11,869
5,5,0,0,8,3,11,869
0,0,1,0,1,0,1,870
1,1,0,1,1,1,2,870
2,2,0,1,1,2,3,870
3,3,0,2,1,4,5,870
4,4,1,3,2,7,9,870
5,5,0,0,2,7,9,870
0,0,1,0,1,0,1,871
1,1,1,1,2,1,3,871
2,2,0,1,2,2,4,871
3,3,0,0,2,2,4,871
0,0,1,0,1,0,1,872
1,1,0,0,1,0,1,872
0,0,1,0,1,0,1,873
1,1,0,0,1,0,1,873
0,0,1,0,1,0,1,874
1,1,1,0,2,0,2,874
2,2,1,0,3,0,3,874
3,3,0,1,3,1,4,874
4,4,0,0,3,1,4,874
0,0,1,0,1,0,1,875
1,1,0,0,1,0,1,875
0,0,1,0,1,0,1,876
1,1,1,0,2,0,2,876
2,2,2,0,4,0,4,876
3,3,1,0,5,0,5,876
4,4,1,0,6,0,6,876
5,5,0,0,6,0,6,876
0,0,1,0,1,0,1,877
1,1,1,0,2,0,2,877
2,2,1,0,3,0,3,877
3,3,0,0,3,0,3,877
0,0,1,0,1,0,1,878
1,1,1,1,2,1,3,878
2,2,1,0,3,1,4,878
3,3,1,0,4,1,5,878
4,4,0,0,4,1,5,878
0,0,1,0,1,0,1,879
1,1,0,0,1,0,1,879
0,0,1,0,1,0,1,880
1,1,1,0,2,0,2,880
2,2,0,0,2,0,2,880
0,0,1,0,1,0,1,881
1,1,1,1,2,1,3,881
2,2,0,0,2,1,3,881
0,0,1,0,1,0,1,882
1,1,0,0,1,0,1,882
0,0,1,0,1,0,1,883
1,1,1,1,2,1,3,883
2,2,2,0,4,1,5,883
3,3,2,0,6,1,7,883
4,4,4,0,10,1,11,883
5,5,1,2,11,3,14,883
6,6,2,3,13,6,19,883
7,7,3,4,16,10,26,883
8,8,3,3,19,13,32,883
9,9,2,3,21,16,37,883
10,10,2,4,23,20,43,883
11,11,4,1,27,21,48,883
12,12,3,3,30,24,54,883
13,13,5,1,35,25,60,883
14,14,7,1,42,26,68,883
15,15,2,0,44,26,70,883
16,16,0,1,44,27,71,883
17,17,0,0,44,27,71,883
0,0,1,0,1,0,1,884
1,1,1,1,2,1,3,884
2,2,0,1,2,2,4,884
3,3,1,0,3,2,5,884
4,4,0,1,3,3,6,884
5,5,1,3,4,6,10,884
6,6,5,5,9,11,20,884
7,7,5,3,14,14,28,884
8,8,3,3,17,17,34,884
9,9,2,1,19,18,37,884
10,10,0,2,19,20,39,884
11,11,1,1,20,21,41,884
12,12,1,1,21,22,43,884
13,13,0,1,21,23,44,884
14,14,0,0,21,23,44,884
0,0,1,0,1,0,1,885
1,1,0,0,1,0,1,885
0,0,1,0,1,0,1,886
1,1,2,0,3,0,3,886
2,2,1,0,4,0,4,886
3,3,2,0,6,0,6,886
4,4,2,2,8,2,10,886
5,5,6,0,14,2,16,886
6,6,2,0,16,2,18,886
7,7,3,1,19,3,22,886
8,8,2,0,21,3,24,886
9,9,3,0,24,3,27,886
10,10,2,0,26,3,29,886
11,11,1,1,27,4,31,886
12,12,2,0,29,4,33,886
13,13,1,2,30,6,36,886
14,14,0,0,30,6,36,886
0,0,1,0,1,0,1,887
1,1,0,0,1,0,1,887
0,0,1,0,1,0,1,888
1,1,1,0,2,0,2,888
2,2,0,0,2,0,2,888
0,0,1,0,1,0,1,889
1,1,1,0,2,0,2,889
2,2,1,0,3,0,3,889
3,3,1,0,4,0,4,889
4,4,0,0,4,0,4,889
0,0,1,0,1,0,1,890
1,1,1,0,2,0,2,890
2,2,0,0,2,0,2,890
0,0,1,0,1,0,1,891
1,1,0,0,1,0,1,891
0,0,1,0,1,0,1,892
1,1,1,0,2,0,2,892
2,2,1,0,3,0,3,892
3,3,2,0,5,0,5,892
4,4,1,0,6,0,6,892
5,5,0,0,6,0,6,892
0,0,1,0,1,0,1,893
1,1,1,0,2,0,2,893
2,2,0,0,2,0,2,893
0,0,1,0,1,0,1,894
1,1,1,0,2,0,2,894
2,2,0,0,2,0,2,894
0,0,1,0,1,0,1,895
1,1,1,0,2,0,2,895
2,2,0,0,2,0,2,895
0,0,1,0,1,0,1,896
1,1,0,1,1,1,2,896
2,2,0,1,1,2,3,896
3,3,1,0,2,2,4,896
4,4,1,0,3,2,5,896
5,5,1,0,4,2,6,896
6,6,2,0,6,2,8,896
7,7,0,0,6,2,8,896
0,0,1,0,1,0,1,897
1,1,0,0,1,0,1,897
0,0,1,0,1,0,1,898
1,1,0,0,1,0,1,898
0,0,1,0,1,0,1,899
1,1,0,1,1,1,2,899
2,2,0,1,1,2,3,899
3,3,0,0,1,2,3,899
0,0,1,0,1,0,1,900
1,1,1,0,2,0,2,900
2,2,0,0,2,0,2,900
0,0,1,0,1,0,1,901
1,1,0,0,1,0,1,901
0,0,1,0,1,0,1,902
1,1,1,0,2,0,2,902
2,2,1,0,3,0,3,902
3,3,1,0,4,0,4,902
4,4,0,1,4,1,5,902
5,5,0,0,4,1,5,902
0,0,1,0,1,0,1,903
1,1,1,0,2,0,2,903
2,2,0,0,2,0,2,903
0,0,1,0,1,0,1,904
1,1,0,0,1,0,1,904
0,0,1,0,1,0,1,905
1,1,0,1,1,1,2,905
2,2,0,1,1,2,3,905
3,3,0,4,1,6,7,905
4,4,1,6,2,12,14,905
5,5,0,4,2,16,18,905
6,6,1,3,3,19,22,905
7,7,0,3,3,22,25,905
8,8,0,4,3,26,29,905
9,9,2,2,5,28,33,905
10,10,0,2,5,30,35,905
11,11,0,1,5,31,36,905
12,12,0,0,5,31,36,905
0,0,1,0,1,0,1,906
1,1,1,0,2,0,2,906
2,2,2,0,4,0,4,906
3,3,2,1,6,1,7,906
4,4,2,1,8,2,10,906
5,5,0,1,8,3,11,906
6,6,1,2,9,5,14,906
7,7,1,1,10,6,16,906
8,8,1,2,11,8,19,906
9,9,1,3,12,11,23,906
10,10,1,5,13,16,29,906
11,11,0,5,13,21,34,906
12,12,1,7,14,28,42,906
13,13,1,6,15,34,49,906
14,14,1,5,16,39,55,906
15,15,3,7,19,46,65,906
16,16,11,4,30,50,80,906
17,17,10,6,40,56,96,906
18,18,11,4,51,60,111,906
19,19,11,5,62,65,127,906
20,20,5,4,67,69,136,906
21,21,3,6,70,75,145,906
22,22,2,7,72,82,154,906
23,23,2,11,74,93,167,906
24,24,5,13,79,106,185,906
25,25,10,15,89,121,210,906
26,26,9,6,98,127,225,906
27,27,5,5,103,132,235,906
28,28,6,2,109,134,243,906
29,29,4,3,113,137,250,906
30,30,3,2,116,139,255,906
31,31,3,2,119,141,260,906
32,32,1,5,120,146,266,906
33,33,2,1,122,147,269,906
34,34,2,2,124,149,273,906
35,35,0,1,124,150,274,906
36,36,0,0,124,150,274,906
0,0,1,0,1,0,1,907
1,1,1,0,2,0,2,907
2,2,0,0,2,0,2,907
0,0,1,0,1,0,1,908
1,1,1,0,2,0,2,908
2,2,0,0,2,0,2,908
0,0,1,0,1,0,1,909
1,1,0,0,1,0,1,909
0,0,1,0,1,0,1,910
1,1,0,1,1,1,2,910
2,2,0,0,1,1,2,910
0,0,1,0,1,0,1,911
1,1,1,0,2,0,2,911
2,2,0,0,2,0,2,911
0,0,1,0,1,0,1,912
1,1,0,0,1,0,1,912
0,0,1,0,1,0,1,913
1,1,0,1,1,1,2,913
2,2,0,1,1,2,3,913
3,3,1,1,2,3,5,913
4,4,2,0,4,3,7,913
5,5,1,0,5,3,8,913
6,6,1,0,6,3,9,913
7,7,1,0,7,3,10,913
8,8,2,1,9,4,13,913
9,9,1,1,10,5,15,913
10,10,1,1,11,6,17,913
11,11,1,0,12,6,18,913
12,12,2,0,14,6,20,913
13,13,3,2,17,8,25,913
14,14,0,3,17,11,28,913
15,15,0,4,17,15,32,913
16,16,0,2,17,17,34,913
17,17,0,2,17,19,36,913
18,18,1,3,18,22,40,913
19,19,4,3,22,25,47,913
20,20,2,0,24,25,49,913
21,21,3,0,27,25,52,913
22,22,2,0,29,25,54,913
23,23,1,0,30,25,55,913
24,24,0,0,30,25,55,913
0,0,1,0,1,0,1,914
1,1,1,0,2,0,2,914
2,2,0,0,2,0,2,914
0,0,1,0,1,0,1,915
1,1,1,0,2,0,2,915
2,2,2,0,4,0,4,915
3,3,5,0,9,0,9,915
4,4,3,0,12,0,12,915
5,5,3,0,15,0,15,915
6,6,4,0,19,0,19,915
7,7,9,0,28,0,28,915
8,8,7,0,35,0,35,915
9,9,5,0,40,0,40,915
10,10,4,0,44,0,44,915
11,11,2,0,46,0,46,915
12,12,0,0,46,0,46,915
0,0,1,0,1,0,1,916
1,1,0,0,1,0,1,916
0,0,1,0,1,0,1,917
1,1,0,0,1,0,1,917
0,0,1,0,1,0,1,918
1,1,0,0,1,0,1,918
0,0,1,0,1,0,1,919
1,1,1,0,2,0,2,919
2,2,0,0,2,0,2,919
0,0,1,0,1,0,1,920
1,1,1,0,2,0,2,920
2,2,1,1,3,1,4,920
3,3,0,0,3,1,4,920
0,0,1,0,1,0,1,921
1,1,1,0,2,0,2,921
2,2,1,0,3,0,3,921
3,3,1,0,4,0,4,921
4,4,0,1,4,1,5,921
5,5,0,0,4,1,5,921
0,0,1,0,1,0,1,922
1,1,0,0,1,0,1,922
0,0,1,0,1,0,1,923
1,1,2,0,3,0,3,923
2,2,1,0,4,0,4,923
3,3,5,0,9,0,9,923
4,4,4,2,13,2,15,923
5,5,4,2,17,4,21,923
6,6,7,3,24,7,31,923
7,7,6,9,30,16,46,923
8,8,7,5,37,21,58,923
9,9,8,4,45,25,70,923
10,10,8,4,53,29,82,923
11,11,3,7,56,36,92,923
12,12,3,6,59,42,101,923
13,13,3,1,62,43,105,923
14,14,3,0,65,43,108,923
15,15,2,0,67,43,110,923
16,16,2,2,69,45,114,923
17,17,3,2,72,47,119,923
18,18,4,0,76,47,123,923
19,19,3,0,79,47,126,923
20,20,1,0,80,47,127,923
21,21,1,0,81,47,128,923
22,22,1,0,82,47,129,923
23,23,1,0,83,47,130,923
24,24,1,0,84,47,131,923
25,25,0,0,84,47,131,923
0,0,1,0,1,0,1,924
1,1,1,1,2,1,3,924
2,2,1,0,3,1,4,924
3,3,3,0,6,1,7,924
4,4,1,1,7,2,9,924
5,5,1,3,8,5,13,924
6,6,0,5,8,10,18,924
7,7,2,3,10,13,23,924
8,8,0,2,10,15,25,924
9,9,1,1,11,16,27,924
10,10,2,1,13,17,30,924
11,11,1,0,14,17,31,924
12,12,1,0,15,17,32,924
13,13,1,0,16,17,33,924
14,14,0,1,16,18,34,924
15,15,0,1,16,19,35,924
16,16,1,0,17,19,36,924
17,17,1,0,18,19,37,924
18,18,0,1,18,20,38,924
19,19,0,0,18,20,38,924
0,0,1,0,1,0,1,925
1,1,1,0,2,0,2,925
2,2,0,0,2,0,2,925
0,0,1,0,1,0,1,926
1,1,0,1,1,1,2,926
2,2,0,1,1,2,3,926
3,3,0,1,1,3,4,926
4,4,2,2,3,5,8,926
5,5,3,1,6,6,12,926
6,6,4,0,10,6,16,926
7,7,3,0,13,6,19,926
8,8,2,1,15,7,22,926
9,9,0,0,15,7,22,926
0,0,1,0,1,0,1,927
1,1,2,0,3,0,3,927
2,2,4,0,7,0,7,927
3,3,3,1,10,1,11,927
4,4,1,3,11,4,15,927
5,5,0,3,11,7,18,927
6,6,2,3,13,10,23,927
7,7,0,3,13,13,26,927
8,8,0,0,13,13,26,927
0,0,1,0,1,0,1,928
1,1,1,0,2,0,2,928
2,2,1,0,3,0,3,928
3,3,0,0,3,0,3,928
0,0,1,0,1,0,1,929
1,1,0,0,1,0,1,929
0,0,1,0,1,0,1,930
1,1,2,0,3,0,3,930
2,2,2,0,5,0,5,930
3,3,2,1,7,1,8,930
4,4,0,1,7,2,9,930
5,5,0,1,7,3,10,930
6,6,0,0,7,3,10,930
0,0,1,0,1,0,1,931
1,1,1,1,2,1,3,931
2,2,1,0,3,1,4,931
3,3,1,0,4,1,5,931
4,4,1,1,5,2,7,931
5,5,0,1,5,3,8,931
6,6,0,0,5,3,8,931
0,0,1,0,1,0,1,932
1,1,1,0,2,0,2,932
2,2,1,0,3,0,3,932
3,3,0,0,3,0,3,932
0,0,1,0,1,0,1,933
1,1,0,0,1,0,1,933
0,0,1,0,1,0,1,934
1,1,2,0,3,0,3,934
2,2,3,0,6,0,6,934
3,3,4,0,10,0,10,934
4,4,3,0,13,0,13,934
5,5,1,4,14,4,18,934
6,6,2,1,16,5,21,934
7,7,0,0,16,5,21,934
0,0,1,0,1,0,1,935
1,1,0,0,1,0,1,935
0,0,1,0,1,0,1,936
1,1,0,0,1,0,1,936
0,0,1,0,1,0,1,937
1,1,0,1,1,1,2,937
2,2,1,0,2,1,3,937
3,3,1,0,3,1,4,937
4,4,0,0,3,1,4,937
0,0,1,0,1,0,1,938
1,1,0,0,1,0,1,938
0,0,1,0,1,0,1,939
1,1,0,0,1,0,1,939
0,0,1,0,1,0,1,940
1,1,2,0,3,0,3,940
2,2,2,1,5,1,6,940
3,3,1,3,6,4,10,940
4,4,3,2,9,6,15,940
5,5,2,1,11,7,18,940
6,6,3,1,14,8,22,940
7,7,4,1,18,9,27,940
8,8,2,1,20,10,30,940
9,9,2,1,22,11,33,940
10,10,2,0,24,11,35,940
11,11,1,0,25,11,36,940
12,12,0,0,25,11,36,940
0,0,1,0,1,0,1,941
1,1,0,0,1,0,1,941
0,0,1,0,1,0,1,942
1,1,0,0,1,0,1,942
0,0,1,0,1,0,1,943
1,1,1,0,2,0,2,943
2,2,2,0,4,0,4,943
3,3,3,0,7,0,7,943
4,4,1,2,8,2,10,943
5,5,2,0,10,2,12,943
6,6,2,0,12,2,14,943
7,7,0,1,12,3,15,943
8,8,0,1,12,4,16,943
9,9,0,0,12,4,16,943
0,0,1,0,1,0,1,944
1,1,1,0,2,0,2,944
2,2,2,1,4,1,5,944
3,3,2,2,6,3,9,944
4,4,0,0,6,3,9,944
0,0,1,0,1,0,1,945
1,1,0,0,1,0,1,945
0,0,1,0,1,0,1,946
1,1,0,0,1,0,1,946
0,0,1,0,1,0,1,947
1,1,0,0,1,0,1,947
0,0,1,0,1,0,1,948
1,1,1,0,2,0,2,948
2,2,0,0,2,0,2,948
0,0,1,0,1,0,1,949
1,1,2,0,3,0,3,949
2,2,2,0,5,0,5,949
3,3,2,0,7,0,7,949
4,4,3,0,10,0,10,949
5,5,4,0,14,0,14,949
6,6,2,1,16,1,17,949
7,7,1,1,17,2,19,949
8,8,0,1,17,3,20,949
9,9,0,1,17,4,21,949
10,10,1,0,18,4,22,949
11,11,1,0,19,4,23,949
12,12,0,0,19,4,23,949
0,0,1,0,1,0,1,950
1,1,0,1,1,1,2,950
2,2,1,0,2,1,3,950
3,3,1,0,3,1,4,950
4,4,0,0,3,1,4,950
0,0,1,0,1,0,1,951
1,1,0,1,1,1,2,951
2,2,0,1,1,2,3,951
3,3,0,0,1,2,3,951
0,0,1,0,1,0,1,952
1,1,0,1,1,1,2,952
2,2,0,0,1,1,2,952
0,0,1,0,1,0,1,953
1,1,1,0,2,0,2,953
2,2,2,0,4,0,4,953
3,3,0,0,4,0,4,953
0,0,1,0,1,0,1,954
1,1,1,0,2,0,2,954
2,2,2,0,4,0,4,954
3,3,0,1,4,1,5,954
4,4,0,1,4,2,6,954
5,5,0,0,4,2,6,954
0,0,1,0,1,0,1,955
1,1,0,0,1,0,1,955
0,0,1,0,1,0,1,956
1,1,1,0,2,0,2,956
2,2,1,0,3,0,3,956
3,3,1,0,4,0,4,956
4,4,0,0,4,0,4,956
0,0,1,0,1,0,1,957
1,1,3,0,4,0,4,957
2,2,4,1,8,1,9,957
3,3,6,2,14,3,17,957
4,4,5,0,19,3,22,957
5,5,3,0,22,3,25,957
6,6,4,2,26,5,31,957
7,7,7,2,33,7,40,957
8,8,5,1,38,8,46,957
9,9,5,2,43,10,53,957
10,10,4,5,47,15,62,957
11,11,10,7,57,22,79,957
12,12,11,7,68,29,97,957
13,13,9,8,77,37,114,957
14,14,12,6,89,43,132,957
15,15,10,8,99,51,150,957
16,16,6,5,105,56,161,957
17,17,8,5,113,61,174,957
18,18,8,5,121,66,187,957
19,19,5,2,126,68,194,957
20,20,5,3,131,71,202,957
21,21,2,3,133,74,207,957
22,22,0,1,133,75,208,957
23,23,0,1,133,76,209,957
24,24,1,2,134,78,212,957
25,25,1,1,135,79,214,957
26,26,1,0,136,79,215,957
27,27,0,0,136,79,215,957
0,0,1,0,1,0,1,958
1,1,0,0,1,0,1,958
0,0,1,0,1,0,1,959
1,1,2,0,3,0,3,959
2,2,1,1,4,1,5,959
3,3,0,1,4,2,6,959
4,4,1,1,5,3,8,959
5,5,1,2,6,5,11,959
6,6,2,1,8,6,14,959
7,7,2,2,10,8,18,959
8,8,1,3,11,11,22,959
9,9,2,4,13,15,28,959
10,10,2,2,15,17,32,959
11,11,4,0,19,17,36,959
12,12,2,2,21,19,40,959
13,13,1,3,22,22,44,959
14,14,1,2,23,24,47,959
15,15,0,3,23,27,50,959
16,16,0,2,23,29,52,959
17,17,0,2,23,31,54,959
18,18,0,1,23,32,55,959
19,19,1,1,24,33,57,959
20,20,0,3,24,36,60,959
21,21,0,1,24,37,61,959
22,22,1,0,25,37,62,959
23,23,1,0,26,37,63,959
24,24,0,0,26,37,63,959
0,0,1,0,1,0,1,960
1,1,1,0,2,0,2,960
2,2,2,0,4,0,4,960
3,3,2,1,6,1,7,960
4,4,1,2,7,3,10,960
5,5,1,2,8,5,13,960
6,6,2,2,10,7,17,960
7,7,1,3,11,10,21,960
8,8,0,2,11,12,23,960
9,9,1,2,12,14,26,960
10,10,2,1,14,15,29,960
11,11,3,0,17,15,32,960
12,12,1,1,18,16,34,960
13,13,1,1,19,17,36,960
14,14,0,1,19,18,37,960
15,15,1,1,20,19,39,960
16,16,0,1,20,20,40,960
17,17,0,0,20,20,40,960
0,0,1,0,1,0,1,961
1,1,0,2,1,2,3,961
2,2,0,4,1,6,7,961
3,3,1,1,2,7,9,961
4,4,0,0,2,7,9,961
0,0,1,0,1,0,1,962
1,1,2,1,3,1,4,962
2,2,2,1,5,2,7,962
3,3,4,1,9,3,12,962
4,4,2,1,11,4,15,962
5,5,1,0,12,4,16,962
6,6,0,0,12,4,16,962
0,0,1,0,1,0,1,963
1,1,2,0,3,0,3,963
2,2,1,0,4,0,4,963
3,3,0,1,4,1,5,963
4,4,0,0,4,1,5,963
0,0,1,0,1,0,1,964
1,1,0,0,1,0,1,964
0,0,1,0,1,0,1,965
1,1,0,0,1,0,1,965
0,0,1,0,1,0,1,966
1,1,1,0,2,0,2,966
2,2,0,0,2,0,2,966
0,0,1,0,1,0,1,967
1,1,2,0,3,0,3,967
2,2,2,0,5,0,5,967
3,3,0,0,5,0,5,967
0,0,1,0,1,0,1,968
1,1,2,0,3,0,3,968
2,2,1,0,4,0,4,968
3,3,1,1,5,1,6,968
4,4,0,2,5,3,8,968
5,5,0,2,5,5,10,968
6,6,0,0,5,5,10,968
0,0,1,0,1,0,1,969
1,1,1,0,2,0,2,969
2,2,0,0,2,0,2,969
0,0,1,0,1,0,1,970
1,1,1,0,2,0,2,970
2,2,2,0,4,0,4,970
3,3,0,0,4,0,4,970
0,0,1,0,1,0,1,971
1,1,1,0,2,0,2,971
2,2,2,0,4,0,4,971
3,3,2,1,6,1,7,971
4,4,4,1,10,2,12,971
5,5,2,0,12,2,14,971
6,6,1,3,13,5,18,971
7,7,0,1,13,6,19,971
8,8,0,1,13,7,20,971
9,9,0,1,13,8,21,971
10,10,0,0,13,8,21,971
0,0,1,0,1,0,1,972
1,1,1,0,2,0,2,972
2,2,1,0,3,0,3,972
3,3,0,0,3,0,3,972
0,0,1,0,1,0,1,973
1,1,1,0,2,0,2,973
2,2,2,1,4,1,5,973
3,3,2,1,6,2,8,973
4,4,0,0,6,2,8,973
0,0,1,0,1,0,1,974
1,1,0,0,1,0,1,974
0,0,1,0,1,0,1,975
1,1,0,0,1,0,1,975
0,0,1,0,1,0,1,976
1,1,0,0,1,0,1,976
0,0,1,0,1,0,1,977
1,1,0,0,1,0,1,977
0,0,1,0,1,0,1,978
1,1,2,0,3,0,3,978
2,2,1,0,4,0,4,978
3,3,0,0,4,0,4,978
0,0,1,0,1,0,1,979
1,1,3,0,4,0,4,979
2,2,2,0,6,0,6,979
3,3,0,0,6,0,6,979
0,0,1,0,1,0,1,980
1,1,0,0,1,0,1,980
0,0,1,0,1,0,1,981
1,1,0,0,1,0,1,981
0,0,1,0,1,0,1,982
1,1,0,1,1,1,2,982
2,2,0,2,1,3,4,982
3,3,2,1,3,4,7,982
4,4,2,2,5,6,11,982
5,5,0,2,5,8,13,982
6,6,1,3,6,11,17,982
7,7,1,2,7,13,20,982
8,8,2,1,9,14,23,982
9,9,2,1,11,15,26,982
10,10,0,0,11,15,26,982
0,0,1,0,1,0,1,983
1,1,0,0,1,0,1,983
0,0,1,0,1,0,1,984
1,1,1,0,2,0,2,984
2,2,1,0,3,0,3,984
3,3,2,0,5,0,5,984
4,4,0,1,5,1,6,984
5,5,0,0,5,1,6,984
0,0,1,0,1,0,1,985
1,1,0,0,1,0,1,985
0,0,1,0,1,0,1,986
1,1,0,1,1,1,2,986
2,2,0,0,1,1,2,986
0,0,1,0,1,0,1,987
1,1,0,0,1,0,1,987
0,0,1,0,1,0,1,988
1,1,0,0,1,0,1,988
0,0,1,0,1,0,1,989
1,1,0,0,1,0,1,989
0,0,1,0,1,0,1,990
1,1,1,0,2,0,2,990
2,2,2,0,4,0,4,990
3,3,3,1,7,1,8,990
4,4,2,1,9,2,11,990
5,5,2,1,11,3,14,990
6,6,0,1,11,4,15,990
7,7,0,0,11,4,15,990
0,0,1,0,1,0,1,991
1,1,1,0,2,0,2,991
2,2,1,1,3,1,4,991
3,3,1,0,4,1,5,991
4,4,1,1,5,2,7,991
5,5,0,1,5,3,8,991
6,6,1,0,6,3,9,991
7,7,1,0,7,3,10,991
8,8,0,0,7,3,10,991
0,0,1,0,1,0,1,992
1,1,0,0,1,0,1,992
0,0,1,0,1,0,1,993
1,1,0,0,1,0,1,993
0,0,1,0,1,0,1,994
1,1,0,1,1,1,2,994
2,2,0,2,1,3,4,994
3,3,0,0,1,3,4,994
0,0,1,0,1,0,1,995
1,1,0,1,1,1,2,995
2,2,0,2,1,3,4,995
3,3,0,0,1,3,4,995
0,0,1,0,1,0,1,996
1,1,0,0,1,0,1,996
0,0,1,0,1,0,1,997
1,1,0,0,1,0,1,997
0,0,1,0,1,0,1,998
1,1,1,0,2,0,2,998
2,2,1,0,3,0,3,998
3,3,0,0,3,0,3,998
0,0,1,0,1,0,1,999
1,1,0,0,1,0,1,999
0,0,1,0,1,0,1,1000
1,1,0,0,1,0,1,1000
0,0,1,0,1,0,1,1001
1,1,0,1,1,1,2,1001
2,2,1,0,2,1,3,1001
3,3,0,0,2,1,3,1001
0,0,1,0,1,0,1,1002
1,1,1,0,2,0,2,1002
2,2,0,0,2,0,2,1002
0,0,1,0,1,0,1,1003
1,1,0,0,1,0,1,1003
0,0,1,0,1,0,1,1004
1,1,0,0,1,0,1,1004
0,0,1,0,1,0,1,1005
1,1,0,1,1,1,2,1005
2,2,1,1,2,2,4,1005
3,3,0,1,2,3,5,1005
4,4,0,1,2,4,6,1005
5,5,0,0,2,4,6,1005
0,0,1,0,1,0,1,1006
1,1,2,0,3,0,3,1006
2,2,1,0,4,0,4,1006
3,3,1,0,5,0,5,1006
4,4,1,0,6,0,6,1006
5,5,2,0,8,0,8,1006
6,6,1,0,9,0,9,1006
7,7,1,0,10,0,10,1006
8,8,0,0,10,0,10,1006
0,0,1,0,1,0,1,1007
1,1,0,0,1,0,1,1007
0,0,1,0,1,0,1,1008
1,1,2,0,3,0,3,1008
2,2,3,0,6,0,6,1008
3,3,1,1,7,1,8,1008
4,4,0,1,7,2,9,1008
5,5,0,0,7,2,9,1008
0,0,1,0,1,0,1,1009
1,1,0,0,1,0,1,1009
0,0,1,0,1,0,1,1010
1,1,0,0,1,0,1,1010
0,0,1,0,1,0,1,1011
1,1,1,0,2,0,2,1011
2,2,0,0,2,0,2,1011
0,0,1,0,1,0,1,1012
1,1,1,1,2,1,3,1012
2,2,4,0,6,1,7,1012
3,3,1,1,7,2,9,1012
4,4,0,1,7,3,10,1012
5,5,0,1,7,4,11,1012
6,6,0,0,7,4,11,1012
0,0,1,0,1,0,1,1013
1,1,0,0,1,0,1,1013
0,0,1,0,1,0,1,1014
1,1,1,0,2,0,2,1014
2,2,0,0,2,0,2,1014
0,0,1,0,1,0,1,1015
1,1,0,0,1,0,1,1015
0,0,1,0,1,0,1,1016
1,1,0,0,1,0,1,1016
0,0,1,0,1,0,1,1017
1,1,0,0,1,0,1,1017
0,0,1,0,1,0,1,1018
1,1,0,1,1,1,2,1018
2,2,0,2,1,3,4,1018
3,3,0,0,1,3,4,1018
0,0,1,0,1,0,1,1019
1,1,0,0,1,0,1,1019
0,0,1,0,1,0,1,1020
1,1,0,0,1,0,1,1020
0,0,1,0,1,0,1,1021
1,1,2,0,3,0,3,1021
2,2,1,0,4,0,4,1021
3,3,0,1,4,1,5,1021
4,4,0,1,4,2,6,1021
5,5,0,1,4,3,7,1021
6,6,0,1,4,4,8,1021
7,7,0,0,4,4,8,1021
0,0,1,0,1,0,1,1022
1,1,0,1,1,1,2,1022
2,2,0,0,1,1,2,1022
0,0,1,0,1,0,1,1023
1,1,1,0,2,0,2,1023
2,2,0,0,2,0,2,1023
0,0,1,0,1,0,1,1024
1,1,3,0,4,0,4,1024
2,2,1,0,5,0,5,1024
3,3,0,0,5,0,5,1024
0,0,1,0,1,0,1,1025
1,1,0,0,1,0,1,1025
0,0,1,0,1,0,1,1026
1,1,2,0,3,0,3,1026
2,2,2,1,5,1,6,1026
3,3,3,1,8,2,10,1026
4,4,1,1,9,3,12,1026
5,5,3,4,12,7,19,1026
6,6,1,3,13,10,23,1026
7,7,0,3,13,13,26,1026
8,8,0,3,13,16,29,1026
9,9,1,3,14,19,33,1026
10,10,2,2,16,21,37,1026
11,11,1,2,17,23,40,1026
12,12,1,1,18,24,42,1026
13,13,0,0,18,24,42,1026
0,0,1,0,1,0,1,1027
1,1,0,0,1,0,1,1027
0,0,1,0,1,0,1,1028
1,1,1,0,2,0,2,1028
2,2,0,0,2,0,2,1028
0,0,1,0,1,0,1,1029
1,1,0,0,1,0,1,1029
0,0,1,0,1,0,1,1030
1,1,0,0,1,0,1,1030
0,0,1,0,1,0,1,1031
1,1,1,0,2,0,2,1031
2,2,2,0,4,0,4,1031
3,3,4,0,8,0,8,1031
4,4,3,0,11,0,11,1031
5,5,3,0,14,0,14,1031
6,6,1,1,15,1,16,1031
7,7,0,1,15,2,17,1031
8,8,0,1,15,3,18,1031
9,9,0,2,15,5,20,1031
10,10,0,3,15,8,23,1031
11,11,2,3,17,11,28,1031
12,12,1,6,18,17,35,1031
13,13,2,9,20,26,46,1031
14,14,2,9,22,35,57,1031
15,15,2,9,24,44,68,1031
16,16,3,9,27,53,80,1031
17,17,3,8,30,61,91,1031
18,18,3,6,33,67,100,1031
19,19,2,3,35,70,105,1031
20,20,0,1,35,71,106,1031
21,21,0,1,35,72,107,1031
22,22,0,1,35,73,108,1031
23,23,0,1,35,74,109,1031
24,24,0,1,35,75,110,1031
25,25,0,0,35,75,110,1031
0,0,1,0,1,0,1,1032
1,1,0,0,1,0,1,1032
0,0,1,0,1,0,1,1033
1,1,1,0,2,0,2,1033
2,2,0,0,2,0,2,1033
0,0,1,0,1,0,1,1034
1,1,0,0,1,0,1,1034
0,0,1,0,1,0,1,1035
1,1,1,0,2,0,2,1035
2,2,1,0,3,0,3,1035
3,3,1,0,4,0,4,1035
4,4,1,0,5,0,5,1035
5,5,1,0,6,0,6,1035
6,6,2,0,8,0,8,1035
7,7,1,0,9,0,9,1035
8,8,1,0,10,0,10,1035
9,9,2,0,12,0,12,1035
10,10,1,0,13,0,13,1035
11,11,1,0,14,0,14,1035
12,12,1,0,15,0,15,1035
13,13,1,0,16,0,16,1035
14,14,2,0,18,0,18,1035
15,15,1,1,19,1,20,1035
16,16,0,1,19,2,21,1035
17,17,0,4,19,6,25,1035
18,18,1,8,20,14,34,1035
19,19,3,5,23,19,42,1035
20,20,1,3,24,22,46,1035
21,21,0,1,24,23,47,1035
22,22,0,1,24,24,48,1035
23,23,0,2,24,26,50,1035
24,24,1,1,25,27,52,1035
25,25,0,0,25,27,52,1035
0,0,1,0,1,0,1,1036
1,1,1,0,2,0,2,1036
2,2,0,0,2,0,2,1036
0,0,1,0,1,0,1,1037
1,1,2,0,3,0,3,1037
2,2,1,0,4,0,4,1037
3,3,1,0,5,0,5,1037
4,4,1,0,6,0,6,1037
5,5,1,0,7,0,7,1037
6,6,1,0,8,0,8,1037
7,7,1,0,9,0,9,1037
8,8,0,0,9,0,9,1037
0,0,1,0,1,0,1,1038
1,1,1,0,2,0,2,1038
2,2,1,0,3,0,3,1038
3,3,0,0,3,0,3,1038
0,0,1,0,1,0,1,1039
1,1,0,0,1,0,1,1039
0,0,1,0,1,0,1,1040
1,1,1,0,2,0,2,1040
2,2,1,1,3,1,4,1040
3,3,0,0,3,1,4,1040
0,0,1,0,1,0,1,1041
1,1,0,0,1,0,1,1041
0,0,1,0,1,0,1,1042
1,1,0,0,1,0,1,1042
0,0,1,0,1,0,1,1043
1,1,0,0,1,0,1,1043
0,0,1,0,1,0,1,1044
1,1,1,0,2,0,2,1044
2,2,0,1,2,1,3,1044
3,3,0,0,2,1,3,1044
0,0,1,0,1,0,1,1045
1,1,2,0,3,0,3,1045
2,2,1,0,4,0,4,1045
3,3,1,0,5,0,5,1045
4,4,1,0,6,0,6,1045
5,5,1,0,7,0,7,1045
6,6,2,0,9,0,9,1045
7,7,2,1,11,1,12,1045
8,8,2,0,13,1,14,1045
9,9,1,0,14,1,15,1045
10,10,2,0,16,1,17,1045
11,11,2,0,18,1,19,1045
12,12,1,0,19,1,20,1045
13,13,0,1,19,2,21,1045
14,14,0,0,19,2,21,1045
0,0,1,0,1,0,1,1046
1,1,1,1,2,1,3,1046
2,2,0,0,2,1,3,1046
0,0,1,0,1,0,1,1047
1,1,1,1,2,1,3,1047
2,2,0,1,2,2,4,1047
3,3,1,1,3,3,6,1047
4,4,0,2,3,5,8,1047
5,5,0,1,3,6,9,1047
6,6,0,0,3,6,9,1047
0,0,1,0,1,0,1,1048
1,1,0,0,1,0,1,1048
0,0,1,0,1,0,1,1049
1,1,0,0,1,0,1,1049
0,0,1,0,1,0,1,1050
1,1,2,0,3,0,3,1050
2,2,4,0,7,0,7,1050
3,3,3,2,10,2,12,1050
4,4,2,2,12,4,16,1050
5,5,1,5,13,9,22,1050
6,6,1,3,14,12,26,1050
7,7,2,3,16,15,31,1050
8,8,1,1,17,16,33,1050
9,9,1,0,18,16,34,1050
10,10,2,0,20,16,36,1050
11,11,1,0,21,16,37,1050
12,12,1,0,22,16,38,1050
13,13,0,0,22,16,38,1050
0,0,1,0,1,0,1,1051
1,1,1,0,2,0,2,1051
2,2,0,0,2,0,2,1051
0,0,1,0,1,0,1,1052
1,1,3,0,4,0,4,1052
2,2,4,0,8,0,8,1052
3,3,4,1,12,1,13,1052
4,4,6,1,18,2,20,1052
5,5,2,2,20,4,24,1052
6,6,3,1,23,5,28,1052
7,7,6,0,29,5,34,1052
8,8,8,0,37,5,42,1052
9,9,3,2,40,7,47,1052
10,10,4,1,44,8,52,1052
11,11,0,2,44,10,54,1052
12,12,0,2,44,12,56,1052
13,13,0,2,44,14,58,1052
14,14,0,0,44,14,58,1052
0,0,1,0,1,0,1,1053
1,1,0,0,1,0,1,1053
0,0,1,0,1,0,1,1054
1,1,1,0,2,0,2,1054
2,2,1,0,3,0,3,1054
3,3,2,0,5,0,5,1054
4,4,3,0,8,0,8,1054
5,5,4,0,12,0,12,1054
6,6,3,0,15,0,15,1054
7,7,2,0,17,0,17,1054
8,8,5,0,22,0,22,1054
9,9,2,0,24,0,24,1054
10,10,0,0,24,0,24,1054
0,0,1,0,1,0,1,1055
1,1,0,1,1,1,2,1055
2,2,0,0,1,1,2,1055
0,0,1,0,1,0,1,1056
1,1,0,0,1,0,1,1056
0,0,1,0,1,0,1,1057
1,1,0,0,1,0,1,1057
0,0,1,0,1,0,1,1058
1,1,1,0,2,0,2,1058
2,2,0,1,2,1,3,1058
3,3,0,1,2,2,4,1058
4,4,0,0,2,2,4,1058
0,0,1,0,1,0,1,1059
1,1,1,0,2,0,2,1059
2,2,0,1,2,1,3,1059
3,3,1,1,3,2,5,1059
4,4,2,0,5,2,7,1059
5,5,0,1,5,3,8,1059
6,6,0,1,5,4,9,1059
7,7,0,1,5,5,10,1059
8,8,0,1,5,6,11,1059
9,9,1,0,6,6,12,1059
10,10,1,0,7,6,13,1059
11,11,2,0,9,6,15,1059
12,12,2,0,11,6,17,1059
13,13,2,1,13,7,20,1059
14,14,1,0,14,7,21,1059
15,15,2,0,16,7,23,1059
16,16,4,0,20,7,27,1059
17,17,2,1,22,8,30,1059
18,18,2,1,24,9,33,1059
19,19,3,1,27,10,37,1059
20,20,1,1,28,11,39,1059
21,21,1,2,29,13,42,1059
22,22,2,0,31,13,44,1059
23,23,2,1,33,14,47,1059
24,24,1,1,34,15,49,1059
25,25,0,0,34,15,49,1059
0,0,1,0,1,0,1,1060
1,1,2,0,3,0,3,1060
2,2,1,0,4,0,4,1060
3,3,1,1,5,1,6,1060
4,4,1,1,6,2,8,1060
5,5,0,2,6,4,10,1060
6,6,1,1,7,5,12,1060
7,7,0,2,7,7,14,1060
8,8,1,2,8,9,17,1060
9,9,1,1,9,10,19,1060
10,10,1,0,10,10,20,1060
11,11,1,0,11,10,21,1060
12,12,1,0,12,10,22,1060
13,13,2,1,14,11,25,1060
14,14,0,1,14,12,26,1060
15,15,0,1,14,13,27,1060
16,16,0,0,14,13,27,1060
0,0,1,0,1,0,1,1061
1,1,1,0,2,0,2,1061
2,2,0,0,2,0,2,1061
0,0,1,0,1,0,1,1062
1,1,0,0,1,0,1,1062
0,0,1,0,1,0,1,1063
1,1,0,0,1,0,1,1063
0,0,1,0,1,0,1,1064
1,1,0,1,1,1,2,1064
2,2,1,0,2,1,3,1064
3,3,0,0,2,1,3,1064
0,0,1,0,1,0,1,1065
1,1,0,0,1,0,1,1065
0,0,1,0,1,0,1,1066
1,1,0,0,1,0,1,1066
0,0,1,0,1,0,1,1067
1,1,0,1,1,1,2,1067
2,2,1,0,2,1,3,1067
3,3,2,0,4,1,5,1067
4,4,2,0,6,1,7,1067
5,5,4,0,10,1,11,1067
6,6,5,1,15,2,17,1067
7,7,5,2,20,4,24,1067
8,8,2,3,22,7,29,1067
9,9,5,1,27,8,35,1067
10,10,5,3,32,11,43,1067
11,11,4,5,36,16,52,1067
12,12,5,5,41,21,62,1067
13,13,3,5,44,26,70,1067
14,14,3,1,47,27,74,1067
15,15,4,1,51,28,79,1067
16,16,2,0,53,28,81,1067
17,17,4,0,57,28,85,1067
18,18,2,1,59,29,88,1067
19,19,2,0,61,29,90,1067
20,20,0,1,61,30,91,1067
21,21,0,3,61,33,94,1067
22,22,0,2,61,35,96,1067
23,23,0,0,61,35,96,1067
0,0,1,0,1,0,1,1068
1,1,0,0,1,0,1,1068
0,0,1,0,1,0,1,1069
1,1,3,0,4,0,4,1069
2,2,4,0,8,0,8,1069
3,3,4,1,12,1,13,1069
4,4,2,1,14,2,16,1069
5,5,2,1,16,3,19,1069
6,6,2,0,18,3,21,1069
7,7,3,1,21,4,25,1069
8,8,2,2,23,6,29,1069
9,9,3,2,26,8,34,1069
10,10,3,3,29,11,40,1069
11,11,2,1,31,12,43,1069
12,12,4,1,35,13,48,1069
13,13,4,1,39,14,53,1069
14,14,6,0,45,14,59,1069
15,15,7,4,52,18,70,1069
16,16,6,7,58,25,83,1069
17,17,6,5,64,30,94,1069
18,18,6,5,70,35,105,1069
19,19,8,4,78,39,117,1069
20,20,5,3,83,42,125,1069
21,21,4,5,87,47,134,1069
22,22,1,7,88,54,142,1069
23,23,4,5,92,59,151,1069
24,24,0,2,92,61,153,1069
25,25,0,2,92,63,155,1069
26,26,1,2,93,65,158,1069
27,27,2,1,95,66,161,1069
28,28,3,3,98,69,167,1069
29,29,3,2,101,71,172,1069
30,30,4,1,105,72,177,1069
31,31,2,1,107,73,180,1069
32,32,2,1,109,74,183,1069
33,33,3,1,112,75,187,1069
34,34,0,0,112,75,187,1069
0,0,1,0,1,0,1,1070
1,1,2,0,3,0,3,1070
2,2,1,0,4,0,4,1070
3,3,1,0,5,0,5,1070
4,4,1,0,6,0,6,1070
5,5,0,0,6,0,6,1070
0,0,1,0,1,0,1,1071
1,1,1,0,2,0,2,1071
2,2,0,1,2,1,3,1071
3,3,0,2,2,3,5,1071
4,4,0,1,2,4,6,1071
5,5,0,2,2,6,8,1071
6,6,1,1,3,7,10,1071
7,7,0,0,3,7,10,1071
0,0,1,0,1,0,1,1072
1,1,0,0,1,0,1,1072
0,0,1,0,1,0,1,1073
1,1,2,0,3,0,3,1073
2,2,6,0,9,0,9,1073
3,3,4,0,13,0,13,1073
4,4,0,1,13,1,14,1073
5,5,0,0,13,1,14,1073
0,0,1,0,1,0,1,1074
1,1,1,0,2,0,2,1074
2,2,3,0,5,0,5,1074
3,3,1,0,6,0,6,1074
4,4,1,1,7,1,8,1074
5,5,1,0,8,1,9,1074
6,6,1,1,9,2,11,1074
7,7,2,0,11,2,13,1074
8,8,1,0,12,2,14,1074
9,9,1,0,13,2,15,1074
10,10,2,1,15,3,18,1074
11,11,1,0,16,3,19,1074
12,12,3,1,19,4,23,1074
13,13,0,0,19,4,23,1074
0,0,1,0,1,0,1,1075
1,1,0,0,1,0,1,1075
0,0,1,0,1,0,1,1076
1,1,2,0,3,0,3,1076
2,2,2,2,5,2,7,1076
3,3,3,1,8,3,11,1076
4,4,2,2,10,5,15,1076
5,5,1,4,11,9,20,1076
6,6,1,2,12,11,23,1076
7,7,0,0,12,11,23,1076
0,0,1,0,1,0,1,1077
1,1,1,0,2,0,2,1077
2,2,1,0,3,0,3,1077
3,3,0,0,3,0,3,1077
0,0,1,0,1,0,1,1078
1,1,1,0,2,0,2,1078
2,2,1,0,3,0,3,1078
3,3,0,0,3,0,3,1078
0,0,1,0,1,0,1,1079
1,1,0,0,1,0,1,1079
0,0,1,0,1,0,1,1080
1,1,1,1,2,1,3,1080
2,2,1,1,3,2,5,1080
3,3,1,1,4,3,7,1080
4,4,1,1,5,4,9,1080
5,5,0,1,5,5,10,1080
6,6,0,1,5,6,11,1080
7,7,0,1,5,7,12,1080
8,8,1,0,6,7,13,1080
9,9,1,0,7,7,14,1080
10,10,2,0,9,7,16,1080
11,11,2,0,11,7,18,1080
12,12,1,1,12,8,20,1080
13,13,2,2,14,10,24,1080
14,14,1,2,15,12,27,1080
15,15,1,0,16,12,28,1080
16,16,1,0,17,12,29,1080
17,17,1,0,18,12,30,1080
18,18,0,0,18,12,30,1080
0,0,1,0,1,0,1,1081
1,1,1,1,2,1,3,1081
2,2,0,0,2,1,3,1081
0,0,1,0,1,0,1,1082
1,1,0,0,1,0,1,1082
0,0,1,0,1,0,1,1083
1,1,0,0,1,0,1,1083
0,0,1,0,1,0,1,1084
1,1,1,0,2,0,2,1084
2,2,0,0,2,0,2,1084
0,0,1,0,1,0,1,1085
1,1,0,1,1,1,2,1085
2,2,0,2,1,3,4,1085
3,3,0,1,1,4,5,1085
4,4,0,1,1,5,6,1085
5,5,0,0,1,5,6,1085
0,0,1,0,1,0,1,1086
1,1,0,0,1,0,1,1086
0,0,1,0,1,0,1,1087
1,1,0,0,1,0,1,1087
0,0,1,0,1,0,1,1088
1,1,2,0,3,0,3,1088
2,2,0,0,3,0,3,1088
0,0,1,0,1,0,1,1089
1,1,0,0,1,0,1,1089
0,0,1,0,1,0,1,1090
1,1,0,0,1,0,1,1090
0,0,1,0,1,0,1,1091
1,1,0,0,1,0,1,1091
0,0,1,0,1,0,1,1092
1,1,1,1,2,1,3,1092
2,2,0,0,2,1,3,1092
0,0,1,0,1,0,1,1093
1,1,0,0,1,0,1,1093
0,0,1,0,1,0,1,1094
1,1,1,0,2,0,2,1094
2,2,1,0,3,0,3,1094
3,3,2,0,5,0,5,1094
4,4,2,3,7,3,10,1094
5,5,3,1,10,4,14,1094
6,6,1,1,11,5,16,1094
7,7,0,1,11,6,17,1094
8,8,0,2,11,8,19,1094
9,9,2,0,13,8,21,1094
10,10,3,1,16,9,25,1094
11,11,2,1,18,10,28,1094
12,12,2,1,20,11,31,1094
13,13,1,0,21,11,32,1094
14,14,0,1,21,12,33,1094
15,15,0,0,21,12,33,1094
0,0,1,0,1,0,1,1095
1,1,0,0,1,0,1,1095
0,0,1,0,1,0,1,1096
1,1,0,0,1,0,1,1096
0,0,1,0,1,0,1,1097
1,1,1,0,2,0,2,1097
2,2,0,0,2,0,2,1097
0,0,1,0,1,0,1,1098
1,1,1,0,2,0,2,1098
2,2,0,1,2,1,3,1098
3,3,1,1,3,2,5,1098
4,4,3,2,6,4,10,1098
5,5,3,1,9,5,14,1098
6,6,0,0,9,5,14,1098
0,0,1,0,1,0,1,1099
1,1,0,1,1,1,2,1099
2,2,0,0,1,1,2,1099
0,0,1,0,1,0,1,1100
1,1,0,0,1,0,1,1100
0,0,1,0,1,0,1,1101
1,1,0,0,1,0,1,1101
0,0,1,0,1,0,1,1102
1,1,1,1,2,1,3,1102
2,2,0,1,2,2,4,1102
3,3,0,2,2,4,6,1102
4,4,0,2,2,6,8,1102
5,5,0,4,2,10,12,1102
6,6,0,5,2,15,17,1102
7,7,3,1,5,16,21,1102
8,8,2,1,7,17,24,1102
9,9,2,1,9,18,27,1102
10,10,2,1,11,19,30,1102
11,11,3,0,14,19,33,1102
12,12,2,0,16,19,35,1102
13,13,1,0,17,19,36,1102
14,14,0,0,17,19,36,1102
0,0,1,0,1,0,1,1103
1,1,0,0,1,0,1,1103
0,0,1,0,1,0,1,1104
1,1,0,0,1,0,1,1104
0,0,1,0,1,0,1,1105
1,1,3,0,4,0,4,1105
2,2,1,2,5,2,7,1105
3,3,2,1,7,3,10,1105
4,4,3,1,10,4,14,1105
5,5,2,3,12,7,19,1105
6,6,2,2,14,9,23,1105
7,7,2,1,16,10,26,1105
8,8,3,2,19,12,31,1105
9,9,0,3,19,15,34,1105
10,10,1,0,20,15,35,1105
11,11,0,0,20,15,35,1105
0,0,1,0,1,0,1,1106
1,1,1,1,2,1,3,1106
2,2,1,2,3,3,6,1106
3,3,1,1,4,4,8,1106
4,4,1,2,5,6,11,1106
5,5,5,1,10,7,17,1106
6,6,1,2,11,9,20,1106
7,7,2,7,13,16,29,1106
8,8,2,5,15,21,36,1106
9,9,6,1,21,22,43,1106
10,10,7,2,28,24,52,1106
11,11,1,4,29,28,57,1106
12,12,0,4,29,32,61,1106
13,13,0,1,29,33,62,1106
14,14,0,1,29,34,63,1106
15,15,0,1,29,35,64,1106
16,16,0,0,29,35,64,1106
0,0,1,0,1,0,1,1107
1,1,0,0,1,0,1,1107
0,0,1,0,1,0,1,1108
1,1,0,0,1,0,1,1108
0,0,1,0,1,0,1,1109
1,1,1,0,2,0,2,1109
2,2,0,0,2,0,2,1109
0,0,1,0,1,0,1,1110
1,1,1,0,2,0,2,1110
2,2,0,0,2,0,2,1110
0,0,1,0,1,0,1,1111
1,1,1,1,2,1,3,1111
2,2,0,0,2,1,3,1111
0,0,1,0,1,0,1,1112
1,1,1,0,2,0,2,1112
2,2,0,0,2,0,2,1112
0,0,1,0,1,0,1,1113
1,1,1,0,2,0,2,1113
2,2,1,0,3,0,3,1113
3,3,1,0,4,0,4,1113
4,4,0,0,4,0,4,1113
0,0,1,0,1,0,1,1114
1,1,2,0,3,0,3,1114
2,2,1,2,4,2,6,1114
3,3,2,1,6,3,9,1114
4,4,1,2,7,5,12,1114
5,5,0,2,7,7,14,1114
6,6,1,2,8,9,17,1114
7,7,1,3,9,12,21,1114
8,8,1,3,10,15,25,1114
9,9,0,0,10,15,25,1114
0,0,1,0,1,0,1,1115
1,1,3,0,4,0,4,1115
2,2,1,1,5,1,6,1115
3,3,1,1,6,2,8,1115
4,4,2,1,8,3,11,1115
5,5,2,0,10,3,13,1115
6,6,4,1,14,4,18,1115
7,7,5,2,19,6,25,1115
8,8,2,3,21,9,30,1115
9,9,1,1,22,10,32,1115
10,10,0,0,22,10,32,1115
0,0,1,0,1,0,1,1116
1,1,0,0,1,0,1,1116
0,0,1,0,1,0,1,1117
1,1,0,1,1,1,2,1117
2,2,1,0,2,1,3,1117
3,3,0,0,2,1,3,1117
0,0,1,0,1,0,1,1118
1,1,2,0,3,0,3,1118
2,2,0,0,3,0,3,1118
0,0,1,0,1,0,1,1119
1,1,0,0,1,0,1,1119
0,0,1,0,1,0,1,1120
1,1,1,0,2,0,2,1120
2,2,1,0,3,0,3,1120
3,3,0,0,3,0,3,1120
0,0,1,0,1,0,1,1121
1,1,1,0,2,0,2,1121
2,2,0,0,2,0,2,1121
0,0,1,0,1,0,1,1122
1,1,1,0,2,0,2,1122
2,2,0,0,2,0,2,1122
0,0,1,0,1,0,1,1123
1,1,1,0,2,0,2,1123
2,2,0,0,2,0,2,1123
0,0,1,0,1,0,1,1124
1,1,2,0,3,0,3,1124
2,2,2,0,5,0,5,1124
3,3,2,0,7,0,7,1124
4,4,2,0,9,0,9,1124
5,5,3,1,12,1,13,1124
6,6,1,3,13,4,17,1124
7,7,1,1,14,5,19,1124
8,8,3,2,17,7,24,1124
9,9,2,1,19,8,27,1124
10,10,2,0,21,8,29,1124
11,11,0,1,21,9,30,1124
12,12,0,0,21,9,30,1124
0,0,1,0,1,0,1,1125
1,1,2,0,3,0,3,1125
2,2,4,0,7,0,7,1125
3,3,1,2,8,2,10,1125
4,4,2,4,10,6,16,1125
5,5,2,3,12,9,21,1125
6,6,2,5,14,14,28,1125
7,7,5,3,19,17,36,1125
8,8,6,4,25,21,46,1125
9,9,8,3,33,24,57,1125
10,10,6,1,39,25,64,1125
11,11,3,2,42,27,69,1125
12,12,3,0,45,27,72,1125
13,13,2,1,47,28,75,1125
14,14,3,1,50,29,79,1125
15,15,2,0,52,29,81,1125
16,16,3,0,55,29,84,1125
17,17,4,0,59,29,88,1125
18,18,2,1,61,30,91,1125
19,19,1,0,62,30,92,1125
20,20,0,0,62,30,92,1125
0,0,1,0,1,0,1,1126
1,1,0,0,1,0,1,1126
0,0,1,0,1,0,1,1127
1,1,0,0,1,0,1,1127
0,0,1,0,1,0,1,1128
1,1,2,2,3,2,5,1128
2,2,2,2,5,4,9,1128
3,3,1,1,6,5,11,1128
4,4,1,0,7,5,12,1128
5,5,0,0,7,5,12,1128
0,0,1,0,1,0,1,1129
1,1,0,0,1,0,1,1129
0,0,1,0,1,0,1,1130
1,1,1,1,2,1,3,1130
2,2,0,0,2,1,3,1130
0,0,1,0,1,0,1,1131
1,1,0,0,1,0,1,1131
0,0,1,0,1,0,1,1132
1,1,2,0,3,0,3,1132
2,2,3,0,6,0,6,1132
3,3,2,0,8,0,8,1132
4,4,1,0,9,0,9,1132
5,5,1,0,10,0,10,1132
6,6,1,0,11,0,11,1132
7,7,1,0,12,0,12,1132
8,8,0,0,12,0,12,1132
0,0,1,0,1,0,1,1133
1,1,0,0,1,0,1,1133
0,0,1,0,1,0,1,1134
1,1,0,2,1,2,3,1134
2,2,2,2,3,4,7,1134
3,3,4,1,7,5,12,1134
4,4,4,0,11,5,16,1134
5,5,2,0,13,5,18,1134
6,6,5,0,18,5,23,1134
7,7,3,1,21,6,27,1134
8,8,7,1,28,7,35,1134
9,9,5,1,33,8,41,1134
10,10,3,1,36,9,45,1134
11,11,5,0,41,9,50,1134
12,12,2,1,43,10,53,1134
13,13,2,2,45,12,57,1134
14,14,2,3,47,15,62,1134
15,15,2,5,49,20,69,1134
16,16,3,4,52,24,76,1134
17,17,2,5,54,29,83,1134
18,18,5,5,59,34,93,1134
19,19,2,7,61,41,102,1134
20,20,6,1,67,42,109,1134
21,21,4,3,71,45,116,1134
22,22,2,4,73,49,122,1134
23,23,1,3,74,52,126,1134
24,24,2,3,76,55,131,1134
25,25,1,4,77,59,136,1134
26,26,2,1,79,60,139,1134
27,27,2,0,81,60,141,1134
28,28,2,0,83,60,143,1134
29,29,3,0,86,60,146,1134
30,30,3,0,89,60,149,1134
31,31,3,1,92,61,153,1134
32,32,1,1,93,62,155,1134
33,33,0,0,93,62,155,1134
0,0,1,0,1,0,1,1135
1,1,0,1,1,1,2,1135
2,2,0,1,1,2,3,1135
3,3,2,0,3,2,5,1135
4,4,0,1,3,3,6,1135
5,5,1,1,4,4,8,1135
6,6,0,0,4,4,8,1135
0,0,1,0,1,0,1,1136
1,1,1,1,2,1,3,1136
2,2,0,0,2,1,3,1136
0,0,1,0,1,0,1,1137
1,1,1,0,2,0,2,1137
2,2,2,0,4,0,4,1137
3,3,2,0,6,0,6,1137
4,4,2,2,8,2,10,1137
5,5,6,3,14,5,19,1137
6,6,4,2,18,7,25,1137
7,7,5,1,23,8,31,1137
8,8,4,1,27,9,36,1137
9,9,1,2,28,11,39,1137
10,10,0,0,28,11,39,1137
0,0,1,0,1,0,1,1138
1,1,2,0,3,0,3,1138
2,2,1,0,4,0,4,1138
3,3,1,0,5,0,5,1138
4,4,0,0,5,0,5,1138
0,0,1,0,1,0,1,1139
1,1,1,0,2,0,2,1139
2,2,2,0,4,0,4,1139
3,3,0,0,4,0,4,1139
0,0,1,0,1,0,1,1140
1,1,0,0,1,0,1,1140
0,0,1,0,1,0,1,1141
1,1,0,0,1,0,1,1141
0,0,1,0,1,0,1,1142
1,1,0,0,1,0,1,1142
0,0,1,0,1,0,1,1143
1,1,1,0,2,0,2,1143
2,2,0,2,2,2,4,1143
3,3,0,2,2,4,6,1143
4,4,0,3,2,7,9,1143
5,5,0,2,2,9,11,1143
6,6,0,1,2,10,12,1143
7,7,0,1,2,11,13,1143
8,8,0,1,2,12,14,1143
9,9,0,0,2,12,14,1143
0,0,1,0,1,0,1,1144
1,1,1,0,2,0,2,1144
2,2,1,0,3,0,3,1144
3,3,0,0,3,0,3,1144
0,0,1,0,1,0,1,1145
1,1,0,0,1,0,1,1145
0,0,1,0,1,0,1,1146
1,1,1,0,2,0,2,1146
2,2,0,0,2,0,2,1146
0,0,1,0,1,0,1,1147
1,1,3,0,4,0,4,1147
2,2,3,2,7,2,9,1147
3,3,2,4,9,6,15,1147
4,4,3,5,12,11,23,1147
5,5,4,6,16,17,33,1147
6,6,5,8,21,25,46,1147
7,7,4,10,25,35,60,1147
8,8,7,2,32,37,69,1147
9,9,3,3,35,40,75,1147
10,10,1,4,36,44,80,1147
11,11,3,3,39,47,86,1147
12,12,3,1,42,48,90,1147
13,13,5,2,47,50,97,1147
14,14,5,1,52,51,103,1147
15,15,1,2,53,53,106,1147
16,16,2,2,55,55,110,1147
17,17,2,3,57,58,115,1147
18,18,3,2,60,60,120,1147
19,19,4,1,64,61,125,1147
20,20,4,2,68,63,131,1147
21,21,2,3,70,66,136,1147
22,22,1,3,71,69,140,1147
23,23,3,3,74,72,146,1147
24,24,2,5,76,77,153,1147
25,25,6,4,82,81,163,1147
26,26,3,5,85,86,171,1147
27,27,6,11,91,97,188,1147
28,28,2,10,93,107,200,1147
29,29,4,9,97,116,213,1147
30,30,5,4,102,120,222,1147
31,31,1,4,103,124,227,1147
32,32,1,2,104,126,230,1147
33,33,3,4,107,130,237,1147
34,34,4,3,111,133,244,1147
35,35,6,2,117,135,252,1147
36,36,4,3,121,138,259,1147
37,37,5,1,126,139,265,1147
38,38,7,1,133,140,273,1147
39,39,7,1,140,141,281,1147
40,40,4,3,144,144,288,1147
41,41,5,6,149,150,299,1147
42,42,8,3,157,153,310,1147
43,43,4,3,161,156,317,1147
44,44,3,2,164,158,322,1147
45,45,3,3,167,161,328,1147
46,46,1,4,168,165,333,1147
47,47,3,1,171,166,337,1147
48,48,1,1,172,167,339,1147
49,49,2,0,174,167,341,1147
50,50,5,0,179,167,346,1147
51,51,2,1,181,168,349,1147
52,52,1,0,182,168,350,1147
53,53,1,0,183,168,351,1147
54,54,0,0,183,168,351,1147
0,0,1,0,1,0,1,1148
1,1,1,1,2,1,3,1148
2,2,0,1,2,2,4,1148
3,3,0,0,2,2,4,1148
0,0,1,0,1,0,1,1149
1,1,1,0,2,0,2,1149
2,2,0,0,2,0,2,1149
0,0,1,0,1,0,1,1150
1,1,0,0,1,0,1,1150
0,0,1,0,1,0,1,1151
1,1,2,1,3,1,4,1151
2,2,1,2,4,3,7,1151
3,3,1,0,5,3,8,1151
4,4,0,0,5,3,8,1151
0,0,1,0,1,0,1,1152
1,1,0,0,1,0,1,1152
0,0,1,0,1,0,1,1153
1,1,1,0,2,0,2,1153
2,2,1,0,3,0,3,1153
3,3,1,0,4,0,4,1153
4,4,0,1,4,1,5,1153
5,5,0,0,4,1,5,1153
0,0,1,0,1,0,1,1154
1,1,0,0,1,0,1,1154
0,0,1,0,1,0,1,1155
1,1,0,0,1,0,1,1155
0,0,1,0,1,0,1,1156
1,1,2,0,3,0,3,1156
2,2,0,0,3,0,3,1156
0,0,1,0,1,0,1,1157
1,1,1,0,2,0,2,1157
2,2,0,0,2,0,2,1157
0,0,1,0,1,0,1,1158
1,1,0,0,1,0,1,1158
0,0,1,0,1,0,1,1159
1,1,0,0,1,0,1,1159
0,0,1,0,1,0,1,1160
1,1,0,1,1,1,2,1160
2,2,0,0,1,1,2,1160
0,0,1,0,1,0,1,1161
1,1,4,1,5,1,6,1161
2,2,1,1,6,2,8,1161
3,3,0,0,6,2,8,1161
0,0,1,0,1,0,1,1162
1,1,2,0,3,0,3,1162
2,2,3,0,6,0,6,1162
3,3,1,0,7,0,7,1162
4,4,1,0,8,0,8,1162
5,5,2,0,10,0,10,1162
6,6,0,1,10,1,11,1162
7,7,0,2,10,3,13,1162
8,8,1,6,11,9,20,1162
9,9,1,6,12,15,27,1162
10,10,1,4,13,19,32,1162
11,11,0,2,13,21,34,1162
12,12,1,0,14,21,35,1162
13,13,1,0,15,21,36,1162
14,14,2,0,17,21,38,1162
15,15,0,1,17,22,39,1162
16,16,0,1,17,23,40,1162
17,17,0,0,17,23,40,1162
0,0,1,0,1,0,1,1163
1,1,1,0,2,0,2,1163
2,2,0,0,2,0,2,1163
0,0,1,0,1,0,1,1164
1,1,1,0,2,0,2,1164
2,2,1,0,3,0,3,1164
3,3,1,0,4,0,4,1164
4,4,1,1,5,1,6,1164
5,5,1,1,6,2,8,1164
6,6,3,3,9,5,14,1164
7,7,4,4,13,9,22,1164
8,8,0,2,13,11,24,1164
9,9,1,1,14,12,26,1164
10,10,0,2,14,14,28,1164
11,11,0,2,14,16,30,1164
12,12,0,1,14,17,31,1164
13,13,0,2,14,19,33,1164
14,14,1,1,15,20,35,1164
15,15,2,0,17,20,37,1164
16,16,0,0,17,20,37,1164
0,0,1,0,1,0,1,1165
1,1,0,0,1,0,1,1165
0,0,1,0,1,0,1,1166
1,1,0,1,1,1,2,1166
2,2,0,2,1,3,4,1166
3,3,0,2,1,5,6,1166
4,4,0,2,1,7,8,1166
5,5,1,2,2,9,11,1166
6,6,0,0,2,9,11,1166
0,0,1,0,1,0,1,1167
1,1,1,0,2,0,2,1167
2,2,1,0,3,0,3,1167
3,3,0,0,3,0,3,1167
0,0,1,0,1,0,1,1168
1,1,0,0,1,0,1,1168
0,0,1,0,1,0,1,1169
1,1,1,1,2,1,3,1169
2,2,0,0,2,1,3,1169
0,0,1,0,1,0,1,1170
1,1,1,1,2,1,3,1170
2,2,1,0,3,1,4,1170
3,3,0,0,3,1,4,1170
0,0,1,0,1,0,1,1171
1,1,0,0,1,0,1,1171
0,0,1,0,1,0,1,1172
1,1,0,0,1,0,1,1172
0,0,1,0,1,0,1,1173
1,1,1,0,2,0,2,1173
2,2,0,0,2,0,2,1173
0,0,1,0,1,0,1,1174
1,1,1,2,2,2,4,1174
2,2,1,0,3,2,5,1174
3,3,1,0,4,2,6,1174
4,4,1,0,5,2,7,1174
5,5,0,0,5,2,7,1174
0,0,1,0,1,0,1,1175
1,1,0,0,1,0,1,1175
0,0,1,0,1,0,1,1176
1,1,2,1,3,1,4,1176
2,2,1,0,4,1,5,1176
3,3,0,0,4,1,5,1176
0,0,1,0,1,0,1,1177
1,1,0,0,1,0,1,1177
0,0,1,0,1,0,1,1178
1,1,0,0,1,0,1,1178
0,0,1,0,1,0,1,1179
1,1,0,0,1,0,1,1179
0,0,1,0,1,0,1,1180
1,1,1,0,2,0,2,1180
2,2,1,2,3,2,5,1180
3,3,0,2,3,4,7,1180
4,4,0,1,3,5,8,1180
5,5,0,2,3,7,10,1180
6,6,0,3,3,10,13,1180
7,7,0,1,3,11,14,1180
8,8,0,0,3,11,14,1180
0,0,1,0,1,0,1,1181
1,1,1,0,2,0,2,1181
2,2,1,1,3,1,4,1181
3,3,0,2,3,3,6,1181
4,4,0,0,3,3,6,1181
0,0,1,0,1,0,1,1182
1,1,2,0,3,0,3,1182
2,2,0,0,3,0,3,1182
0,0,1,0,1,0,1,1183
1,1,0,0,1,0,1,1183
0,0,1,0,1,0,1,1184
1,1,0,0,1,0,1,1184
0,0,1,0,1,0,1,1185
1,1,0,1,1,1,2,1185
2,2,0,0,1,1,2,1185
0,0,1,0,1,0,1,1186
1,1,0,0,1,0,1,1186
0,0,1,0,1,0,1,1187
1,1,0,0,1,0,1,1187
0,0,1,0,1,0,1,1188
1,1,0,0,1,0,1,1188
0,0,1,0,1,0,1,1189
1,1,1,0,2,0,2,1189
2,2,0,0,2,0,2,1189
0,0,1,0,1,0,1,1190
1,1,2,0,3,0,3,1190
2,2,2,0,5,0,5,1190
3,3,0,0,5,0,5,1190
0,0,1,0,1,0,1,1191
1,1,0,0,1,0,1,1191
0,0,1,0,1,0,1,1192
1,1,0,0,1,0,1,1192
0,0,1,0,1,0,1,1193
1,1,0,0,1,0,1,1193
0,0,1,0,1,0,1,1194
1,1,3,1,4,1,5,1194
2,2,0,1,4,2,6,1194
3,3,0,0,4,2,6,1194
0,0,1,0,1,0,1,1195
1,1,0,0,1,0,1,1195
0,0,1,0,1,0,1,1196
1,1,2,0,3,0,3,1196
2,2,0,0,3,0,3,1196
0,0,1,0,1,0,1,1197
1,1,0,0,1,0,1,1197
0,0,1,0,1,0,1,1198
1,1,2,0,3,0,3,1198
2,2,1,0,4,0,4,1198
3,3,1,0,5,0,5,1198
4,4,1,0,6,0,6,1198
5,5,0,0,6,0,6,1198
0,0,1,0,1,0,1,1199
1,1,0,0,1,0,1,1199
0,0,1,0,1,0,1,1200
1,1,0,0,1,0,1,1200
0,0,1,0,1,0,1,1201
1,1,0,0,1,0,1,1201
0,0,1,0,1,0,1,1202
1,1,3,0,4,0,4,1202
2,2,4,0,8,0,8,1202
3,3,4,0,12,0,12,1202
4,4,6,1,18,1,19,1202
5,5,4,0,22,1,23,1202
6,6,1,0,23,1,24,1202
7,7,0,0,23,1,24,1202
0,0,1,0,1,0,1,1203
1,1,0,0,1,0,1,1203
0,0,1,0,1,0,1,1204
1,1,2,0,3,0,3,1204
2,2,0,0,3,0,3,1204
0,0,1,0,1,0,1,1205
1,1,0,0,1,0,1,1205
0,0,1,0,1,0,1,1206
1,1,0,0,1,0,1,1206
0,0,1,0,1,0,1,1207
1,1,0,1,1,1,2,1207
2,2,1,0,2,1,3,1207
3,3,1,1,3,2,5,1207
4,4,0,4,3,6,9,1207
5,5,0,3,3,9,12,1207
6,6,1,1,4,10,14,1207
7,7,1,3,5,13,18,1207
8,8,0,2,5,15,20,1207
9,9,0,0,5,15,20,1207
0,0,1,0,1,0,1,1208
1,1,0,0,1,0,1,1208
0,0,1,0,1,0,1,1209
1,1,0,0,1,0,1,1209
0,0,1,0,1,0,1,1210
1,1,2,0,3,0,3,1210
2,2,1,0,4,0,4,1210
3,3,1,0,5,0,5,1210
4,4,1,1,6,1,7,1210
5,5,1,0,7,1,8,1210
6,6,0,0,7,1,8,1210
0,0,1,0,1,0,1,1211
1,1,2,0,3,0,3,1211
2,2,1,0,4,0,4,1211
3,3,0,0,4,0,4,1211
0,0,1,0,1,0,1,1212
1,1,3,0,4,0,4,1212
2,2,1,0,5,0,5,1212
3,3,1,1,6,1,7,1212
4,4,6,0,12,1,13,1212
5,5,8,0,20,1,21,1212
6,6,6,3,26,4,30,1212
7,7,4,2,30,6,36,1212
8,8,1,0,31,6,37,1212
9,9,1,0,32,6,38,1212
10,10,0,0,32,6,38,1212
0,0,1,0,1,0,1,1213
1,1,0,0,1,0,1,1213
0,0,1,0,1,0,1,1214
1,1,0,0,1,0,1,1214
0,0,1,0,1,0,1,1215
1,1,0,1,1,1,2,1215
2,2,0,0,1,1,2,1215
0,0,1,0,1,0,1,1216
1,1,0,0,1,0,1,1216
0,0,1,0,1,0,1,1217
1,1,0,0,1,0,1,1217
0,0,1,0,1,0,1,1218
1,1,0,0,1,0,1,1218
0,0,1,0,1,0,1,1219
1,1,1,1,2,1,3,1219
2,2,1,1,3,2,5,1219
3,3,1,1,4,3,7,1219
4,4,0,0,4,3,7,1219
0,0,1,0,1,0,1,1220
1,1,1,0,2,0,2,1220
2,2,0,0,2,0,2,1220
0,0,1,0,1,0,1,1221
1,1,1,0,2,0,2,1221
2,2,0,0,2,0,2,1221
0,0,1,0,1,0,1,1222
1,1,0,0,1,0,1,1222
0,0,1,0,1,0,1,1223
1,1,0,1,1,1,2,1223
2,2,0,0,1,1,2,1223
0,0,1,0,1,0,1,1224
1,1,0,0,1,0,1,1224
0,0,1,0,1,0,1,1225
1,1,0,0,1,0,1,1225
0,0,1,0,1,0,1,1226
1,1,2,0,3,0,3,1226
2,2,2,0,5,0,5,1226
3,3,2,0,7,0,7,1226
4,4,0,1,7,1,8,1226
5,5,0,1,7,2,9,1226
6,6,1,0,8,2,10,1226
7,7,2,0,10,2,12,1226
8,8,0,1,10,3,13,1226
9,9,0,2,10,5,15,1226
10,10,0,2,10,7,17,1226
11,11,0,3,10,10,20,1226
12,12,0,2,10,12,22,1226
13,13,0,3,10,15,25,1226
14,14,0,4,10,19,29,1226
15,15,1,2,11,21,32,1226
16,16,1,2,12,23,35,1226
17,17,1,1,13,24,37,1226
18,18,1,0,14,24,38,1226
19,19,0,0,14,24,38,1226
0,0,1,0,1,0,1,1227
1,1,0,1,1,1,2,1227
2,2,0,2,1,3,4,1227
3,3,0,2,1,5,6,1227
4,4,0,2,1,7,8,1227
5,5,1,1,2,8,10,1227
6,6,1,3,3,11,14,1227
7,7,1,3,4,14,18,1227
8,8,1,2,5,16,21,1227
9,9,1,1,6,17,23,1227
10,10,0,2,6,19,25,1227
11,11,1,1,7,20,27,1227
12,12,0,1,7,21,28,1227
13,13,0,1,7,22,29,1227
14,14,1,1,8,23,31,1227
15,15,1,2,9,25,34,1227
16,16,2,2,11,27,38,1227
17,17,3,1,14,28,42,1227
18,18,1,2,15,30,45,1227
19,19,2,2,17,32,49,1227
20,20,2,4,19,36,55,1227
21,21,3,4,22,40,62,1227
22,22,2,4,24,44,68,1227
23,23,1,4,25,48,73,1227
24,24,4,2,29,50,79,1227
25,25,0,2,29,52,81,1227
26,26,0,2,29,54,83,1227
27,27,1,2,30,56,86,1227
28,28,2,2,32,58,90,1227
29,29,1,1,33,59,92,1227
30,30,1,2,34,61,95,1227
31,31,0,2,34,63,97,1227
32,32,0,0,34,63,97,1227
0,0,1,0,1,0,1,1228
1,1,0,0,1,0,1,1228
0,0,1,0,1,0,1,1229
1,1,1,0,2,0,2,1229
2,2,0,0,2,0,2,1229
0,0,1,0,1,0,1,1230
1,1,1,0,2,0,2,1230
2,2,0,0,2,0,2,1230
0,0,1,0,1,0,1,1231
1,1,0,0,1,0,1,1231
0,0,1,0,1,0,1,1232
1,1,2,0,3,0,3,1232
2,2,1,1,4,1,5,1232
3,3,1,2,5,3,8,1232
4,4,2,4,7,7,14,1232
5,5,1,4,8,11,19,1232
6,6,2,3,10,14,24,1232
7,7,2,0,12,14,26,1232
8,8,0,3,12,17,29,1232
9,9,2,2,14,19,33,1232
10,10,3,1,17,20,37,1232
11,11,5,1,22,21,43,1232
12,12,3,1,25,22,47,1232
13,13,1,0,26,22,48,1232
14,14,1,0,27,22,49,1232
15,15,1,0,28,22,50,1232
16,16,0,0,28,22,50,1232
0,0,1,0,1,0,1,1233
1,1,1,0,2,0,2,1233
2,2,1,1,3,1,4,1233
3,3,0,0,3,1,4,1233
0,0,1,0,1,0,1,1234
1,1,3,0,4,0,4,1234
2,2,4,0,8,0,8,1234
3,3,1,0,9,0,9,1234
4,4,1,0,10,0,10,1234
5,5,0,0,10,0,10,1234
0,0,1,0,1,0,1,1235
1,1,0,0,1,0,1,1235
0,0,1,0,1,0,1,1236
1,1,1,1,2,1,3,1236
2,2,1,1,3,2,5,1236
3,3,1,1,4,3,7,1236
4,4,0,2,4,5,9,1236
5,5,0,0,4,5,9,1236
0,0,1,0,1,0,1,1237
1,1,0,0,1,0,1,1237
0,0,1,0,1,0,1,1238
1,1,0,0,1,0,1,1238
0,0,1,0,1,0,1,1239
1,1,1,0,2,0,2,1239
2,2,0,0,2,0,2,1239
0,0,1,0,1,0,1,1240
1,1,2,0,3,0,3,1240
2,2,1,0,4,0,4,1240
3,3,2,0,6,0,6,1240
4,4,0,0,6,0,6,1240
0,0,1,0,1,0,1,1241
1,1,0,0,1,0,1,1241
0,0,1,0,1,0,1,1242
1,1,0,0,1,0,1,1242
0,0,1,0,1,0,1,1243
1,1,2,0,3,0,3,1243
2,2,2,0,5,0,5,1243
3,3,1,1,6,1,7,1243
4,4,0,1,6,2,8,1243
5,5,0,0,6,2,8,1243
0,0,1,0,1,0,1,1244
1,1,2,0,3,0,3,1244
2,2,1,0,4,0,4,1244
3,3,1,2,5,2,7,1244
4,4,2,4,7,6,13,1244
5,5,4,4,11,10,21,1244
6,6,4,2,15,12,27,1244
7,7,3,2,18,14,32,1244
8,8,1,1,19,15,34,1244
9,9,0,0,19,15,34,1244
0,0,1,0,1,0,1,1245
1,1,1,2,2,2,4,1245
2,2,2,1,4,3,7,1245
3,3,2,2,6,5,11,1245
4,4,0,2,6,7,13,1245
5,5,2,2,8,9,17,1245
6,6,1,3,9,12,21,1245
7,7,1,1,10,13,23,1245
8,8,1,3,11,16,27,1245
9,9,2,0,13,16,29,1245
10,10,2,0,15,16,31,1245
11,11,2,0,17,16,33,1245
12,12,0,1,17,17,34,1245
13,13,0,1,17,18,35,1245
14,14,1,2,18,20,38,1245
15,15,1,2,19,22,41,1245
16,16,3,3,22,25,47,1245
17,17,4,1,26,26,52,1245
18,18,1,0,27,26,53,1245
19,19,1,0,28,26,54,1245
20,20,1,0,29,26,55,1245
21,21,1,0,30,26,56,1245
22,22,0,1,30,27,57,1245
23,23,0,0,30,27,57,1245
0,0,1,0,1,0,1,1246
1,1,0,0,1,0,1,1246
0,0,1,0,1,0,1,1247
1,1,1,0,2,0,2,1247
2,2,0,0,2,0,2,1247
0,0,1,0,1,0,1,1248
1,1,2,0,3,0,3,1248
2,2,1,0,4,0,4,1248
3,3,2,0,6,0,6,1248
4,4,0,0,6,0,6,1248
0,0,1,0,1,0,1,1249
1,1,0,0,1,0,1,1249
0,0,1,0,1,0,1,1250
1,1,1,0,2,0,2,1250
2,2,0,0,2,0,2,1250
0,0,1,0,1,0,1,1251
1,1,1,0,2,0,2,1251
2,2,0,0,2,0,2,1251
0,0,1,0,1,0,1,1252
1,1,1,0,2,0,2,1252
2,2,0,0,2,0,2,1252
0,0,1,0,1,0,1,1253
1,1,1,0,2,0,2,1253
2,2,0,1,2,1,3,1253
3,3,0,0,2,1,3,1253
0,0,1,0,1,0,1,1254
1,1,1,0,2,0,2,1254
2,2,0,0,2,0,2,1254
0,0,1,0,1,0,1,1255
1,1,0,0,1,0,1,1255
0,0,1,0,1,0,1,1256
1,1,0,0,1,0,1,1256
0,0,1,0,1,0,1,1257
1,1,2,0,3,0,3,1257
2,2,2,1,5,1,6,1257
3,3,0,1,5,2,7,1257
4,4,0,0,5,2,7,1257
0,0,1,0,1,0,1,1258
1,1,1,0,2,0,2,1258
2,2,0,0,2,0,2,1258
0,0,1,0,1,0,1,1259
1,1,0,0,1,0,1,1259
0,0,1,0,1,0,1,1260
1,1,1,0,2,0,2,1260
2,2,0,1,2,1,3,1260
3,3,0,2,2,3,5,1260
4,4,1,2,3,5,8,1260
5,5,0,2,3,7,10,1260
6,6,1,2,4,9,13,1260
7,7,1,0,5,9,14,1260
8,8,2,0,7,9,16,1260
9,9,3,0,10,9,19,1260
10,10,3,0,13,9,22,1260
11,11,4,0,17,9,26,1260
12,12,2,3,19,12,31,1260
13,13,2,1,21,13,34,1260
14,14,1,2,22,15,37,1260
15,15,1,3,23,18,41,1260
16,16,1,1,24,19,43,1260
17,17,0,1,24,20,44,1260
18,18,0,3,24,23,47,1260
19,19,1,1,25,24,49,1260
20,20,2,1,27,25,52,1260
21,21,1,0,28,25,53,1260
22,22,0,0,28,25,53,1260
0,0,1,0,1,0,1,1261
1,1,1,0,2,0,2,1261
2,2,0,0,2,0,2,1261
0,0,1,0,1,0,1,1262
1,1,2,0,3,0,3,1262
2,2,2,0,5,0,5,1262
3,3,2,0,7,0,7,1262
4,4,2,1,9,1,10,1262
5,5,0,0,9,1,10,1262
0,0,1,0,1,0,1,1263
1,1,0,1,1,1,2,1263
2,2,0,2,1,3,4,1263
3,3,1,0,2,3,5,1263
4,4,1,0,3,3,6,1263
5,5,0,0,3,3,6,1263
0,0,1,0,1,0,1,1264
1,1,1,0,2,0,2,1264
2,2,2,0,4,0,4,1264
3,3,0,0,4,0,4,1264
0,0,1,0,1,0,1,1265
1,1,2,0,3,0,3,1265
2,2,1,0,4,0,4,1265
3,3,1,0,5,0,5,1265
4,4,4,0,9,0,9,1265
5,5,1,0,10,0,10,1265
6,6,1,1,11,1,12,1265
7,7,1,0,12,1,13,1265
8,8,0,0,12,1,13,1265
0,0,1,0,1,0,1,1266
1,1,1,0,2,0,2,1266
2,2,1,0,3,0,3,1266
3,3,1,1,4,1,5,1266
4,4,1,3,5,4,9,1266
5,5,3,1,8,5,13,1266
6,6,2,4,10,9,19,1266
7,7,1,4,11,13,24,1266
8,8,1,4,12,17,29,1266
9,9,4,0,16,17,33,1266
10,10,4,0,20,17,37,1266
11,11,2,2,22,19,41,1266
12,12,0,0,22,19,41,1266
0,0,1,0,1,0,1,1267
1,1,0,0,1,0,1,1267
0,0,1,0,1,0,1,1268
1,1,0,0,1,0,1,1268
0,0,1,0,1,0,1,1269
1,1,3,0,4,0,4,1269
2,2,4,0,8,0,8,1269
3,3,0,3,8,3,11,1269
4,4,0,4,8,7,15,1269
5,5,0,2,8,9,17,1269
6,6,0,2,8,11,19,1269
7,7,1,1,9,12,21,1269
8,8,0,3,9,15,24,1269
9,9,1,2,10,17,27,1269
10,10,1,2,11,19,30,1269
11,11,0,2,11,21,32,1269
12,12,0,1,11,22,33,1269
13,13,0,0,11,22,33,1269
0,0,1,0,1,0,1,1270
1,1,0,0,1,0,1,1270
0,0,1,0,1,0,1,1271
1,1,0,0,1,0,1,1271
0,0,1,0,1,0,1,1272
1,1,0,0,1,0,1,1272
0,0,1,0,1,0,1,1273
1,1,0,0,1,0,1,1273
0,0,1,0,1,0,1,1274
1,1,0,0,1,0,1,1274
0,0,1,0,1,0,1,1275
1,1,1,0,2,0,2,1275
2,2,1,0,3,0,3,1275
3,3,0,1,3,1,4,1275
4,4,0,0,3,1,4,1275
0,0,1,0,1,0,1,1276
1,1,2,0,3,0,3,1276
2,2,2,2,5,2,7,1276
3,3,2,1,7,3,10,1276
4,4,3,1,10,4,14,1276
5,5,4,3,14,7,21,1276
6,6,2,2,16,9,25,1276
7,7,1,0,17,9,26,1276
8,8,1,0,18,9,27,1276
9,9,0,0,18,9,27,1276
0,0,1,0,1,0,1,1277
1,1,0,1,1,1,2,1277
2,2,0,0,1,1,2,1277
0,0,1,0,1,0,1,1278
1,1,0,0,1,0,1,1278
0,0,1,0,1,0,1,1279
1,1,0,0,1,0,1,1279
0,0,1,0,1,0,1,1280
1,1,0,0,1,0,1,1280
0,0,1,0,1,0,1,1281
1,1,1,0,2,0,2,1281
2,2,1,0,3,0,3,1281
3,3,3,0,6,0,6,1281
4,4,0,0,6,0,6,1281
0,0,1,0,1,0,1,1282
1,1,1,0,2,0,2,1282
2,2,0,0,2,0,2,1282
0,0,1,0,1,0,1,1283
1,1,1,0,2,0,2,1283
2,2,1,0,3,0,3,1283
3,3,1,0,4,0,4,1283
4,4,0,0,4,0,4,1283
0,0,1,0,1,0,1,1284
1,1,2,0,3,0,3,1284
2,2,2,1,5,1,6,1284
3,3,2,1,7,2,9,1284
4,4,2,1,9,3,12,1284
5,5,4,0,13,3,16,1284
6,6,3,0,16,3,19,1284
7,7,1,1,17,4,21,1284
8,8,0,2,17,6,23,1284
9,9,0,1,17,7,24,1284
10,10,0,0,17,7,24,1284
0,0,1,0,1,0,1,1285
1,1,0,0,1,0,1,1285
0,0,1,0,1,0,1,1286
1,1,4,1,5,1,6,1286
2,2,3,0,8,1,9,1286
3,3,1,1,9,2,11,1286
4,4,3,1,12,3,15,1286
5,5,2,0,14,3,17,1286
6,6,0,0,14,3,17,1286
0,0,1,0,1,0,1,1287
1,1,1,0,2,0,2,1287
2,2,1,1,3,1,4,1287
3,3,1,0,4,1,5,1287
4,4,2,0,6,1,7,1287
5,5,4,0,10,1,11,1287
6,6,1,0,11,1,12,1287
7,7,0,0,11,1,12,1287
0,0,1,0,1,0,1,1288
1,1,0,0,1,0,1,1288
0,0,1,0,1,0,1,1289
1,1,2,0,3,0,3,1289
2,2,1,0,4,0,4,1289
3,3,0,0,4,0,4,1289
0,0,1,0,1,0,1,1290
1,1,3,0,4,0,4,1290
2,2,4,1,8,1,9,1290
3,3,2,2,10,3,13,1290
4,4,2,0,12,3,15,1290
5,5,0,0,12,3,15,1290
0,0,1,0,1,0,1,1291
1,1,1,2,2,2,4,1291
2,2,2,1,4,3,7,1291
3,3,3,2,7,5,12,1291
4,4,4,2,11,7,18,1291
5,5,2,3,13,10,23,1291
6,6,2,1,15,11,26,1291
7,7,1,2,16,13,29,1291
8,8,1,0,17,13,30,1291
9,9,1,0,18,13,31,1291
10,10,1,0,19,13,32,1291
11,11,0,2,19,15,34,1291
12,12,0,1,19,16,35,1291
13,13,0,1,19,17,36,1291
14,14,0,0,19,17,36,1291
0,0,1,0,1,0,1,1292
1,1,1,0,2,0,2,1292
2,2,1,0,3,0,3,1292
3,3,0,0,3,0,3,1292
0,0,1,0,1,0,1,1293
1,1,0,0,1,0,1,1293
0,0,1,0,1,0,1,1294
1,1,0,1,1,1,2,1294
2,2,1,1,2,2,4,1294
3,3,0,3,2,5,7,1294
4,4,1,3,3,8,11,1294
5,5,1,1,4,9,13,1294
6,6,1,2,5,11,16,1294
7,7,0,2,5,13,18,1294
8,8,0,0,5,13,18,1294
0,0,1,0,1,0,1,1295
1,1,1,0,2,0,2,1295
2,2,1,0,3,0,3,1295
3,3,2,0,5,0,5,1295
4,4,0,0,5,0,5,1295
0,0,1,0,1,0,1,1296
1,1,0,0,1,0,1,1296
0,0,1,0,1,0,1,1297
1,1,1,0,2,0,2,1297
2,2,0,0,2,0,2,1297
0,0,1,0,1,0,1,1298
1,1,0,0,1,0,1,1298
0,0,1,0,1,0,1,1299
1,1,1,0,2,0,2,1299
2,2,1,0,3,0,3,1299
3,3,2,0,5,0,5,1299
4,4,0,0,5,0,5,1299
0,0,1,0,1,0,1,1300
1,1,0,0,1,0,1,1300
0,0,1,0,1,0,1,1301
1,1,0,0,1,0,1,1301
0,0,1,0,1,0,1,1302
1,1,1,0,2,0,2,1302
2,2,1,1,3,1,4,1302
3,3,0,2,3,3,6,1302
4,4,0,2,3,5,8,1302
5,5,0,2,3,7,10,1302
6,6,0,1,3,8,11,1302
7,7,0,0,3,8,11,1302
0,0,1,0,1,0,1,1303
1,1,0,0,1,0,1,1303
0,0,1,0,1,0,1,1304
1,1,2,0,3,0,3,1304
2,2,0,0,3,0,3,1304
0,0,1,0,1,0,1,1305
1,1,0,0,1,0,1,1305
0,0,1,0,1,0,1,1306
1,1,4,0,5,0,5,1306
2,2,1,1,6,1,7,1306
3,3,1,1,7,2,9,1306
4,4,2,1,9,3,12,1306
5,5,1,0,10,3,13,1306
6,6,0,0,10,3,13,1306
0,0,1,0,1,0,1,1307
1,1,1,0,2,0,2,1307
2,2,1,0,3,0,3,1307
3,3,1,0,4,0,4,1307
4,4,1,0,5,0,5,1307
5,5,2,0,7,0,7,1307
6,6,0,0,7,0,7,1307
0,0,1,0,1,0,1,1308
1,1,0,0,1,0,1,1308
0,0,1,0,1,0,1,1309
1,1,0,0,1,0,1,1309
0,0,1,0,1,0,1,1310
1,1,1,1,2,1,3,1310
2,2,1,0,3,1,4,1310
3,3,0,2,3,3,6,1310
4,4,0,1,3,4,7,1310
5,5,0,1,3,5,8,1310
6,6,2,1,5,6,11,1310
7,7,2,2,7,8,15,1310
8,8,0,2,7,10,17,1310
9,9,0,2,7,12,19,1310
10,10,3,2,10,14,24,1310
11,11,1,2,11,16,27,1310
12,12,0,2,11,18,29,1310
13,13,0,0,11,18,29,1310
0,0,1,0,1,0,1,1311
1,1,0,0,1,0,1,1311
0,0,1,0,1,0,1,1312
1,1,0,0,1,0,1,1312
0,0,1,0,1,0,1,1313
1,1,1,2,2,2,4,1313
2,2,2,1,4,3,7,1313
3,3,0,4,4,7,11,1313
4,4,0,2,4,9,13,1313
5,5,0,1,4,10,14,1313
6,6,1,0,5,10,15,1313
7,7,2,0,7,10,17,1313
8,8,1,1,8,11,19,1313
9,9,5,1,13,12,25,1313
10,10,2,6,15,18,33,1313
11,11,0,2,15,20,35,1313
12,12,0,1,15,21,36,1313
13,13,0,0,15,21,36,1313
0,0,1,0,1,0,1,1314
1,1,0,0,1,0,1,1314
0,0,1,0,1,0,1,1315
1,1,1,0,2,0,2,1315
2,2,1,1,3,1,4,1315
3,3,1,0,4,1,5,1315
4,4,2,0,6,1,7,1315
5,5,1,0,7,1,8,1315
6,6,1,0,8,1,9,1315
7,7,1,0,9,1,10,1315
8,8,1,0,10,1,11,1315
9,9,1,0,11,1,12,1315
10,10,4,0,15,1,16,1315
11,11,1,0,16,1,17,1315
12,12,0,0,16,1,17,1315
0,0,1,0,1,0,1,1316
1,1,1,0,2,0,2,1316
2,2,2,0,4,0,4,1316
3,3,4,0,8,0,8,1316
4,4,2,0,10,0,10,1316
5,5,1,0,11,0,11,1316
6,6,0,1,11,1,12,1316
7,7,0,2,11,3,14,1316
8,8,1,2,12,5,17,1316
9,9,0,3,12,8,20,1316
10,10,1,1,13,9,22,1316
11,11,0,0,13,9,22,1316
0,0,1,0,1,0,1,1317
1,1,0,0,1,0,1,1317
0,0,1,0,1,0,1,1318
1,1,0,0,1,0,1,1318
0,0,1,0,1,0,1,1319
1,1,2,0,3,0,3,1319
2,2,2,0,5,0,5,1319
3,3,2,0,7,0,7,1319
4,4,5,1,12,1,13,1319
5,5,8,1,20,2,22,1319
6,6,13,2,33,4,37,1319
7,7,8,5,41,9,50,1319
8,8,4,6,45,15,60,1319
9,9,6,4,51,19,70,1319
10,10,5,4,56,23,79,1319
11,11,4,4,60,27,87,1319
12,12,3,3,63,30,93,1319
13,13,2,2,65,32,97,1319
14,14,3,1,68,33,101,1319
15,15,1,1,69,34,103,1319
16,16,0,1,69,35,104,1319
17,17,1,1,70,36,106,1319
18,18,2,0,72,36,108,1319
19,19,1,1,73,37,110,1319
20,20,2,1,75,38,113,1319
21,21,5,1,80,39,119,1319
22,22,2,1,82,40,122,1319
23,23,2,0,84,40,124,1319
24,24,1,0,85,40,125,1319
25,25,0,0,85,40,125,1319
0,0,1,0,1,0,1,1320
1,1,0,1,1,1,2,1320
2,2,0,0,1,1,2,1320
0,0,1,0,1,0,1,1321
1,1,2,1,3,1,4,1321
2,2,2,0,5,1,6,1321
3,3,1,0,6,1,7,1321
4,4,0,0,6,1,7,1321
0,0,1,0,1,0,1,1322
1,1,0,0,1,0,1,1322
0,0,1,0,1,0,1,1323
1,1,0,0,1,0,1,1323
0,0,1,0,1,0,1,1324
1,1,2,0,3,0,3,1324
2,2,0,0,3,0,3,1324
0,0,1,0,1,0,1,1325
1,1,2,0,3,0,3,1325
2,2,3,0,6,0,6,1325
3,3,3,1,9,1,10,1325
4,4,0,0,9,1,10,1325
0,0,1,0,1,0,1,1326
1,1,1,0,2,0,2,1326
2,2,0,0,2,0,2,1326
0,0,1,0,1,0,1,1327
1,1,1,0,2,0,2,1327
2,2,0,0,2,0,2,1327
0,0,1,0,1,0,1,1328
1,1,0,1,1,1,2,1328
2,2,0,1,1,2,3,1328
3,3,1,1,2,3,5,1328
4,4,2,0,4,3,7,1328
5,5,2,0,6,3,9,1328
6,6,3,1,9,4,13,1328
7,7,7,2,16,6,22,1328
8,8,6,0,22,6,28,1328
9,9,6,0,28,6,34,1328
10,10,4,0,32,6,38,1328
11,11,3,0,35,6,41,1328
12,12,1,0,36,6,42,1328
13,13,3,0,39,6,45,1328
14,14,3,1,42,7,49,1328
15,15,0,2,42,9,51,1328
16,16,0,1,42,10,52,1328
17,17,1,0,43,10,53,1328
18,18,1,0,44,10,54,1328
19,19,1,0,45,10,55,1328
20,20,0,0,45,10,55,1328
0,0,1,0,1,0,1,1329
1,1,2,0,3,0,3,1329
2,2,3,1,6,1,7,1329
3,3,3,0,9,1,10,1329
4,4,5,0,14,1,15,1329
5,5,5,0,19,1,20,1329
6,6,9,1,28,2,30,1329
7,7,7,3,35,5,40,1329
8,8,6,5,41,10,51,1329
9,9,1,7,42,17,59,1329
10,10,1,5,43,22,65,1329
11,11,1,4,44,26,70,1329
12,12,1,7,45,33,78,1329
13,13,1,6,46,39,85,1329
14,14,2,5,48,44,92,1329
15,15,3,4,51,48,99,1329
16,16,4,3,55,51,106,1329
17,17,8,4,63,55,118,1329
18,18,8,3,71,58,129,1329
19,19,2,7,73,65,138,1329
20,20,2,3,75,68,143,1329
21,21,1,2,76,70,146,1329
22,22,0,1,76,71,147,1329
23,23,0,0,76,71,147,1329
0,0,1,0,1,0,1,1330
1,1,0,0,1,0,1,1330
0,0,1,0,1,0,1,1331
1,1,1,0,2,0,2,1331
2,2,0,0,2,0,2,1331
0,0,1,0,1,0,1,1332
1,1,1,0,2,0,2,1332
2,2,0,0,2,0,2,1332
0,0,1,0,1,0,1,1333
1,1,1,0,2,0,2,1333
2,2,2,0,4,0,4,1333
3,3,2,0,6,0,6,1333
4,4,4,1,10,1,11,1333
5,5,2,0,12,1,13,1333
6,6,1,0,13,1,14,1333
7,7,1,0,14,1,15,1333
8,8,0,0,14,1,15,1333
0,0,1,0,1,0,1,1334
1,1,0,1,1,1,2,1334
2,2,0,0,1,1,2,1334
0,0,1,0,1,0,1,1335
1,1,0,0,1,0,1,1335
0,0,1,0,1,0,1,1336
1,1,1,0,2,0,2,1336
2,2,0,0,2,0,2,1336
0,0,1,0,1,0,1,1337
1,1,2,0,3,0,3,1337
2,2,3,0,6,0,6,1337
3,3,1,0,7,0,7,1337
4,4,1,0,8,0,8,1337
5,5,1,0,9,0,9,1337
6,6,1,0,10,0,10,1337
7,7,0,0,10,0,10,1337
0,0,1,0,1,0,1,1338
1,1,1,0,2,0,2,1338
2,2,0,0,2,0,2,1338
0,0,1,0,1,0,1,1339
1,1,0,0,1,0,1,1339
0,0,1,0,1,0,1,1340
1,1,1,0,2,0,2,1340
2,2,1,0,3,0,3,1340
3,3,0,0,3,0,3,1340
0,0,1,0,1,0,1,1341
1,1,1,0,2,0,2,1341
2,2,0,0,2,0,2,1341
0,0,1,0,1,0,1,1342
1,1,1,1,2,1,3,1342
2,2,1,0,3,1,4,1342
3,3,1,1,4,2,6,1342
4,4,2,1,6,3,9,1342
5,5,1,0,7,3,10,1342
6,6,0,0,7,3,10,1342
0,0,1,0,1,0,1,1343
1,1,0,0,1,0,1,1343
0,0,1,0,1,0,1,1344
1,1,1,0,2,0,2,1344
2,2,0,0,2,0,2,1344
0,0,1,0,1,0,1,1345
1,1,1,0,2,0,2,1345
2,2,0,0,2,0,2,1345
0,0,1,0,1,0,1,1346
1,1,4,0,5,0,5,1346
2,2,3,1,8,1,9,1346
3,3,2,0,10,1,11,1346
4,4,0,0,10,1,11,1346
0,0,1,0,1,0,1,1347
1,1,1,1,2,1,3,1347
2,2,0,0,2,1,3,1347
0,0,1,0,1,0,1,1348
1,1,0,0,1,0,1,1348
0,0,1,0,1,0,1,1349
1,1,0,0,1,0,1,1349
0,0,1,0,1,0,1,1350
1,1,2,0,3,0,3,1350
2,2,1,1,4,1,5,1350
3,3,1,1,5,2,7,1350
4,4,1,0,6,2,8,1350
5,5,0,0,6,2,8,1350
0,0,1,0,1,0,1,1351
1,1,1,0,2,0,2,1351
2,2,2,0,4,0,4,1351
3,3,2,0,6,0,6,1351
4,4,1,1,7,1,8,1351
5,5,1,0,8,1,9,1351
6,6,2,0,10,1,11,1351
7,7,6,0,16,1,17,1351
8,8,6,1,22,2,24,1351
9,9,4,6,26,8,34,1351
10,10,5,6,31,14,45,1351
11,11,7,3,38,17,55,1351
12,12,9,2,47,19,66,1351
13,13,14,3,61,22,83,1351
14,14,13,5,74,27,101,1351
15,15,11,4,85,31,116,1351
16,16,9,4,94,35,129,1351
17,17,7,3,101,38,139,1351
18,18,2,2,103,40,143,1351
19,19,1,0,104,40,144,1351
20,20,2,1,106,41,147,1351
21,21,0,0,106,41,147,1351
0,0,1,0,1,0,1,1352
1,1,0,0,1,0,1,1352
0,0,1,0,1,0,1,1353
1,1,1,1,2,1,3,1353
2,2,2,0,4,1,5,1353
3,3,2,1,6,2,8,1353
4,4,2,2,8,4,12,1353
5,5,1,2,9,6,15,1353
6,6,1,0,10,6,16,1353
7,7,1,1,11,7,18,1353
8,8,0,2,11,9,20,1353
9,9,0,0,11,9,20,1353
0,0,1,0,1,0,1,1354
1,1,2,0,3,0,3,1354
2,2,2,0,5,0,5,1354
3,3,1,0,6,0,6,1354
4,4,1,0,7,0,7,1354
5,5,0,0,7,0,7,1354
0,0,1,0,1,0,1,1355
1,1,1,0,2,0,2,1355
2,2,2,1,4,1,5,1355
3,3,1,3,5,4,9,1355
4,4,0,3,5,7,12,1355
5,5,0,2,5,9,14,1355
6,6,0,0,5,9,14,1355
0,0,1,0,1,0,1,1356
1,1,1,0,2,0,2,1356
2,2,1,0,3,0,3,1356
3,3,0,1,3,1,4,1356
4,4,0,0,3,1,4,1356
0,0,1,0,1,0,1,1357
1,1,1,1,2,1,3,1357
2,2,0,2,2,3,5,1357
3,3,0,0,2,3,5,1357
0,0,1,0,1,0,1,1358
1,1,1,0,2,0,2,1358
2,2,2,0,4,0,4,1358
3,3,2,0,6,0,6,1358
4,4,0,0,6,0,6,1358
0,0,1,0,1,0,1,1359
1,1,0,0,1,0,1,1359
0,0,1,0,1,0,1,1360
1,1,0,1,1,1,2,1360
2,2,0,1,1,2,3,1360
3,3,0,3,1,5,6,1360
4,4,1,1,2,6,8,1360
5,5,0,0,2,6,8,1360
0,0,1,0,1,0,1,1361
1,1,1,1,2,1,3,1361
2,2,3,0,5,1,6,1361
3,3,2,0,7,1,8,1361
4,4,2,0,9,1,10,1361
5,5,4,0,13,1,14,1361
6,6,4,0,17,1,18,1361
7,7,3,0,20,1,21,1361
8,8,3,3,23,4,27,1361
9,9,4,2,27,6,33,1361
10,10,4,1,31,7,38,1361
11,11,2,1,33,8,41,1361
12,12,0,0,33,8,41,1361
0,0,1,0,1,0,1,1362
1,1,0,0,1,0,1,1362
0,0,1,0,1,0,1,1363
1,1,0,0,1,0,1,1363
0,0,1,0,1,0,1,1364
1,1,2,1,3,1,4,1364
2,2,2,1,5,2,7,1364
3,3,2,1,7,3,10,1364
4,4,0,1,7,4,11,1364
5,5,0,0,7,4,11,1364
0,0,1,0,1,0,1,1365
1,1,0,1,1,1,2,1365
2,2,0,1,1,2,3,1365
3,3,0,0,1,2,3,1365
0,0,1,0,1,0,1,1366
1,1,0,0,1,0,1,1366
0,0,1,0,1,0,1,1367
1,1,0,0,1,0,1,1367
0,0,1,0,1,0,1,1368
1,1,2,0,3,0,3,1368
2,2,2,1,5,1,6,1368
3,3,0,2,5,3,8,1368
4,4,1,0,6,3,9,1368
5,5,0,0,6,3,9,1368
0,0,1,0,1,0,1,1369
1,1,0,0,1,0,1,1369
0,0,1,0,1,0,1,1370
1,1,0,0,1,0,1,1370
0,0,1,0,1,0,1,1371
1,1,0,0,1,0,1,1371
0,0,1,0,1,0,1,1372
1,1,2,0,3,0,3,1372
2,2,2,1,5,1,6,1372
3,3,1,1,6,2,8,1372
4,4,1,1,7,3,10,1372
5,5,2,1,9,4,13,1372
6,6,0,2,9,6,15,1372
7,7,0,1,9,7,16,1372
8,8,0,1,9,8,17,1372
9,9,0,0,9,8,17,1372
0,0,1,0,1,0,1,1373
1,1,0,0,1,0,1,1373
0,0,1,0,1,0,1,1374
1,1,3,0,4,0,4,1374
2,2,3,0,7,0,7,1374
3,3,3,0,10,0,10,1374
4,4,2,1,12,1,13,1374
5,5,1,1,13,2,15,1374
6,6,0,0,13,2,15,1374
0,0,1,0,1,0,1,1375
1,1,2,0,3,0,3,1375
2,2,1,0,4,0,4,1375
3,3,1,0,5,0,5,1375
4,4,0,0,5,0,5,1375
0,0,1,0,1,0,1,1376
1,1,2,0,3,0,3,1376
2,2,3,3,6,3,9,1376
3,3,1,4,7,7,14,1376
4,4,1,6,8,13,21,1376
5,5,5,3,13,16,29,1376
6,6,3,6,16,22,38,1376
7,7,3,3,19,25,44,1376
8,8,6,2,25,27,52,1376
9,9,4,6,29,33,62,1376
10,10,4,6,33,39,72,1376
11,11,6,3,39,42,81,1376
12,12,2,10,41,52,93,1376
13,13,1,8,42,60,102,1376
14,14,3,7,45,67,112,1376
15,15,1,1,46,68,114,1376
16,16,3,1,49,69,118,1376
17,17,4,1,53,70,123,1376
18,18,4,3,57,73,130,1376
19,19,7,3,64,76,140,1376
20,20,9,6,73,82,155,1376
21,21,7,6,80,88,168,1376
22,22,4,4,84,92,176,1376
23,23,7,2,91,94,185,1376
24,24,4,3,95,97,192,1376
25,25,2,3,97,100,197,1376
26,26,3,1,100,101,201,1376
27,27,4,3,104,104,208,1376
28,28,4,5,108,109,217,1376
29,29,3,4,111,113,224,1376
30,30,7,3,118,116,234,1376
31,31,7,2,125,118,243,1376
32,32,3,4,128,122,250,1376
33,33,3,5,131,127,258,1376
34,34,4,1,135,128,263,1376
35,35,2,0,137,128,265,1376
36,36,0,0,137,128,265,1376
0,0,1,0,1,0,1,1377
1,1,1,0,2,0,2,1377
2,2,2,0,4,0,4,1377
3,3,1,1,5,1,6,1377
4,4,1,1,6,2,8,1377
5,5,1,0,7,2,9,1377
6,6,0,0,7,2,9,1377
0,0,1,0,1,0,1,1378
1,1,3,0,4,0,4,1378
2,2,2,0,6,0,6,1378
3,3,1,0,7,0,7,1378
4,4,1,0,8,0,8,1378
5,5,0,0,8,0,8,1378
0,0,1,0,1,0,1,1379
1,1,0,0,1,0,1,1379
0,0,1,0,1,0,1,1380
1,1,0,0,1,0,1,1380
0,0,1,0,1,0,1,1381
1,1,0,0,1,0,1,1381
0,0,1,0,1,0,1,1382
1,1,1,0,2,0,2,1382
2,2,1,0,3,0,3,1382
3,3,1,0,4,0,4,1382
4,4,0,0,4,0,4,1382
0,0,1,0,1,0,1,1383
1,1,0,0,1,0,1,1383
0,0,1,0,1,0,1,1384
1,1,0,0,1,0,1,1384
0,0,1,0,1,0,1,1385
1,1,0,0,1,0,1,1385
0,0,1,0,1,0,1,1386
1,1,1,0,2,0,2,1386
2,2,0,0,2,0,2,1386
0,0,1,0,1,0,1,1387
1,1,1,0,2,0,2,1387
2,2,0,0,2,0,2,1387
0,0,1,0,1,0,1,1388
1,1,1,1,2,1,3,1388
2,2,0,1,2,2,4,1388
3,3,0,0,2,2,4,1388
0,0,1,0,1,0,1,1389
1,1,1,0,2,0,2,1389
2,2,0,0,2,0,2,1389
0,0,1,0,1,0,1,1390
1,1,1,0,2,0,2,1390
2,2,0,0,2,0,2,1390
0,0,1,0,1,0,1,1391
1,1,1,0,2,0,2,1391
2,2,1,0,3,0,3,1391
3,3,0,1,3,1,4,1391
4,4,0,0,3,1,4,1391
0,0,1,0,1,0,1,1392
1,1,0,0,1,0,1,1392
0,0,1,0,1,0,1,1393
1,1,2,0,3,0,3,1393
2,2,0,1,3,1,4,1393
3,3,0,0,3,1,4,1393
0,0,1,0,1,0,1,1394
1,1,1,0,2,0,2,1394
2,2,0,1,2,1,3,1394
3,3,0,0,2,1,3,1394
0,0,1,0,1,0,1,1395
1,1,1,0,2,0,2,1395
2,2,1,0,3,0,3,1395
3,3,1,0,4,0,4,1395
4,4,1,0,5,0,5,1395
5,5,1,0,6,0,6,1395
6,6,1,0,7,0,7,1395
7,7,0,0,7,0,7,1395
0,0,1,0,1,0,1,1396
1,1,2,0,3,0,3,1396
2,2,3,0,6,0,6,1396
3,3,5,1,11,1,12,1396
4,4,4,2,15,3,18,1396
5,5,3,5,18,8,26,1396
6,6,1,5,19,13,32,1396
7,7,4,5,23,18,41,1396
8,8,1,3,24,21,45,1396
9,9,0,0,24,21,45,1396
0,0,1,0,1,0,1,1397
1,1,1,0,2,0,2,1397
2,2,1,0,3,0,3,1397
3,3,0,0,3,0,3,1397
0,0,1,0,1,0,1,1398
1,1,0,0,1,0,1,1398
0,0,1,0,1,0,1,1399
1,1,0,0,1,0,1,1399
0,0,1,0,1,0,1,1400
1,1,1,0,2,0,2,1400
2,2,1,0,3,0,3,1400
3,3,0,2,3,2,5,1400
4,4,0,1,3,3,6,1400
5,5,0,1,3,4,7,1400
6,6,0,0,3,4,7,1400
0,0,1,0,1,0,1,1401
1,1,1,1,2,1,3,1401
2,2,2,0,4,1,5,1401
3,3,0,0,4,1,5,1401
0,0,1,0,1,0,1,1402
1,1,0,0,1,0,1,1402
0,0,1,0,1,0,1,1403
1,1,0,0,1,0,1,1403
0,0,1,0,1,0,1,1404
1,1,0,0,1,0,1,1404
0,0,1,0,1,0,1,1405
1,1,2,0,3,0,3,1405
2,2,2,0,5,0,5,1405
3,3,3,0,8,0,8,1405
4,4,3,0,11,0,11,1405
5,5,3,1,14,1,15,1405
6,6,4,1,18,2,20,1405
7,7,1,1,19,3,22,1405
8,8,0,0,19,3,22,1405
0,0,1,0,1,0,1,1406
1,1,0,0,1,0,1,1406
0,0,1,0,1,0,1,1407
1,1,0,1,1,1,2,1407
2,2,1,2,2,3,5,1407
3,3,0,1,2,4,6,1407
4,4,0,2,2,6,8,1407
5,5,1,2,3,8,11,1407
6,6,0,2,3,10,13,1407
7,7,1,4,4,14,18,1407
8,8,2,2,6,16,22,1407
9,9,1,3,7,19,26,1407
10,10,2,2,9,21,30,1407
11,11,0,0,9,21,30,1407
0,0,1,0,1,0,1,1408
1,1,1,1,2,1,3,1408
2,2,3,0,5,1,6,1408
3,3,0,0,5,1,6,1408
0,0,1,0,1,0,1,1409
1,1,3,0,4,0,4,1409
2,2,2,0,6,0,6,1409
3,3,0,0,6,0,6,1409
0,0,1,0,1,0,1,1410
1,1,1,0,2,0,2,1410
2,2,0,0,2,0,2,1410
0,0,1,0,1,0,1,1411
1,1,3,0,4,0,4,1411
2,2,3,0,7,0,7,1411
3,3,2,1,9,1,10,1411
4,4,2,0,11,1,12,1411
5,5,0,0,11,1,12,1411
0,0,1,0,1,0,1,1412
1,1,0,1,1,1,2,1412
2,2,0,1,1,2,3,1412
3,3,0,2,1,4,5,1412
4,4,0,0,1,4,5,1412
0,0,1,0,1,0,1,1413
1,1,0,0,1,0,1,1413
0,0,1,0,1,0,1,1414
1,1,1,0,2,0,2,1414
2,2,1,0,3,0,3,1414
3,3,2,0,5,0,5,1414
4,4,1,1,6,1,7,1414
5,5,0,1,6,2,8,1414
6,6,0,3,6,5,11,1414
7,7,0,2,6,7,13,1414
8,8,1,0,7,7,14,1414
9,9,1,0,8,7,15,1414
10,10,0,0,8,7,15,1414
0,0,1,0,1,0,1,1415
1,1,1,0,2,0,2,1415
2,2,2,0,4,0,4,1415
3,3,2,0,6,0,6,1415
4,4,1,0,7,0,7,1415
5,5,0,0,7,0,7,1415
0,0,1,0,1,0,1,1416
1,1,0,0,1,0,1,1416
0,0,1,0,1,0,1,1417
1,1,0,0,1,0,1,1417
0,0,1,0,1,0,1,1418
1,1,1,0,2,0,2,1418
2,2,0,0,2,0,2,1418
0,0,1,0,1,0,1,1419
1,1,0,0,1,0,1,1419
0,0,1,0,1,0,1,1420
1,1,1,1,2,1,3,1420
2,2,2,0,4,1,5,1420
3,3,3,1,7,2,9,1420
4,4,2,2,9,4,13,1420
5,5,1,2,10,6,16,1420
6,6,0,1,10,7,17,1420
7,7,0,1,10,8,18,1420
8,8,1,0,11,8,19,1420
9,9,1,0,12,8,20,1420
10,10,0,0,12,8,20,1420
0,0,1,0,1,0,1,1421
1,1,0,0,1,0,1,1421
0,0,1,0,1,0,1,1422
1,1,0,0,1,0,1,1422
0,0,1,0,1,0,1,1423
1,1,3,1,4,1,5,1423
2,2,5,3,9,4,13,1423
3,3,4,3,13,7,20,1423
4,4,3,1,16,8,24,1423
5,5,2,1,18,9,27,1423
6,6,2,1,20,10,30,1423
7,7,1,0,21,10,31,1423
8,8,0,1,21,11,32,1423
9,9,0,1,21,12,33,1423
10,10,0,0,21,12,33,1423
0,0,1,0,1,0,1,1424
1,1,1,0,2,0,2,1424
2,2,2,1,4,1,5,1424
3,3,3,2,7,3,10,1424
4,4,2,4,9,7,16,1424
5,5,3,3,12,10,22,1424
6,6,3,3,15,13,28,1424
7,7,1,2,16,15,31,1424
8,8,1,1,17,16,33,1424
9,9,1,0,18,16,34,1424
10,10,2,0,20,16,36,1424
11,11,0,0,20,16,36,1424
0,0,1,0,1,0,1,1425
1,1,0,0,1,0,1,1425
0,0,1,0,1,0,1,1426
1,1,0,0,1,0,1,1426
0,0,1,0,1,0,1,1427
1,1,3,0,4,0,4,1427
2,2,3,1,7,1,8,1427
3,3,3,2,10,3,13,1427
4,4,1,5,11,8,19,1427
5,5,2,6,13,14,27,1427
6,6,1,5,14,19,33,1427
7,7,1,6,15,25,40,1427
8,8,2,4,17,29,46,1427
9,9,2,3,19,32,51,1427
10,10,1,5,20,37,57,1427
11,11,1,2,21,39,60,1427
12,12,0,2,21,41,62,1427
13,13,0,0,21,41,62,1427
0,0,1,0,1,0,1,1428
1,1,0,0,1,0,1,1428
0,0,1,0,1,0,1,1429
1,1,0,1,1,1,2,1429
2,2,0,1,1,2,3,1429
3,3,0,1,1,3,4,1429
4,4,0,1,1,4,5,1429
5,5,1,0,2,4,6,1429
6,6,3,0,5,4,9,1429
7,7,4,0,9,4,13,1429
8,8,6,1,15,5,20,1429
9,9,4,0,19,5,24,1429
10,10,4,0,23,5,28,1429
11,11,1,1,24,6,30,1429
12,12,0,1,24,7,31,1429
13,13,0,0,24,7,31,1429
0,0,1,0,1,0,1,1430
1,1,1,0,2,0,2,1430
2,2,0,0,2,0,2,1430
0,0,1,0,1,0,1,1431
1,1,1,0,2,0,2,1431
2,2,1,1,3,1,4,1431
3,3,0,1,3,2,5,1431
4,4,0,1,3,3,6,1431
5,5,0,0,3,3,6,1431
0,0,1,0,1,0,1,1432
1,1,2,0,3,0,3,1432
2,2,2,0,5,0,5,1432
3,3,2,0,7,0,7,1432
4,4,0,1,7,1,8,1432
5,5,0,2,7,3,10,1432
6,6,0,2,7,5,12,1432
7,7,1,3,8,8,16,1432
8,8,2,4,10,12,22,1432
9,9,3,2,13,14,27,1432
10,10,4,0,17,14,31,1432
11,11,2,0,19,14,33,1432
12,12,1,0,20,14,34,1432
13,13,0,0,20,14,34,1432
0,0,1,0,1,0,1,1433
1,1,1,1,2,1,3,1433
2,2,2,1,4,2,6,1433
3,3,1,0,5,2,7,1433
4,4,1,0,6,2,8,1433
5,5,1,0,7,2,9,1433
6,6,1,0,8,2,10,1433
7,7,1,1,9,3,12,1433
8,8,1,1,10,4,14,1433
9,9,2,0,12,4,16,1433
10,10,0,0,12,4,16,1433
0,0,1,0,1,0,1,1434
1,1,2,1,3,1,4,1434
2,2,2,2,5,3,8,1434
3,3,1,1,6,4,10,1434
4,4,1,1,7,5,12,1434
5,5,2,0,9,5,14,1434
6,6,1,1,10,6,16,1434
7,7,0,1,10,7,17,1434
8,8,0,2,10,9,19,1434
9,9,0,3,10,12,22,1434
10,10,2,7,12,19,31,1434
11,11,4,7,16,26,42,1434
12,12,4,4,20,30,50,1434
13,13,5,3,25,33,58,1434
14,14,6,4,31,37,68,1434
15,15,3,8,34,45,79,1434
16,16,4,6,38,51,89,1434
17,17,2,3,40,54,94,1434
18,18,4,1,44,55,99,1434
19,19,2,1,46,56,102,1434
20,20,0,3,46,59,105,1434
21,21,0,3,46,62,108,1434
22,22,0,2,46,64,110,1434
23,23,1,2,47,66,113,1434
24,24,1,0,48,66,114,1434
25,25,1,0,49,66,115,1434
26,26,0,0,49,66,115,1434
0,0,1,0,1,0,1,1435
1,1,1,1,2,1,3,1435
2,2,0,0,2,1,3,1435
0,0,1,0,1,0,1,1436
1,1,0,0,1,0,1,1436
0,0,1,0,1,0,1,1437
1,1,0,0,1,0,1,1437
0,0,1,0,1,0,1,1438
1,1,0,0,1,0,1,1438
0,0,1,0,1,0,1,1439
1,1,0,0,1,0,1,1439
0,0,1,0,1,0,1,1440
1,1,2,1,3,1,4,1440
2,2,2,1,5,2,7,1440
3,3,0,0,5,2,7,1440
0,0,1,0,1,0,1,1441
1,1,1,0,2,0,2,1441
2,2,1,0,3,0,3,1441
3,3,2,0,5,0,5,1441
4,4,0,0,5,0,5,1441
0,0,1,0,1,0,1,1442
1,1,0,0,1,0,1,1442
0,0,1,0,1,0,1,1443
1,1,2,0,3,0,3,1443
2,2,2,0,5,0,5,1443
3,3,0,0,5,0,5,1443
0,0,1,0,1,0,1,1444
1,1,0,0,1,0,1,1444
0,0,1,0,1,0,1,1445
1,1,0,0,1,0,1,1445
0,0,1,0,1,0,1,1446
1,1,2,2,3,2,5,1446
2,2,0,7,3,9,12,1446
3,3,1,3,4,12,16,1446
4,4,0,4,4,16,20,1446
5,5,1,2,5,18,23,1446
6,6,1,2,6,20,26,1446
7,7,1,1,7,21,28,1446
8,8,1,1,8,22,30,1446
9,9,0,0,8,22,30,1446
0,0,1,0,1,0,1,1447
1,1,0,1,1,1,2,1447
2,2,0,0,1,1,2,1447
0,0,1,0,1,0,1,1448
1,1,2,0,3,0,3,1448
2,2,2,0,5,0,5,1448
3,3,1,0,6,0,6,1448
4,4,0,0,6,0,6,1448
0,0,1,0,1,0,1,1449
1,1,0,0,1,0,1,1449
0,0,1,0,1,0,1,1450
1,1,2,0,3,0,3,1450
2,2,1,0,4,0,4,1450
3,3,0,1,4,1,5,1450
4,4,0,0,4,1,5,1450
0,0,1,0,1,0,1,1451
1,1,1,1,2,1,3,1451
2,2,3,1,5,2,7,1451
3,3,4,1,9,3,12,1451
4,4,2,1,11,4,15,1451
5,5,1,0,12,4,16,1451
6,6,0,1,12,5,17,1451
7,7,0,2,12,7,19,1451
8,8,0,1,12,8,20,1451
9,9,2,1,14,9,23,1451
10,10,4,2,18,11,29,1451
11,11,2,1,20,12,32,1451
12,12,1,1,21,13,34,1451
13,13,0,0,21,13,34,1451
0,0,1,0,1,0,1,1452
1,1,0,0,1,0,1,1452
0,0,1,0,1,0,1,1453
1,1,0,1,1,1,2,1453
2,2,0,2,1,3,4,1453
3,3,0,1,1,4,5,1453
4,4,1,1,2,5,7,1453
5,5,2,0,4,5,9,1453
6,6,2,0,6,5,11,1453
7,7,2,0,8,5,13,1453
8,8,2,0,10,5,15,1453
9,9,1,0,11,5,16,1453
10,10,1,0,12,5,17,1453
11,11,0,0,12,5,17,1453
0,0,1,0,1,0,1,1454
1,1,1,1,2,1,3,1454
2,2,1,1,3,2,5,1454
3,3,2,1,5,3,8,1454
4,4,1,1,6,4,10,1454
5,5,1,1,7,5,12,1454
6,6,0,0,7,5,12,1454
0,0,1,0,1,0,1,1455
1,1,0,0,1,0,1,1455
0,0,1,0,1,0,1,1456
1,1,1,0,2,0,2,1456
2,2,2,0,4,0,4,1456
3,3,1,2,5,2,7,1456
4,4,1,1,6,3,9,1456
5,5,1,0,7,3,10,1456
6,6,1,0,8,3,11,1456
7,7,1,1,9,4,13,1456
8,8,1,2,10,6,16,1456
9,9,3,1,13,7,20,1456
10,10,2,0,15,7,22,1456
11,11,2,0,17,7,24,1456
12,12,0,0,17,7,24,1456
0,0,1,0,1,0,1,1457
1,1,0,0,1,0,1,1457
0,0,1,0,1,0,1,1458
1,1,0,0,1,0,1,1458
0,0,1,0,1,0,1,1459
1,1,1,0,2,0,2,1459
2,2,1,0,3,0,3,1459
3,3,0,0,3,0,3,1459
0,0,1,0,1,0,1,1460
1,1,0,0,1,0,1,1460
0,0,1,0,1,0,1,1461
1,1,0,0,1,0,1,1461
0,0,1,0,1,0,1,1462
1,1,0,0,1,0,1,1462
0,0,1,0,1,0,1,1463
1,1,0,1,1,1,2,1463
2,2,0,1,1,2,3,1463
3,3,0,0,1,2,3,1463
0,0,1,0,1,0,1,1464
1,1,1,0,2,0,2,1464
2,2,1,0,3,0,3,1464
3,3,3,1,6,1,7,1464
4,4,2,1,8,2,10,1464
5,5,3,2,11,4,15,1464
6,6,3,3,14,7,21,1464
7,7,3,1,17,8,25,1464
8,8,3,0,20,8,28,1464
9,9,3,1,23,9,32,1464
10,10,1,0,24,9,33,1464
11,11,0,1,24,10,34,1464
12,12,0,1,24,11,35,1464
13,13,0,0,24,11,35,1464
0,0,1,0,1,0,1,1465
1,1,1,0,2,0,2,1465
2,2,0,0,2,0,2,1465
0,0,1,0,1,0,1,1466
1,1,1,0,2,0,2,1466
2,2,1,0,3,0,3,1466
3,3,1,0,4,0,4,1466
4,4,3,0,7,0,7,1466
5,5,2,0,9,0,9,1466
6,6,3,1,12,1,13,1466
7,7,1,0,13,1,14,1466
8,8,0,0,13,1,14,1466
0,0,1,0,1,0,1,1467
1,1,2,0,3,0,3,1467
2,2,5,0,8,0,8,1467
3,3,3,0,11,0,11,1467
4,4,2,1,13,1,14,1467
5,5,3,1,16,2,18,1467
6,6,1,1,17,3,20,1467
7,7,2,1,19,4,23,1467
8,8,1,0,20,4,24,1467
9,9,1,0,21,4,25,1467
10,10,0,0,21,4,25,1467
0,0,1,0,1,0,1,1468
1,1,0,1,1,1,2,1468
2,2,0,0,1,1,2,1468
0,0,1,0,1,0,1,1469
1,1,2,0,3,0,3,1469
2,2,1,0,4,0,4,1469
3,3,0,0,4,0,4,1469
0,0,1,0,1,0,1,1470
1,1,2,0,3,0,3,1470
2,2,1,0,4,0,4,1470
3,3,1,1,5,1,6,1470
4,4,1,0,6,1,7,1470
5,5,1,0,7,1,8,1470
6,6,0,0,7,1,8,1470
0,0,1,0,1,0,1,1471
1,1,1,0,2,0,2,1471
2,2,0,0,2,0,2,1471
0,0,1,0,1,0,1,1472
1,1,0,0,1,0,1,1472
0,0,1,0,1,0,1,1473
1,1,0,0,1,0,1,1473
0,0,1,0,1,0,1,1474
1,1,1,0,2,0,2,1474
2,2,0,0,2,0,2,1474
0,0,1,0,1,0,1,1475
1,1,2,0,3,0,3,1475
2,2,1,0,4,0,4,1475
3,3,3,0,7,0,7,1475
4,4,1,0,8,0,8,1475
5,5,0,0,8,0,8,1475
0,0,1,0,1,0,1,1476
1,1,0,0,1,0,1,1476
0,0,1,0,1,0,1,1477
1,1,1,0,2,0,2,1477
2,2,1,0,3,0,3,1477
3,3,0,0,3,0,3,1477
0,0,1,0,1,0,1,1478
1,1,1,0,2,0,2,1478
2,2,0,0,2,0,2,1478
0,0,1,0,1,0,1,1479
1,1,0,0,1,0,1,1479
0,0,1,0,1,0,1,1480
1,1,0,0,1,0,1,1480
0,0,1,0,1,0,1,1481
1,1,0,0,1,0,1,1481
0,0,1,0,1,0,1,1482
1,1,2,0,3,0,3,1482
2,2,1,0,4,0,4,1482
3,3,0,1,4,1,5,1482
4,4,0,1,4,2,6,1482
5,5,0,1,4,3,7,1482
6,6,1,1,5,4,9,1482
7,7,3,1,8,5,13,1482
8,8,1,0,9,5,14,1482
9,9,2,0,11,5,16,1482
10,10,4,0,15,5,20,1482
11,11,3,0,18,5,23,1482
12,12,2,1,20,6,26,1482
13,13,0,0,20,6,26,1482
0,0,1,0,1,0,1,1483
1,1,0,1,1,1,2,1483
2,2,0,0,1,1,2,1483
0,0,1,0,1,0,1,1484
1,1,0,0,1,0,1,1484
0,0,1,0,1,0,1,1485
1,1,0,0,1,0,1,1485
0,0,1,0,1,0,1,1486
1,1,0,0,1,0,1,1486
0,0,1,0,1,0,1,1487
1,1,3,0,4,0,4,1487
2,2,0,1,4,1,5,1487
3,3,1,1,5,2,7,1487
4,4,2,0,7,2,9,1487
5,5,0,0,7,2,9,1487
0,0,1,0,1,0,1,1488
1,1,1,0,2,0,2,1488
2,2,0,1,2,1,3,1488
3,3,0,2,2,3,5,1488
4,4,1,3,3,6,9,1488
5,5,3,5,6,11,17,1488
6,6,2,3,8,14,22,1488
7,7,4,2,12,16,28,1488
8,8,2,4,14,20,34,1488
9,9,0,2,14,22,36,1488
10,10,0,1,14,23,37,1488
11,11,0,0,14,23,37,1488
0,0,1,0,1,0,1,1489
1,1,0,0,1,0,1,1489
0,0,1,0,1,0,1,1490
1,1,0,0,1,0,1,1490
0,0,1,0,1,0,1,1491
1,1,0,0,1,0,1,1491
0,0,1,0,1,0,1,1492
1,1,1,0,2,0,2,1492
2,2,1,0,3,0,3,1492
3,3,2,0,5,0,5,1492
4,4,1,1,6,1,7,1492
5,5,2,1,8,2,10,1492
6,6,2,1,10,3,13,1492
7,7,2,1,12,4,16,1492
8,8,4,1,16,5,21,1492
9,9,2,0,18,5,23,1492
10,10,0,1,18,6,24,1492
11,11,0,0,18,6,24,1492
0,0,1,0,1,0,1,1493
1,1,1,0,2,0,2,1493
2,2,0,1,2,1,3,1493
3,3,0,3,2,4,6,1493
4,4,0,0,2,4,6,1493
0,0,1,0,1,0,1,1494
1,1,1,0,2,0,2,1494
2,2,1,0,3,0,3,1494
3,3,1,0,4,0,4,1494
4,4,0,0,4,0,4,1494
0,0,1,0,1,0,1,1495
1,1,1,1,2,1,3,1495
2,2,0,1,2,2,4,1495
3,3,0,1,2,3,5,1495
4,4,1,1,3,4,7,1495
5,5,3,2,6,6,12,1495
6,6,1,1,7,7,14,1495
7,7,1,0,8,7,15,1495
8,8,1,0,9,7,16,1495
9,9,1,0,10,7,17,1495
10,10,1,0,11,7,18,1495
11,11,0,0,11,7,18,1495
0,0,1,0,1,0,1,1496
1,1,1,0,2,0,2,1496
2,2,1,0,3,0,3,1496
3,3,1,2,4,2,6,1496
4,4,1,1,5,3,8,1496
5,5,1,1,6,4,10,1496
6,6,1,3,7,7,14,1496
7,7,0,1,7,8,15,1496
8,8,0,0,7,8,15,1496
0,0,1,0,1,0,1,1497
1,1,0,1,1,1,2,1497
2,2,0,1,1,2,3,1497
3,3,0,1,1,3,4,1497
4,4,0,1,1,4,5,1497
5,5,0,0,1,4,5,1497
0,0,1,0,1,0,1,1498
1,1,0,1,1,1,2,1498
2,2,0,1,1,2,3,1498
3,3,0,0,1,2,3,1498
0,0,1,0,1,0,1,1499
1,1,1,0,2,0,2,1499
2,2,1,0,3,0,3,1499
3,3,1,0,4,0,4,1499
4,4,0,1,4,1,5,1499
5,5,0,0,4,1,5,1499
0,0,1,0,1,0,1,1500
1,1,3,0,4,0,4,1500
2,2,5,1,9,1,10,1500
3,3,5,1,14,2,16,1500
4,4,1,1,15,3,18,1500
5,5,0,1,15,4,19,1500
6,6,0,1,15,5,20,1500
7,7,0,2,15,7,22,1500
8,8,0,1,15,8,23,1500
9,9,0,1,15,9,24,1500
10,10,0,1,15,10,25,1500
11,11,0,0,15,10,25,1500
0,0,1,0,1,0,1,1501
1,1,0,0,1,0,1,1501
0,0,1,0,1,0,1,1502
1,1,1,1,2,1,3,1502
2,2,1,0,3,1,4,1502
3,3,0,0,3,1,4,1502
0,0,1,0,1,0,1,1503
1,1,0,0,1,0,1,1503
0,0,1,0,1,0,1,1504
1,1,0,0,1,0,1,1504
0,0,1,0,1,0,1,1505
1,1,0,0,1,0,1,1505
0,0,1,0,1,0,1,1506
1,1,1,0,2,0,2,1506
2,2,0,0,2,0,2,1506
0,0,1,0,1,0,1,1507
1,1,2,0,3,0,3,1507
2,2,4,0,7,0,7,1507
3,3,2,1,9,1,10,1507
4,4,2,0,11,1,12,1507
5,5,2,1,13,2,15,1507
6,6,3,1,16,3,19,1507
7,7,3,2,19,5,24,1507
8,8,2,2,21,7,28,1507
9,9,2,3,23,10,33,1507
10,10,0,0,23,10,33,1507
0,0,1,0,1,0,1,1508
1,1,0,0,1,0,1,1508
0,0,1,0,1,0,1,1509
1,1,1,0,2,0,2,1509
2,2,1,0,3,0,3,1509
3,3,1,0,4,0,4,1509
4,4,1,0,5,0,5,1509
5,5,1,0,6,0,6,1509
6,6,1,0,7,0,7,1509
7,7,1,0,8,0,8,1509
8,8,0,0,8,0,8,1509
0,0,1,0,1,0,1,1510
1,1,2,0,3,0,3,1510
2,2,1,0,4,0,4,1510
3,3,2,0,6,0,6,1510
4,4,3,0,9,0,9,1510
5,5,1,0,10,0,10,1510
6,6,2,0,12,0,12,1510
7,7,1,0,13,0,13,1510
8,8,1,0,14,0,14,1510
9,9,0,1,14,1,15,1510
10,10,0,0,14,1,15,1510
0,0,1,0,1,0,1,1511
1,1,0,0,1,0,1,1511
0,0,1,0,1,0,1,1512
1,1,0,0,1,0,1,1512
0,0,1,0,1,0,1,1513
1,1,1,0,2,0,2,1513
2,2,3,0,5,0,5,1513
3,3,2,0,7,0,7,1513
4,4,4,2,11,2,13,1513
5,5,3,1,14,3,17,1513
6,6,1,0,15,3,18,1513
7,7,0,0,15,3,18,1513
0,0,1,0,1,0,1,1514
1,1,1,0,2,0,2,1514
2,2,0,0,2,0,2,1514
0,0,1,0,1,0,1,1515
1,1,0,0,1,0,1,1515
0,0,1,0,1,0,1,1516
1,1,1,0,2,0,2,1516
2,2,1,0,3,0,3,1516
3,3,0,0,3,0,3,1516
0,0,1,0,1,0,1,1517
1,1,0,0,1,0,1,1517
0,0,1,0,1,0,1,1518
1,1,1,0,2,0,2,1518
2,2,0,0,2,0,2,1518
0,0,1,0,1,0,1,1519
1,1,0,1,1,1,2,1519
2,2,0,0,1,1,2,1519
0,0,1,0,1,0,1,1520
1,1,1,0,2,0,2,1520
2,2,1,0,3,0,3,1520
3,3,1,0,4,0,4,1520
4,4,0,0,4,0,4,1520
0,0,1,0,1,0,1,1521
1,1,1,0,2,0,2,1521
2,2,0,0,2,0,2,1521
0,0,1,0,1,0,1,1522
1,1,1,1,2,1,3,1522
2,2,2,0,4,1,5,1522
3,3,1,0,5,1,6,1522
4,4,0,1,5,2,7,1522
5,5,0,1,5,3,8,1522
6,6,1,1,6,4,10,1522
7,7,0,0,6,4,10,1522
0,0,1,0,1,0,1,1523
1,1,0,1,1,1,2,1523
2,2,0,1,1,2,3,1523
3,3,0,2,1,4,5,1523
4,4,0,3,1,7,8,1523
5,5,1,3,2,10,12,1523
6,6,2,1,4,11,15,1523
7,7,0,2,4,13,17,1523
8,8,0,2,4,15,19,1523
9,9,0,2,4,17,21,1523
10,10,0,1,4,18,22,1523
11,11,0,0,4,18,22,1523
0,0,1,0,1,0,1,1524
1,1,0,0,1,0,1,1524
0,0,1,0,1,0,1,1525
1,1,0,1,1,1,2,1525
2,2,0,0,1,1,2,1525
0,0,1,0,1,0,1,1526
1,1,0,0,1,0,1,1526
0,0,1,0,1,0,1,1527
1,1,1,0,2,0,2,1527
2,2,1,1,3,1,4,1527
3,3,0,2,3,3,6,1527
4,4,0,0,3,3,6,1527
0,0,1,0,1,0,1,1528
1,1,0,0,1,0,1,1528
0,0,1,0,1,0,1,1529
1,1,0,0,1,0,1,1529
0,0,1,0,1,0,1,1530
1,1,2,1,3,1,4,1530
2,2,1,1,4,2,6,1530
3,3,1,1,5,3,8,1530
4,4,0,2,5,5,10,1530
5,5,0,0,5,5,10,1530
0,0,1,0,1,0,1,1531
1,1,1,0,2,0,2,1531
2,2,0,0,2,0,2,1531
0,0,1,0,1,0,1,1532
1,1,3,0,4,0,4,1532
2,2,2,0,6,0,6,1532
3,3,0,0,6,0,6,1532
0,0,1,0,1,0,1,1533
1,1,1,0,2,0,2,1533
2,2,1,0,3,0,3,1533
3,3,2,0,5,0,5,1533
4,4,1,3,6,3,9,1533
5,5,0,3,6,6,12,1533
6,6,0,1,6,7,13,1533
7,7,0,1,6,8,14,1533
8,8,0,0,6,8,14,1533
0,0,1,0,1,0,1,1534
1,1,1,0,2,0,2,1534
2,2,1,0,3,0,3,1534
3,3,2,0,5,0,5,1534
4,4,1,0,6,0,6,1534
5,5,0,0,6,0,6,1534
0,0,1,0,1,0,1,1535
1,1,1,0,2,0,2,1535
2,2,0,0,2,0,2,1535
0,0,1,0,1,0,1,1536
1,1,1,1,2,1,3,1536
2,2,0,1,2,2,4,1536
3,3,0,0,2,2,4,1536
0,0,1,0,1,0,1,1537
1,1,1,1,2,1,3,1537
2,2,1,1,3,2,5,1537
3,3,4,0,7,2,9,1537
4,4,1,1,8,3,11,1537
5,5,2,0,10,3,13,1537
6,6,0,0,10,3,13,1537
0,0,1,0,1,0,1,1538
1,1,1,0,2,0,2,1538
2,2,0,0,2,0,2,1538
0,0,1,0,1,0,1,1539
1,1,0,0,1,0,1,1539
0,0,1,0,1,0,1,1540
1,1,1,0,2,0,2,1540
2,2,1,0,3,0,3,1540
3,3,1,0,4,0,4,1540
4,4,0,0,4,0,4,1540
0,0,1,0,1,0,1,1541
1,1,2,0,3,0,3,1541
2,2,1,0,4,0,4,1541
3,3,1,0,5,0,5,1541
4,4,2,0,7,0,7,1541
5,5,4,1,11,1,12,1541
6,6,5,1,16,2,18,1541
7,7,0,2,16,4,20,1541
8,8,0,1,16,5,21,1541
9,9,0,0,16,5,21,1541
0,0,1,0,1,0,1,1542
1,1,0,0,1,0,1,1542
0,0,1,0,1,0,1,1543
1,1,0,0,1,0,1,1543
0,0,1,0,1,0,1,1544
1,1,0,0,1,0,1,1544
0,0,1,0,1,0,1,1545
1,1,1,0,2,0,2,1545
2,2,1,1,3,1,4,1545
3,3,1,2,4,3,7,1545
4,4,1,2,5,5,10,1545
5,5,0,1,5,6,11,1545
6,6,0,1,5,7,12,1545
7,7,1,1,6,8,14,1545
8,8,2,1,8,9,17,1545
9,9,1,0,9,9,18,1545
10,10,0,0,9,9,18,1545
0,0,1,0,1,0,1,1546
1,1,0,0,1,0,1,1546
0,0,1,0,1,0,1,1547
1,1,1,0,2,0,2,1547
2,2,0,0,2,0,2,1547
0,0,1,0,1,0,1,1548
1,1,1,1,2,1,3,1548
2,2,0,0,2,1,3,1548
0,0,1,0,1,0,1,1549
1,1,1,1,2,1,3,1549
2,2,1,0,3,1,4,1549
3,3,0,0,3,1,4,1549
0,0,1,0,1,0,1,1550
1,1,1,0,2,0,2,1550
2,2,0,1,2,1,3,1550
3,3,1,0,3,1,4,1550
4,4,0,0,3,1,4,1550
0,0,1,0,1,0,1,1551
1,1,1,0,2,0,2,1551
2,2,1,0,3,0,3,1551
3,3,1,2,4,2,6,1551
4,4,0,2,4,4,8,1551
5,5,2,3,6,7,13,1551
6,6,0,4,6,11,17,1551
7,7,0,4,6,15,21,1551
8,8,0,4,6,19,25,1551
9,9,0,3,6,22,28,1551
10,10,0,3,6,25,31,1551
11,11,0,3,6,28,34,1551
12,12,1,1,7,29,36,1551
13,13,1,0,8,29,37,1551
14,14,1,0,9,29,38,1551
15,15,0,0,9,29,38,1551
0,0,1,0,1,0,1,1552
1,1,1,1,2,1,3,1552
2,2,1,1,3,2,5,1552
3,3,0,0,3,2,5,1552
0,0,1,0,1,0,1,1553
1,1,0,0,1,0,1,1553
0,0,1,0,1,0,1,1554
1,1,1,0,2,0,2,1554
2,2,0,1,2,1,3,1554
3,3,0,0,2,1,3,1554
0,0,1,0,1,0,1,1555
1,1,1,1,2,1,3,1555
2,2,0,1,2,2,4,1555
3,3,1,3,3,5,8,1555
4,4,2,2,5,7,12,1555
5,5,3,4,8,11,19,1555
6,6,1,3,9,14,23,1555
7,7,3,3,12,17,29,1555
8,8,4,5,16,22,38,1555
9,9,1,2,17,24,41,1555
10,10,1,2,18,26,44,1555
11,11,0,1,18,27,45,1555
12,12,0,1,18,28,46,1555
13,13,1,1,19,29,48,1555
14,14,1,1,20,30,50,1555
15,15,2,1,22,31,53,1555
16,16,1,1,23,32,55,1555
17,17,1,1,24,33,57,1555
18,18,0,2,24,35,59,1555
19,19,0,1,24,36,60,1555
20,20,0,0,24,36,60,1555
0,0,1,0,1,0,1,1556
1,1,1,0,2,0,2,1556
2,2,0,0,2,0,2,1556
0,0,1,0,1,0,1,1557
1,1,1,0,2,0,2,1557
2,2,1,1,3,1,4,1557
3,3,0,2,3,3,6,1557
4,4,1,1,4,4,8,1557
5,5,1,2,5,6,11,1557
6,6,2,2,7,8,15,1557
7,7,3,3,10,11,21,1557
8,8,6,4,16,15,31,1557
9,9,7,6,23,21,44,1557
10,10,1,6,24,27,51,1557
11,11,4,3,28,30,58,1557
12,12,2,2,30,32,62,1557
13,13,2,3,32,35,67,1557
14,14,2,2,34,37,71,1557
15,15,2,1,36,38,74,1557
16,16,2,0,38,38,76,1557
17,17,2,1,40,39,79,1557
18,18,2,1,42,40,82,1557
19,19,1,1,43,41,84,1557
20,20,0,0,43,41,84,1557
0,0,1,0,1,0,1,1558
1,1,1,0,2,0,2,1558
2,2,1,0,3,0,3,1558
3,3,0,0,3,0,3,1558
0,0,1,0,1,0,1,1559
1,1,0,0,1,0,1,1559
0,0,1,0,1,0,1,1560
1,1,1,0,2,0,2,1560
2,2,0,0,2,0,2,1560
0,0,1,0,1,0,1,1561
1,1,2,0,3,0,3,1561
2,2,1,0,4,0,4,1561
3,3,0,0,4,0,4,1561
0,0,1,0,1,0,1,1562
1,1,1,0,2,0,2,1562
2,2,1,0,3,0,3,1562
3,3,1,0,4,0,4,1562
4,4,0,0,4,0,4,1562
0,0,1,0,1,0,1,1563
1,1,1,0,2,0,2,1563
2,2,1,0,3,0,3,1563
3,3,1,0,4,0,4,1563
4,4,1,0,5,0,5,1563
5,5,1,1,6,1,7,1563
6,6,0,1,6,2,8,1563
7,7,0,0,6,2,8,1563
0,0,1,0,1,0,1,1564
1,1,2,0,3,0,3,1564
2,2,0,0,3,0,3,1564
0,0,1,0,1,0,1,1565
1,1,0,0,1,0,1,1565
0,0,1,0,1,0,1,1566
1,1,2,0,3,0,3,1566
2,2,3,0,6,0,6,1566
3,3,4,0,10,0,10,1566
4,4,5,0,15,0,15,1566
5,5,2,1,17,1,18,1566
6,6,2,1,19,2,21,1566
7,7,1,1,20,3,23,1566
8,8,0,0,20,3,23,1566
0,0,1,0,1,0,1,1567
1,1,1,0,2,0,2,1567
2,2,0,1,2,1,3,1567
3,3,0,1,2,2,4,1567
4,4,0,0,2,2,4,1567
0,0,1,0,1,0,1,1568
1,1,1,0,2,0,2,1568
2,2,0,0,2,0,2,1568
0,0,1,0,1,0,1,1569
1,1,1,0,2,0,2,1569
2,2,0,0,2,0,2,1569
0,0,1,0,1,0,1,1570
1,1,0,0,1,0,1,1570
0,0,1,0,1,0,1,1571
1,1,0,0,1,0,1,1571
0,0,1,0,1,0,1,1572
1,1,2,0,3,0,3,1572
2,2,2,1,5,1,6,1572
3,3,1,0,6,1,7,1572
4,4,0,1,6,2,8,1572
5,5,0,0,6,2,8,1572
0,0,1,0,1,0,1,1573
1,1,1,0,2,0,2,1573
2,2,0,1,2,1,3,1573
3,3,0,0,2,1,3,1573
0,0,1,0,1,0,1,1574
1,1,1,0,2,0,2,1574
2,2,0,0,2,0,2,1574
0,0,1,0,1,0,1,1575
1,1,2,0,3,0,3,1575
2,2,1,0,4,0,4,1575
3,3,1,0,5,0,5,1575
4,4,0,0,5,0,5,1575
0,0,1,0,1,0,1,1576
1,1,3,0,4,0,4,1576
2,2,4,0,8,0,8,1576
3,3,1,1,9,1,10,1576
4,4,0,2,9,3,12,1576
5,5,0,0,9,3,12,1576
0,0,1,0,1,0,1,1577
1,1,0,1,1,1,2,1577
2,2,0,0,1,1,2,1577
0,0,1,0,1,0,1,1578
1,1,1,0,2,0,2,1578
2,2,1,0,3,0,3,1578
3,3,0,0,3,0,3,1578
0,0,1,0,1,0,1,1579
1,1,3,0,4,0,4,1579
2,2,0,1,4,1,5,1579
3,3,0,0,4,1,5,1579
0,0,1,0,1,0,1,1580
1,1,0,0,1,0,1,1580
0,0,1,0,1,0,1,1581
1,1,3,0,4,0,4,1581
2,2,2,0,6,0,6,1581
3,3,0,1,6,1,7,1581
4,4,0,0,6,1,7,1581
0,0,1,0,1,0,1,1582
1,1,0,0,1,0,1,1582
0,0,1,0,1,0,1,1583
1,1,0,0,1,0,1,1583
0,0,1,0,1,0,1,1584
1,1,0,0,1,0,1,1584
0,0,1,0,1,0,1,1585
1,1,2,0,3,0,3,1585
2,2,5,1,8,1,9,1585
3,3,7,0,15,1,16,1585
4,4,5,0,20,1,21,1585
5,5,2,0,22,1,23,1585
6,6,2,1,24,2,26,1585
7,7,1,1,25,3,28,1585
8,8,1,0,26,3,29,1585
9,9,0,0,26,3,29,1585
0,0,1,0,1,0,1,1586
1,1,1,1,2,1,3,1586
2,2,1,0,3,1,4,1586
3,3,3,0,6,1,7,1586
4,4,3,0,9,1,10,1586
5,5,1,1,10,2,12,1586
6,6,1,1,11,3,14,1586
7,7,0,0,11,3,14,1586
0,0,1,0,1,0,1,1587
1,1,2,0,3,0,3,1587
2,2,1,2,4,2,6,1587
3,3,2,1,6,3,9,1587
4,4,0,2,6,5,11,1587
5,5,0,2,6,7,13,1587
6,6,1,0,7,7,14,1587
7,7,2,0,9,7,16,1587
8,8,3,1,12,8,20,1587
9,9,4,1,16,9,25,1587
10,10,2,0,18,9,27,1587
11,11,1,0,19,9,28,1587
12,12,0,0,19,9,28,1587
0,0,1,0,1,0,1,1588
1,1,0,0,1,0,1,1588
0,0,1,0,1,0,1,1589
1,1,2,0,3,0,3,1589
2,2,1,0,4,0,4,1589
3,3,0,0,4,0,4,1589
0,0,1,0,1,0,1,1590
1,1,1,0,2,0,2,1590
2,2,2,0,4,0,4,1590
3,3,0,0,4,0,4,1590
0,0,1,0,1,0,1,1591
1,1,2,0,3,0,3,1591
2,2,2,1,5,1,6,1591
3,3,3,2,8,3,11,1591
4,4,4,3,12,6,18,1591
5,5,8,2,20,8,28,1591
6,6,3,0,23,8,31,1591
7,7,0,2,23,10,33,1591
8,8,1,0,24,10,34,1591
9,9,0,0,24,10,34,1591
0,0,1,0,1,0,1,1592
1,1,1,0,2,0,2,1592
2,2,2,0,4,0,4,1592
3,3,2,0,6,0,6,1592
4,4,2,0,8,0,8,1592
5,5,1,0,9,0,9,1592
6,6,1,0,10,0,10,1592
7,7,2,0,12,0,12,1592
8,8,0,1,12,1,13,1592
9,9,0,0,12,1,13,1592
0,0,1,0,1,0,1,1593
1,1,1,0,2,0,2,1593
2,2,0,0,2,0,2,1593
0,0,1,0,1,0,1,1594
1,1,0,0,1,0,1,1594
0,0,1,0,1,0,1,1595
1,1,2,0,3,0,3,1595
2,2,1,0,4,0,4,1595
3,3,0,0,4,0,4,1595
0,0,1,0,1,0,1,1596
1,1,1,0,2,0,2,1596
2,2,1,0,3,0,3,1596
3,3,1,0,4,0,4,1596
4,4,1,0,5,0,5,1596
5,5,1,0,6,0,6,1596
6,6,1,0,7,0,7,1596
7,7,0,0,7,0,7,1596
0,0,1,0,1,0,1,1597
1,1,1,0,2,0,2,1597
2,2,0,0,2,0,2,1597
0,0,1,0,1,0,1,1598
1,1,1,0,2,0,2,1598
2,2,1,0,3,0,3,1598
3,3,0,0,3,0,3,1598
0,0,1,0,1,0,1,1599
1,1,1,0,2,0,2,1599
2,2,0,0,2,0,2,1599
0,0,1,0,1,0,1,1600
1,1,1,1,2,1,3,1600
2,2,1,1,3,2,5,1600
3,3,1,0,4,2,6,1600
4,4,1,1,5,3,8,1600
5,5,1,0,6,3,9,1600
6,6,0,0,6,3,9,1600
0,0,1,0,1,0,1,1601
1,1,0,0,1,0,1,1601
0,0,1,0,1,0,1,1602
1,1,1,0,2,0,2,1602
2,2,1,0,3,0,3,1602
3,3,2,1,5,1,6,1602
4,4,0,0,5,1,6,1602
0,0,1,0,1,0,1,1603
1,1,1,0,2,0,2,1603
2,2,2,0,4,0,4,1603
3,3,4,0,8,0,8,1603
4,4,1,1,9,1,10,1603
5,5,3,0,12,1,13,1603
6,6,1,0,13,1,14,1603
7,7,2,1,15,2,17,1603
8,8,3,1,18,3,21,1603
9,9,1,2,19,5,24,1603
10,10,0,2,19,7,26,1603
11,11,0,2,19,9,28,1603
12,12,1,1,20,10,30,1603
13,13,2,1,22,11,33,1603
14,14,0,3,22,14,36,1603
15,15,2,0,24,14,38,1603
16,16,0,2,24,16,40,1603
17,17,0,1,24,17,41,1603
18,18,0,3,24,20,44,1603
19,19,0,5,24,25,49,1603
20,20,1,5,25,30,55,1603
21,21,0,2,25,32,57,1603
22,22,0,0,25,32,57,1603
0,0,1,0,1,0,1,1604
1,1,1,0,2,0,2,1604
2,2,0,0,2,0,2,1604
0,0,1,0,1,0,1,1605
1,1,0,0,1,0,1,1605
0,0,1,0,1,0,1,1606
1,1,0,0,1,0,1,1606
0,0,1,0,1,0,1,1607
1,1,0,0,1,0,1,1607
0,0,1,0,1,0,1,1608
1,1,0,0,1,0,1,1608
0,0,1,0,1,0,1,1609
1,1,1,0,2,0,2,1609
2,2,0,0,2,0,2,1609
0,0,1,0,1,0,1,1610
1,1,1,0,2,0,2,1610
2,2,1,0,3,0,3,1610
3,3,1,0,4,0,4,1610
4,4,1,0,5,0,5,1610
5,5,0,0,5,0,5,1610
0,0,1,0,1,0,1,1611
1,1,1,1,2,1,3,1611
2,2,1,1,3,2,5,1611
3,3,0,0,3,2,5,1611
0,0,1,0,1,0,1,1612
1,1,0,0,1,0,1,1612
0,0,1,0,1,0,1,1613
1,1,0,0,1,0,1,1613
0,0,1,0,1,0,1,1614
1,1,0,0,1,0,1,1614
0,0,1,0,1,0,1,1615
1,1,0,0,1,0,1,1615
0,0,1,0,1,0,1,1616
1,1,0,0,1,0,1,1616
0,0,1,0,1,0,1,1617
1,1,2,1,3,1,4,1617
2,2,3,1,6,2,8,1617
3,3,3,0,9,2,11,1617
4,4,2,0,11,2,13,1617
5,5,2,0,13,2,15,1617
6,6,3,0,16,2,18,1617
7,7,2,1,18,3,21,1617
8,8,1,2,19,5,24,1617
9,9,1,0,20,5,25,1617
10,10,0,1,20,6,26,1617
11,11,0,0,20,6,26,1617
0,0,1,0,1,0,1,1618
1,1,2,1,3,1,4,1618
2,2,3,0,6,1,7,1618
3,3,3,0,9,1,10,1618
4,4,1,0,10,1,11,1618
5,5,3,0,13,1,14,1618
6,6,2,1,15,2,17,1618
7,7,2,1,17,3,20,1618
8,8,1,0,18,3,21,1618
9,9,1,0,19,3,22,1618
10,10,2,0,21,3,24,1618
11,11,0,0,21,3,24,1618
0,0,1,0,1,0,1,1619
1,1,0,0,1,0,1,1619
0,0,1,0,1,0,1,1620
1,1,0,0,1,0,1,1620
0,0,1,0,1,0,1,1621
1,1,0,0,1,0,1,1621
0,0,1,0,1,0,1,1622
1,1,2,0,3,0,3,1622
2,2,3,1,6,1,7,1622
3,3,6,1,12,2,14,1622
4,4,5,2,17,4,21,1622
5,5,3,2,20,6,26,1622
6,6,3,2,23,8,31,1622
7,7,2,2,25,10,35,1622
8,8,2,2,27,12,39,1622
9,9,1,2,28,14,42,1622
10,10,1,2,29,16,45,1622
11,11,0,0,29,16,45,1622
0,0,1,0,1,0,1,1623
1,1,1,0,2,0,2,1623
2,2,1,0,3,0,3,1623
3,3,1,0,4,0,4,1623
4,4,0,0,4,0,4,1623
0,0,1,0,1,0,1,1624
1,1,0,1,1,1,2,1624
2,2,1,1,2,2,4,1624
3,3,1,1,3,3,6,1624
4,4,4,0,7,3,10,1624
5,5,3,2,10,5,15,1624
6,6,4,3,14,8,22,1624
7,7,4,3,18,11,29,1624
8,8,6,3,24,14,38,1624
9,9,7,5,31,19,50,1624
10,10,4,7,35,26,61,1624
11,11,3,5,38,31,69,1624
12,12,2,2,40,33,73,1624
13,13,3,0,43,33,76,1624
14,14,3,1,46,34,80,1624
15,15,4,0,50,34,84,1624
16,16,3,0,53,34,87,1624
17,17,5,0,58,34,92,1624
18,18,2,1,60,35,95,1624
19,19,1,0,61,35,96,1624
20,20,0,1,61,36,97,1624
21,21,0,2,61,38,99,1624
22,22,1,2,62,40,102,1624
23,23,1,0,63,40,103,1624
24,24,0,0,63,40,103,1624
0,0,1,0,1,0,1,1625
1,1,0,0,1,0,1,1625
0,0,1,0,1,0,1,1626
1,1,0,0,1,0,1,1626
0,0,1,0,1,0,1,1627
1,1,0,0,1,0,1,1627
0,0,1,0,1,0,1,1628
1,1,1,1,2,1,3,1628
2,2,0,0,2,1,3,1628
0,0,1,0,1,0,1,1629
1,1,1,0,2,0,2,1629
2,2,1,0,3,0,3,1629
3,3,1,0,4,0,4,1629
4,4,1,0,5,0,5,1629
5,5,0,0,5,0,5,1629
0,0,1,0,1,0,1,1630
1,1,0,0,1,0,1,1630
0,0,1,0,1,0,1,1631
1,1,0,0,1,0,1,1631
0,0,1,0,1,0,1,1632
1,1,1,1,2,1,3,1632
2,2,1,4,3,5,8,1632
3,3,3,2,6,7,13,1632
4,4,2,2,8,9,17,1632
5,5,1,2,9,11,20,1632
6,6,1,5,10,16,26,1632
7,7,3,1,13,17,30,1632
8,8,5,1,18,18,36,1632
9,9,2,0,20,18,38,1632
10,10,0,0,20,18,38,1632
0,0,1,0,1,0,1,1633
1,1,1,0,2,0,2,1633
2,2,1,0,3,0,3,1633
3,3,1,0,4,0,4,1633
4,4,4,0,8,0,8,1633
5,5,5,2,13,2,15,1633
6,6,3,2,16,4,20,1633
7,7,1,1,17,5,22,1633
8,8,1,0,18,5,23,1633
9,9,0,1,18,6,24,1633
10,10,0,0,18,6,24,1633
0,0,1,0,1,0,1,1634
1,1,4,0,5,0,5,1634
2,2,3,0,8,0,8,1634
3,3,1,0,9,0,9,1634
4,4,0,0,9,0,9,1634
0,0,1,0,1,0,1,1635
1,1,2,0,3,0,3,1635
2,2,2,0,5,0,5,1635
3,3,3,1,8,1,9,1635
4,4,3,1,11,2,13,1635
5,5,1,1,12,3,15,1635
6,6,1,0,13,3,16,1635
7,7,1,0,14,3,17,1635
8,8,1,1,15,4,19,1635
9,9,0,1,15,5,20,1635
10,10,0,1,15,6,21,1635
11,11,0,2,15,8,23,1635
12,12,0,0,15,8,23,1635
0,0,1,0,1,0,1,1636
1,1,0,0,1,0,1,1636
0,0,1,0,1,0,1,1637
1,1,1,1,2,1,3,1637
2,2,2,1,4,2,6,1637
3,3,1,1,5,3,8,1637
4,4,1,0,6,3,9,1637
5,5,1,1,7,4,11,1637
6,6,0,2,7,6,13,1637
7,7,0,1,7,7,14,1637
8,8,0,2,7,9,16,1637
9,9,0,0,7,9,16,1637
0,0,1,0,1,0,1,1638
1,1,1,0,2,0,2,1638
2,2,0,0,2,0,2,1638
0,0,1,0,1,0,1,1639
1,1,1,0,2,0,2,1639
2,2,1,0,3,0,3,1639
3,3,0,0,3,0,3,1639
0,0,1,0,1,0,1,1640
1,1,4,0,5,0,5,1640
2,2,1,0,6,0,6,1640
3,3,1,0,7,0,7,1640
4,4,0,0,7,0,7,1640
0,0,1,0,1,0,1,1641
1,1,0,0,1,0,1,1641
0,0,1,0,1,0,1,1642
1,1,0,0,1,0,1,1642
0,0,1,0,1,0,1,1643
1,1,1,1,2,1,3,1643
2,2,0,1,2,2,4,1643
3,3,1,0,3,2,5,1643
4,4,1,0,4,2,6,1643
5,5,0,0,4,2,6,1643
0,0,1,0,1,0,1,1644
1,1,0,0,1,0,1,1644
0,0,1,0,1,0,1,1645
1,1,0,0,1,0,1,1645
0,0,1,0,1,0,1,1646
1,1,3,0,4,0,4,1646
2,2,2,1,6,1,7,1646
3,3,1,1,7,2,9,1646
4,4,0,2,7,4,11,1646
5,5,1,2,8,6,14,1646
6,6,0,1,8,7,15,1646
7,7,0,1,8,8,16,1646
8,8,2,0,10,8,18,1646
9,9,0,0,10,8,18,1646
0,0,1,0,1,0,1,1647
1,1,2,0,3,0,3,1647
2,2,1,0,4,0,4,1647
3,3,2,0,6,0,6,1647
4,4,2,0,8,0,8,1647
5,5,2,0,10,0,10,1647
6,6,0,0,10,0,10,1647
0,0,1,0,1,0,1,1648
1,1,1,1,2,1,3,1648
2,2,0,1,2,2,4,1648
3,3,0,1,2,3,5,1648
4,4,0,2,2,5,7,1648
5,5,0,1,2,6,8,1648
6,6,0,2,2,8,10,1648
7,7,0,2,2,10,12,1648
8,8,0,1,2,11,13,1648
9,9,0,0,2,11,13,1648
0,0,1,0,1,0,1,1649
1,1,0,0,1,0,1,1649
0,0,1,0,1,0,1,1650
1,1,0,0,1,0,1,1650
0,0,1,0,1,0,1,1651
1,1,1,0,2,0,2,1651
2,2,0,0,2,0,2,1651
0,0,1,0,1,0,1,1652
1,1,0,0,1,0,1,1652
0,0,1,0,1,0,1,1653
1,1,2,0,3,0,3,1653
2,2,0,0,3,0,3,1653
0,0,1,0,1,0,1,1654
1,1,0,0,1,0,1,1654
0,0,1,0,1,0,1,1655
1,1,1,0,2,0,2,1655
2,2,2,0,4,0,4,1655
3,3,2,1,6,1,7,1655
4,4,1,2,7,3,10,1655
5,5,2,2,9,5,14,1655
6,6,4,1,13,6,19,1655
7,7,5,0,18,6,24,1655
8,8,5,0,23,6,29,1655
9,9,3,0,26,6,32,1655
10,10,2,0,28,6,34,1655
11,11,5,1,33,7,40,1655
12,12,5,1,38,8,46,1655
13,13,3,1,41,9,50,1655
14,14,3,5,44,14,58,1655
15,15,4,4,48,18,66,1655
16,16,4,6,52,24,76,1655
17,17,5,8,57,32,89,1655
18,18,11,3,68,35,103,1655
19,19,7,4,75,39,114,1655
20,20,7,2,82,41,123,1655
21,21,6,2,88,43,131,1655
22,22,6,5,94,48,142,1655
23,23,5,2,99,50,149,1655
24,24,3,2,102,52,154,1655
25,25,2,0,104,52,156,1655
26,26,1,0,105,52,157,1655
27,27,4,0,109,52,161,1655
28,28,3,3,112,55,167,1655
29,29,4,4,116,59,175,1655
30,30,4,1,120,60,180,1655
31,31,3,0,123,60,183,1655
32,32,0,0,123,60,183,1655
0,0,1,0,1,0,1,1656
1,1,1,0,2,0,2,1656
2,2,1,0,3,0,3,1656
3,3,0,0,3,0,3,1656
0,0,1,0,1,0,1,1657
1,1,2,0,3,0,3,1657
2,2,0,1,3,1,4,1657
3,3,0,0,3,1,4,1657
0,0,1,0,1,0,1,1658
1,1,0,0,1,0,1,1658
0,0,1,0,1,0,1,1659
1,1,0,0,1,0,1,1659
0,0,1,0,1,0,1,1660
1,1,0,0,1,0,1,1660
0,0,1,0,1,0,1,1661
1,1,1,0,2,0,2,1661
2,2,0,0,2,0,2,1661
0,0,1,0,1,0,1,1662
1,1,0,0,1,0,1,1662
0,0,1,0,1,0,1,1663
1,1,0,1,1,1,2,1663
2,2,0,1,1,2,3,1663
3,3,0,1,1,3,4,1663
4,4,0,0,1,3,4,1663
0,0,1,0,1,0,1,1664
1,1,2,1,3,1,4,1664
2,2,0,1,3,2,5,1664
3,3,1,1,4,3,7,1664
4,4,1,0,5,3,8,1664
5,5,1,0,6,3,9,1664
6,6,0,0,6,3,9,1664
0,0,1,0,1,0,1,1665
1,1,1,0,2,0,2,1665
2,2,0,0,2,0,2,1665
0,0,1,0,1,0,1,1666
1,1,0,0,1,0,1,1666
0,0,1,0,1,0,1,1667
1,1,0,0,1,0,1,1667
0,0,1,0,1,0,1,1668
1,1,1,0,2,0,2,1668
2,2,0,0,2,0,2,1668
0,0,1,0,1,0,1,1669
1,1,0,1,1,1,2,1669
2,2,0,0,1,1,2,1669
0,0,1,0,1,0,1,1670
1,1,3,0,4,0,4,1670
2,2,4,0,8,0,8,1670
3,3,0,0,8,0,8,1670
0,0,1,0,1,0,1,1671
1,1,0,0,1,0,1,1671
0,0,1,0,1,0,1,1672
1,1,0,0,1,0,1,1672
0,0,1,0,1,0,1,1673
1,1,0,0,1,0,1,1673
0,0,1,0,1,0,1,1674
1,1,1,0,2,0,2,1674
2,2,2,0,4,0,4,1674
3,3,5,0,9,0,9,1674
4,4,4,1,13,1,14,1674
5,5,3,2,16,3,19,1674
6,6,3,1,19,4,23,1674
7,7,3,1,22,5,27,1674
8,8,4,1,26,6,32,1674
9,9,1,3,27,9,36,1674
10,10,1,5,28,14,42,1674
11,11,3,3,31,17,48,1674
12,12,3,4,34,21,55,1674
13,13,4,4,38,25,63,1674
14,14,0,5,38,30,68,1674
15,15,0,4,38,34,72,1674
16,16,0,0,38,34,72,1674
0,0,1,0,1,0,1,1675
1,1,0,1,1,1,2,1675
2,2,0,0,1,1,2,1675
0,0,1,0,1,0,1,1676
1,1,3,0,4,0,4,1676
2,2,1,0,5,0,5,1676
3,3,2,0,7,0,7,1676
4,4,0,0,7,0,7,1676
0,0,1,0,1,0,1,1677
1,1,0,0,1,0,1,1677
0,0,1,0,1,0,1,1678
1,1,0,0,1,0,1,1678
0,0,1,0,1,0,1,1679
1,1,1,0,2,0,2,1679
2,2,0,0,2,0,2,1679
0,0,1,0,1,0,1,1680
1,1,1,0,2,0,2,1680
2,2,0,0,2,0,2,1680
0,0,1,0,1,0,1,1681
1,1,0,0,1,0,1,1681
0,0,1,0,1,0,1,1682
1,1,0,0,1,0,1,1682
0,0,1,0,1,0,1,1683
1,1,2,0,3,0,3,1683
2,2,1,0,4,0,4,1683
3,3,0,0,4,0,4,1683
0,0,1,0,1,0,1,1684
1,1,0,0,1,0,1,1684
0,0,1,0,1,0,1,1685
1,1,0,0,1,0,1,1685
0,0,1,0,1,0,1,1686
1,1,0,0,1,0,1,1686
0,0,1,0,1,0,1,1687
1,1,0,0,1,0,1,1687
0,0,1,0,1,0,1,1688
1,1,0,0,1,0,1,1688
0,0,1,0,1,0,1,1689
1,1,1,0,2,0,2,1689
2,2,0,0,2,0,2,1689
0,0,1,0,1,0,1,1690
1,1,1,0,2,0,2,1690
2,2,2,0,4,0,4,1690
3,3,1,0,5,0,5,1690
4,4,1,0,6,0,6,1690
5,5,1,0,7,0,7,1690
6,6,0,0,7,0,7,1690
0,0,1,0,1,0,1,1691
1,1,1,0,2,0,2,1691
2,2,2,2,4,2,6,1691
3,3,4,4,8,6,14,1691
4,4,2,2,10,8,18,1691
5,5,1,2,11,10,21,1691
6,6,0,0,11,10,21,1691
0,0,1,0,1,0,1,1692
1,1,0,1,1,1,2,1692
2,2,1,0,2,1,3,1692
3,3,0,1,2,2,4,1692
4,4,0,1,2,3,5,1692
5,5,1,0,3,3,6,1692
6,6,0,0,3,3,6,1692
0,0,1,0,1,0,1,1693
1,1,3,0,4,0,4,1693
2,2,4,1,8,1,9,1693
3,3,3,1,11,2,13,1693
4,4,2,0,13,2,15,1693
5,5,0,0,13,2,15,1693
0,0,1,0,1,0,1,1694
1,1,0,0,1,0,1,1694
0,0,1,0,1,0,1,1695
1,1,0,0,1,0,1,1695
0,0,1,0,1,0,1,1696
1,1,0,0,1,0,1,1696
0,0,1,0,1,0,1,1697
1,1,2,0,3,0,3,1697
2,2,2,0,5,0,5,1697
3,3,2,1,7,1,8,1697
4,4,1,2,8,3,11,1697
5,5,0,1,8,4,12,1697
6,6,0,0,8,4,12,1697
0,0,1,0,1,0,1,1698
1,1,1,0,2,0,2,1698
2,2,0,0,2,0,2,1698
0,0,1,0,1,0,1,1699
1,1,1,0,2,0,2,1699
2,2,0,0,2,0,2,1699
0,0,1,0,1,0,1,1700
1,1,2,0,3,0,3,1700
2,2,2,0,5,0,5,1700
3,3,0,0,5,0,5,1700
0,0,1,0,1,0,1,1701
1,1,0,0,1,0,1,1701
0,0,1,0,1,0,1,1702
1,1,1,0,2,0,2,1702
2,2,0,0,2,0,2,1702
0,0,1,0,1,0,1,1703
1,1,2,0,3,0,3,1703
2,2,1,0,4,0,4,1703
3,3,0,0,4,0,4,1703
0,0,1,0,1,0,1,1704
1,1,0,0,1,0,1,1704
0,0,1,0,1,0,1,1705
1,1,0,0,1,0,1,1705
0,0,1,0,1,0,1,1706
1,1,0,0,1,0,1,1706
0,0,1,0,1,0,1,1707
1,1,2,0,3,0,3,1707
2,2,2,0,5,0,5,1707
3,3,1,0,6,0,6,1707
4,4,1,0,7,0,7,1707
5,5,1,0,8,0,8,1707
6,6,0,0,8,0,8,1707
0,0,1,0,1,0,1,1708
1,1,1,0,2,0,2,1708
2,2,1,1,3,1,4,1708
3,3,1,1,4,2,6,1708
4,4,2,2,6,4,10,1708
5,5,2,2,8,6,14,1708
6,6,2,1,10,7,17,1708
7,7,1,0,11,7,18,1708
8,8,0,0,11,7,18,1708
0,0,1,0,1,0,1,1709
1,1,0,0,1,0,1,1709
0,0,1,0,1,0,1,1710
1,1,2,1,3,1,4,1710
2,2,2,1,5,2,7,1710
3,3,1,0,6,2,8,1710
4,4,1,0,7,2,9,1710
5,5,0,0,7,2,9,1710
0,0,1,0,1,0,1,1711
1,1,0,0,1,0,1,1711
0,0,1,0,1,0,1,1712
1,1,1,0,2,0,2,1712
2,2,0,1,2,1,3,1712
3,3,0,0,2,1,3,1712
0,0,1,0,1,0,1,1713
1,1,2,0,3,0,3,1713
2,2,2,0,5,0,5,1713
3,3,1,0,6,0,6,1713
4,4,1,1,7,1,8,1713
5,5,1,1,8,2,10,1713
6,6,0,0,8,2,10,1713
0,0,1,0,1,0,1,1714
1,1,1,0,2,0,2,1714
2,2,0,0,2,0,2,1714
0,0,1,0,1,0,1,1715
1,1,0,0,1,0,1,1715
0,0,1,0,1,0,1,1716
1,1,0,0,1,0,1,1716
0,0,1,0,1,0,1,1717
1,1,1,0,2,0,2,1717
2,2,0,0,2,0,2,1717
0,0,1,0,1,0,1,1718
1,1,1,0,2,0,2,1718
2,2,2,0,4,0,4,1718
3,3,0,0,4,0,4,1718
0,0,1,0,1,0,1,1719
1,1,2,1,3,1,4,1719
2,2,4,2,7,3,10,1719
3,3,3,2,10,5,15,1719
4,4,2,1,12,6,18,1719
5,5,4,1,16,7,23,1719
6,6,6,0,22,7,29,1719
7,7,2,1,24,8,32,1719
8,8,2,1,26,9,35,1719
9,9,1,3,27,12,39,1719
10,10,2,2,29,14,43,1719
11,11,2,0,31,14,45,1719
12,12,1,0,32,14,46,1719
13,13,0,0,32,14,46,1719
0,0,1,0,1,0,1,1720
1,1,1,0,2,0,2,1720
2,2,0,0,2,0,2,1720
0,0,1,0,1,0,1,1721
1,1,3,0,4,0,4,1721
2,2,4,1,8,1,9,1721
3,3,4,4,12,5,17,1721
4,4,4,6,16,11,27,1721
5,5,1,9,17,20,37,1721
6,6,0,6,17,26,43,1721
7,7,2,5,19,31,50,1721
8,8,5,3,24,34,58,1721
9,9,6,0,30,34,64,1721
10,10,3,0,33,34,67,1721
11,11,2,0,35,34,69,1721
12,12,2,1,37,35,72,1721
13,13,0,0,37,35,72,1721
0,0,1,0,1,0,1,1722
1,1,0,0,1,0,1,1722
0,0,1,0,1,0,1,1723
1,1,1,0,2,0,2,1723
2,2,0,1,2,1,3,1723
3,3,0,0,2,1,3,1723
0,0,1,0,1,0,1,1724
1,1,0,0,1,0,1,1724
0,0,1,0,1,0,1,1725
1,1,0,0,1,0,1,1725
0,0,1,0,1,0,1,1726
1,1,0,0,1,0,1,1726
0,0,1,0,1,0,1,1727
1,1,1,0,2,0,2,1727
2,2,0,0,2,0,2,1727
0,0,1,0,1,0,1,1728
1,1,0,1,1,1,2,1728
2,2,0,2,1,3,4,1728
3,3,0,0,1,3,4,1728
0,0,1,0,1,0,1,1729
1,1,0,1,1,1,2,1729
2,2,0,0,1,1,2,1729
0,0,1,0,1,0,1,1730
1,1,1,0,2,0,2,1730
2,2,1,0,3,0,3,1730
3,3,0,0,3,0,3,1730
0,0,1,0,1,0,1,1731
1,1,0,0,1,0,1,1731
0,0,1,0,1,0,1,1732
1,1,1,0,2,0,2,1732
2,2,0,0,2,0,2,1732
0,0,1,0,1,0,1,1733
1,1,0,1,1,1,2,1733
2,2,0,0,1,1,2,1733
0,0,1,0,1,0,1,1734
1,1,0,0,1,0,1,1734
0,0,1,0,1,0,1,1735
1,1,0,0,1,0,1,1735
0,0,1,0,1,0,1,1736
1,1,1,0,2,0,2,1736
2,2,0,0,2,0,2,1736
0,0,1,0,1,0,1,1737
1,1,4,0,5,0,5,1737
2,2,1,1,6,1,7,1737
3,3,0,1,6,2,8,1737
4,4,0,0,6,2,8,1737
0,0,1,0,1,0,1,1738
1,1,0,0,1,0,1,1738
0,0,1,0,1,0,1,1739
1,1,0,0,1,0,1,1739
0,0,1,0,1,0,1,1740
1,1,0,0,1,0,1,1740
0,0,1,0,1,0,1,1741
1,1,0,0,1,0,1,1741
0,0,1,0,1,0,1,1742
1,1,1,2,2,2,4,1742
2,2,0,1,2,3,5,1742
3,3,1,0,3,3,6,1742
4,4,1,0,4,3,7,1742
5,5,2,0,6,3,9,1742
6,6,1,0,7,3,10,1742
7,7,0,1,7,4,11,1742
8,8,0,0,7,4,11,1742
0,0,1,0,1,0,1,1743
1,1,1,0,2,0,2,1743
2,2,2,1,4,1,5,1743
3,3,1,2,5,3,8,1743
4,4,0,1,5,4,9,1743
5,5,0,0,5,4,9,1743
0,0,1,0,1,0,1,1744
1,1,2,0,3,0,3,1744
2,2,2,2,5,2,7,1744
3,3,1,3,6,5,11,1744
4,4,1,2,7,7,14,1744
5,5,1,1,8,8,16,1744
6,6,0,1,8,9,17,1744
7,7,0,0,8,9,17,1744
0,0,1,0,1,0,1,1745
1,1,2,0,3,0,3,1745
2,2,1,0,4,0,4,1745
3,3,0,0,4,0,4,1745
0,0,1,0,1,0,1,1746
1,1,0,0,1,0,1,1746
0,0,1,0,1,0,1,1747
1,1,0,0,1,0,1,1747
0,0,1,0,1,0,1,1748
1,1,1,0,2,0,2,1748
2,2,0,0,2,0,2,1748
0,0,1,0,1,0,1,1749
1,1,2,0,3,0,3,1749
2,2,2,0,5,0,5,1749
3,3,0,1,5,1,6,1749
4,4,0,2,5,3,8,1749
5,5,0,1,5,4,9,1749
6,6,0,0,5,4,9,1749
0,0,1,0,1,0,1,1750
1,1,0,1,1,1,2,1750
2,2,0,1,1,2,3,1750
3,3,0,0,1,2,3,1750
0,0,1,0,1,0,1,1751
1,1,0,0,1,0,1,1751
0,0,1,0,1,0,1,1752
1,1,2,0,3,0,3,1752
2,2,0,1,3,1,4,1752
3,3,1,0,4,1,5,1752
4,4,2,0,6,1,7,1752
5,5,2,0,8,1,9,1752
6,6,2,0,10,1,11,1752
7,7,1,0,11,1,12,1752
8,8,0,0,11,1,12,1752
0,0,1,0,1,0,1,1753
1,1,0,0,1,0,1,1753
0,0,1,0,1,0,1,1754
1,1,1,0,2,0,2,1754
2,2,2,0,4,0,4,1754
3,3,2,1,6,1,7,1754
4,4,2,3,8,4,12,1754
5,5,0,2,8,6,14,1754
6,6,0,4,8,10,18,1754
7,7,0,2,8,12,20,1754
8,8,1,0,9,12,21,1754
9,9,0,0,9,12,21,1754
0,0,1,0,1,0,1,1755
1,1,0,0,1,0,1,1755
0,0,1,0,1,0,1,1756
1,1,1,1,2,1,3,1756
2,2,0,0,2,1,3,1756
0,0,1,0,1,0,1,1757
1,1,0,0,1,0,1,1757
0,0,1,0,1,0,1,1758
1,1,0,0,1,0,1,1758
0,0,1,0,1,0,1,1759
1,1,0,0,1,0,1,1759
0,0,1,0,1,0,1,1760
1,1,0,0,1,0,1,1760
0,0,1,0,1,0,1,1761
1,1,0,1,1,1,2,1761
2,2,1,3,2,4,6,1761
3,3,1,4,3,8,11,1761
4,4,1,2,4,10,14,1761
5,5,1,1,5,11,16,1761
6,6,0,2,5,13,18,1761
7,7,1,2,6,15,21,1761
8,8,3,2,9,17,26,1761
9,9,3,4,12,21,33,1761
10,10,3,4,15,25,40,1761
11,11,5,6,20,31,51,1761
12,12,3,5,23,36,59,1761
13,13,1,7,24,43,67,1761
14,14,3,5,27,48,75,1761
15,15,5,8,32,56,88,1761
16,16,5,5,37,61,98,1761
17,17,6,5,43,66,109,1761
18,18,8,2,51,68,119,1761
19,19,8,0,59,68,127,1761
20,20,8,2,67,70,137,1761
21,21,7,8,74,78,152,1761
22,22,5,9,79,87,166,1761
23,23,6,6,85,93,178,1761
24,24,1,8,86,101,187,1761
25,25,4,8,90,109,199,1761
26,26,2,4,92,113,205,1761
27,27,3,1,95,114,209,1761
28,28,1,1,96,115,211,1761
29,29,1,1,97,116,213,1761
30,30,2,2,99,118,217,1761
31,31,3,0,102,118,220,1761
32,32,1,1,103,119,222,1761
33,33,0,1,103,120,223,1761
34,34,0,0,103,120,223,1761
0,0,1,0,1,0,1,1762
1,1,1,0,2,0,2,1762
2,2,1,1,3,1,4,1762
3,3,4,3,7,4,11,1762
4,4,6,3,13,7,20,1762
5,5,3,2,16,9,25,1762
6,6,0,1,16,10,26,1762
7,7,0,0,16,10,26,1762
0,0,1,0,1,0,1,1763
1,1,0,0,1,0,1,1763
0,0,1,0,1,0,1,1764
1,1,0,0,1,0,1,1764
0,0,1,0,1,0,1,1765
1,1,0,0,1,0,1,1765
0,0,1,0,1,0,1,1766
1,1,1,1,2,1,3,1766
2,2,0,1,2,2,4,1766
3,3,0,1,2,3,5,1766
4,4,0,0,2,3,5,1766
0,0,1,0,1,0,1,1767
1,1,1,0,2,0,2,1767
2,2,1,0,3,0,3,1767
3,3,0,0,3,0,3,1767
0,0,1,0,1,0,1,1768
1,1,2,0,3,0,3,1768
2,2,3,0,6,0,6,1768
3,3,6,2,12,2,14,1768
4,4,9,4,21,6,27,1768
5,5,4,6,25,12,37,1768
6,6,7,3,32,15,47,1768
7,7,3,1,35,16,51,1768
8,8,2,2,37,18,55,1768
9,9,3,3,40,21,61,1768
10,10,4,2,44,23,67,1768
11,11,5,3,49,26,75,1768
12,12,5,3,54,29,83,1768
13,13,2,4,56,33,89,1768
14,14,1,1,57,34,91,1768
15,15,0,1,57,35,92,1768
16,16,0,0,57,35,92,1768
0,0,1,0,1,0,1,1769
1,1,0,0,1,0,1,1769
0,0,1,0,1,0,1,1770
1,1,0,1,1,1,2,1770
2,2,0,0,1,1,2,1770
0,0,1,0,1,0,1,1771
1,1,0,2,1,2,3,1771
2,2,0,3,1,5,6,1771
3,3,1,2,2,7,9,1771
4,4,1,1,3,8,11,1771
5,5,1,0,4,8,12,1771
6,6,1,0,5,8,13,1771
7,7,1,0,6,8,14,1771
8,8,1,2,7,10,17,1771
9,9,0,6,7,16,23,1771
10,10,0,3,7,19,26,1771
11,11,2,2,9,21,30,1771
12,12,5,1,14,22,36,1771
13,13,5,0,19,22,41,1771
14,14,3,0,22,22,44,1771
15,15,2,0,24,22,46,1771
16,16,3,0,27,22,49,1771
17,17,0,0,27,22,49,1771
0,0,1,0,1,0,1,1772
1,1,0,0,1,0,1,1772
0,0,1,0,1,0,1,1773
1,1,1,0,2,0,2,1773
2,2,0,0,2,0,2,1773
0,0,1,0,1,0,1,1774
1,1,0,0,1,0,1,1774
0,0,1,0,1,0,1,1775
1,1,1,0,2,0,2,1775
2,2,1,0,3,0,3,1775
3,3,0,1,3,1,4,1775
4,4,0,0,3,1,4,1775
0,0,1,0,1,0,1,1776
1,1,0,0,1,0,1,1776
0,0,1,0,1,0,1,1777
1,1,3,1,4,1,5,1777
2,2,1,3,5,4,9,1777
3,3,3,3,8,7,15,1777
4,4,2,3,10,10,20,1777
5,5,2,1,12,11,23,1777
6,6,1,0,13,11,24,1777
7,7,2,0,15,11,26,1777
8,8,0,0,15,11,26,1777
0,0,1,0,1,0,1,1778
1,1,2,0,3,0,3,1778
2,2,1,1,4,1,5,1778
3,3,0,0,4,1,5,1778
0,0,1,0,1,0,1,1779
1,1,0,0,1,0,1,1779
0,0,1,0,1,0,1,1780
1,1,1,0,2,0,2,1780
2,2,0,0,2,0,2,1780
0,0,1,0,1,0,1,1781
1,1,0,0,1,0,1,1781
0,0,1,0,1,0,1,1782
1,1,1,0,2,0,2,1782
2,2,1,2,3,2,5,1782
3,3,0,4,3,6,9,1782
4,4,0,2,3,8,11,1782
5,5,0,2,3,10,13,1782
6,6,0,0,3,10,13,1782
0,0,1,0,1,0,1,1783
1,1,0,0,1,0,1,1783
0,0,1,0,1,0,1,1784
1,1,1,1,2,1,3,1784
2,2,0,0,2,1,3,1784
0,0,1,0,1,0,1,1785
1,1,2,0,3,0,3,1785
2,2,3,0,6,0,6,1785
3,3,2,3,8,3,11,1785
4,4,0,0,8,3,11,1785
0,0,1,0,1,0,1,1786
1,1,2,0,3,0,3,1786
2,2,2,0,5,0,5,1786
3,3,4,0,9,0,9,1786
4,4,3,0,12,0,12,1786
5,5,3,1,15,1,16,1786
6,6,5,3,20,4,24,1786
7,7,1,2,21,6,27,1786
8,8,0,1,21,7,28,1786
9,9,0,2,21,9,30,1786
10,10,0,1,21,10,31,1786
11,11,1,1,22,11,33,1786
12,12,1,1,23,12,35,1786
13,13,0,0,23,12,35,1786
0,0,1,0,1,0,1,1787
1,1,2,0,3,0,3,1787
2,2,3,1,6,1,7,1787
3,3,2,0,8,1,9,1787
4,4,1,0,9,1,10,1787
5,5,0,0,9,1,10,1787
0,0,1,0,1,0,1,1788
1,1,1,0,2,0,2,1788
2,2,1,0,3,0,3,1788
3,3,0,0,3,0,3,1788
0,0,1,0,1,0,1,1789
1,1,1,0,2,0,2,1789
2,2,1,1,3,1,4,1789
3,3,1,1,4,2,6,1789
4,4,0,1,4,3,7,1789
5,5,0,1,4,4,8,1789
6,6,0,1,4,5,9,1789
7,7,0,1,4,6,10,1789
8,8,0,1,4,7,11,1789
9,9,0,1,4,8,12,1789
10,10,0,1,4,9,13,1789
11,11,0,0,4,9,13,1789
0,0,1,0,1,0,1,1790
1,1,1,0,2,0,2,1790
2,2,0,0,2,0,2,1790
0,0,1,0,1,0,1,1791
1,1,2,1,3,1,4,1791
2,2,1,0,4,1,5,1791
3,3,1,0,5,1,6,1791
4,4,1,0,6,1,7,1791
5,5,1,0,7,1,8,1791
6,6,0,0,7,1,8,1791
0,0,1,0,1,0,1,1792
1,1,0,0,1,0,1,1792
0,0,1,0,1,0,1,1793
1,1,1,0,2,0,2,1793
2,2,1,0,3,0,3,1793
3,3,1,0,4,0,4,1793
4,4,1,0,5,0,5,1793
5,5,0,0,5,0,5,1793
0,0,1,0,1,0,1,1794
1,1,2,0,3,0,3,1794
2,2,4,0,7,0,7,1794
3,3,4,2,11,2,13,1794
4,4,2,2,13,4,17,1794
5,5,1,4,14,8,22,1794
6,6,3,3,17,11,28,1794
7,7,3,5,20,16,36,1794
8,8,5,2,25,18,43,1794
9,9,7,4,32,22,54,1794
10,10,2,6,34,28,62,1794
11,11,2,4,36,32,68,1794
12,12,5,3,41,35,76,1794
13,13,3,1,44,36,80,1794
14,14,5,1,49,37,86,1794
15,15,4,0,53,37,90,1794
16,16,4,1,57,38,95,1794
17,17,3,1,60,39,99,1794
18,18,5,1,65,40,105,1794
19,19,7,1,72,41,113,1794
20,20,2,0,74,41,115,1794
21,21,2,0,76,41,117,1794
22,22,2,0,78,41,119,1794
23,23,3,1,81,42,123,1794
24,24,3,1,84,43,127,1794
25,25,1,1,85,44,129,1794
26,26,0,1,85,45,130,1794
27,27,0,0,85,45,130,1794
0,0,1,0,1,0,1,1795
1,1,1,1,2,1,3,1795
2,2,3,1,5,2,7,1795
3,3,2,2,7,4,11,1795
4,4,4,2,11,6,17,1795
5,5,2,2,13,8,21,1795
6,6,1,3,14,11,25,1795
7,7,2,4,16,15,31,1795
8,8,0,5,16,20,36,1795
9,9,1,4,17,24,41,1795
10,10,0,7,17,31,48,1795
11,11,1,7,18,38,56,1795
12,12,1,3,19,41,60,1795
13,13,2,2,21,43,64,1795
14,14,4,2,25,45,70,1795
15,15,2,0,27,45,72,1795
16,16,2,0,29,45,74,1795
17,17,1,0,30,45,75,1795
18,18,4,1,34,46,80,1795
19,19,2,4,36,50,86,1795
20,20,3,2,39,52,91,1795
21,21,3,3,42,55,97,1795
22,22,5,4,47,59,106,1795
23,23,1,5,48,64,112,1795
24,24,3,4,51,68,119,1795
25,25,4,5,55,73,128,1795
26,26,2,9,57,82,139,1795
27,27,4,4,61,86,147,1795
28,28,1,1,62,87,149,1795
29,29,0,0,62,87,149,1795
0,0,1,0,1,0,1,1796
1,1,0,0,1,0,1,1796
0,0,1,0,1,0,1,1797
1,1,1,0,2,0,2,1797
2,2,1,0,3,0,3,1797
3,3,0,0,3,0,3,1797
0,0,1,0,1,0,1,1798
1,1,1,0,2,0,2,1798
2,2,3,0,5,0,5,1798
3,3,2,1,7,1,8,1798
4,4,2,0,9,1,10,1798
5,5,0,0,9,1,10,1798
0,0,1,0,1,0,1,1799
1,1,1,0,2,0,2,1799
2,2,0,1,2,1,3,1799
3,3,1,1,3,2,5,1799
4,4,2,2,5,4,9,1799
5,5,2,0,7,4,11,1799
6,6,3,1,10,5,15,1799
7,7,1,1,11,6,17,1799
8,8,0,0,11,6,17,1799
0,0,1,0,1,0,1,1800
1,1,0,0,1,0,1,1800
0,0,1,0,1,0,1,1801
1,1,1,0,2,0,2,1801
2,2,1,2,3,2,5,1801
3,3,1,2,4,4,8,1801
4,4,0,1,4,5,9,1801
5,5,0,0,4,5,9,1801
0,0,1,0,1,0,1,1802
1,1,1,0,2,0,2,1802
2,2,0,0,2,0,2,1802
0,0,1,0,1,0,1,1803
1,1,1,0,2,0,2,1803
2,2,1,0,3,0,3,1803
3,3,1,0,4,0,4,1803
4,4,1,1,5,1,6,1803
5,5,3,2,8,3,11,1803
6,6,0,5,8,8,16,1803
7,7,1,2,9,10,19,1803
8,8,0,2,9,12,21,1803
9,9,0,0,9,12,21,1803
0,0,1,0,1,0,1,1804
1,1,1,0,2,0,2,1804
2,2,1,0,3,0,3,1804
3,3,0,0,3,0,3,1804
0,0,1,0,1,0,1,1805
1,1,0,0,1,0,1,1805
0,0,1,0,1,0,1,1806
1,1,0,0,1,0,1,1806
0,0,1,0,1,0,1,1807
1,1,1,1,2,1,3,1807
2,2,0,1,2,2,4,1807
3,3,0,2,2,4,6,1807
4,4,0,0,2,4,6,1807
0,0,1,0,1,0,1,1808
1,1,0,0,1,0,1,1808
0,0,1,0,1,0,1,1809
1,1,0,0,1,0,1,1809
0,0,1,0,1,0,1,1810
1,1,0,0,1,0,1,1810
0,0,1,0,1,0,1,1811
1,1,1,0,2,0,2,1811
2,2,3,0,5,0,5,1811
3,3,1,0,6,0,6,1811
4,4,3,0,9,0,9,1811
5,5,3,2,12,2,14,1811
6,6,3,3,15,5,20,1811
7,7,0,3,15,8,23,1811
8,8,2,3,17,11,28,1811
9,9,3,1,20,12,32,1811
10,10,3,1,23,13,36,1811
11,11,2,0,25,13,38,1811
12,12,0,1,25,14,39,1811
13,13,1,0,26,14,40,1811
14,14,3,0,29,14,43,1811
15,15,3,1,32,15,47,1811
16,16,1,0,33,15,48,1811
17,17,2,0,35,15,50,1811
18,18,0,0,35,15,50,1811
0,0,1,0,1,0,1,1812
1,1,2,0,3,0,3,1812
2,2,2,1,5,1,6,1812
3,3,3,3,8,4,12,1812
4,4,1,5,9,9,18,1812
5,5,0,4,9,13,22,1812
6,6,2,2,11,15,26,1812
7,7,1,2,12,17,29,1812
8,8,0,1,12,18,30,1812
9,9,0,1,12,19,31,1812
10,10,0,0,12,19,31,1812
0,0,1,0,1,0,1,1813
1,1,2,0,3,0,3,1813
2,2,3,0,6,0,6,1813
3,3,3,1,9,1,10,1813
4,4,6,2,15,3,18,1813
5,5,6,5,21,8,29,1813
6,6,6,1,27,9,36,1813
7,7,8,0,35,9,44,1813
8,8,4,2,39,11,50,1813
9,9,3,3,42,14,56,1813
10,10,1,3,43,17,60,1813
11,11,0,3,43,20,63,1813
12,12,0,1,43,21,64,1813
13,13,0,0,43,21,64,1813
0,0,1,0,1,0,1,1814
1,1,0,1,1,1,2,1814
2,2,0,2,1,3,4,1814
3,3,0,4,1,7,8,1814
4,4,0,4,1,11,12,1814
5,5,0,0,1,11,12,1814
0,0,1,0,1,0,1,1815
1,1,1,2,2,2,4,1815
2,2,3,0,5,2,7,1815
3,3,1,0,6,2,8,1815
4,4,0,0,6,2,8,1815
0,0,1,0,1,0,1,1816
1,1,0,0,1,0,1,1816
0,0,1,0,1,0,1,1817
1,1,0,0,1,0,1,1817
0,0,1,0,1,0,1,1818
1,1,1,0,2,0,2,1818
2,2,2,0,4,0,4,1818
3,3,2,1,6,1,7,1818
4,4,1,1,7,2,9,1818
5,5,2,0,9,2,11,1818
6,6,1,0,10,2,12,1818
7,7,0,0,10,2,12,1818
0,0,1,0,1,0,1,1819
1,1,0,0,1,0,1,1819
0,0,1,0,1,0,1,1820
1,1,1,0,2,0,2,1820
2,2,3,0,5,0,5,1820
3,3,2,1,7,1,8,1820
4,4,3,0,10,1,11,1820
5,5,1,1,11,2,13,1820
6,6,2,0,13,2,15,1820
7,7,4,0,17,2,19,1820
8,8,3,2,20,4,24,1820
9,9,0,2,20,6,26,1820
10,10,0,2,20,8,28,1820
11,11,0,0,20,8,28,1820
0,0,1,0,1,0,1,1821
1,1,0,0,1,0,1,1821
0,0,1,0,1,0,1,1822
1,1,0,0,1,0,1,1822
0,0,1,0,1,0,1,1823
1,1,1,0,2,0,2,1823
2,2,0,0,2,0,2,1823
0,0,1,0,1,0,1,1824
1,1,1,0,2,0,2,1824
2,2,0,0,2,0,2,1824
0,0,1,0,1,0,1,1825
1,1,0,0,1,0,1,1825
0,0,1,0,1,0,1,1826
1,1,0,0,1,0,1,1826
0,0,1,0,1,0,1,1827
1,1,1,0,2,0,2,1827
2,2,1,0,3,0,3,1827
3,3,0,1,3,1,4,1827
4,4,0,1,3,2,5,1827
5,5,0,0,3,2,5,1827
0,0,1,0,1,0,1,1828
1,1,1,1,2,1,3,1828
2,2,1,1,3,2,5,1828
3,3,1,1,4,3,7,1828
4,4,1,0,5,3,8,1828
5,5,0,0,5,3,8,1828
0,0,1,0,1,0,1,1829
1,1,1,1,2,1,3,1829
2,2,1,1,3,2,5,1829
3,3,1,2,4,4,8,1829
4,4,2,4,6,8,14,1829
5,5,1,8,7,16,23,1829
6,6,0,7,7,23,30,1829
7,7,1,5,8,28,36,1829
8,8,2,4,10,32,42,1829
9,9,0,3,10,35,45,1829
10,10,0,2,10,37,47,1829
11,11,0,0,10,37,47,1829
0,0,1,0,1,0,1,1830
1,1,1,0,2,0,2,1830
2,2,0,0,2,0,2,1830
0,0,1,0,1,0,1,1831
1,1,1,0,2,0,2,1831
2,2,1,0,3,0,3,1831
3,3,0,2,3,2,5,1831
4,4,0,2,3,4,7,1831
5,5,0,2,3,6,9,1831
6,6,0,1,3,7,10,1831
7,7,0,1,3,8,11,1831
8,8,0,1,3,9,12,1831
9,9,0,0,3,9,12,1831
0,0,1,0,1,0,1,1832
1,1,0,0,1,0,1,1832
0,0,1,0,1,0,1,1833
1,1,1,0,2,0,2,1833
2,2,1,0,3,0,3,1833
3,3,1,0,4,0,4,1833
4,4,2,0,6,0,6,1833
5,5,0,0,6,0,6,1833
0,0,1,0,1,0,1,1834
1,1,0,0,1,0,1,1834
0,0,1,0,1,0,1,1835
1,1,1,0,2,0,2,1835
2,2,0,0,2,0,2,1835
0,0,1,0,1,0,1,1836
1,1,0,0,1,0,1,1836
0,0,1,0,1,0,1,1837
1,1,1,0,2,0,2,1837
2,2,0,0,2,0,2,1837
0,0,1,0,1,0,1,1838
1,1,0,0,1,0,1,1838
0,0,1,0,1,0,1,1839
1,1,2,0,3,0,3,1839
2,2,3,0,6,0,6,1839
3,3,1,1,7,1,8,1839
4,4,0,1,7,2,9,1839
5,5,0,1,7,3,10,1839
6,6,1,0,8,3,11,1839
7,7,2,0,10,3,13,1839
8,8,1,0,11,3,14,1839
9,9,1,0,12,3,15,1839
10,10,0,0,12,3,15,1839
0,0,1,0,1,0,1,1840
1,1,1,0,2,0,2,1840
2,2,1,1,3,1,4,1840
3,3,1,1,4,2,6,1840
4,4,2,0,6,2,8,1840
5,5,4,0,10,2,12,1840
6,6,3,1,13,3,16,1840
7,7,3,2,16,5,21,1840
8,8,3,2,19,7,26,1840
9,9,2,2,21,9,30,1840
10,10,1,4,22,13,35,1840
11,11,2,1,24,14,38,1840
12,12,1,0,25,14,39,1840
13,13,1,0,26,14,40,1840
14,14,2,0,28,14,42,1840
15,15,2,0,30,14,44,1840
16,16,2,0,32,14,46,1840
17,17,1,0,33,14,47,1840
18,18,1,0,34,14,48,1840
19,19,2,0,36,14,50,1840
20,20,2,0,38,14,52,1840
21,21,2,1,40,15,55,1840
22,22,0,1,40,16,56,1840
23,23,0,1,40,17,57,1840
24,24,0,0,40,17,57,1840
0,0,1,0,1,0,1,1841
1,1,2,0,3,0,3,1841
2,2,5,0,8,0,8,1841
3,3,4,0,12,0,12,1841
4,4,4,2,16,2,18,1841
5,5,1,2,17,4,21,1841
6,6,2,4,19,8,27,1841
7,7,4,6,23,14,37,1841
8,8,7,7,30,21,51,1841
9,9,6,4,36,25,61,1841
10,10,6,1,42,26,68,1841
11,11,4,2,46,28,74,1841
12,12,2,2,48,30,78,1841
13,13,4,0,52,30,82,1841
14,14,5,1,57,31,88,1841
15,15,6,3,63,34,97,1841
16,16,6,2,69,36,105,1841
17,17,7,1,76,37,113,1841
18,18,6,1,82,38,120,1841
19,19,3,0,85,38,123,1841
20,20,2,0,87,38,125,1841
21,21,1,0,88,38,126,1841
22,22,1,0,89,38,127,1841
23,23,1,0,90,38,128,1841
24,24,0,0,90,38,128,1841
0,0,1,0,1,0,1,1842
1,1,1,0,2,0,2,1842
2,2,0,0,2,0,2,1842
0,0,1,0,1,0,1,1843
1,1,1,0,2,0,2,1843
2,2,0,0,2,0,2,1843
0,0,1,0,1,0,1,1844
1,1,1,0,2,0,2,1844
2,2,3,0,5,0,5,1844
3,3,2,1,7,1,8,1844
4,4,2,2,9,3,12,1844
5,5,0,1,9,4,13,1844
6,6,0,0,9,4,13,1844
0,0,1,0,1,0,1,1845
1,1,1,0,2,0,2,1845
2,2,0,2,2,2,4,1845
3,3,0,2,2,4,6,1845
4,4,0,3,2,7,9,1845
5,5,0,2,2,9,11,1845
6,6,0,2,2,11,13,1845
7,7,0,2,2,13,15,1845
8,8,0,1,2,14,16,1845
9,9,0,0,2,14,16,1845
0,0,1,0,1,0,1,1846
1,1,0,0,1,0,1,1846
0,0,1,0,1,0,1,1847
1,1,0,1,1,1,2,1847
2,2,0,1,1,2,3,1847
3,3,0,1,1,3,4,1847
4,4,0,0,1,3,4,1847
0,0,1,0,1,0,1,1848
1,1,1,0,2,0,2,1848
2,2,0,1,2,1,3,1848
3,3,0,0,2,1,3,1848
0,0,1,0,1,0,1,1849
1,1,1,0,2,0,2,1849
2,2,1,0,3,0,3,1849
3,3,1,0,4,0,4,1849
4,4,2,0,6,0,6,1849
5,5,1,0,7,0,7,1849
6,6,1,0,8,0,8,1849
7,7,1,0,9,0,9,1849
8,8,0,0,9,0,9,1849
0,0,1,0,1,0,1,1850
1,1,0,0,1,0,1,1850
0,0,1,0,1,0,1,1851
1,1,3,0,4,0,4,1851
2,2,1,1,5,1,6,1851
3,3,4,2,9,3,12,1851
4,4,2,2,11,5,16,1851
5,5,4,6,15,11,26,1851
6,6,6,6,21,17,38,1851
7,7,5,7,26,24,50,1851
8,8,9,5,35,29,64,1851
9,9,10,5,45,34,79,1851
10,10,10,7,55,41,96,1851
11,11,20,9,75,50,125,1851
12,12,9,11,84,61,145,1851
13,13,10,11,94,72,166,1851
14,14,9,10,103,82,185,1851
15,15,8,12,111,94,205,1851
16,16,5,9,116,103,219,1851
17,17,3,7,119,110,229,1851
18,18,2,7,121,117,238,1851
19,19,5,7,126,124,250,1851
20,20,5,4,131,128,259,1851
21,21,6,4,137,132,269,1851
22,22,1,2,138,134,272,1851
23,23,0,0,138,134,272,1851
0,0,1,0,1,0,1,1852
1,1,0,0,1,0,1,1852
0,0,1,0,1,0,1,1853
1,1,1,0,2,0,2,1853
2,2,0,0,2,0,2,1853
0,0,1,0,1,0,1,1854
1,1,2,1,3,1,4,1854
2,2,2,1,5,2,7,1854
3,3,2,3,7,5,12,1854
4,4,0,3,7,8,15,1854
5,5,0,1,7,9,16,1854
6,6,1,2,8,11,19,1854
7,7,0,2,8,13,21,1854
8,8,0,0,8,13,21,1854
0,0,1,0,1,0,1,1855
1,1,2,0,3,0,3,1855
2,2,2,0,5,0,5,1855
3,3,3,0,8,0,8,1855
4,4,3,0,11,0,11,1855
5,5,0,1,11,1,12,1855
6,6,1,0,12,1,13,1855
7,7,1,0,13,1,14,1855
8,8,0,0,13,1,14,1855
0,0,1,0,1,0,1,1856
1,1,2,0,3,0,3,1856
2,2,0,0,3,0,3,1856
0,0,1,0,1,0,1,1857
1,1,0,0,1,0,1,1857
0,0,1,0,1,0,1,1858
1,1,2,0,3,0,3,1858
2,2,1,1,4,1,5,1858
3,3,2,5,6,6,12,1858
4,4,4,5,10,11,21,1858
5,5,5,6,15,17,32,1858
6,6,4,6,19,23,42,1858
7,7,4,8,23,31,54,1858
8,8,4,7,27,38,65,1858
9,9,5,7,32,45,77,1858
10,10,6,8,38,53,91,1858
11,11,9,8,47,61,108,1858
12,12,6,7,53,68,121,1858
13,13,8,7,61,75,136,1858
14,14,5,5,66,80,146,1858
15,15,2,3,68,83,151,1858
16,16,2,2,70,85,155,1858
17,17,1,3,71,88,159,1858
18,18,1,0,72,88,160,1858
19,19,2,1,74,89,163,1858
20,20,1,0,75,89,164,1858
21,21,0,0,75,89,164,1858
0,0,1,0,1,0,1,1859
1,1,0,0,1,0,1,1859
0,0,1,0,1,0,1,1860
1,1,2,0,3,0,3,1860
2,2,0,0,3,0,3,1860
0,0,1,0,1,0,1,1861
1,1,1,0,2,0,2,1861
2,2,0,0,2,0,2,1861
0,0,1,0,1,0,1,1862
1,1,1,0,2,0,2,1862
2,2,0,0,2,0,2,1862
0,0,1,0,1,0,1,1863
1,1,0,0,1,0,1,1863
0,0,1,0,1,0,1,1864
1,1,0,0,1,0,1,1864
0,0,1,0,1,0,1,1865
1,1,1,0,2,0,2,1865
2,2,2,1,4,1,5,1865
3,3,1,0,5,1,6,1865
4,4,1,0,6,1,7,1865
5,5,0,0,6,1,7,1865
0,0,1,0,1,0,1,1866
1,1,0,0,1,0,1,1866
0,0,1,0,1,0,1,1867
1,1,1,0,2,0,2,1867
2,2,0,0,2,0,2,1867
0,0,1,0,1,0,1,1868
1,1,0,1,1,1,2,1868
2,2,0,1,1,2,3,1868
3,3,0,1,1,3,4,1868
4,4,0,1,1,4,5,1868
5,5,0,2,1,6,7,1868
6,6,2,0,3,6,9,1868
7,7,0,0,3,6,9,1868
0,0,1,0,1,0,1,1869
1,1,0,0,1,0,1,1869
0,0,1,0,1,0,1,1870
1,1,1,1,2,1,3,1870
2,2,0,2,2,3,5,1870
3,3,3,0,5,3,8,1870
4,4,2,0,7,3,10,1870
5,5,4,0,11,3,14,1870
6,6,5,0,16,3,19,1870
7,7,0,0,16,3,19,1870
0,0,1,0,1,0,1,1871
1,1,0,0,1,0,1,1871
0,0,1,0,1,0,1,1872
1,1,0,0,1,0,1,1872
0,0,1,0,1,0,1,1873
1,1,0,0,1,0,1,1873
0,0,1,0,1,0,1,1874
1,1,1,0,2,0,2,1874
2,2,2,0,4,0,4,1874
3,3,2,1,6,1,7,1874
4,4,2,0,8,1,9,1874
5,5,2,0,10,1,11,1874
6,6,3,1,13,2,15,1874
7,7,3,1,16,3,19,1874
8,8,3,1,19,4,23,1874
9,9,2,0,21,4,25,1874
10,10,2,0,23,4,27,1874
11,11,4,1,27,5,32,1874
12,12,2,1,29,6,35,1874
13,13,0,2,29,8,37,1874
14,14,0,4,29,12,41,1874
15,15,0,1,29,13,42,1874
16,16,1,3,30,16,46,1874
17,17,2,2,32,18,50,1874
18,18,1,0,33,18,51,1874
19,19,0,0,33,18,51,1874
0,0,1,0,1,0,1,1875
1,1,1,0,2,0,2,1875
2,2,0,0,2,0,2,1875
0,0,1,0,1,0,1,1876
1,1,0,0,1,0,1,1876
0,0,1,0,1,0,1,1877
1,1,1,0,2,0,2,1877
2,2,0,1,2,1,3,1877
3,3,0,2,2,3,5,1877
4,4,0,0,2,3,5,1877
0,0,1,0,1,0,1,1878
1,1,3,0,4,0,4,1878
2,2,5,0,9,0,9,1878
3,3,2,4,11,4,15,1878
4,4,3,2,14,6,20,1878
5,5,2,0,16,6,22,1878
6,6,2,0,18,6,24,1878
7,7,3,0,21,6,27,1878
8,8,2,0,23,6,29,1878
9,9,1,0,24,6,30,1878
10,10,1,0,25,6,31,1878
11,11,2,0,27,6,33,1878
12,12,0,0,27,6,33,1878
0,0,1,0,1,0,1,1879
1,1,0,1,1,1,2,1879
2,2,0,0,1,1,2,1879
0,0,1,0,1,0,1,1880
1,1,3,0,4,0,4,1880
2,2,0,0,4,0,4,1880
0,0,1,0,1,0,1,1881
1,1,1,0,2,0,2,1881
2,2,2,1,4,1,5,1881
3,3,1,1,5,2,7,1881
4,4,0,1,5,3,8,1881
5,5,0,0,5,3,8,1881
0,0,1,0,1,0,1,1882
1,1,0,0,1,0,1,1882
0,0,1,0,1,0,1,1883
1,1,0,0,1,0,1,1883
0,0,1,0,1,0,1,1884
1,1,1,0,2,0,2,1884
2,2,0,1,2,1,3,1884
3,3,0,0,2,1,3,1884
0,0,1,0,1,0,1,1885
1,1,1,0,2,0,2,1885
2,2,1,0,3,0,3,1885
3,3,0,1,3,1,4,1885
4,4,0,1,3,2,5,1885
5,5,0,0,3,2,5,1885
0,0,1,0,1,0,1,1886
1,1,1,0,2,0,2,1886
2,2,0,0,2,0,2,1886
0,0,1,0,1,0,1,1887
1,1,1,1,2,1,3,1887
2,2,1,0,3,1,4,1887
3,3,0,0,3,1,4,1887
0,0,1,0,1,0,1,1888
1,1,1,0,2,0,2,1888
2,2,1,0,3,0,3,1888
3,3,0,0,3,0,3,1888
0,0,1,0,1,0,1,1889
1,1,0,0,1,0,1,1889
0,0,1,0,1,0,1,1890
1,1,0,0,1,0,1,1890
0,0,1,0,1,0,1,1891
1,1,1,0,2,0,2,1891
2,2,0,1,2,1,3,1891
3,3,0,1,2,2,4,1891
4,4,0,1,2,3,5,1891
5,5,0,2,2,5,7,1891
6,6,0,1,2,6,8,1891
7,7,0,1,2,7,9,1891
8,8,1,1,3,8,11,1891
9,9,2,2,5,10,15,1891
10,10,2,2,7,12,19,1891
11,11,2,1,9,13,22,1891
12,12,1,0,10,13,23,1891
13,13,1,0,11,13,24,1891
14,14,2,0,13,13,26,1891
15,15,4,0,17,13,30,1891
16,16,3,0,20,13,33,1891
17,17,4,1,24,14,38,1891
18,18,4,3,28,17,45,1891
19,19,2,1,30,18,48,1891
20,20,5,2,35,20,55,1891
21,21,1,0,36,20,56,1891
22,22,2,0,38,20,58,1891
23,23,2,0,40,20,60,1891
24,24,3,1,43,21,64,1891
25,25,1,1,44,22,66,1891
26,26,2,0,46,22,68,1891
27,27,3,0,49,22,71,1891
28,28,3,0,52,22,74,1891
29,29,4,0,56,22,78,1891
30,30,5,1,61,23,84,1891
31,31,1,2,62,25,87,1891
32,32,1,3,63,28,91,1891
33,33,2,1,65,29,94,1891
34,34,3,1,68,30,98,1891
35,35,0,0,68,30,98,1891
0,0,1,0,1,0,1,1892
1,1,3,1,4,1,5,1892
2,2,1,2,5,3,8,1892
3,3,2,1,7,4,11,1892
4,4,2,1,9,5,14,1892
5,5,0,3,9,8,17,1892
6,6,2,2,11,10,21,1892
7,7,0,1,11,11,22,1892
8,8,0,0,11,11,22,1892
0,0,1,0,1,0,1,1893
1,1,0,0,1,0,1,1893
0,0,1,0,1,0,1,1894
1,1,2,0,3,0,3,1894
2,2,0,0,3,0,3,1894
0,0,1,0,1,0,1,1895
1,1,0,0,1,0,1,1895
0,0,1,0,1,0,1,1896
1,1,0,0,1,0,1,1896
0,0,1,0,1,0,1,1897
1,1,2,0,3,0,3,1897
2,2,2,1,5,1,6,1897
3,3,2,2,7,3,10,1897
4,4,1,2,8,5,13,1897
5,5,1,4,9,9,18,1897
6,6,3,1,12,10,22,1897
7,7,4,3,16,13,29,1897
8,8,2,3,18,16,34,1897
9,9,3,4,21,20,41,1897
10,10,1,2,22,22,44,1897
11,11,2,2,24,24,48,1897
12,12,1,2,25,26,51,1897
13,13,0,3,25,29,54,1897
14,14,0,4,25,33,58,1897
15,15,1,4,26,37,63,1897
16,16,1,3,27,40,67,1897
17,17,1,2,28,42,70,1897
18,18,0,1,28,43,71,1897
19,19,0,1,28,44,72,1897
20,20,0,0,28,44,72,1897
0,0,1,0,1,0,1,1898
1,1,1,0,2,0,2,1898
2,2,1,0,3,0,3,1898
3,3,1,0,4,0,4,1898
4,4,0,1,4,1,5,1898
5,5,2,2,6,3,9,1898
6,6,2,2,8,5,13,1898
7,7,1,0,9,5,14,1898
8,8,1,0,10,5,15,1898
9,9,2,0,12,5,17,1898
10,10,1,2,13,7,20,1898
11,11,0,2,13,9,22,1898
12,12,1,2,14,11,25,1898
13,13,0,4,14,15,29,1898
14,14,0,5,14,20,34,1898
15,15,3,5,17,25,42,1898
16,16,4,3,21,28,49,1898
17,17,4,2,25,30,55,1898
18,18,4,1,29,31,60,1898
19,19,1,0,30,31,61,1898
20,20,0,0,30,31,61,1898
0,0,1,0,1,0,1,1899
1,1,0,0,1,0,1,1899
0,0,1,0,1,0,1,1900
1,1,0,0,1,0,1,1900
0,0,1,0,1,0,1,1901
1,1,0,1,1,1,2,1901
2,2,0,2,1,3,4,1901
3,3,0,0,1,3,4,1901
0,0,1,0,1,0,1,1902
1,1,2,0,3,0,3,1902
2,2,3,1,6,1,7,1902
3,3,1,1,7,2,9,1902
4,4,0,1,7,3,10,1902
5,5,0,0,7,3,10,1902
0,0,1,0,1,0,1,1903
1,1,0,1,1,1,2,1903
2,2,0,0,1,1,2,1903
0,0,1,0,1,0,1,1904
1,1,0,0,1,0,1,1904
0,0,1,0,1,0,1,1905
1,1,0,0,1,0,1,1905
0,0,1,0,1,0,1,1906
1,1,1,0,2,0,2,1906
2,2,0,0,2,0,2,1906
0,0,1,0,1,0,1,1907
1,1,0,0,1,0,1,1907
0,0,1,0,1,0,1,1908
1,1,0,0,1,0,1,1908
0,0,1,0,1,0,1,1909
1,1,1,0,2,0,2,1909
2,2,1,0,3,0,3,1909
3,3,0,0,3,0,3,1909
0,0,1,0,1,0,1,1910
1,1,1,0,2,0,2,1910
2,2,0,0,2,0,2,1910
0,0,1,0,1,0,1,1911
1,1,2,0,3,0,3,1911
2,2,3,0,6,0,6,1911
3,3,1,1,7,1,8,1911
4,4,0,0,7,1,8,1911
0,0,1,0,1,0,1,1912
1,1,2,0,3,0,3,1912
2,2,1,0,4,0,4,1912
3,3,1,0,5,0,5,1912
4,4,0,1,5,1,6,1912
5,5,0,0,5,1,6,1912
0,0,1,0,1,0,1,1913
1,1,0,1,1,1,2,1913
2,2,0,0,1,1,2,1913
0,0,1,0,1,0,1,1914
1,1,0,0,1,0,1,1914
0,0,1,0,1,0,1,1915
1,1,0,0,1,0,1,1915
0,0,1,0,1,0,1,1916
1,1,1,0,2,0,2,1916
2,2,1,0,3,0,3,1916
3,3,0,0,3,0,3,1916
0,0,1,0,1,0,1,1917
1,1,0,0,1,0,1,1917
0,0,1,0,1,0,1,1918
1,1,0,1,1,1,2,1918
2,2,0,0,1,1,2,1918
0,0,1,0,1,0,1,1919
1,1,1,0,2,0,2,1919
2,2,0,0,2,0,2,1919
0,0,1,0,1,0,1,1920
1,1,1,0,2,0,2,1920
2,2,0,0,2,0,2,1920
0,0,1,0,1,0,1,1921
1,1,0,0,1,0,1,1921
0,0,1,0,1,0,1,1922
1,1,2,0,3,0,3,1922
2,2,1,0,4,0,4,1922
3,3,1,0,5,0,5,1922
4,4,0,0,5,0,5,1922
0,0,1,0,1,0,1,1923
1,1,1,0,2,0,2,1923
2,2,0,0,2,0,2,1923
0,0,1,0,1,0,1,1924
1,1,1,0,2,0,2,1924
2,2,0,0,2,0,2,1924
0,0,1,0,1,0,1,1925
1,1,1,0,2,0,2,1925
2,2,2,0,4,0,4,1925
3,3,0,0,4,0,4,1925
0,0,1,0,1,0,1,1926
1,1,0,0,1,0,1,1926
0,0,1,0,1,0,1,1927
1,1,0,0,1,0,1,1927
0,0,1,0,1,0,1,1928
1,1,1,0,2,0,2,1928
2,2,0,0,2,0,2,1928
0,0,1,0,1,0,1,1929
1,1,1,0,2,0,2,1929
2,2,0,0,2,0,2,1929
0,0,1,0,1,0,1,1930
1,1,0,0,1,0,1,1930
0,0,1,0,1,0,1,1931
1,1,2,0,3,0,3,1931
2,2,1,1,4,1,5,1931
3,3,0,3,4,4,8,1931
4,4,0,3,4,7,11,1931
5,5,0,2,4,9,13,1931
6,6,0,1,4,10,14,1931
7,7,0,1,4,11,15,1931
8,8,0,1,4,12,16,1931
9,9,0,0,4,12,16,1931
0,0,1,0,1,0,1,1932
1,1,0,0,1,0,1,1932
0,0,1,0,1,0,1,1933
1,1,3,0,4,0,4,1933
2,2,3,2,7,2,9,1933
3,3,5,3,12,5,17,1933
4,4,1,2,13,7,20,1933
5,5,1,0,14,7,21,1933
6,6,1,1,15,8,23,1933
7,7,1,3,16,11,27,1933
8,8,1,5,17,16,33,1933
9,9,0,4,17,20,37,1933
10,10,1,1,18,21,39,1933
11,11,3,1,21,22,43,1933
12,12,2,2,23,24,47,1933
13,13,2,4,25,28,53,1933
14,14,6,0,31,28,59,1933
15,15,3,1,34,29,63,1933
16,16,1,2,35,31,66,1933
17,17,2,1,37,32,69,1933
18,18,1,0,38,32,70,1933
19,19,0,0,38,32,70,1933
0,0,1,0,1,0,1,1934
1,1,1,0,2,0,2,1934
2,2,0,1,2,1,3,1934
3,3,1,1,3,2,5,1934
4,4,0,1,3,3,6,1934
5,5,0,0,3,3,6,1934
0,0,1,0,1,0,1,1935
1,1,0,0,1,0,1,1935
0,0,1,0,1,0,1,1936
1,1,1,0,2,0,2,1936
2,2,0,0,2,0,2,1936
0,0,1,0,1,0,1,1937
1,1,0,0,1,0,1,1937
0,0,1,0,1,0,1,1938
1,1,1,0,2,0,2,1938
2,2,0,1,2,1,3,1938
3,3,0,0,2,1,3,1938
0,0,1,0,1,0,1,1939
1,1,0,0,1,0,1,1939
0,0,1,0,1,0,1,1940
1,1,0,0,1,0,1,1940
0,0,1,0,1,0,1,1941
1,1,2,0,3,0,3,1941
2,2,3,1,6,1,7,1941
3,3,3,0,9,1,10,1941
4,4,2,2,11,3,14,1941
5,5,2,2,13,5,18,1941
6,6,3,0,16,5,21,1941
7,7,0,1,16,6,22,1941
8,8,0,1,16,7,23,1941
9,9,0,0,16,7,23,1941
0,0,1,0,1,0,1,1942
1,1,0,0,1,0,1,1942
0,0,1,0,1,0,1,1943
1,1,1,0,2,0,2,1943
2,2,1,1,3,1,4,1943
3,3,0,1,3,2,5,1943
4,4,0,1,3,3,6,1943
5,5,1,0,4,3,7,1943
6,6,2,0,6,3,9,1943
7,7,2,0,8,3,11,1943
8,8,0,0,8,3,11,1943
0,0,1,0,1,0,1,1944
1,1,2,0,3,0,3,1944
2,2,1,0,4,0,4,1944
3,3,0,0,4,0,4,1944
0,0,1,0,1,0,1,1945
1,1,3,0,4,0,4,1945
2,2,1,0,5,0,5,1945
3,3,0,0,5,0,5,1945
0,0,1,0,1,0,1,1946
1,1,1,0,2,0,2,1946
2,2,2,0,4,0,4,1946
3,3,1,0,5,0,5,1946
4,4,1,0,6,0,6,1946
5,5,4,0,10,0,10,1946
6,6,5,1,15,1,16,1946
7,7,7,2,22,3,25,1946
8,8,4,1,26,4,30,1946
9,9,3,2,29,6,35,1946
10,10,0,2,29,8,37,1946
11,11,0,0,29,8,37,1946
0,0,1,0,1,0,1,1947
1,1,0,0,1,0,1,1947
0,0,1,0,1,0,1,1948
1,1,1,0,2,0,2,1948
2,2,0,0,2,0,2,1948
0,0,1,0,1,0,1,1949
1,1,0,0,1,0,1,1949
0,0,1,0,1,0,1,1950
1,1,1,0,2,0,2,1950
2,2,1,0,3,0,3,1950
3,3,2,0,5,0,5,1950
4,4,2,1,7,1,8,1950
5,5,1,0,8,1,9,1950
6,6,0,0,8,1,9,1950
0,0,1,0,1,0,1,1951
1,1,0,0,1,0,1,1951
0,0,1,0,1,0,1,1952
1,1,1,0,2,0,2,1952
2,2,1,0,3,0,3,1952
3,3,1,0,4,0,4,1952
4,4,0,0,4,0,4,1952
0,0,1,0,1,0,1,1953
1,1,0,1,1,1,2,1953
2,2,0,0,1,1,2,1953
0,0,1,0,1,0,1,1954
1,1,0,1,1,1,2,1954
2,2,0,1,1,2,3,1954
3,3,0,0,1,2,3,1954
0,0,1,0,1,0,1,1955
1,1,2,0,3,0,3,1955
2,2,2,0,5,0,5,1955
3,3,5,0,10,0,10,1955
4,4,3,3,13,3,16,1955
5,5,2,2,15,5,20,1955
6,6,0,0,15,5,20,1955
0,0,1,0,1,0,1,1956
1,1,1,2,2,2,4,1956
2,2,0,1,2,3,5,1956
3,3,0,1,2,4,6,1956
4,4,0,0,2,4,6,1956
0,0,1,0,1,0,1,1957
1,1,1,1,2,1,3,1957
2,2,1,3,3,4,7,1957
3,3,1,5,4,9,13,1957
4,4,0,6,4,15,19,1957
5,5,2,3,6,18,24,1957
6,6,4,3,10,21,31,1957
7,7,4,1,14,22,36,1957
8,8,0,2,14,24,38,1957
9,9,1,1,15,25,40,1957
10,10,1,2,16,27,43,1957
11,11,1,3,17,30,47,1957
12,12,0,4,17,34,51,1957
13,13,1,2,18,36,54,1957
14,14,3,3,21,39,60,1957
15,15,1,2,22,41,63,1957
16,16,2,1,24,42,66,1957
17,17,0,3,24,45,69,1957
18,18,1,3,25,48,73,1957
19,19,2,4,27,52,79,1957
20,20,0,3,27,55,82,1957
21,21,0,2,27,57,84,1957
22,22,0,1,27,58,85,1957
23,23,0,1,27,59,86,1957
24,24,0,1,27,60,87,1957
25,25,0,1,27,61,88,1957
26,26,1,2,28,63,91,1957
27,27,0,2,28,65,93,1957
28,28,0,1,28,66,94,1957
29,29,0,0,28,66,94,1957
0,0,1,0,1,0,1,1958
1,1,0,0,1,0,1,1958
0,0,1,0,1,0,1,1959
1,1,1,0,2,0,2,1959
2,2,0,0,2,0,2,1959
0,0,1,0,1,0,1,1960
1,1,0,0,1,0,1,1960
0,0,1,0,1,0,1,1961
1,1,0,0,1,0,1,1961
0,0,1,0,1,0,1,1962
1,1,0,0,1,0,1,1962
0,0,1,0,1,0,1,1963
1,1,0,0,1,0,1,1963
0,0,1,0,1,0,1,1964
1,1,1,0,2,0,2,1964
2,2,1,0,3,0,3,1964
3,3,0,0,3,0,3,1964
0,0,1,0,1,0,1,1965
1,1,2,1,3,1,4,1965
2,2,0,1,3,2,5,1965
3,3,0,0,3,2,5,1965
0,0,1,0,1,0,1,1966
1,1,0,0,1,0,1,1966
0,0,1,0,1,0,1,1967
1,1,1,0,2,0,2,1967
2,2,1,0,3,0,3,1967
3,3,1,0,4,0,4,1967
4,4,1,0,5,0,5,1967
5,5,1,0,6,0,6,1967
6,6,1,0,7,0,7,1967
7,7,1,0,8,0,8,1967
8,8,0,0,8,0,8,1967
0,0,1,0,1,0,1,1968
1,1,2,0,3,0,3,1968
2,2,0,0,3,0,3,1968
0,0,1,0,1,0,1,1969
1,1,1,0,2,0,2,1969
2,2,1,0,3,0,3,1969
3,3,0,1,3,1,4,1969
4,4,0,1,3,2,5,1969
5,5,1,1,4,3,7,1969
6,6,1,3,5,6,11,1969
7,7,1,2,6,8,14,1969
8,8,0,0,6,8,14,1969
0,0,1,0,1,0,1,1970
1,1,0,0,1,0,1,1970
0,0,1,0,1,0,1,1971
1,1,2,0,3,0,3,1971
2,2,1,0,4,0,4,1971
3,3,0,0,4,0,4,1971
0,0,1,0,1,0,1,1972
1,1,0,0,1,0,1,1972
0,0,1,0,1,0,1,1973
1,1,1,1,2,1,3,1973
2,2,1,1,3,2,5,1973
3,3,0,1,3,3,6,1973
4,4,0,0,3,3,6,1973
0,0,1,0,1,0,1,1974
1,1,0,0,1,0,1,1974
0,0,1,0,1,0,1,1975
1,1,0,0,1,0,1,1975
0,0,1,0,1,0,1,1976
1,1,1,0,2,0,2,1976
2,2,1,0,3,0,3,1976
3,3,0,0,3,0,3,1976
0,0,1,0,1,0,1,1977
1,1,1,0,2,0,2,1977
2,2,1,0,3,0,3,1977
3,3,0,2,3,2,5,1977
4,4,1,1,4,3,7,1977
5,5,2,1,6,4,10,1977
6,6,0,2,6,6,12,1977
7,7,1,4,7,10,17,1977
8,8,0,5,7,15,22,1977
9,9,4,0,11,15,26,1977
10,10,6,2,17,17,34,1977
11,11,4,1,21,18,39,1977
12,12,7,0,28,18,46,1977
13,13,7,0,35,18,53,1977
14,14,3,2,38,20,58,1977
15,15,2,2,40,22,62,1977
16,16,0,5,40,27,67,1977
17,17,0,3,40,30,70,1977
18,18,0,2,40,32,72,1977
19,19,2,4,42,36,78,1977
20,20,1,4,43,40,83,1977
21,21,4,0,47,40,87,1977
22,22,4,1,51,41,92,1977
23,23,3,0,54,41,95,1977
24,24,2,0,56,41,97,1977
25,25,1,0,57,41,98,1977
26,26,0,0,57,41,98,1977
0,0,1,0,1,0,1,1978
1,1,2,0,3,0,3,1978
2,2,2,0,5,0,5,1978
3,3,2,2,7,2,9,1978
4,4,0,5,7,7,14,1978
5,5,0,8,7,15,22,1978
6,6,4,6,11,21,32,1978
7,7,5,8,16,29,45,1978
8,8,2,9,18,38,56,1978
9,9,4,12,22,50,72,1978
10,10,2,6,24,56,80,1978
11,11,0,3,24,59,83,1978
12,12,0,1,24,60,84,1978
13,13,1,0,25,60,85,1978
14,14,1,0,26,60,86,1978
15,15,1,0,27,60,87,1978
16,16,1,0,28,60,88,1978
17,17,1,0,29,60,89,1978
18,18,1,1,30,61,91,1978
19,19,1,1,31,62,93,1978
20,20,0,1,31,63,94,1978
21,21,0,1,31,64,95,1978
22,22,0,1,31,65,96,1978
23,23,0,2,31,67,98,1978
24,24,1,0,32,67,99,1978
25,25,1,0,33,67,100,1978
26,26,0,0,33,67,100,1978
0,0,1,0,1,0,1,1979
1,1,1,1,2,1,3,1979
2,2,0,0,2,1,3,1979
0,0,1,0,1,0,1,1980
1,1,0,0,1,0,1,1980
0,0,1,0,1,0,1,1981
1,1,0,1,1,1,2,1981
2,2,0,1,1,2,3,1981
3,3,0,1,1,3,4,1981
4,4,0,1,1,4,5,1981
5,5,1,1,2,5,7,1981
6,6,1,1,3,6,9,1981
7,7,2,0,5,6,11,1981
8,8,1,1,6,7,13,1981
9,9,0,0,6,7,13,1981
0,0,1,0,1,0,1,1982
1,1,1,0,2,0,2,1982
2,2,1,0,3,0,3,1982
3,3,0,0,3,0,3,1982
0,0,1,0,1,0,1,1983
1,1,2,0,3,0,3,1983
2,2,3,0,6,0,6,1983
3,3,1,0,7,0,7,1983
4,4,0,0,7,0,7,1983
0,0,1,0,1,0,1,1984
1,1,0,0,1,0,1,1984
0,0,1,0,1,0,1,1985
1,1,2,0,3,0,3,1985
2,2,1,0,4,0,4,1985
3,3,0,0,4,0,4,1985
0,0,1,0,1,0,1,1986
1,1,1,0,2,0,2,1986
2,2,3,0,5,0,5,1986
3,3,3,0,8,0,8,1986
4,4,2,0,10,0,10,1986
5,5,3,1,13,1,14,1986
6,6,2,2,15,3,18,1986
7,7,2,3,17,6,23,1986
8,8,2,2,19,8,27,1986
9,9,0,4,19,12,31,1986
10,10,0,2,19,14,33,1986
11,11,0,1,19,15,34,1986
12,12,0,3,19,18,37,1986
13,13,0,2,19,20,39,1986
14,14,0,1,19,21,40,1986
15,15,0,0,19,21,40,1986
0,0,1,0,1,0,1,1987
1,1,1,0,2,0,2,1987
2,2,1,0,3,0,3,1987
3,3,0,0,3,0,3,1987
0,0,1,0,1,0,1,1988
1,1,1,0,2,0,2,1988
2,2,1,0,3,0,3,1988
3,3,1,0,4,0,4,1988
4,4,0,0,4,0,4,1988
0,0,1,0,1,0,1,1989
1,1,0,0,1,0,1,1989
0,0,1,0,1,0,1,1990
1,1,1,0,2,0,2,1990
2,2,2,0,4,0,4,1990
3,3,0,0,4,0,4,1990
0,0,1,0,1,0,1,1991
1,1,1,0,2,0,2,1991
2,2,0,0,2,0,2,1991
0,0,1,0,1,0,1,1992
1,1,0,1,1,1,2,1992
2,2,0,0,1,1,2,1992
0,0,1,0,1,0,1,1993
1,1,0,0,1,0,1,1993
0,0,1,0,1,0,1,1994
1,1,0,1,1,1,2,1994
2,2,0,1,1,2,3,1994
3,3,1,0,2,2,4,1994
4,4,0,1,2,3,5,1994
5,5,0,0,2,3,5,1994
0,0,1,0,1,0,1,1995
1,1,0,0,1,0,1,1995
0,0,1,0,1,0,1,1996
1,1,0,0,1,0,1,1996
0,0,1,0,1,0,1,1997
1,1,1,0,2,0,2,1997
2,2,2,0,4,0,4,1997
3,3,1,2,5,2,7,1997
4,4,0,1,5,3,8,1997
5,5,0,0,5,3,8,1997
0,0,1,0,1,0,1,1998
1,1,1,0,2,0,2,1998
2,2,0,1,2,1,3,1998
3,3,0,3,2,4,6,1998
4,4,0,2,2,6,8,1998
5,5,0,1,2,7,9,1998
6,6,0,2,2,9,11,1998
7,7,0,0,2,9,11,1998
0,0,1,0,1,0,1,1999
1,1,1,0,2,0,2,1999
2,2,0,0,2,0,2,1999
0,0,1,0,1,0,1,2000
1,1,1,0,2,0,2,2000
2,2,3,0,5,0,5,2000
3,3,2,0,7,0,7,2000
4,4,2,1,9,1,10,2000
5,5,1,0,10,1,11,2000
6,6,0,0,10,1,11,2000
0,0,1,0,1,0,1,2001
1,1,1,0,2,0,2,2001
2,2,1,0,3,0,3,2001
3,3,1,0,4,0,4,2001
4,4,0,0,4,0,4,2001
0,0,1,0,1,0,1,2002
1,1,1,0,2,0,2,2002
2,2,2,0,4,0,4,2002
3,3,4,0,8,0,8,2002
4,4,3,1,11,1,12,2002
5,5,4,5,15,6,21,2002
6,6,3,4,18,10,28,2002
7,7,3,4,21,14,35,2002
8,8,4,3,25,17,42,2002
9,9,5,3,30,20,50,2002
10,10,2,3,32,23,55,2002
11,11,3,1,35,24,59,2002
12,12,3,0,38,24,62,2002
13,13,2,0,40,24,64,2002
14,14,3,0,43,24,67,2002
15,15,3,0,46,24,70,2002
16,16,1,0,47,24,71,2002
17,17,1,0,48,24,72,2002
18,18,1,1,49,25,74,2002
19,19,0,0,49,25,74,2002
0,0,1,0,1,0,1,2003
1,1,1,1,2,1,3,2003
2,2,2,0,4,1,5,2003
3,3,2,0,6,1,7,2003
4,4,2,1,8,2,10,2003
5,5,2,1,10,3,13,2003
6,6,2,2,12,5,17,2003
7,7,0,2,12,7,19,2003
8,8,0,1,12,8,20,2003
9,9,1,1,13,9,22,2003
10,10,1,1,14,10,24,2003
11,11,2,1,16,11,27,2003
12,12,0,2,16,13,29,2003
13,13,1,2,17,15,32,2003
14,14,1,2,18,17,35,2003
15,15,0,1,18,18,36,2003
16,16,1,0,19,18,37,2003
17,17,1,0,20,18,38,2003
18,18,0,0,20,18,38,2003
0,0,1,0,1,0,1,2004
1,1,0,0,1,0,1,2004
0,0,1,0,1,0,1,2005
1,1,0,0,1,0,1,2005
0,0,1,0,1,0,1,2006
1,1,1,0,2,0,2,2006
2,2,1,0,3,0,3,2006
3,3,1,1,4,1,5,2006
4,4,0,0,4,1,5,2006
0,0,1,0,1,0,1,2007
1,1,1,0,2,0,2,2007
2,2,1,0,3,0,3,2007
3,3,0,1,3,1,4,2007
4,4,1,0,4,1,5,2007
5,5,1,0,5,1,6,2007
6,6,1,0,6,1,7,2007
7,7,0,0,6,1,7,2007
0,0,1,0,1,0,1,2008
1,1,1,1,2,1,3,2008
2,2,0,0,2,1,3,2008
0,0,1,0,1,0,1,2009
1,1,0,0,1,0,1,2009
0,0,1,0,1,0,1,2010
1,1,0,0,1,0,1,2010
0,0,1,0,1,0,1,2011
1,1,1,0,2,0,2,2011
2,2,1,0,3,0,3,2011
3,3,2,0,5,0,5,2011
4,4,1,0,6,0,6,2011
5,5,1,0,7,0,7,2011
6,6,0,2,7,2,9,2011
7,7,0,4,7,6,13,2011
8,8,1,1,8,7,15,2011
9,9,1,1,9,8,17,2011
10,10,1,2,10,10,20,2011
11,11,0,1,10,11,21,2011
12,12,2,0,12,11,23,2011
13,13,1,1,13,12,25,2011
14,14,3,0,16,12,28,2011
15,15,2,0,18,12,30,2011
16,16,2,1,20,13,33,2011
17,17,3,2,23,15,38,2011
18,18,0,3,23,18,41,2011
19,19,0,2,23,20,43,2011
20,20,2,2,25,22,47,2011
21,21,2,2,27,24,51,2011
22,22,2,0,29,24,53,2011
23,23,1,0,30,24,54,2011
24,24,0,1,30,25,55,2011
25,25,0,0,30,25,55,2011
0,0,1,0,1,0,1,2012
1,1,0,0,1,0,1,2012
0,0,1,0,1,0,1,2013
1,1,0,0,1,0,1,2013
0,0,1,0,1,0,1,2014
1,1,0,0,1,0,1,2014
0,0,1,0,1,0,1,2015
1,1,0,0,1,0,1,2015
0,0,1,0,1,0,1,2016
1,1,0,0,1,0,1,2016
0,0,1,0,1,0,1,2017
1,1,1,0,2,0,2,2017
2,2,2,0,4,0,4,2017
3,3,2,1,6,1,7,2017
4,4,0,1,6,2,8,2017
5,5,0,0,6,2,8,2017
0,0,1,0,1,0,1,2018
1,1,0,0,1,0,1,2018
0,0,1,0,1,0,1,2019
1,1,3,0,4,0,4,2019
2,2,1,0,5,0,5,2019
3,3,2,0,7,0,7,2019
4,4,0,0,7,0,7,2019
0,0,1,0,1,0,1,2020
1,1,0,0,1,0,1,2020
0,0,1,0,1,0,1,2021
1,1,0,0,1,0,1,2021
0,0,1,0,1,0,1,2022
1,1,2,0,3,0,3,2022
2,2,1,1,4,1,5,2022
3,3,0,1,4,2,6,2022
4,4,0,0,4,2,6,2022
0,0,1,0,1,0,1,2023
1,1,0,1,1,1,2,2023
2,2,0,2,1,3,4,2023
3,3,0,1,1,4,5,2023
4,4,0,0,1,4,5,2023
0,0,1,0,1,0,1,2024
1,1,3,0,4,0,4,2024
2,2,0,0,4,0,4,2024
0,0,1,0,1,0,1,2025
1,1,0,1,1,1,2,2025
2,2,0,2,1,3,4,2025
3,3,0,1,1,4,5,2025
4,4,0,1,1,5,6,2025
5,5,0,1,1,6,7,2025
6,6,0,0,1,6,7,2025
0,0,1,0,1,0,1,2026
1,1,0,0,1,0,1,2026
0,0,1,0,1,0,1,2027
1,1,1,2,2,2,4,2027
2,2,1,1,3,3,6,2027
3,3,0,1,3,4,7,2027
4,4,2,0,5,4,9,2027
5,5,2,1,7,5,12,2027
6,6,0,0,7,5,12,2027
0,0,1,0,1,0,1,2028
1,1,1,1,2,1,3,2028
2,2,0,0,2,1,3,2028
0,0,1,0,1,0,1,2029
1,1,1,0,2,0,2,2029
2,2,0,0,2,0,2,2029
0,0,1,0,1,0,1,2030
1,1,1,0,2,0,2,2030
2,2,0,0,2,0,2,2030
0,0,1,0,1,0,1,2031
1,1,1,0,2,0,2,2031
2,2,1,0,3,0,3,2031
3,3,1,1,4,1,5,2031
4,4,1,1,5,2,7,2031
5,5,1,3,6,5,11,2031
6,6,1,1,7,6,13,2031
7,7,1,1,8,7,15,2031
8,8,0,3,8,10,18,2031
9,9,0,1,8,11,19,2031
10,10,0,1,8,12,20,2031
11,11,0,1,8,13,21,2031
12,12,0,3,8,16,24,2031
13,13,2,0,10,16,26,2031
14,14,1,0,11,16,27,2031
15,15,1,0,12,16,28,2031
16,16,2,0,14,16,30,2031
17,17,1,1,15,17,32,2031
18,18,0,2,15,19,34,2031
19,19,1,1,16,20,36,2031
20,20,2,1,18,21,39,2031
21,21,2,1,20,22,42,2031
22,22,0,1,20,23,43,2031
23,23,0,2,20,25,45,2031
24,24,0,2,20,27,47,2031
25,25,0,1,20,28,48,2031
26,26,1,1,21,29,50,2031
27,27,1,3,22,32,54,2031
28,28,0,3,22,35,57,2031
29,29,1,3,23,38,61,2031
30,30,0,3,23,41,64,2031
31,31,1,1,24,42,66,2031
32,32,4,0,28,42,70,2031
33,33,3,2,31,44,75,2031
34,34,2,4,33,48,81,2031
35,35,3,5,36,53,89,2031
36,36,4,2,40,55,95,2031
37,37,2,1,42,56,98,2031
38,38,1,1,43,57,100,2031
39,39,1,2,44,59,103,2031
40,40,0,0,44,59,103,2031
0,0,1,0,1,0,1,2032
1,1,1,0,2,0,2,2032
2,2,0,0,2,0,2,2032
0,0,1,0,1,0,1,2033
1,1,0,0,1,0,1,2033
0,0,1,0,1,0,1,2034
1,1,3,0,4,0,4,2034
2,2,4,0,8,0,8,2034
3,3,1,1,9,1,10,2034
4,4,0,2,9,3,12,2034
5,5,0,1,9,4,13,2034
6,6,0,2,9,6,15,2034
7,7,1,1,10,7,17,2034
8,8,0,2,10,9,19,2034
9,9,2,1,12,10,22,2034
10,10,0,3,12,13,25,2034
11,11,0,0,12,13,25,2034
0,0,1,0,1,0,1,2035
1,1,2,1,3,1,4,2035
2,2,1,1,4,2,6,2035
3,3,0,1,4,3,7,2035
4,4,0,2,4,5,9,2035
5,5,1,0,5,5,10,2035
6,6,2,0,7,5,12,2035
7,7,3,0,10,5,15,2035
8,8,6,1,16,6,22,2035
9,9,10,0,26,6,32,2035
10,10,9,0,35,6,41,2035
11,11,2,2,37,8,45,2035
12,12,1,1,38,9,47,2035
13,13,0,0,38,9,47,2035
0,0,1,0,1,0,1,2036
1,1,1,0,2,0,2,2036
2,2,2,1,4,1,5,2036
3,3,1,2,5,3,8,2036
4,4,0,1,5,4,9,2036
5,5,0,0,5,4,9,2036
0,0,1,0,1,0,1,2037
1,1,1,0,2,0,2,2037
2,2,1,1,3,1,4,2037
3,3,1,0,4,1,5,2037
4,4,1,0,5,1,6,2037
5,5,0,0,5,1,6,2037
0,0,1,0,1,0,1,2038
1,1,1,0,2,0,2,2038
2,2,1,0,3,0,3,2038
3,3,0,0,3,0,3,2038
0,0,1,0,1,0,1,2039
1,1,1,1,2,1,3,2039
2,2,0,0,2,1,3,2039
0,0,1,0,1,0,1,2040
1,1,1,0,2,0,2,2040
2,2,2,0,4,0,4,2040
3,3,2,0,6,0,6,2040
4,4,1,0,7,0,7,2040
5,5,0,0,7,0,7,2040
0,0,1,0,1,0,1,2041
1,1,0,0,1,0,1,2041
0,0,1,0,1,0,1,2042
1,1,1,1,2,1,3,2042
2,2,0,1,2,2,4,2042
3,3,1,1,3,3,6,2042
4,4,0,0,3,3,6,2042
0,0,1,0,1,0,1,2043
1,1,0,1,1,1,2,2043
2,2,1,1,2,2,4,2043
3,3,1,0,3,2,5,2043
4,4,1,0,4,2,6,2043
5,5,0,0,4,2,6,2043
0,0,1,0,1,0,1,2044
1,1,0,0,1,0,1,2044
0,0,1,0,1,0,1,2045
1,1,0,0,1,0,1,2045
0,0,1,0,1,0,1,2046
1,1,0,1,1,1,2,2046
2,2,0,0,1,1,2,2046
0,0,1,0,1,0,1,2047
1,1,0,0,1,0,1,2047
0,0,1,0,1,0,1,2048
1,1,0,0,1,0,1,2048
0,0,1,0,1,0,1,2049
1,1,0,0,1,0,1,2049
0,0,1,0,1,0,1,2050
1,1,1,0,2,0,2,2050
2,2,1,0,3,0,3,2050
3,3,0,0,3,0,3,2050
0,0,1,0,1,0,1,2051
1,1,1,0,2,0,2,2051
2,2,2,0,4,0,4,2051
3,3,2,0,6,0,6,2051
4,4,0,0,6,0,6,2051
0,0,1,0,1,0,1,2052
1,1,0,1,1,1,2,2052
2,2,0,2,1,3,4,2052
3,3,0,1,1,4,5,2052
4,4,0,0,1,4,5,2052
0,0,1,0,1,0,1,2053
1,1,0,0,1,0,1,2053
0,0,1,0,1,0,1,2054
1,1,0,0,1,0,1,2054
0,0,1,0,1,0,1,2055
1,1,0,1,1,1,2,2055
2,2,0,1,1,2,3,2055
3,3,0,1,1,3,4,2055
4,4,1,0,2,3,5,2055
5,5,1,1,3,4,7,2055
6,6,0,0,3,4,7,2055
0,0,1,0,1,0,1,2056
1,1,1,1,2,1,3,2056
2,2,1,1,3,2,5,2056
3,3,0,2,3,4,7,2056
4,4,0,2,3,6,9,2056
5,5,0,1,3,7,10,2056
6,6,0,2,3,9,12,2056
7,7,0,2,3,11,14,2056
8,8,0,0,3,11,14,2056
0,0,1,0,1,0,1,2057
1,1,0,0,1,0,1,2057
0,0,1,0,1,0,1,2058
1,1,0,0,1,0,1,2058
0,0,1,0,1,0,1,2059
1,1,0,0,1,0,1,2059
0,0,1,0,1,0,1,2060
1,1,2,0,3,0,3,2060
2,2,3,0,6,0,6,2060
3,3,0,0,6,0,6,2060
0,0,1,0,1,0,1,2061
1,1,2,2,3,2,5,2061
2,2,2,3,5,5,10,2061
3,3,2,2,7,7,14,2061
4,4,3,3,10,10,20,2061
5,5,2,4,12,14,26,2061
6,6,2,1,14,15,29,2061
7,7,1,1,15,16,31,2061
8,8,0,2,15,18,33,2061
9,9,2,0,17,18,35,2061
10,10,3,1,20,19,39,2061
11,11,2,1,22,20,42,2061
12,12,0,2,22,22,44,2061
13,13,2,1,24,23,47,2061
14,14,1,1,25,24,49,2061
15,15,0,0,25,24,49,2061
0,0,1,0,1,0,1,2062
1,1,1,1,2,1,3,2062
2,2,1,0,3,1,4,2062
3,3,0,0,3,1,4,2062
0,0,1,0,1,0,1,2063
1,1,1,1,2,1,3,2063
2,2,1,1,3,2,5,2063
3,3,1,2,4,4,8,2063
4,4,3,1,7,5,12,2063
5,5,6,0,13,5,18,2063
6,6,6,1,19,6,25,2063
7,7,6,3,25,9,34,2063
8,8,3,5,28,14,42,2063
9,9,6,4,34,18,52,2063
10,10,1,4,35,22,57,2063
11,11,0,5,35,27,62,2063
12,12,1,1,36,28,64,2063
13,13,2,1,38,29,67,2063
14,14,4,0,42,29,71,2063
15,15,4,0,46,29,75,2063
16,16,2,1,48,30,78,2063
17,17,3,0,51,30,81,2063
18,18,3,0,54,30,84,2063
19,19,4,1,58,31,89,2063
20,20,1,2,59,33,92,2063
21,21,0,3,59,36,95,2063
22,22,2,3,61,39,100,2063
23,23,3,5,64,44,108,2063
24,24,5,10,69,54,123,2063
25,25,6,8,75,62,137,2063
26,26,9,8,84,70,154,2063
27,27,4,9,88,79,167,2063
28,28,5,9,93,88,181,2063
29,29,4,11,97,99,196,2063
30,30,6,8,103,107,210,2063
31,31,11,9,114,116,230,2063
32,32,12,5,126,121,247,2063
33,33,14,6,140,127,267,2063
34,34,8,7,148,134,282,2063
35,35,2,8,150,142,292,2063
36,36,4,4,154,146,300,2063
37,37,4,1,158,147,305,2063
38,38,5,2,163,149,312,2063
39,39,5,5,168,154,322,2063
40,40,0,3,168,157,325,2063
41,41,1,6,169,163,332,2063
42,42,2,4,171,167,338,2063
43,43,2,3,173,170,343,2063
44,44,2,5,175,175,350,2063
45,45,1,2,176,177,353,2063
46,46,1,1,177,178,355,2063
47,47,1,0,178,178,356,2063
48,48,2,0,180,178,358,2063
49,49,2,1,182,179,361,2063
50,50,2,1,184,180,364,2063
51,51,4,1,188,181,369,2063
52,52,2,3,190,184,374,2063
53,53,0,2,190,186,376,2063
54,54,0,0,190,186,376,2063
0,0,1,0,1,0,1,2064
1,1,1,0,2,0,2,2064
2,2,1,0,3,0,3,2064
3,3,1,1,4,1,5,2064
4,4,1,0,5,1,6,2064
5,5,1,1,6,2,8,2064
6,6,3,1,9,3,12,2064
7,7,3,2,12,5,17,2064
8,8,1,3,13,8,21,2064
9,9,0,2,13,10,23,2064
10,10,0,0,13,10,23,2064
0,0,1,0,1,0,1,2065
1,1,0,1,1,1,2,2065
2,2,0,0,1,1,2,2065
0,0,1,0,1,0,1,2066
1,1,0,0,1,0,1,2066
0,0,1,0,1,0,1,2067
1,1,1,0,2,0,2,2067
2,2,1,0,3,0,3,2067
3,3,1,3,4,3,7,2067
4,4,1,5,5,8,13,2067
5,5,2,5,7,13,20,2067
6,6,1,5,8,18,26,2067
7,7,2,5,10,23,33,2067
8,8,5,5,15,28,43,2067
9,9,3,5,18,33,51,2067
10,10,2,3,20,36,56,2067
11,11,4,4,24,40,64,2067
12,12,2,8,26,48,74,2067
13,13,3,6,29,54,83,2067
14,14,4,7,33,61,94,2067
15,15,5,7,38,68,106,2067
16,16,7,9,45,77,122,2067
17,17,10,3,55,80,135,2067
18,18,7,4,62,84,146,2067
19,19,8,5,70,89,159,2067
20,20,8,4,78,93,171,2067
21,21,5,0,83,93,176,2067
22,22,1,1,84,94,178,2067
23,23,5,1,89,95,184,2067
24,24,5,2,94,97,191,2067
25,25,4,4,98,101,199,2067
26,26,1,1,99,102,201,2067
27,27,0,1,99,103,202,2067
28,28,0,3,99,106,205,2067
29,29,0,3,99,109,208,2067
30,30,1,0,100,109,209,2067
31,31,0,0,100,109,209,2067
0,0,1,0,1,0,1,2068
1,1,0,1,1,1,2,2068
2,2,0,0,1,1,2,2068
0,0,1,0,1,0,1,2069
1,1,0,1,1,1,2,2069
2,2,1,0,2,1,3,2069
3,3,0,0,2,1,3,2069
0,0,1,0,1,0,1,2070
1,1,0,0,1,0,1,2070
0,0,1,0,1,0,1,2071
1,1,2,0,3,0,3,2071
2,2,1,0,4,0,4,2071
3,3,2,0,6,0,6,2071
4,4,1,0,7,0,7,2071
5,5,0,0,7,0,7,2071
0,0,1,0,1,0,1,2072
1,1,1,0,2,0,2,2072
2,2,0,1,2,1,3,2072
3,3,1,1,3,2,5,2072
4,4,0,1,3,3,6,2072
5,5,0,0,3,3,6,2072
0,0,1,0,1,0,1,2073
1,1,2,0,3,0,3,2073
2,2,4,0,7,0,7,2073
3,3,3,0,10,0,10,2073
4,4,2,0,12,0,12,2073
5,5,0,1,12,1,13,2073
6,6,0,1,12,2,14,2073
7,7,1,0,13,2,15,2073
8,8,0,0,13,2,15,2073
0,0,1,0,1,0,1,2074
1,1,1,0,2,0,2,2074
2,2,0,1,2,1,3,2074
3,3,0,1,2,2,4,2074
4,4,0,1,2,3,5,2074
5,5,0,0,2,3,5,2074
0,0,1,0,1,0,1,2075
1,1,0,0,1,0,1,2075
0,0,1,0,1,0,1,2076
1,1,1,0,2,0,2,2076
2,2,4,0,6,0,6,2076
3,3,3,0,9,0,9,2076
4,4,2,4,11,4,15,2076
5,5,2,7,13,11,24,2076
6,6,2,6,15,17,32,2076
7,7,0,3,15,20,35,2076
8,8,0,0,15,20,35,2076
0,0,1,0,1,0,1,2077
1,1,0,0,1,0,1,2077
0,0,1,0,1,0,1,2078
1,1,1,0,2,0,2,2078
2,2,1,1,3,1,4,2078
3,3,2,2,5,3,8,2078
4,4,0,1,5,4,9,2078
5,5,0,0,5,4,9,2078
0,0,1,0,1,0,1,2079
1,1,1,0,2,0,2,2079
2,2,0,0,2,0,2,2079
0,0,1,0,1,0,1,2080
1,1,3,1,4,1,5,2080
2,2,1,4,5,5,10,2080
3,3,1,2,6,7,13,2080
4,4,2,2,8,9,17,2080
5,5,3,2,11,11,22,2080
6,6,6,1,17,12,29,2080
7,7,8,0,25,12,37,2080
8,8,7,4,32,16,48,2080
9,9,4,1,36,17,53,2080
10,10,1,3,37,20,57,2080
11,11,1,0,38,20,58,2080
12,12,0,0,38,20,58,2080
0,0,1,0,1,0,1,2081
1,1,1,0,2,0,2,2081
2,2,0,0,2,0,2,2081
0,0,1,0,1,0,1,2082
1,1,2,0,3,0,3,2082
2,2,3,0,6,0,6,2082
3,3,1,3,7,3,10,2082
4,4,0,2,7,5,12,2082
5,5,0,1,7,6,13,2082
6,6,3,1,10,7,17,2082
7,7,0,3,10,10,20,2082
8,8,0,4,10,14,24,2082
9,9,0,7,10,21,31,2082
10,10,1,5,11,26,37,2082
11,11,0,3,11,29,40,2082
12,12,1,3,12,32,44,2082
13,13,0,2,12,34,46,2082
14,14,1,0,13,34,47,2082
15,15,2,0,15,34,49,2082
16,16,3,0,18,34,52,2082
17,17,4,0,22,34,56,2082
18,18,3,0,25,34,59,2082
19,19,1,1,26,35,61,2082
20,20,1,0,27,35,62,2082
21,21,2,0,29,35,64,2082
22,22,2,0,31,35,66,2082
23,23,0,0,31,35,66,2082
0,0,1,0,1,0,1,2083
1,1,0,0,1,0,1,2083
0,0,1,0,1,0,1,2084
1,1,0,2,1,2,3,2084
2,2,1,1,2,3,5,2084
3,3,0,0,2,3,5,2084
0,0,1,0,1,0,1,2085
1,1,0,0,1,0,1,2085
0,0,1,0,1,0,1,2086
1,1,1,0,2,0,2,2086
2,2,2,0,4,0,4,2086
3,3,2,0,6,0,6,2086
4,4,0,1,6,1,7,2086
5,5,0,0,6,1,7,2086
0,0,1,0,1,0,1,2087
1,1,1,0,2,0,2,2087
2,2,0,0,2,0,2,2087
0,0,1,0,1,0,1,2088
1,1,1,0,2,0,2,2088
2,2,0,0,2,0,2,2088
0,0,1,0,1,0,1,2089
1,1,1,0,2,0,2,2089
2,2,1,0,3,0,3,2089
3,3,2,0,5,0,5,2089
4,4,3,0,8,0,8,2089
5,5,1,0,9,0,9,2089
6,6,2,0,11,0,11,2089
7,7,2,0,13,0,13,2089
8,8,2,0,15,0,15,2089
9,9,3,0,18,0,18,2089
10,10,1,1,19,1,20,2089
11,11,1,0,20,1,21,2089
12,12,0,0,20,1,21,2089
0,0,1,0,1,0,1,2090
1,1,1,0,2,0,2,2090
2,2,1,0,3,0,3,2090
3,3,0,0,3,0,3,2090
0,0,1,0,1,0,1,2091
1,1,0,1,1,1,2,2091
2,2,0,1,1,2,3,2091
3,3,0,0,1,2,3,2091
0,0,1,0,1,0,1,2092
1,1,0,0,1,0,1,2092
0,0,1,0,1,0,1,2093
1,1,2,0,3,0,3,2093
2,2,0,0,3,0,3,2093
0,0,1,0,1,0,1,2094
1,1,0,0,1,0,1,2094
0,0,1,0,1,0,1,2095
1,1,0,1,1,1,2,2095
2,2,1,1,2,2,4,2095
3,3,1,0,3,2,5,2095
4,4,1,0,4,2,6,2095
5,5,2,0,6,2,8,2095
6,6,1,0,7,2,9,2095
7,7,0,0,7,2,9,2095
0,0,1,0,1,0,1,2096
1,1,0,0,1,0,1,2096
0,0,1,0,1,0,1,2097
1,1,0,0,1,0,1,2097
0,0,1,0,1,0,1,2098
1,1,0,0,1,0,1,2098
0,0,1,0,1,0,1,2099
1,1,1,0,2,0,2,2099
2,2,1,0,3,0,3,2099
3,3,1,0,4,0,4,2099
4,4,1,0,5,0,5,2099
5,5,1,0,6,0,6,2099
6,6,2,0,8,0,8,2099
7,7,4,1,12,1,13,2099
8,8,1,4,13,5,18,2099
9,9,2,2,15,7,22,2099
10,10,5,0,20,7,27,2099
11,11,6,0,26,7,33,2099
12,12,4,2,30,9,39,2099
13,13,3,0,33,9,42,2099
14,14,3,0,36,9,45,2099
15,15,3,1,39,10,49,2099
16,16,1,4,40,14,54,2099
17,17,0,2,40,16,56,2099
18,18,0,2,40,18,58,2099
19,19,1,1,41,19,60,2099
20,20,0,1,41,20,61,2099
21,21,0,0,41,20,61,2099
0,0,1,0,1,0,1,2100
1,1,1,0,2,0,2,2100
2,2,0,1,2,1,3,2100
3,3,0,1,2,2,4,2100
4,4,1,0,3,2,5,2100
5,5,1,0,4,2,6,2100
6,6,2,0,6,2,8,2100
7,7,2,0,8,2,10,2100
8,8,0,1,8,3,11,2100
9,9,0,1,8,4,12,2100
10,10,0,2,8,6,14,2100
11,11,0,2,8,8,16,2100
12,12,0,2,8,10,18,2100
13,13,0,0,8,10,18,2100
0,0,1,0,1,0,1,2101
1,1,1,0,2,0,2,2101
2,2,2,0,4,0,4,2101
3,3,1,1,5,1,6,2101
4,4,0,1,5,2,7,2101
5,5,0,0,5,2,7,2101
0,0,1,0,1,0,1,2102
1,1,1,0,2,0,2,2102
2,2,1,1,3,1,4,2102
3,3,0,0,3,1,4,2102
0,0,1,0,1,0,1,2103
1,1,1,0,2,0,2,2103
2,2,4,0,6,0,6,2103
3,3,8,0,14,0,14,2103
4,4,8,2,22,2,24,2103
5,5,4,5,26,7,33,2103
6,6,9,4,35,11,46,2103
7,7,10,8,45,19,64,2103
8,8,9,11,54,30,84,2103
9,9,8,13,62,43,105,2103
10,10,8,18,70,61,131,2103
11,11,12,16,82,77,159,2103
12,12,16,11,98,88,186,2103
13,13,9,7,107,95,202,2103
14,14,3,9,110,104,214,2103
15,15,4,9,114,113,227,2103
16,16,2,5,116,118,234,2103
17,17,1,4,117,122,239,2103
18,18,4,2,121,124,245,2103
19,19,2,0,123,124,247,2103
20,20,3,0,126,124,250,2103
21,21,4,0,130,124,254,2103
22,22,2,2,132,126,258,2103
23,23,1,4,133,130,263,2103
24,24,1,2,134,132,266,2103
25,25,1,2,135,134,269,2103
26,26,0,0,135,134,269,2103
0,0,1,0,1,0,1,2104
1,1,0,1,1,1,2,2104
2,2,0,1,1,2,3,2104
3,3,0,2,1,4,5,2104
4,4,0,4,1,8,9,2104
5,5,0,4,1,12,13,2104
6,6,2,2,3,14,17,2104
7,7,1,1,4,15,19,2104
8,8,0,2,4,17,21,2104
9,9,1,3,5,20,25,2104
10,10,1,6,6,26,32,2104
11,11,3,4,9,30,39,2104
12,12,5,3,14,33,47,2104
13,13,5,6,19,39,58,2104
14,14,5,3,24,42,66,2104
15,15,1,3,25,45,70,2104
16,16,1,1,26,46,72,2104
17,17,0,2,26,48,74,2104
18,18,0,1,26,49,75,2104
19,19,1,0,27,49,76,2104
20,20,0,0,27,49,76,2104
0,0,1,0,1,0,1,2105
1,1,1,0,2,0,2,2105
2,2,1,0,3,0,3,2105
3,3,1,0,4,0,4,2105
4,4,0,0,4,0,4,2105
0,0,1,0,1,0,1,2106
1,1,4,0,5,0,5,2106
2,2,3,0,8,0,8,2106
3,3,2,0,10,0,10,2106
4,4,1,0,11,0,11,2106
5,5,0,1,11,1,12,2106
6,6,1,0,12,1,13,2106
7,7,1,0,13,1,14,2106
8,8,1,1,14,2,16,2106
9,9,1,1,15,3,18,2106
10,10,0,1,15,4,19,2106
11,11,0,0,15,4,19,2106
0,0,1,0,1,0,1,2107
1,1,0,0,1,0,1,2107
0,0,1,0,1,0,1,2108
1,1,0,0,1,0,1,2108
0,0,1,0,1,0,1,2109
1,1,1,0,2,0,2,2109
2,2,0,0,2,0,2,2109
0,0,1,0,1,0,1,2110
1,1,0,0,1,0,1,2110
0,0,1,0,1,0,1,2111
1,1,1,0,2,0,2,2111
2,2,0,1,2,1,3,2111
3,3,0,1,2,2,4,2111
4,4,0,1,2,3,5,2111
5,5,1,0,3,3,6,2111
6,6,0,0,3,3,6,2111
0,0,1,0,1,0,1,2112
1,1,0,0,1,0,1,2112
0,0,1,0,1,0,1,2113
1,1,0,0,1,0,1,2113
0,0,1,0,1,0,1,2114
1,1,1,1,2,1,3,2114
2,2,1,0,3,1,4,2114
3,3,1,0,4,1,5,2114
4,4,3,0,7,1,8,2114
5,5,0,0,7,1,8,2114
0,0,1,0,1,0,1,2115
1,1,1,1,2,1,3,2115
2,2,0,0,2,1,3,2115
0,0,1,0,1,0,1,2116
1,1,1,1,2,1,3,2116
2,2,3,1,5,2,7,2116
3,3,2,0,7,2,9,2116
4,4,0,0,7,2,9,2116
0,0,1,0,1,0,1,2117
1,1,1,0,2,0,2,2117
2,2,0,0,2,0,2,2117
0,0,1,0,1,0,1,2118
1,1,0,0,1,0,1,2118
0,0,1,0,1,0,1,2119
1,1,1,0,2,0,2,2119
2,2,0,0,2,0,2,2119
0,0,1,0,1,0,1,2120
1,1,0,0,1,0,1,2120
0,0,1,0,1,0,1,2121
1,1,0,0,1,0,1,2121
0,0,1,0,1,0,1,2122
1,1,0,0,1,0,1,2122
0,0,1,0,1,0,1,2123
1,1,1,1,2,1,3,2123
2,2,2,1,4,2,6,2123
3,3,2,3,6,5,11,2123
4,4,1,3,7,8,15,2123
5,5,0,2,7,10,17,2123
6,6,1,3,8,13,21,2123
7,7,2,2,10,15,25,2123
8,8,0,2,10,17,27,2123
9,9,0,0,10,17,27,2123
0,0,1,0,1,0,1,2124
1,1,1,0,2,0,2,2124
2,2,0,0,2,0,2,2124
0,0,1,0,1,0,1,2125
1,1,2,0,3,0,3,2125
2,2,1,0,4,0,4,2125
3,3,1,0,5,0,5,2125
4,4,0,0,5,0,5,2125
0,0,1,0,1,0,1,2126
1,1,0,0,1,0,1,2126
0,0,1,0,1,0,1,2127
1,1,2,0,3,0,3,2127
2,2,1,0,4,0,4,2127
3,3,3,0,7,0,7,2127
4,4,3,2,10,2,12,2127
5,5,6,4,16,6,22,2127
6,6,5,3,21,9,30,2127
7,7,0,3,21,12,33,2127
8,8,0,2,21,14,35,2127
9,9,0,0,21,14,35,2127
0,0,1,0,1,0,1,2128
1,1,0,0,1,0,1,2128
0,0,1,0,1,0,1,2129
1,1,1,1,2,1,3,2129
2,2,2,0,4,1,5,2129
3,3,2,2,6,3,9,2129
4,4,4,4,10,7,17,2129
5,5,4,3,14,10,24,2129
6,6,2,5,16,15,31,2129
7,7,2,3,18,18,36,2129
8,8,3,4,21,22,43,2129
9,9,2,2,23,24,47,2129
10,10,2,3,25,27,52,2129
11,11,0,2,25,29,54,2129
12,12,0,2,25,31,56,2129
13,13,0,2,25,33,58,2129
14,14,0,6,25,39,64,2129
15,15,1,2,26,41,67,2129
16,16,2,1,28,42,70,2129
17,17,1,0,29,42,71,2129
18,18,2,1,31,43,74,2129
19,19,2,3,33,46,79,2129
20,20,1,3,34,49,83,2129
21,21,1,3,35,52,87,2129
22,22,0,2,35,54,89,2129
23,23,0,0,35,54,89,2129
0,0,1,0,1,0,1,2130
1,1,0,0,1,0,1,2130
0,0,1,0,1,0,1,2131
1,1,0,0,1,0,1,2131
0,0,1,0,1,0,1,2132
1,1,1,0,2,0,2,2132
2,2,0,0,2,0,2,2132
0,0,1,0,1,0,1,2133
1,1,1,1,2,1,3,2133
2,2,1,0,3,1,4,2133
3,3,1,0,4,1,5,2133
4,4,0,0,4,1,5,2133
0,0,1,0,1,0,1,2134
1,1,2,0,3,0,3,2134
2,2,1,0,4,0,4,2134
3,3,0,1,4,1,5,2134
4,4,0,1,4,2,6,2134
5,5,1,2,5,4,9,2134
6,6,2,0,7,4,11,2134
7,7,0,0,7,4,11,2134
0,0,1,0,1,0,1,2135
1,1,0,0,1,0,1,2135
0,0,1,0,1,0,1,2136
1,1,0,0,1,0,1,2136
0,0,1,0,1,0,1,2137
1,1,0,0,1,0,1,2137
0,0,1,0,1,0,1,2138
1,1,3,1,4,1,5,2138
2,2,2,1,6,2,8,2138
3,3,4,0,10,2,12,2138
4,4,2,0,12,2,14,2138
5,5,0,0,12,2,14,2138
0,0,1,0,1,0,1,2139
1,1,0,0,1,0,1,2139
0,0,1,0,1,0,1,2140
1,1,0,0,1,0,1,2140
0,0,1,0,1,0,1,2141
1,1,2,0,3,0,3,2141
2,2,4,1,7,1,8,2141
3,3,1,1,8,2,10,2141
4,4,1,3,9,5,14,2141
5,5,1,3,10,8,18,2141
6,6,2,4,12,12,24,2141
7,7,1,2,13,14,27,2141
8,8,0,0,13,14,27,2141
0,0,1,0,1,0,1,2142
1,1,2,0,3,0,3,2142
2,2,0,2,3,2,5,2142
3,3,0,2,3,4,7,2142
4,4,1,1,4,5,9,2142
5,5,2,1,6,6,12,2142
6,6,0,1,6,7,13,2142
7,7,0,1,6,8,14,2142
8,8,0,1,6,9,15,2142
9,9,0,0,6,9,15,2142
0,0,1,0,1,0,1,2143
1,1,1,0,2,0,2,2143
2,2,0,0,2,0,2,2143
0,0,1,0,1,0,1,2144
1,1,2,0,3,0,3,2144
2,2,1,0,4,0,4,2144
3,3,1,0,5,0,5,2144
4,4,1,0,6,0,6,2144
5,5,0,0,6,0,6,2144
0,0,1,0,1,0,1,2145
1,1,1,0,2,0,2,2145
2,2,1,0,3,0,3,2145
3,3,0,0,3,0,3,2145
0,0,1,0,1,0,1,2146
1,1,1,0,2,0,2,2146
2,2,1,0,3,0,3,2146
3,3,0,0,3,0,3,2146
0,0,1,0,1,0,1,2147
1,1,0,1,1,1,2,2147
2,2,1,0,2,1,3,2147
3,3,0,1,2,2,4,2147
4,4,0,0,2,2,4,2147
0,0,1,0,1,0,1,2148
1,1,0,0,1,0,1,2148
0,0,1,0,1,0,1,2149
1,1,0,0,1,0,1,2149
0,0,1,0,1,0,1,2150
1,1,2,0,3,0,3,2150
2,2,3,0,6,0,6,2150
3,3,2,1,8,1,9,2150
4,4,1,0,9,1,10,2150
5,5,1,0,10,1,11,2150
6,6,0,0,10,1,11,2150
0,0,1,0,1,0,1,2151
1,1,1,0,2,0,2,2151
2,2,1,0,3,0,3,2151
3,3,2,0,5,0,5,2151
4,4,2,0,7,0,7,2151
5,5,1,0,8,0,8,2151
6,6,1,0,9,0,9,2151
7,7,3,0,12,0,12,2151
8,8,0,0,12,0,12,2151
0,0,1,0,1,0,1,2152
1,1,0,0,1,0,1,2152
0,0,1,0,1,0,1,2153
1,1,2,0,3,0,3,2153
2,2,0,0,3,0,3,2153
0,0,1,0,1,0,1,2154
1,1,0,0,1,0,1,2154
0,0,1,0,1,0,1,2155
1,1,0,1,1,1,2,2155
2,2,0,1,1,2,3,2155
3,3,0,1,1,3,4,2155
4,4,0,0,1,3,4,2155
0,0,1,0,1,0,1,2156
1,1,1,0,2,0,2,2156
2,2,0,0,2,0,2,2156
0,0,1,0,1,0,1,2157
1,1,1,0,2,0,2,2157
2,2,1,0,3,0,3,2157
3,3,1,0,4,0,4,2157
4,4,1,1,5,1,6,2157
5,5,0,1,5,2,7,2157
6,6,0,1,5,3,8,2157
7,7,0,0,5,3,8,2157
0,0,1,0,1,0,1,2158
1,1,0,0,1,0,1,2158
0,0,1,0,1,0,1,2159
1,1,1,0,2,0,2,2159
2,2,0,0,2,0,2,2159
0,0,1,0,1,0,1,2160
1,1,1,1,2,1,3,2160
2,2,1,1,3,2,5,2160
3,3,1,1,4,3,7,2160
4,4,1,2,5,5,10,2160
5,5,1,0,6,5,11,2160
6,6,0,0,6,5,11,2160
0,0,1,0,1,0,1,2161
1,1,1,2,2,2,4,2161
2,2,1,3,3,5,8,2161
3,3,0,4,3,9,12,2161
4,4,2,2,5,11,16,2161
5,5,2,2,7,13,20,2161
6,6,0,2,7,15,22,2161
7,7,0,3,7,18,25,2161
8,8,2,2,9,20,29,2161
9,9,0,0,9,20,29,2161
0,0,1,0,1,0,1,2162
1,1,0,0,1,0,1,2162
0,0,1,0,1,0,1,2163
1,1,0,0,1,0,1,2163
0,0,1,0,1,0,1,2164
1,1,3,0,4,0,4,2164
2,2,4,1,8,1,9,2164
3,3,5,3,13,4,17,2164
4,4,1,2,14,6,20,2164
5,5,2,0,16,6,22,2164
6,6,1,0,17,6,23,2164
7,7,0,0,17,6,23,2164
0,0,1,0,1,0,1,2165
1,1,0,0,1,0,1,2165
0,0,1,0,1,0,1,2166
1,1,0,0,1,0,1,2166
0,0,1,0,1,0,1,2167
1,1,1,0,2,0,2,2167
2,2,1,0,3,0,3,2167
3,3,0,2,3,2,5,2167
4,4,1,1,4,3,7,2167
5,5,0,0,4,3,7,2167
0,0,1,0,1,0,1,2168
1,1,4,0,5,0,5,2168
2,2,2,0,7,0,7,2168
3,3,2,1,9,1,10,2168
4,4,2,0,11,1,12,2168
5,5,1,1,12,2,14,2168
6,6,0,0,12,2,14,2168
0,0,1,0,1,0,1,2169
1,1,0,0,1,0,1,2169
0,0,1,0,1,0,1,2170
1,1,1,1,2,1,3,2170
2,2,1,0,3,1,4,2170
3,3,1,0,4,1,5,2170
4,4,0,0,4,1,5,2170
0,0,1,0,1,0,1,2171
1,1,0,1,1,1,2,2171
2,2,0,0,1,1,2,2171
0,0,1,0,1,0,1,2172
1,1,0,0,1,0,1,2172
0,0,1,0,1,0,1,2173
1,1,0,0,1,0,1,2173
0,0,1,0,1,0,1,2174
1,1,1,0,2,0,2,2174
2,2,1,0,3,0,3,2174
3,3,1,0,4,0,4,2174
4,4,2,0,6,0,6,2174
5,5,3,0,9,0,9,2174
6,6,0,0,9,0,9,2174
0,0,1,0,1,0,1,2175
1,1,1,0,2,0,2,2175
2,2,1,0,3,0,3,2175
3,3,1,0,4,0,4,2175
4,4,2,0,6,0,6,2175
5,5,4,0,10,0,10,2175
6,6,3,0,13,0,13,2175
7,7,1,2,14,2,16,2175
8,8,1,0,15,2,17,2175
9,9,0,0,15,2,17,2175
0,0,1,0,1,0,1,2176
1,1,0,0,1,0,1,2176
0,0,1,0,1,0,1,2177
1,1,1,0,2,0,2,2177
2,2,2,0,4,0,4,2177
3,3,1,0,5,0,5,2177
4,4,0,0,5,0,5,2177
0,0,1,0,1,0,1,2178
1,1,1,0,2,0,2,2178
2,2,0,0,2,0,2,2178
0,0,1,0,1,0,1,2179
1,1,1,0,2,0,2,2179
2,2,0,1,2,1,3,2179
3,3,0,0,2,1,3,2179
0,0,1,0,1,0,1,2180
1,1,2,0,3,0,3,2180
2,2,1,1,4,1,5,2180
3,3,1,1,5,2,7,2180
4,4,0,0,5,2,7,2180
0,0,1,0,1,0,1,2181
1,1,1,1,2,1,3,2181
2,2,0,0,2,1,3,2181
0,0,1,0,1,0,1,2182
1,1,2,0,3,0,3,2182
2,2,1,1,4,1,5,2182
3,3,1,1,5,2,7,2182
4,4,0,0,5,2,7,2182
0,0,1,0,1,0,1,2183
1,1,2,1,3,1,4,2183
2,2,0,2,3,3,6,2183
3,3,1,0,4,3,7,2183
4,4,2,0,6,3,9,2183
5,5,3,0,9,3,12,2183
6,6,0,1,9,4,13,2183
7,7,1,1,10,5,15,2183
8,8,1,1,11,6,17,2183
9,9,1,1,12,7,19,2183
10,10,0,1,12,8,20,2183
11,11,0,0,12,8,20,2183
0,0,1,0,1,0,1,2184
1,1,0,1,1,1,2,2184
2,2,0,3,1,4,5,2184
3,3,0,2,1,6,7,2184
4,4,0,2,1,8,9,2184
5,5,0,2,1,10,11,2184
6,6,1,1,2,11,13,2184
7,7,0,0,2,11,13,2184
0,0,1,0,1,0,1,2185
1,1,0,1,1,1,2,2185
2,2,0,0,1,1,2,2185
0,0,1,0,1,0,1,2186
1,1,2,1,3,1,4,2186
2,2,0,1,3,2,5,2186
3,3,0,2,3,4,7,2186
4,4,2,0,5,4,9,2186
5,5,1,1,6,5,11,2186
6,6,0,0,6,5,11,2186
0,0,1,0,1,0,1,2187
1,1,1,0,2,0,2,2187
2,2,0,0,2,0,2,2187
0,0,1,0,1,0,1,2188
1,1,0,0,1,0,1,2188
0,0,1,0,1,0,1,2189
1,1,0,0,1,0,1,2189
0,0,1,0,1,0,1,2190
1,1,0,0,1,0,1,2190
0,0,1,0,1,0,1,2191
1,1,2,0,3,0,3,2191
2,2,2,0,5,0,5,2191
3,3,1,0,6,0,6,2191
4,4,1,0,7,0,7,2191
5,5,0,0,7,0,7,2191
0,0,1,0,1,0,1,2192
1,1,2,1,3,1,4,2192
2,2,1,2,4,3,7,2192
3,3,0,1,4,4,8,2192
4,4,1,1,5,5,10,2192
5,5,0,2,5,7,12,2192
6,6,0,0,5,7,12,2192
0,0,1,0,1,0,1,2193
1,1,0,0,1,0,1,2193
0,0,1,0,1,0,1,2194
1,1,1,0,2,0,2,2194
2,2,1,0,3,0,3,2194
3,3,0,0,3,0,3,2194
0,0,1,0,1,0,1,2195
1,1,0,0,1,0,1,2195
0,0,1,0,1,0,1,2196
1,1,1,0,2,0,2,2196
2,2,0,0,2,0,2,2196
0,0,1,0,1,0,1,2197
1,1,0,0,1,0,1,2197
0,0,1,0,1,0,1,2198
1,1,1,0,2,0,2,2198
2,2,1,0,3,0,3,2198
3,3,1,0,4,0,4,2198
4,4,0,0,4,0,4,2198
0,0,1,0,1,0,1,2199
1,1,0,1,1,1,2,2199
2,2,0,1,1,2,3,2199
3,3,0,0,1,2,3,2199
0,0,1,0,1,0,1,2200
1,1,1,0,2,0,2,2200
2,2,1,0,3,0,3,2200
3,3,1,0,4,0,4,2200
4,4,0,0,4,0,4,2200
0,0,1,0,1,0,1,2201
1,1,0,0,1,0,1,2201
0,0,1,0,1,0,1,2202
1,1,0,0,1,0,1,2202
0,0,1,0,1,0,1,2203
1,1,0,0,1,0,1,2203
0,0,1,0,1,0,1,2204
1,1,1,0,2,0,2,2204
2,2,4,0,6,0,6,2204
3,3,6,2,12,2,14,2204
4,4,4,1,16,3,19,2204
5,5,3,1,19,4,23,2204
6,6,4,1,23,5,28,2204
7,7,1,4,24,9,33,2204
8,8,0,2,24,11,35,2204
9,9,2,1,26,12,38,2204
10,10,0,0,26,12,38,2204
0,0,1,0,1,0,1,2205
1,1,0,0,1,0,1,2205
0,0,1,0,1,0,1,2206
1,1,0,0,1,0,1,2206
0,0,1,0,1,0,1,2207
1,1,1,0,2,0,2,2207
2,2,1,0,3,0,3,2207
3,3,2,0,5,0,5,2207
4,4,1,1,6,1,7,2207
5,5,1,0,7,1,8,2207
6,6,2,0,9,1,10,2207
7,7,1,0,10,1,11,2207
8,8,1,1,11,2,13,2207
9,9,2,2,13,4,17,2207
10,10,3,4,16,8,24,2207
11,11,3,2,19,10,29,2207
12,12,6,3,25,13,38,2207
13,13,5,3,30,16,46,2207
14,14,7,2,37,18,55,2207
15,15,10,3,47,21,68,2207
16,16,7,5,54,26,80,2207
17,17,2,3,56,29,85,2207
18,18,3,0,59,29,88,2207
19,19,2,0,61,29,90,2207
20,20,0,0,61,29,90,2207
0,0,1,0,1,0,1,2208
1,1,2,0,3,0,3,2208
2,2,0,0,3,0,3,2208
0,0,1,0,1,0,1,2209
1,1,0,0,1,0,1,2209
0,0,1,0,1,0,1,2210
1,1,1,1,2,1,3,2210
2,2,0,0,2,1,3,2210
0,0,1,0,1,0,1,2211
1,1,1,0,2,0,2,2211
2,2,0,0,2,0,2,2211
0,0,1,0,1,0,1,2212
1,1,1,0,2,0,2,2212
2,2,2,0,4,0,4,2212
3,3,1,0,5,0,5,2212
4,4,2,1,7,1,8,2212
5,5,1,1,8,2,10,2212
6,6,1,1,9,3,12,2212
7,7,0,0,9,3,12,2212
0,0,1,0,1,0,1,2213
1,1,0,0,1,0,1,2213
0,0,1,0,1,0,1,2214
1,1,1,0,2,0,2,2214
2,2,0,1,2,1,3,2214
3,3,0,0,2,1,3,2214
0,0,1,0,1,0,1,2215
1,1,0,0,1,0,1,2215
0,0,1,0,1,0,1,2216
1,1,0,0,1,0,1,2216
0,0,1,0,1,0,1,2217
1,1,1,0,2,0,2,2217
2,2,1,0,3,0,3,2217
3,3,0,0,3,0,3,2217
0,0,1,0,1,0,1,2218
1,1,1,0,2,0,2,2218
2,2,1,0,3,0,3,2218
3,3,1,0,4,0,4,2218
4,4,0,0,4,0,4,2218
0,0,1,0,1,0,1,2219
1,1,0,2,1,2,3,2219
2,2,0,3,1,5,6,2219
3,3,0,2,1,7,8,2219
4,4,0,2,1,9,10,2219
5,5,0,0,1,9,10,2219
0,0,1,0,1,0,1,2220
1,1,0,0,1,0,1,2220
0,0,1,0,1,0,1,2221
1,1,0,0,1,0,1,2221
0,0,1,0,1,0,1,2222
1,1,1,0,2,0,2,2222
2,2,1,0,3,0,3,2222
3,3,1,0,4,0,4,2222
4,4,2,0,6,0,6,2222
5,5,2,0,8,0,8,2222
6,6,3,0,11,0,11,2222
7,7,1,0,12,0,12,2222
8,8,0,2,12,2,14,2222
9,9,1,2,13,4,17,2222
10,10,1,2,14,6,20,2222
11,11,2,2,16,8,24,2222
12,12,0,3,16,11,27,2222
13,13,0,1,16,12,28,2222
14,14,1,0,17,12,29,2222
15,15,1,0,18,12,30,2222
16,16,1,0,19,12,31,2222
17,17,0,0,19,12,31,2222
0,0,1,0,1,0,1,2223
1,1,2,0,3,0,3,2223
2,2,0,0,3,0,3,2223
0,0,1,0,1,0,1,2224
1,1,0,0,1,0,1,2224
0,0,1,0,1,0,1,2225
1,1,1,0,2,0,2,2225
2,2,1,0,3,0,3,2225
3,3,0,0,3,0,3,2225
0,0,1,0,1,0,1,2226
1,1,0,0,1,0,1,2226
0,0,1,0,1,0,1,2227
1,1,0,0,1,0,1,2227
0,0,1,0,1,0,1,2228
1,1,1,1,2,1,3,2228
2,2,0,1,2,2,4,2228
3,3,0,0,2,2,4,2228
0,0,1,0,1,0,1,2229
1,1,2,0,3,0,3,2229
2,2,1,1,4,1,5,2229
3,3,2,2,6,3,9,2229
4,4,0,2,6,5,11,2229
5,5,1,3,7,8,15,2229
6,6,0,2,7,10,17,2229
7,7,2,0,9,10,19,2229
8,8,2,0,11,10,21,2229
9,9,5,0,16,10,26,2229
10,10,6,1,22,11,33,2229
11,11,4,1,26,12,38,2229
12,12,1,2,27,14,41,2229
13,13,1,3,28,17,45,2229
14,14,2,3,30,20,50,2229
15,15,1,2,31,22,53,2229
16,16,2,1,33,23,56,2229
17,17,1,1,34,24,58,2229
18,18,1,1,35,25,60,2229
19,19,0,1,35,26,61,2229
20,20,1,1,36,27,63,2229
21,21,0,1,36,28,64,2229
22,22,0,1,36,29,65,2229
23,23,0,3,36,32,68,2229
24,24,0,2,36,34,70,2229
25,25,0,1,36,35,71,2229
26,26,1,1,37,36,73,2229
27,27,0,0,37,36,73,2229
0,0,1,0,1,0,1,2230
1,1,2,0,3,0,3,2230
2,2,3,0,6,0,6,2230
3,3,2,0,8,0,8,2230
4,4,2,0,10,0,10,2230
5,5,1,0,11,0,11,2230
6,6,1,0,12,0,12,2230
7,7,0,0,12,0,12,2230
0,0,1,0,1,0,1,2231
1,1,2,0,3,0,3,2231
2,2,1,0,4,0,4,2231
3,3,0,1,4,1,5,2231
4,4,1,0,5,1,6,2231
5,5,1,0,6,1,7,2231
6,6,1,0,7,1,8,2231
7,7,1,0,8,1,9,2231
8,8,0,0,8,1,9,2231
0,0,1,0,1,0,1,2232
1,1,0,0,1,0,1,2232
0,0,1,0,1,0,1,2233
1,1,0,0,1,0,1,2233
0,0,1,0,1,0,1,2234
1,1,0,0,1,0,1,2234
0,0,1,0,1,0,1,2235
1,1,1,0,2,0,2,2235
2,2,0,0,2,0,2,2235
0,0,1,0,1,0,1,2236
1,1,1,0,2,0,2,2236
2,2,0,0,2,0,2,2236
0,0,1,0,1,0,1,2237
1,1,0,1,1,1,2,2237
2,2,0,0,1,1,2,2237
0,0,1,0,1,0,1,2238
1,1,3,0,4,0,4,2238
2,2,1,0,5,0,5,2238
3,3,1,0,6,0,6,2238
4,4,1,1,7,1,8,2238
5,5,0,2,7,3,10,2238
6,6,0,4,7,7,14,2238
7,7,1,3,8,10,18,2238
8,8,1,3,9,13,22,2238
9,9,0,2,9,15,24,2238
10,10,0,0,9,15,24,2238
0,0,1,0,1,0,1,2239
1,1,0,1,1,1,2,2239
2,2,0,0,1,1,2,2239
0,0,1,0,1,0,1,2240
1,1,0,0,1,0,1,2240
0,0,1,0,1,0,1,2241
1,1,0,0,1,0,1,2241
0,0,1,0,1,0,1,2242
1,1,3,0,4,0,4,2242
2,2,1,2,5,2,7,2242
3,3,3,3,8,5,13,2242
4,4,1,1,9,6,15,2242
5,5,1,0,10,6,16,2242
6,6,0,0,10,6,16,2242
0,0,1,0,1,0,1,2243
1,1,1,0,2,0,2,2243
2,2,1,0,3,0,3,2243
3,3,0,0,3,0,3,2243
0,0,1,0,1,0,1,2244
1,1,0,0,1,0,1,2244
0,0,1,0,1,0,1,2245
1,1,2,0,3,0,3,2245
2,2,1,0,4,0,4,2245
3,3,2,0,6,0,6,2245
4,4,2,0,8,0,8,2245
5,5,4,0,12,0,12,2245
6,6,4,0,16,0,16,2245
7,7,4,0,20,0,20,2245
8,8,0,1,20,1,21,2245
9,9,0,0,20,1,21,2245
0,0,1,0,1,0,1,2246
1,1,1,0,2,0,2,2246
2,2,1,1,3,1,4,2246
3,3,2,0,5,1,6,2246
4,4,1,1,6,2,8,2246
5,5,4,1,10,3,13,2246
6,6,0,3,10,6,16,2246
7,7,0,2,10,8,18,2246
8,8,1,1,11,9,20,2246
9,9,1,1,12,10,22,2246
10,10,0,2,12,12,24,2246
11,11,1,1,13,13,26,2246
12,12,1,1,14,14,28,2246
13,13,1,0,15,14,29,2246
14,14,0,0,15,14,29,2246
0,0,1,0,1,0,1,2247
1,1,2,0,3,0,3,2247
2,2,4,1,7,1,8,2247
3,3,2,0,9,1,10,2247
4,4,1,1,10,2,12,2247
5,5,1,1,11,3,14,2247
6,6,1,0,12,3,15,2247
7,7,2,1,14,4,18,2247
8,8,0,1,14,5,19,2247
9,9,3,0,17,5,22,2247
10,10,1,0,18,5,23,2247
11,11,2,0,20,5,25,2247
12,12,2,0,22,5,27,2247
13,13,1,0,23,5,28,2247
14,14,1,0,24,5,29,2247
15,15,1,0,25,5,30,2247
16,16,0,1,25,6,31,2247
17,17,0,2,25,8,33,2247
18,18,1,2,26,10,36,2247
19,19,1,2,27,12,39,2247
20,20,0,3,27,15,42,2247
21,21,0,0,27,15,42,2247
0,0,1,0,1,0,1,2248
1,1,2,0,3,0,3,2248
2,2,1,1,4,1,5,2248
3,3,1,0,5,1,6,2248
4,4,0,0,5,1,6,2248
0,0,1,0,1,0,1,2249
1,1,3,0,4,0,4,2249
2,2,1,1,5,1,6,2249
3,3,0,2,5,3,8,2249
4,4,1,2,6,5,11,2249
5,5,2,0,8,5,13,2249
6,6,0,1,8,6,14,2249
7,7,1,0,9,6,15,2249
8,8,0,1,9,7,16,2249
9,9,0,2,9,9,18,2249
10,10,2,1,11,10,21,2249
11,11,3,1,14,11,25,2249
12,12,3,2,17,13,30,2249
13,13,2,0,19,13,32,2249
14,14,1,0,20,13,33,2249
15,15,1,1,21,14,35,2249
16,16,0,1,21,15,36,2249
17,17,0,1,21,16,37,2249
18,18,0,0,21,16,37,2249
0,0,1,0,1,0,1,2250
1,1,0,0,1,0,1,2250
0,0,1,0,1,0,1,2251
1,1,1,0,2,0,2,2251
2,2,0,0,2,0,2,2251
0,0,1,0,1,0,1,2252
1,1,1,0,2,0,2,2252
2,2,1,0,3,0,3,2252
3,3,0,1,3,1,4,2252
4,4,0,1,3,2,5,2252
5,5,0,1,3,3,6,2252
6,6,0,0,3,3,6,2252
0,0,1,0,1,0,1,2253
1,1,0,0,1,0,1,2253
0,0,1,0,1,0,1,2254
1,1,1,1,2,1,3,2254
2,2,2,1,4,2,6,2254
3,3,1,1,5,3,8,2254
4,4,0,1,5,4,9,2254
5,5,0,1,5,5,10,2254
6,6,1,0,6,5,11,2254
7,7,0,0,6,5,11,2254
0,0,1,0,1,0,1,2255
1,1,1,2,2,2,4,2255
2,2,2,0,4,2,6,2255
3,3,0,0,4,2,6,2255
0,0,1,0,1,0,1,2256
1,1,0,1,1,1,2,2256
2,2,0,1,1,2,3,2256
3,3,1,3,2,5,7,2256
4,4,2,4,4,9,13,2256
5,5,1,2,5,11,16,2256
6,6,1,2,6,13,19,2256
7,7,1,1,7,14,21,2256
8,8,1,0,8,14,22,2256
9,9,3,0,11,14,25,2256
10,10,2,1,13,15,28,2256
11,11,1,1,14,16,30,2256
12,12,1,1,15,17,32,2256
13,13,0,0,15,17,32,2256
0,0,1,0,1,0,1,2257
1,1,1,0,2,0,2,2257
2,2,1,0,3,0,3,2257
3,3,0,0,3,0,3,2257
0,0,1,0,1,0,1,2258
1,1,2,0,3,0,3,2258
2,2,1,1,4,1,5,2258
3,3,0,0,4,1,5,2258
0,0,1,0,1,0,1,2259
1,1,2,0,3,0,3,2259
2,2,0,1,3,1,4,2259
3,3,0,1,3,2,5,2259
4,4,0,3,3,5,8,2259
5,5,1,3,4,8,12,2259
6,6,4,3,8,11,19,2259
7,7,5,3,13,14,27,2259
8,8,3,2,16,16,32,2259
9,9,1,3,17,19,36,2259
10,10,3,4,20,23,43,2259
11,11,2,3,22,26,48,2259
12,12,1,1,23,27,50,2259
13,13,3,1,26,28,54,2259
14,14,1,1,27,29,56,2259
15,15,0,0,27,29,56,2259
0,0,1,0,1,0,1,2260
1,1,0,0,1,0,1,2260
0,0,1,0,1,0,1,2261
1,1,4,1,5,1,6,2261
2,2,2,3,7,4,11,2261
3,3,2,2,9,6,15,2261
4,4,3,1,12,7,19,2261
5,5,1,1,13,8,21,2261
6,6,1,0,14,8,22,2261
7,7,0,0,14,8,22,2261
0,0,1,0,1,0,1,2262
1,1,1,0,2,0,2,2262
2,2,0,0,2,0,2,2262
0,0,1,0,1,0,1,2263
1,1,0,0,1,0,1,2263
0,0,1,0,1,0,1,2264
1,1,2,0,3,0,3,2264
2,2,0,0,3,0,3,2264
0,0,1,0,1,0,1,2265
1,1,3,1,4,1,5,2265
2,2,3,0,7,1,8,2265
3,3,2,0,9,1,10,2265
4,4,2,0,11,1,12,2265
5,5,2,0,13,1,14,2265
6,6,2,2,15,3,18,2265
7,7,3,2,18,5,23,2265
8,8,1,2,19,7,26,2265
9,9,1,1,20,8,28,2265
10,10,1,0,21,8,29,2265
11,11,0,0,21,8,29,2265
0,0,1,0,1,0,1,2266
1,1,0,0,1,0,1,2266
0,0,1,0,1,0,1,2267
1,1,0,1,1,1,2,2267
2,2,0,1,1,2,3,2267
3,3,0,0,1,2,3,2267
0,0,1,0,1,0,1,2268
1,1,2,0,3,0,3,2268
2,2,0,0,3,0,3,2268
0,0,1,0,1,0,1,2269
1,1,0,0,1,0,1,2269
0,0,1,0,1,0,1,2270
1,1,1,1,2,1,3,2270
2,2,2,0,4,1,5,2270
3,3,1,0,5,1,6,2270
4,4,0,1,5,2,7,2270
5,5,0,0,5,2,7,2270
0,0,1,0,1,0,1,2271
1,1,0,0,1,0,1,2271
0,0,1,0,1,0,1,2272
1,1,0,0,1,0,1,2272
0,0,1,0,1,0,1,2273
1,1,0,0,1,0,1,2273
0,0,1,0,1,0,1,2274
1,1,1,0,2,0,2,2274
2,2,1,0,3,0,3,2274
3,3,0,0,3,0,3,2274
0,0,1,0,1,0,1,2275
1,1,3,0,4,0,4,2275
2,2,6,0,10,0,10,2275
3,3,2,0,12,0,12,2275
4,4,0,1,12,1,13,2275
5,5,0,0,12,1,13,2275
0,0,1,0,1,0,1,2276
1,1,0,0,1,0,1,2276
0,0,1,0,1,0,1,2277
1,1,1,0,2,0,2,2277
2,2,0,0,2,0,2,2277
0,0,1,0,1,0,1,2278
1,1,1,0,2,0,2,2278
2,2,2,0,4,0,4,2278
3,3,3,0,7,0,7,2278
4,4,3,2,10,2,12,2278
5,5,5,1,15,3,18,2278
6,6,4,3,19,6,25,2278
7,7,6,1,25,7,32,2278
8,8,6,3,31,10,41,2278
9,9,6,2,37,12,49,2278
10,10,10,2,47,14,61,2278
11,11,5,4,52,18,70,2278
12,12,3,4,55,22,77,2278
13,13,4,2,59,24,83,2278
14,14,3,3,62,27,89,2278
15,15,2,1,64,28,92,2278
16,16,2,1,66,29,95,2278
17,17,1,2,67,31,98,2278
18,18,1,1,68,32,100,2278
19,19,2,0,70,32,102,2278
20,20,1,1,71,33,104,2278
21,21,1,0,72,33,105,2278
22,22,0,0,72,33,105,2278
0,0,1,0,1,0,1,2279
1,1,0,0,1,0,1,2279
0,0,1,0,1,0,1,2280
1,1,0,1,1,1,2,2280
2,2,0,1,1,2,3,2280
3,3,0,1,1,3,4,2280
4,4,0,0,1,3,4,2280
0,0,1,0,1,0,1,2281
1,1,0,0,1,0,1,2281
0,0,1,0,1,0,1,2282
1,1,3,1,4,1,5,2282
2,2,2,2,6,3,9,2282
3,3,1,2,7,5,12,2282
4,4,1,1,8,6,14,2282
5,5,1,1,9,7,16,2282
6,6,2,0,11,7,18,2282
7,7,1,0,12,7,19,2282
8,8,1,1,13,8,21,2282
9,9,1,0,14,8,22,2282
10,10,1,0,15,8,23,2282
11,11,3,0,18,8,26,2282
12,12,2,1,20,9,29,2282
13,13,1,2,21,11,32,2282
14,14,1,0,22,11,33,2282
15,15,0,0,22,11,33,2282
0,0,1,0,1,0,1,2283
1,1,2,0,3,0,3,2283
2,2,1,0,4,0,4,2283
3,3,2,0,6,0,6,2283
4,4,0,0,6,0,6,2283
0,0,1,0,1,0,1,2284
1,1,0,1,1,1,2,2284
2,2,0,3,1,4,5,2284
3,3,3,4,4,8,12,2284
4,4,3,2,7,10,17,2284
5,5,3,0,10,10,20,2284
6,6,2,0,12,10,22,2284
7,7,3,1,15,11,26,2284
8,8,2,4,17,15,32,2284
9,9,2,3,19,18,37,2284
10,10,3,2,22,20,42,2284
11,11,4,3,26,23,49,2284
12,12,5,3,31,26,57,2284
13,13,3,3,34,29,63,2284
14,14,3,3,37,32,69,2284
15,15,3,0,40,32,72,2284
16,16,4,0,44,32,76,2284
17,17,3,1,47,33,80,2284
18,18,1,1,48,34,82,2284
19,19,1,1,49,35,84,2284
20,20,1,0,50,35,85,2284
21,21,3,0,53,35,88,2284
22,22,2,1,55,36,91,2284
23,23,2,2,57,38,95,2284
24,24,0,5,57,43,100,2284
25,25,1,2,58,45,103,2284
26,26,1,5,59,50,109,2284
27,27,2,3,61,53,114,2284
28,28,0,3,61,56,117,2284
29,29,1,2,62,58,120,2284
30,30,3,3,65,61,126,2284
31,31,2,2,67,63,130,2284
32,32,0,0,67,63,130,2284
0,0,1,0,1,0,1,2285
1,1,1,0,2,0,2,2285
2,2,0,0,2,0,2,2285
0,0,1,0,1,0,1,2286
1,1,0,0,1,0,1,2286
0,0,1,0,1,0,1,2287
1,1,0,0,1,0,1,2287
0,0,1,0,1,0,1,2288
1,1,0,0,1,0,1,2288
0,0,1,0,1,0,1,2289
1,1,0,0,1,0,1,2289
0,0,1,0,1,0,1,2290
1,1,1,0,2,0,2,2290
2,2,1,1,3,1,4,2290
3,3,0,4,3,5,8,2290
4,4,1,4,4,9,13,2290
5,5,0,3,4,12,16,2290
6,6,0,4,4,16,20,2290
7,7,2,4,6,20,26,2290
8,8,4,2,10,22,32,2290
9,9,3,3,13,25,38,2290
10,10,4,1,17,26,43,2290
11,11,3,1,20,27,47,2290
12,12,6,0,26,27,53,2290
13,13,6,0,32,27,59,2290
14,14,5,0,37,27,64,2290
15,15,2,0,39,27,66,2290
16,16,2,0,41,27,68,2290
17,17,3,0,44,27,71,2290
18,18,4,3,48,30,78,2290
19,19,5,2,53,32,85,2290
20,20,4,6,57,38,95,2290
21,21,3,5,60,43,103,2290
22,22,3,2,63,45,108,2290
23,23,5,2,68,47,115,2290
24,24,1,2,69,49,118,2290
25,25,1,1,70,50,120,2290
26,26,1,0,71,50,121,2290
27,27,1,0,72,50,122,2290
28,28,0,0,72,50,122,2290
0,0,1,0,1,0,1,2291
1,1,1,1,2,1,3,2291
2,2,2,1,4,2,6,2291
3,3,3,2,7,4,11,2291
4,4,2,2,9,6,15,2291
5,5,2,3,11,9,20,2291
6,6,1,2,12,11,23,2291
7,7,2,1,14,12,26,2291
8,8,1,1,15,13,28,2291
9,9,0,2,15,15,30,2291
10,10,0,2,15,17,32,2291
11,11,0,1,15,18,33,2291
12,12,1,2,16,20,36,2291
13,13,0,2,16,22,38,2291
14,14,0,0,16,22,38,2291
0,0,1,0,1,0,1,2292
1,1,0,0,1,0,1,2292
0,0,1,0,1,0,1,2293
1,1,1,0,2,0,2,2293
2,2,1,0,3,0,3,2293
3,3,0,0,3,0,3,2293
0,0,1,0,1,0,1,2294
1,1,2,0,3,0,3,2294
2,2,0,0,3,0,3,2294
0,0,1,0,1,0,1,2295
1,1,1,0,2,0,2,2295
2,2,2,0,4,0,4,2295
3,3,0,0,4,0,4,2295
0,0,1,0,1,0,1,2296
1,1,1,1,2,1,3,2296
2,2,0,0,2,1,3,2296
0,0,1,0,1,0,1,2297
1,1,0,0,1,0,1,2297
0,0,1,0,1,0,1,2298
1,1,0,0,1,0,1,2298
0,0,1,0,1,0,1,2299
1,1,1,0,2,0,2,2299
2,2,1,0,3,0,3,2299
3,3,1,0,4,0,4,2299
4,4,0,0,4,0,4,2299
0,0,1,0,1,0,1,2300
1,1,0,1,1,1,2,2300
2,2,1,1,2,2,4,2300
3,3,2,2,4,4,8,2300
4,4,2,2,6,6,12,2300
5,5,0,3,6,9,15,2300
6,6,0,1,6,10,16,2300
7,7,1,2,7,12,19,2300
8,8,1,2,8,14,22,2300
9,9,1,1,9,15,24,2300
10,10,0,1,9,16,25,2300
11,11,0,0,9,16,25,2300
0,0,1,0,1,0,1,2301
1,1,0,0,1,0,1,2301
0,0,1,0,1,0,1,2302
1,1,2,0,3,0,3,2302
2,2,1,0,4,0,4,2302
3,3,1,0,5,0,5,2302
4,4,2,0,7,0,7,2302
5,5,0,1,7,1,8,2302
6,6,1,0,8,1,9,2302
7,7,2,0,10,1,11,2302
8,8,2,0,12,1,13,2302
9,9,2,1,14,2,16,2302
10,10,0,0,14,2,16,2302
0,0,1,0,1,0,1,2303
1,1,2,1,3,1,4,2303
2,2,2,1,5,2,7,2303
3,3,2,0,7,2,9,2303
4,4,2,0,9,2,11,2303
5,5,3,1,12,3,15,2303
6,6,2,3,14,6,20,2303
7,7,2,1,16,7,23,2303
8,8,1,0,17,7,24,2303
9,9,1,0,18,7,25,2303
10,10,0,1,18,8,26,2303
11,11,1,3,19,11,30,2303
12,12,2,3,21,14,35,2303
13,13,3,6,24,20,44,2303
14,14,3,5,27,25,52,2303
15,15,4,3,31,28,59,2303
16,16,4,4,35,32,67,2303
17,17,1,0,36,32,68,2303
18,18,1,1,37,33,70,2303
19,19,0,1,37,34,71,2303
20,20,1,0,38,34,72,2303
21,21,1,0,39,34,73,2303
22,22,2,0,41,34,75,2303
23,23,3,1,44,35,79,2303
24,24,3,0,47,35,82,2303
25,25,2,2,49,37,86,2303
26,26,2,0,51,37,88,2303
27,27,0,1,51,38,89,2303
28,28,0,2,51,40,91,2303
29,29,0,1,51,41,92,2303
30,30,0,1,51,42,93,2303
31,31,0,0,51,42,93,2303
0,0,1,0,1,0,1,2304
1,1,1,0,2,0,2,2304
2,2,1,0,3,0,3,2304
3,3,0,0,3,0,3,2304
0,0,1,0,1,0,1,2305
1,1,1,2,2,2,4,2305
2,2,0,2,2,4,6,2305
3,3,2,1,4,5,9,2305
4,4,3,3,7,8,15,2305
5,5,1,3,8,11,19,2305
6,6,1,1,9,12,21,2305
7,7,0,4,9,16,25,2305
8,8,1,1,10,17,27,2305
9,9,0,1,10,18,28,2305
10,10,0,1,10,19,29,2305
11,11,0,0,10,19,29,2305
0,0,1,0,1,0,1,2306
1,1,1,2,2,2,4,2306
2,2,2,3,4,5,9,2306
3,3,4,1,8,6,14,2306
4,4,4,1,12,7,19,2306
5,5,2,0,14,7,21,2306
6,6,1,1,15,8,23,2306
7,7,0,2,15,10,25,2306
8,8,1,0,16,10,26,2306
9,9,0,1,16,11,27,2306
10,10,0,1,16,12,28,2306
11,11,0,0,16,12,28,2306
0,0,1,0,1,0,1,2307
1,1,0,0,1,0,1,2307
0,0,1,0,1,0,1,2308
1,1,0,0,1,0,1,2308
0,0,1,0,1,0,1,2309
1,1,0,1,1,1,2,2309
2,2,0,1,1,2,3,2309
3,3,0,0,1,2,3,2309
0,0,1,0,1,0,1,2310
1,1,0,1,1,1,2,2310
2,2,0,0,1,1,2,2310
0,0,1,0,1,0,1,2311
1,1,2,0,3,0,3,2311
2,2,5,1,8,1,9,2311
3,3,5,0,13,1,14,2311
4,4,4,0,17,1,18,2311
5,5,3,1,20,2,22,2311
6,6,1,1,21,3,24,2311
7,7,1,0,22,3,25,2311
8,8,1,0,23,3,26,2311
9,9,1,0,24,3,27,2311
10,10,2,0,26,3,29,2311
11,11,0,0,26,3,29,2311
0,0,1,0,1,0,1,2312
1,1,0,1,1,1,2,2312
2,2,0,1,1,2,3,2312
3,3,0,1,1,3,4,2312
4,4,1,1,2,4,6,2312
5,5,2,3,4,7,11,2312
6,6,1,1,5,8,13,2312
7,7,0,0,5,8,13,2312
0,0,1,0,1,0,1,2313
1,1,0,0,1,0,1,2313
0,0,1,0,1,0,1,2314
1,1,0,0,1,0,1,2314
0,0,1,0,1,0,1,2315
1,1,0,0,1,0,1,2315
0,0,1,0,1,0,1,2316
1,1,0,0,1,0,1,2316
0,0,1,0,1,0,1,2317
1,1,3,1,4,1,5,2317
2,2,3,2,7,3,10,2317
3,3,2,4,9,7,16,2317
4,4,5,7,14,14,28,2317
5,5,7,5,21,19,40,2317
6,6,6,3,27,22,49,2317
7,7,2,0,29,22,51,2317
8,8,2,3,31,25,56,2317
9,9,2,4,33,29,62,2317
10,10,2,2,35,31,66,2317
11,11,1,2,36,33,69,2317
12,12,0,3,36,36,72,2317
13,13,0,2,36,38,74,2317
14,14,1,2,37,40,77,2317
15,15,1,2,38,42,80,2317
16,16,0,1,38,43,81,2317
17,17,0,0,38,43,81,2317
0,0,1,0,1,0,1,2318
1,1,1,0,2,0,2,2318
2,2,1,0,3,0,3,2318
3,3,0,0,3,0,3,2318
0,0,1,0,1,0,1,2319
1,1,0,0,1,0,1,2319
0,0,1,0,1,0,1,2320
1,1,2,0,3,0,3,2320
2,2,2,1,5,1,6,2320
3,3,1,0,6,1,7,2320
4,4,1,0,7,1,8,2320
5,5,1,0,8,1,9,2320
6,6,1,0,9,1,10,2320
7,7,0,0,9,1,10,2320
0,0,1,0,1,0,1,2321
1,1,1,0,2,0,2,2321
2,2,0,1,2,1,3,2321
3,3,0,3,2,4,6,2321
4,4,1,2,3,6,9,2321
5,5,0,2,3,8,11,2321
6,6,2,3,5,11,16,2321
7,7,1,3,6,14,20,2321
8,8,0,2,6,16,22,2321
9,9,0,1,6,17,23,2321
10,10,0,1,6,18,24,2321
11,11,0,1,6,19,25,2321
12,12,2,1,8,20,28,2321
13,13,2,0,10,20,30,2321
14,14,1,1,11,21,32,2321
15,15,0,2,11,23,34,2321
16,16,0,0,11,23,34,2321
0,0,1,0,1,0,1,2322
1,1,1,0,2,0,2,2322
2,2,0,0,2,0,2,2322
0,0,1,0,1,0,1,2323
1,1,1,0,2,0,2,2323
2,2,0,0,2,0,2,2323
0,0,1,0,1,0,1,2324
1,1,0,0,1,0,1,2324
0,0,1,0,1,0,1,2325
1,1,0,0,1,0,1,2325
0,0,1,0,1,0,1,2326
1,1,1,0,2,0,2,2326
2,2,0,0,2,0,2,2326
0,0,1,0,1,0,1,2327
1,1,1,1,2,1,3,2327
2,2,3,1,5,2,7,2327
3,3,1,0,6,2,8,2327
4,4,0,0,6,2,8,2327
0,0,1,0,1,0,1,2328
1,1,1,0,2,0,2,2328
2,2,0,0,2,0,2,2328
0,0,1,0,1,0,1,2329
1,1,0,0,1,0,1,2329
0,0,1,0,1,0,1,2330
1,1,0,2,1,2,3,2330
2,2,0,0,1,2,3,2330
0,0,1,0,1,0,1,2331
1,1,0,0,1,0,1,2331
0,0,1,0,1,0,1,2332
1,1,0,0,1,0,1,2332
0,0,1,0,1,0,1,2333
1,1,0,0,1,0,1,2333
0,0,1,0,1,0,1,2334
1,1,2,0,3,0,3,2334
2,2,0,0,3,0,3,2334
0,0,1,0,1,0,1,2335
1,1,0,0,1,0,1,2335
0,0,1,0,1,0,1,2336
1,1,0,0,1,0,1,2336
0,0,1,0,1,0,1,2337
1,1,0,0,1,0,1,2337
0,0,1,0,1,0,1,2338
1,1,1,0,2,0,2,2338
2,2,1,0,3,0,3,2338
3,3,0,0,3,0,3,2338
0,0,1,0,1,0,1,2339
1,1,0,0,1,0,1,2339
0,0,1,0,1,0,1,2340
1,1,1,0,2,0,2,2340
2,2,1,0,3,0,3,2340
3,3,1,0,4,0,4,2340
4,4,1,0,5,0,5,2340
5,5,0,0,5,0,5,2340
0,0,1,0,1,0,1,2341
1,1,1,0,2,0,2,2341
2,2,1,0,3,0,3,2341
3,3,1,0,4,0,4,2341
4,4,0,0,4,0,4,2341
0,0,1,0,1,0,1,2342
1,1,2,0,3,0,3,2342
2,2,1,0,4,0,4,2342
3,3,2,0,6,0,6,2342
4,4,2,0,8,0,8,2342
5,5,3,0,11,0,11,2342
6,6,2,0,13,0,13,2342
7,7,1,1,14,1,15,2342
8,8,1,2,15,3,18,2342
9,9,2,4,17,7,24,2342
10,10,1,4,18,11,29,2342
11,11,2,4,20,15,35,2342
12,12,1,6,21,21,42,2342
13,13,1,4,22,25,47,2342
14,14,0,5,22,30,52,2342
15,15,0,5,22,35,57,2342
16,16,2,6,24,41,65,2342
17,17,2,3,26,44,70,2342
18,18,1,0,27,44,71,2342
19,19,0,0,27,44,71,2342
0,0,1,0,1,0,1,2343
1,1,1,0,2,0,2,2343
2,2,0,0,2,0,2,2343
0,0,1,0,1,0,1,2344
1,1,0,0,1,0,1,2344
0,0,1,0,1,0,1,2345
1,1,1,1,2,1,3,2345
2,2,3,1,5,2,7,2345
3,3,4,1,9,3,12,2345
4,4,5,1,14,4,18,2345
5,5,7,2,21,6,27,2345
6,6,4,2,25,8,33,2345
7,7,1,2,26,10,36,2345
8,8,1,3,27,13,40,2345
9,9,2,1,29,14,43,2345
10,10,2,0,31,14,45,2345
11,11,0,0,31,14,45,2345
0,0,1,0,1,0,1,2346
1,1,1,0,2,0,2,2346
2,2,1,1,3,1,4,2346
3,3,0,0,3,1,4,2346
0,0,1,0,1,0,1,2347
1,1,0,0,1,0,1,2347
0,0,1,0,1,0,1,2348
1,1,0,0,1,0,1,2348
0,0,1,0,1,0,1,2349
1,1,0,0,1,0,1,2349
0,0,1,0,1,0,1,2350
1,1,2,0,3,0,3,2350
2,2,1,0,4,0,4,2350
3,3,0,0,4,0,4,2350
0,0,1,0,1,0,1,2351
1,1,3,0,4,0,4,2351
2,2,1,0,5,0,5,2351
3,3,1,0,6,0,6,2351
4,4,2,0,8,0,8,2351
5,5,1,0,9,0,9,2351
6,6,1,0,10,0,10,2351
7,7,2,0,12,0,12,2351
8,8,0,0,12,0,12,2351
0,0,1,0,1,0,1,2352
1,1,0,0,1,0,1,2352
0,0,1,0,1,0,1,2353
1,1,0,0,1,0,1,2353
0,0,1,0,1,0,1,2354
1,1,2,2,3,2,5,2354
2,2,2,1,5,3,8,2354
3,3,1,1,6,4,10,2354
4,4,2,0,8,4,12,2354
5,5,0,0,8,4,12,2354
0,0,1,0,1,0,1,2355
1,1,0,0,1,0,1,2355
0,0,1,0,1,0,1,2356
1,1,1,0,2,0,2,2356
2,2,1,0,3,0,3,2356
3,3,0,0,3,0,3,2356
0,0,1,0,1,0,1,2357
1,1,1,0,2,0,2,2357
2,2,0,0,2,0,2,2357
0,0,1,0,1,0,1,2358
1,1,1,0,2,0,2,2358
2,2,0,0,2,0,2,2358
0,0,1,0,1,0,1,2359
1,1,0,0,1,0,1,2359
0,0,1,0,1,0,1,2360
1,1,0,0,1,0,1,2360
0,0,1,0,1,0,1,2361
1,1,2,0,3,0,3,2361
2,2,1,1,4,1,5,2361
3,3,1,0,5,1,6,2361
4,4,0,0,5,1,6,2361
0,0,1,0,1,0,1,2362
1,1,0,2,1,2,3,2362
2,2,1,3,2,5,7,2362
3,3,1,5,3,10,13,2362
4,4,2,2,5,12,17,2362
5,5,2,0,7,12,19,2362
6,6,0,2,7,14,21,2362
7,7,0,1,7,15,22,2362
8,8,0,1,7,16,23,2362
9,9,0,2,7,18,25,2362
10,10,1,0,8,18,26,2362
11,11,1,1,9,19,28,2362
12,12,0,2,9,21,30,2362
13,13,0,1,9,22,31,2362
14,14,0,1,9,23,32,2362
15,15,0,1,9,24,33,2362
16,16,0,1,9,25,34,2362
17,17,0,0,9,25,34,2362
0,0,1,0,1,0,1,2363
1,1,1,0,2,0,2,2363
2,2,2,0,4,0,4,2363
3,3,1,0,5,0,5,2363
4,4,0,1,5,1,6,2363
5,5,0,0,5,1,6,2363
0,0,1,0,1,0,1,2364
1,1,0,0,1,0,1,2364
0,0,1,0,1,0,1,2365
1,1,1,0,2,0,2,2365
2,2,0,1,2,1,3,2365
3,3,0,1,2,2,4,2365
4,4,0,0,2,2,4,2365
0,0,1,0,1,0,1,2366
1,1,0,0,1,0,1,2366
0,0,1,0,1,0,1,2367
1,1,1,0,2,0,2,2367
2,2,0,0,2,0,2,2367
0,0,1,0,1,0,1,2368
1,1,0,0,1,0,1,2368
0,0,1,0,1,0,1,2369
1,1,2,0,3,0,3,2369
2,2,1,1,4,1,5,2369
3,3,0,1,4,2,6,2369
4,4,0,2,4,4,8,2369
5,5,1,0,5,4,9,2369
6,6,2,0,7,4,11,2369
7,7,5,1,12,5,17,2369
8,8,2,3,14,8,22,2369
9,9,3,1,17,9,26,2369
10,10,3,0,20,9,29,2369
11,11,2,0,22,9,31,2369
12,12,2,0,24,9,33,2369
13,13,1,2,25,11,36,2369
14,14,3,0,28,11,39,2369
15,15,2,0,30,11,41,2369
16,16,0,2,30,13,43,2369
17,17,1,1,31,14,45,2369
18,18,0,2,31,16,47,2369
19,19,1,0,32,16,48,2369
20,20,0,0,32,16,48,2369
0,0,1,0,1,0,1,2370
1,1,0,0,1,0,1,2370
0,0,1,0,1,0,1,2371
1,1,2,0,3,0,3,2371
2,2,2,0,5,0,5,2371
3,3,0,0,5,0,5,2371
0,0,1,0,1,0,1,2372
1,1,0,0,1,0,1,2372
0,0,1,0,1,0,1,2373
1,1,1,0,2,0,2,2373
2,2,0,0,2,0,2,2373
0,0,1,0,1,0,1,2374
1,1,0,0,1,0,1,2374
0,0,1,0,1,0,1,2375
1,1,3,0,4,0,4,2375
2,2,0,1,4,1,5,2375
3,3,0,1,4,2,6,2375
4,4,0,2,4,4,8,2375
5,5,0,1,4,5,9,2375
6,6,0,0,4,5,9,2375
0,0,1,0,1,0,1,2376
1,1,2,1,3,1,4,2376
2,2,1,0,4,1,5,2376
3,3,1,0,5,1,6,2376
4,4,2,0,7,1,8,2376
5,5,1,0,8,1,9,2376
6,6,0,0,8,1,9,2376
0,0,1,0,1,0,1,2377
1,1,1,0,2,0,2,2377
2,2,0,0,2,0,2,2377
0,0,1,0,1,0,1,2378
1,1,0,0,1,0,1,2378
0,0,1,0,1,0,1,2379
1,1,0,0,1,0,1,2379
0,0,1,0,1,0,1,2380
1,1,0,0,1,0,1,2380
0,0,1,0,1,0,1,2381
1,1,0,0,1,0,1,2381
0,0,1,0,1,0,1,2382
1,1,3,0,4,0,4,2382
2,2,3,1,7,1,8,2382
3,3,0,1,7,2,9,2382
4,4,0,1,7,3,10,2382
5,5,0,2,7,5,12,2382
6,6,0,2,7,7,14,2382
7,7,1,1,8,8,16,2382
8,8,0,0,8,8,16,2382
0,0,1,0,1,0,1,2383
1,1,3,0,4,0,4,2383
2,2,0,1,4,1,5,2383
3,3,0,0,4,1,5,2383
0,0,1,0,1,0,1,2384
1,1,0,0,1,0,1,2384
0,0,1,0,1,0,1,2385
1,1,2,0,3,0,3,2385
2,2,3,0,6,0,6,2385
3,3,4,0,10,0,10,2385
4,4,4,0,14,0,14,2385
5,5,5,0,19,0,19,2385
6,6,5,2,24,2,26,2385
7,7,4,3,28,5,33,2385
8,8,5,1,33,6,39,2385
9,9,3,2,36,8,44,2385
10,10,2,1,38,9,47,2385
11,11,1,0,39,9,48,2385
12,12,0,0,39,9,48,2385
0,0,1,0,1,0,1,2386
1,1,0,0,1,0,1,2386
0,0,1,0,1,0,1,2387
1,1,0,1,1,1,2,2387
2,2,1,0,2,1,3,2387
3,3,0,1,2,2,4,2387
4,4,0,2,2,4,6,2387
5,5,0,3,2,7,9,2387
6,6,1,4,3,11,14,2387
7,7,2,0,5,11,16,2387
8,8,2,1,7,12,19,2387
9,9,1,5,8,17,25,2387
10,10,2,6,10,23,33,2387
11,11,5,3,15,26,41,2387
12,12,5,4,20,30,50,2387
13,13,1,0,21,30,51,2387
14,14,2,0,23,30,53,2387
15,15,2,1,25,31,56,2387
16,16,3,1,28,32,60,2387
17,17,2,0,30,32,62,2387
18,18,1,1,31,33,64,2387
19,19,0,1,31,34,65,2387
20,20,1,1,32,35,67,2387
21,21,0,1,32,36,68,2387
22,22,0,0,32,36,68,2387
0,0,1,0,1,0,1,2388
1,1,1,1,2,1,3,2388
2,2,3,0,5,1,6,2388
3,3,4,0,9,1,10,2388
4,4,2,0,11,1,12,2388
5,5,2,0,13,1,14,2388
6,6,0,0,13,1,14,2388
0,0,1,0,1,0,1,2389
1,1,2,0,3,0,3,2389
2,2,4,0,7,0,7,2389
3,3,2,1,9,1,10,2389
4,4,1,2,10,3,13,2389
5,5,0,2,10,5,15,2389
6,6,1,4,11,9,20,2389
7,7,3,6,14,15,29,2389
8,8,3,5,17,20,37,2389
9,9,3,4,20,24,44,2389
10,10,1,2,21,26,47,2389
11,11,1,2,22,28,50,2389
12,12,2,1,24,29,53,2389
13,13,0,0,24,29,53,2389
0,0,1,0,1,0,1,2390
1,1,0,0,1,0,1,2390
0,0,1,0,1,0,1,2391
1,1,0,0,1,0,1,2391
0,0,1,0,1,0,1,2392
1,1,1,0,2,0,2,2392
2,2,0,0,2,0,2,2392
0,0,1,0,1,0,1,2393
1,1,0,0,1,0,1,2393
0,0,1,0,1,0,1,2394
1,1,0,1,1,1,2,2394
2,2,0,0,1,1,2,2394
0,0,1,0,1,0,1,2395
1,1,0,0,1,0,1,2395
0,0,1,0,1,0,1,2396
1,1,2,0,3,0,3,2396
2,2,1,0,4,0,4,2396
3,3,0,1,4,1,5,2396
4,4,0,0,4,1,5,2396
0,0,1,0,1,0,1,2397
1,1,1,0,2,0,2,2397
2,2,1,0,3,0,3,2397
3,3,0,0,3,0,3,2397
0,0,1,0,1,0,1,2398
1,1,1,0,2,0,2,2398
2,2,2,0,4,0,4,2398
3,3,1,0,5,0,5,2398
4,4,0,1,5,1,6,2398
5,5,0,0,5,1,6,2398
0,0,1,0,1,0,1,2399
1,1,1,0,2,0,2,2399
2,2,0,0,2,0,2,2399
0,0,1,0,1,0,1,2400
1,1,3,0,4,0,4,2400
2,2,1,0,5,0,5,2400
3,3,0,0,5,0,5,2400
0,0,1,0,1,0,1,2401
1,1,0,0,1,0,1,2401
0,0,1,0,1,0,1,2402
1,1,0,0,1,0,1,2402
0,0,1,0,1,0,1,2403
1,1,0,1,1,1,2,2403
2,2,0,3,1,4,5,2403
3,3,0,2,1,6,7,2403
4,4,0,1,1,7,8,2403
5,5,1,0,2,7,9,2403
6,6,1,0,3,7,10,2403
7,7,2,0,5,7,12,2403
8,8,2,0,7,7,14,2403
9,9,1,0,8,7,15,2403
10,10,1,0,9,7,16,2403
11,11,0,1,9,8,17,2403
12,12,0,2,9,10,19,2403
13,13,0,1,9,11,20,2403
14,14,0,0,9,11,20,2403
0,0,1,0,1,0,1,2404
1,1,0,0,1,0,1,2404
0,0,1,0,1,0,1,2405
1,1,0,0,1,0,1,2405
0,0,1,0,1,0,1,2406
1,1,1,0,2,0,2,2406
2,2,0,0,2,0,2,2406
0,0,1,0,1,0,1,2407
1,1,0,0,1,0,1,2407
0,0,1,0,1,0,1,2408
1,1,0,1,1,1,2,2408
2,2,0,0,1,1,2,2408
0,0,1,0,1,0,1,2409
1,1,1,0,2,0,2,2409
2,2,2,0,4,0,4,2409
3,3,1,1,5,1,6,2409
4,4,2,3,7,4,11,2409
5,5,3,2,10,6,16,2409
6,6,0,3,10,9,19,2409
7,7,0,2,10,11,21,2409
8,8,0,1,10,12,22,2409
9,9,1,1,11,13,24,2409
10,10,1,2,12,15,27,2409
11,11,0,3,12,18,30,2409
12,12,0,5,12,23,35,2409
13,13,2,5,14,28,42,2409
14,14,1,4,15,32,47,2409
15,15,1,4,16,36,52,2409
16,16,2,3,18,39,57,2409
17,17,3,3,21,42,63,2409
18,18,4,4,25,46,71,2409
19,19,3,1,28,47,75,2409
20,20,4,2,32,49,81,2409
21,21,6,2,38,51,89,2409
22,22,5,3,43,54,97,2409
23,23,3,5,46,59,105,2409
24,24,1,4,47,63,110,2409
25,25,0,1,47,64,111,2409
26,26,0,0,47,64,111,2409
0,0,1,0,1,0,1,2410
1,1,1,1,2,1,3,2410
2,2,1,0,3,1,4,2410
3,3,1,0,4,1,5,2410
4,4,1,0,5,1,6,2410
5,5,1,0,6,1,7,2410
6,6,1,1,7,2,9,2410
7,7,0,0,7,2,9,2410
0,0,1,0,1,0,1,2411
1,1,1,0,2,0,2,2411
2,2,1,0,3,0,3,2411
3,3,0,0,3,0,3,2411
0,0,1,0,1,0,1,2412
1,1,0,0,1,0,1,2412
0,0,1,0,1,0,1,2413
1,1,0,0,1,0,1,2413
0,0,1,0,1,0,1,2414
1,1,0,0,1,0,1,2414
0,0,1,0,1,0,1,2415
1,1,3,0,4,0,4,2415
2,2,5,0,9,0,9,2415
3,3,5,0,14,0,14,2415
4,4,8,1,22,1,23,2415
5,5,6,4,28,5,33,2415
6,6,7,2,35,7,42,2415
7,7,6,4,41,11,52,2415
8,8,3,3,44,14,58,2415
9,9,1,5,45,19,64,2415
10,10,0,6,45,25,70,2415
11,11,1,5,46,30,76,2415
12,12,0,3,46,33,79,2415
13,13,0,2,46,35,81,2415
14,14,2,2,48,37,85,2415
15,15,0,3,48,40,88,2415
16,16,0,1,48,41,89,2415
17,17,0,1,48,42,90,2415
18,18,0,2,48,44,92,2415
19,19,0,1,48,45,93,2415
20,20,1,0,49,45,94,2415
21,21,0,0,49,45,94,2415
0,0,1,0,1,0,1,2416
1,1,1,0,2,0,2,2416
2,2,0,1,2,1,3,2416
3,3,0,1,2,2,4,2416
4,4,0,0,2,2,4,2416
0,0,1,0,1,0,1,2417
1,1,1,0,2,0,2,2417
2,2,1,1,3,1,4,2417
3,3,1,3,4,4,8,2417
4,4,1,3,5,7,12,2417
5,5,0,5,5,12,17,2417
6,6,2,6,7,18,25,2417
7,7,1,3,8,21,29,2417
8,8,0,0,8,21,29,2417
0,0,1,0,1,0,1,2418
1,1,0,0,1,0,1,2418
0,0,1,0,1,0,1,2419
1,1,1,0,2,0,2,2419
2,2,2,0,4,0,4,2419
3,3,1,0,5,0,5,2419
4,4,1,0,6,0,6,2419
5,5,2,0,8,0,8,2419
6,6,5,1,13,1,14,2419
7,7,7,2,20,3,23,2419
8,8,4,3,24,6,30,2419
9,9,2,6,26,12,38,2419
10,10,3,5,29,17,46,2419
11,11,10,4,39,21,60,2419
12,12,8,6,47,27,74,2419
13,13,3,6,50,33,83,2419
14,14,5,6,55,39,94,2419
15,15,5,6,60,45,105,2419
16,16,7,6,67,51,118,2419
17,17,5,1,72,52,124,2419
18,18,3,0,75,52,127,2419
19,19,2,0,77,52,129,2419
20,20,0,0,77,52,129,2419
0,0,1,0,1,0,1,2420
1,1,2,0,3,0,3,2420
2,2,2,0,5,0,5,2420
3,3,2,0,7,0,7,2420
4,4,1,0,8,0,8,2420
5,5,1,0,9,0,9,2420
6,6,0,0,9,0,9,2420
0,0,1,0,1,0,1,2421
1,1,0,0,1,0,1,2421
0,0,1,0,1,0,1,2422
1,1,0,0,1,0,1,2422
0,0,1,0,1,0,1,2423
1,1,0,0,1,0,1,2423
0,0,1,0,1,0,1,2424
1,1,0,0,1,0,1,2424
0,0,1,0,1,0,1,2425
1,1,2,0,3,0,3,2425
2,2,1,1,4,1,5,2425
3,3,1,2,5,3,8,2425
4,4,0,1,5,4,9,2425
5,5,0,0,5,4,9,2425
0,0,1,0,1,0,1,2426
1,1,0,0,1,0,1,2426
0,0,1,0,1,0,1,2427
1,1,2,0,3,0,3,2427
2,2,0,0,3,0,3,2427
0,0,1,0,1,0,1,2428
1,1,0,1,1,1,2,2428
2,2,1,2,2,3,5,2428
3,3,1,1,3,4,7,2428
4,4,0,2,3,6,9,2428
5,5,0,2,3,8,11,2428
6,6,0,0,3,8,11,2428
0,0,1,0,1,0,1,2429
1,1,2,0,3,0,3,2429
2,2,0,0,3,0,3,2429
0,0,1,0,1,0,1,2430
1,1,1,0,2,0,2,2430
2,2,0,0,2,0,2,2430
0,0,1,0,1,0,1,2431
1,1,1,0,2,0,2,2431
2,2,3,0,5,0,5,2431
3,3,2,2,7,2,9,2431
4,4,4,3,11,5,16,2431
5,5,5,2,16,7,23,2431
6,6,4,1,20,8,28,2431
7,7,2,3,22,11,33,2431
8,8,1,4,23,15,38,2431
9,9,0,1,23,16,39,2431
10,10,0,1,23,17,40,2431
11,11,0,1,23,18,41,2431
12,12,0,0,23,18,41,2431
0,0,1,0,1,0,1,2432
1,1,0,0,1,0,1,2432
0,0,1,0,1,0,1,2433
1,1,0,0,1,0,1,2433
0,0,1,0,1,0,1,2434
1,1,0,0,1,0,1,2434
0,0,1,0,1,0,1,2435
1,1,0,0,1,0,1,2435
0,0,1,0,1,0,1,2436
1,1,1,0,2,0,2,2436
2,2,0,2,2,2,4,2436
3,3,1,4,3,6,9,2436
4,4,1,2,4,8,12,2436
5,5,1,1,5,9,14,2436
6,6,0,0,5,9,14,2436
0,0,1,0,1,0,1,2437
1,1,1,0,2,0,2,2437
2,2,2,0,4,0,4,2437
3,3,0,0,4,0,4,2437
0,0,1,0,1,0,1,2438
1,1,2,0,3,0,3,2438
2,2,0,2,3,2,5,2438
3,3,1,1,4,3,7,2438
4,4,1,2,5,5,10,2438
5,5,1,3,6,8,14,2438
6,6,0,0,6,8,14,2438
0,0,1,0,1,0,1,2439
1,1,2,0,3,0,3,2439
2,2,1,2,4,2,6,2439
3,3,0,4,4,6,10,2439
4,4,0,5,4,11,15,2439
5,5,1,4,5,15,20,2439
6,6,3,2,8,17,25,2439
7,7,3,6,11,23,34,2439
8,8,3,3,14,26,40,2439
9,9,6,2,20,28,48,2439
10,10,1,2,21,30,51,2439
11,11,1,2,22,32,54,2439
12,12,2,0,24,32,56,2439
13,13,2,1,26,33,59,2439
14,14,4,3,30,36,66,2439
15,15,3,4,33,40,73,2439
16,16,5,1,38,41,79,2439
17,17,6,1,44,42,86,2439
18,18,5,1,49,43,92,2439
19,19,3,0,52,43,95,2439
20,20,3,0,55,43,98,2439
21,21,1,0,56,43,99,2439
22,22,1,0,57,43,100,2439
23,23,1,0,58,43,101,2439
24,24,0,0,58,43,101,2439
0,0,1,0,1,0,1,2440
1,1,0,0,1,0,1,2440
0,0,1,0,1,0,1,2441
1,1,1,0,2,0,2,2441
2,2,0,0,2,0,2,2441
0,0,1,0,1,0,1,2442
1,1,0,1,1,1,2,2442
2,2,1,1,2,2,4,2442
3,3,0,0,2,2,4,2442
0,0,1,0,1,0,1,2443
1,1,0,0,1,0,1,2443
0,0,1,0,1,0,1,2444
1,1,0,1,1,1,2,2444
2,2,0,1,1,2,3,2444
3,3,0,0,1,2,3,2444
0,0,1,0,1,0,1,2445
1,1,2,0,3,0,3,2445
2,2,3,1,6,1,7,2445
3,3,2,2,8,3,11,2445
4,4,1,3,9,6,15,2445
5,5,1,2,10,8,18,2445
6,6,1,4,11,12,23,2445
7,7,1,3,12,15,27,2445
8,8,3,3,15,18,33,2445
9,9,4,0,19,18,37,2445
10,10,0,1,19,19,38,2445
11,11,0,0,19,19,38,2445
0,0,1,0,1,0,1,2446
1,1,2,0,3,0,3,2446
2,2,1,0,4,0,4,2446
3,3,0,0,4,0,4,2446
0,0,1,0,1,0,1,2447
1,1,2,0,3,0,3,2447
2,2,1,0,4,0,4,2447
3,3,1,0,5,0,5,2447
4,4,0,0,5,0,5,2447
0,0,1,0,1,0,1,2448
1,1,0,0,1,0,1,2448
0,0,1,0,1,0,1,2449
1,1,0,0,1,0,1,2449
0,0,1,0,1,0,1,2450
1,1,0,0,1,0,1,2450
0,0,1,0,1,0,1,2451
1,1,0,0,1,0,1,2451
0,0,1,0,1,0,1,2452
1,1,0,0,1,0,1,2452
0,0,1,0,1,0,1,2453
1,1,1,0,2,0,2,2453
2,2,0,0,2,0,2,2453
0,0,1,0,1,0,1,2454
1,1,0,0,1,0,1,2454
0,0,1,0,1,0,1,2455
1,1,1,0,2,0,2,2455
2,2,1,0,3,0,3,2455
3,3,2,0,5,0,5,2455
4,4,4,0,9,0,9,2455
5,5,3,0,12,0,12,2455
6,6,2,2,14,2,16,2455
7,7,1,1,15,3,18,2455
8,8,1,1,16,4,20,2455
9,9,1,1,17,5,22,2455
10,10,0,0,17,5,22,2455
0,0,1,0,1,0,1,2456
1,1,2,0,3,0,3,2456
2,2,2,0,5,0,5,2456
3,3,2,0,7,0,7,2456
4,4,0,0,7,0,7,2456
0,0,1,0,1,0,1,2457
1,1,0,0,1,0,1,2457
0,0,1,0,1,0,1,2458
1,1,0,0,1,0,1,2458
0,0,1,0,1,0,1,2459
1,1,0,0,1,0,1,2459
0,0,1,0,1,0,1,2460
1,1,1,0,2,0,2,2460
2,2,1,0,3,0,3,2460
3,3,0,0,3,0,3,2460
0,0,1,0,1,0,1,2461
1,1,1,0,2,0,2,2461
2,2,1,0,3,0,3,2461
3,3,0,1,3,1,4,2461
4,4,0,0,3,1,4,2461
0,0,1,0,1,0,1,2462
1,1,1,0,2,0,2,2462
2,2,1,0,3,0,3,2462
3,3,1,0,4,0,4,2462
4,4,0,0,4,0,4,2462
0,0,1,0,1,0,1,2463
1,1,1,0,2,0,2,2463
2,2,0,1,2,1,3,2463
3,3,0,1,2,2,4,2463
4,4,0,0,2,2,4,2463
0,0,1,0,1,0,1,2464
1,1,1,0,2,0,2,2464
2,2,0,0,2,0,2,2464
0,0,1,0,1,0,1,2465
1,1,0,0,1,0,1,2465
0,0,1,0,1,0,1,2466
1,1,1,0,2,0,2,2466
2,2,0,0,2,0,2,2466
0,0,1,0,1,0,1,2467
1,1,1,0,2,0,2,2467
2,2,2,0,4,0,4,2467
3,3,1,1,5,1,6,2467
4,4,0,0,5,1,6,2467
0,0,1,0,1,0,1,2468
1,1,1,0,2,0,2,2468
2,2,1,1,3,1,4,2468
3,3,2,0,5,1,6,2468
4,4,0,0,5,1,6,2468
0,0,1,0,1,0,1,2469
1,1,0,0,1,0,1,2469
0,0,1,0,1,0,1,2470
1,1,0,0,1,0,1,2470
0,0,1,0,1,0,1,2471
1,1,0,0,1,0,1,2471
0,0,1,0,1,0,1,2472
1,1,2,0,3,0,3,2472
2,2,1,0,4,0,4,2472
3,3,3,1,7,1,8,2472
4,4,3,0,10,1,11,2472
5,5,0,0,10,1,11,2472
0,0,1,0,1,0,1,2473
1,1,0,0,1,0,1,2473
0,0,1,0,1,0,1,2474
1,1,3,0,4,0,4,2474
2,2,3,1,7,1,8,2474
3,3,1,1,8,2,10,2474
4,4,1,1,9,3,12,2474
5,5,1,2,10,5,15,2474
6,6,1,0,11,5,16,2474
7,7,2,0,13,5,18,2474
8,8,0,2,13,7,20,2474
9,9,1,1,14,8,22,2474
10,10,2,0,16,8,24,2474
11,11,2,0,18,8,26,2474
12,12,1,1,19,9,28,2474
13,13,0,0,19,9,28,2474
0,0,1,0,1,0,1,2475
1,1,1,0,2,0,2,2475
2,2,1,0,3,0,3,2475
3,3,0,0,3,0,3,2475
0,0,1,0,1,0,1,2476
1,1,2,0,3,0,3,2476
2,2,1,0,4,0,4,2476
3,3,0,0,4,0,4,2476
0,0,1,0,1,0,1,2477
1,1,1,0,2,0,2,2477
2,2,0,0,2,0,2,2477
0,0,1,0,1,0,1,2478
1,1,1,0,2,0,2,2478
2,2,1,0,3,0,3,2478
3,3,2,0,5,0,5,2478
4,4,3,0,8,0,8,2478
5,5,2,0,10,0,10,2478
6,6,0,0,10,0,10,2478
0,0,1,0,1,0,1,2479
1,1,2,0,3,0,3,2479
2,2,0,0,3,0,3,2479
0,0,1,0,1,0,1,2480
1,1,0,1,1,1,2,2480
2,2,0,1,1,2,3,2480
3,3,0,0,1,2,3,2480
0,0,1,0,1,0,1,2481
1,1,0,0,1,0,1,2481
0,0,1,0,1,0,1,2482
1,1,0,0,1,0,1,2482
0,0,1,0,1,0,1,2483
1,1,0,0,1,0,1,2483
0,0,1,0,1,0,1,2484
1,1,0,0,1,0,1,2484
0,0,1,0,1,0,1,2485
1,1,0,0,1,0,1,2485
0,0,1,0,1,0,1,2486
1,1,0,2,1,2,3,2486
2,2,1,0,2,2,4,2486
3,3,1,0,3,2,5,2486
4,4,1,1,4,3,7,2486
5,5,0,3,4,6,10,2486
6,6,1,3,5,9,14,2486
7,7,2,3,7,12,19,2486
8,8,2,5,9,17,26,2486
9,9,2,6,11,23,34,2486
10,10,2,5,13,28,41,2486
11,11,3,2,16,30,46,2486
12,12,2,2,18,32,50,2486
13,13,3,2,21,34,55,2486
14,14,3,0,24,34,58,2486
15,15,1,1,25,35,60,2486
16,16,3,2,28,37,65,2486
17,17,0,2,28,39,67,2486
18,18,0,4,28,43,71,2486
19,19,2,5,30,48,78,2486
20,20,1,5,31,53,84,2486
21,21,3,4,34,57,91,2486
22,22,3,2,37,59,96,2486
23,23,2,2,39,61,100,2486
24,24,2,1,41,62,103,2486
25,25,1,1,42,63,105,2486
26,26,0,0,42,63,105,2486
0,0,1,0,1,0,1,2487
1,1,0,0,1,0,1,2487
0,0,1,0,1,0,1,2488
1,1,0,0,1,0,1,2488
0,0,1,0,1,0,1,2489
1,1,0,0,1,0,1,2489
0,0,1,0,1,0,1,2490
1,1,1,1,2,1,3,2490
2,2,2,0,4,1,5,2490
3,3,4,0,8,1,9,2490
4,4,4,1,12,2,14,2490
5,5,3,1,15,3,18,2490
6,6,2,0,17,3,20,2490
7,7,2,0,19,3,22,2490
8,8,0,0,19,3,22,2490
0,0,1,0,1,0,1,2491
1,1,0,0,1,0,1,2491
0,0,1,0,1,0,1,2492
1,1,3,0,4,0,4,2492
2,2,4,0,8,0,8,2492
3,3,3,0,11,0,11,2492
4,4,2,0,13,0,13,2492
5,5,2,1,15,1,16,2492
6,6,3,2,18,3,21,2492
7,7,0,1,18,4,22,2492
8,8,0,0,18,4,22,2492
0,0,1,0,1,0,1,2493
1,1,1,2,2,2,4,2493
2,2,1,6,3,8,11,2493
3,3,1,5,4,13,17,2493
4,4,0,2,4,15,19,2493
5,5,0,3,4,18,22,2493
6,6,0,2,4,20,24,2493
7,7,0,3,4,23,27,2493
8,8,1,1,5,24,29,2493
9,9,1,0,6,24,30,2493
10,10,1,0,7,24,31,2493
11,11,0,0,7,24,31,2493
0,0,1,0,1,0,1,2494
1,1,1,0,2,0,2,2494
2,2,2,0,4,0,4,2494
3,3,1,0,5,0,5,2494
4,4,1,0,6,0,6,2494
5,5,0,0,6,0,6,2494
0,0,1,0,1,0,1,2495
1,1,1,0,2,0,2,2495
2,2,0,0,2,0,2,2495
0,0,1,0,1,0,1,2496
1,1,0,1,1,1,2,2496
2,2,0,0,1,1,2,2496
0,0,1,0,1,0,1,2497
1,1,1,0,2,0,2,2497
2,2,0,0,2,0,2,2497
0,0,1,0,1,0,1,2498
1,1,0,0,1,0,1,2498
0,0,1,0,1,0,1,2499
1,1,1,0,2,0,2,2499
2,2,2,0,4,0,4,2499
3,3,3,0,7,0,7,2499
4,4,2,1,9,1,10,2499
5,5,1,1,10,2,12,2499
6,6,1,1,11,3,14,2499
7,7,0,0,11,3,14,2499
0,0,1,0,1,0,1,2500
1,1,0,0,1,0,1,2500
0,0,1,0,1,0,1,2501
1,1,2,1,3,1,4,2501
2,2,4,3,7,4,11,2501
3,3,4,6,11,10,21,2501
4,4,6,8,17,18,35,2501
5,5,8,2,25,20,45,2501
6,6,4,1,29,21,50,2501
7,7,5,3,34,24,58,2501
8,8,3,3,37,27,64,2501
9,9,2,2,39,29,68,2501
10,10,3,2,42,31,73,2501
11,11,3,3,45,34,79,2501
12,12,2,4,47,38,85,2501
13,13,2,3,49,41,90,2501
14,14,1,1,50,42,92,2501
15,15,1,0,51,42,93,2501
16,16,1,0,52,42,94,2501
17,17,0,0,52,42,94,2501
0,0,1,0,1,0,1,2502
1,1,0,0,1,0,1,2502
0,0,1,0,1,0,1,2503
1,1,1,0,2,0,2,2503
2,2,0,0,2,0,2,2503
0,0,1,0,1,0,1,2504
1,1,0,0,1,0,1,2504
0,0,1,0,1,0,1,2505
1,1,0,0,1,0,1,2505
0,0,1,0,1,0,1,2506
1,1,0,0,1,0,1,2506
0,0,1,0,1,0,1,2507
1,1,2,0,3,0,3,2507
2,2,3,0,6,0,6,2507
3,3,3,1,9,1,10,2507
4,4,3,2,12,3,15,2507
5,5,3,1,15,4,19,2507
6,6,3,1,18,5,23,2507
7,7,2,0,20,5,25,2507
8,8,2,1,22,6,28,2507
9,9,2,0,24,6,30,2507
10,10,3,0,27,6,33,2507
11,11,2,0,29,6,35,2507
12,12,3,0,32,6,38,2507
13,13,6,0,38,6,44,2507
14,14,5,3,43,9,52,2507
15,15,0,2,43,11,54,2507
16,16,0,2,43,13,56,2507
17,17,0,1,43,14,57,2507
18,18,0,1,43,15,58,2507
19,19,0,2,43,17,60,2507
20,20,0,1,43,18,61,2507
21,21,0,3,43,21,64,2507
22,22,0,3,43,24,67,2507
23,23,1,1,44,25,69,2507
24,24,3,1,47,26,73,2507
25,25,3,1,50,27,77,2507
26,26,2,4,52,31,83,2507
27,27,1,1,53,32,85,2507
28,28,1,1,54,33,87,2507
29,29,0,3,54,36,90,2507
30,30,0,2,54,38,92,2507
31,31,0,3,54,41,95,2507
32,32,1,3,55,44,99,2507
33,33,0,0,55,44,99,2507
0,0,1,0,1,0,1,2508
1,1,2,0,3,0,3,2508
2,2,4,0,7,0,7,2508
3,3,1,0,8,0,8,2508
4,4,0,0,8,0,8,2508
0,0,1,0,1,0,1,2509
1,1,1,0,2,0,2,2509
2,2,0,0,2,0,2,2509
0,0,1,0,1,0,1,2510
1,1,1,0,2,0,2,2510
2,2,0,0,2,0,2,2510
0,0,1,0,1,0,1,2511
1,1,0,0,1,0,1,2511
0,0,1,0,1,0,1,2512
1,1,0,1,1,1,2,2512
2,2,0,0,1,1,2,2512
0,0,1,0,1,0,1,2513
1,1,0,0,1,0,1,2513
0,0,1,0,1,0,1,2514
1,1,1,1,2,1,3,2514
2,2,1,1,3,2,5,2514
3,3,1,0,4,2,6,2514
4,4,0,1,4,3,7,2514
5,5,1,0,5,3,8,2514
6,6,0,0,5,3,8,2514
0,0,1,0,1,0,1,2515
1,1,1,0,2,0,2,2515
2,2,0,1,2,1,3,2515
3,3,0,2,2,3,5,2515
4,4,0,3,2,6,8,2515
5,5,1,2,3,8,11,2515
6,6,1,2,4,10,14,2515
7,7,1,2,5,12,17,2515
8,8,0,2,5,14,19,2515
9,9,1,1,6,15,21,2515
10,10,1,3,7,18,25,2515
11,11,0,2,7,20,27,2515
12,12,0,2,7,22,29,2515
13,13,3,4,10,26,36,2515
14,14,4,3,14,29,43,2515
15,15,6,3,20,32,52,2515
16,16,3,4,23,36,59,2515
17,17,6,1,29,37,66,2515
18,18,1,2,30,39,69,2515
19,19,3,1,33,40,73,2515
20,20,1,1,34,41,75,2515
21,21,1,2,35,43,78,2515
22,22,0,0,35,43,78,2515
0,0,1,0,1,0,1,2516
1,1,1,0,2,0,2,2516
2,2,2,0,4,0,4,2516
3,3,2,0,6,0,6,2516
4,4,2,0,8,0,8,2516
5,5,1,0,9,0,9,2516
6,6,0,0,9,0,9,2516
0,0,1,0,1,0,1,2517
1,1,1,1,2,1,3,2517
2,2,1,0,3,1,4,2517
3,3,1,0,4,1,5,2517
4,4,0,0,4,1,5,2517
0,0,1,0,1,0,1,2518
1,1,1,1,2,1,3,2518
2,2,0,0,2,1,3,2518
0,0,1,0,1,0,1,2519
1,1,0,0,1,0,1,2519
0,0,1,0,1,0,1,2520
1,1,2,0,3,0,3,2520
2,2,1,0,4,0,4,2520
3,3,0,0,4,0,4,2520
0,0,1,0,1,0,1,2521
1,1,2,0,3,0,3,2521
2,2,2,1,5,1,6,2521
3,3,1,0,6,1,7,2521
4,4,0,0,6,1,7,2521
0,0,1,0,1,0,1,2522
1,1,1,0,2,0,2,2522
2,2,0,1,2,1,3,2522
3,3,0,0,2,1,3,2522
0,0,1,0,1,0,1,2523
1,1,0,0,1,0,1,2523
0,0,1,0,1,0,1,2524
1,1,1,1,2,1,3,2524
2,2,2,0,4,1,5,2524
3,3,2,0,6,1,7,2524
4,4,0,1,6,2,8,2524
5,5,0,0,6,2,8,2524
0,0,1,0,1,0,1,2525
1,1,1,1,2,1,3,2525
2,2,1,2,3,3,6,2525
3,3,0,1,3,4,7,2525
4,4,0,0,3,4,7,2525
0,0,1,0,1,0,1,2526
1,1,1,0,2,0,2,2526
2,2,2,0,4,0,4,2526
3,3,2,0,6,0,6,2526
4,4,4,0,10,0,10,2526
5,5,3,1,13,1,14,2526
6,6,1,1,14,2,16,2526
7,7,1,2,15,4,19,2526
8,8,2,0,17,4,21,2526
9,9,0,0,17,4,21,2526
0,0,1,0,1,0,1,2527
1,1,1,1,2,1,3,2527
2,2,0,0,2,1,3,2527
0,0,1,0,1,0,1,2528
1,1,1,0,2,0,2,2528
2,2,0,0,2,0,2,2528
0,0,1,0,1,0,1,2529
1,1,0,0,1,0,1,2529
0,0,1,0,1,0,1,2530
1,1,0,1,1,1,2,2530
2,2,0,0,1,1,2,2530
0,0,1,0,1,0,1,2531
1,1,2,0,3,0,3,2531
2,2,1,1,4,1,5,2531
3,3,1,0,5,1,6,2531
4,4,0,0,5,1,6,2531
0,0,1,0,1,0,1,2532
1,1,1,0,2,0,2,2532
2,2,0,0,2,0,2,2532
0,0,1,0,1,0,1,2533
1,1,0,1,1,1,2,2533
2,2,0,1,1,2,3,2533
3,3,0,1,1,3,4,2533
4,4,0,0,1,3,4,2533
0,0,1,0,1,0,1,2534
1,1,0,0,1,0,1,2534
0,0,1,0,1,0,1,2535
1,1,2,1,3,1,4,2535
2,2,3,0,6,1,7,2535
3,3,4,0,10,1,11,2535
4,4,0,0,10,1,11,2535
0,0,1,0,1,0,1,2536
1,1,0,0,1,0,1,2536
0,0,1,0,1,0,1,2537
1,1,0,0,1,0,1,2537
0,0,1,0,1,0,1,2538
1,1,1,0,2,0,2,2538
2,2,0,0,2,0,2,2538
0,0,1,0,1,0,1,2539
1,1,1,0,2,0,2,2539
2,2,0,0,2,0,2,2539
0,0,1,0,1,0,1,2540
1,1,1,2,2,2,4,2540
2,2,2,2,4,4,8,2540
3,3,2,3,6,7,13,2540
4,4,0,3,6,10,16,2540
5,5,0,3,6,13,19,2540
6,6,0,2,6,15,21,2540
7,7,1,2,7,17,24,2540
8,8,0,0,7,17,24,2540
0,0,1,0,1,0,1,2541
1,1,1,0,2,0,2,2541
2,2,2,0,4,0,4,2541
3,3,0,0,4,0,4,2541
0,0,1,0,1,0,1,2542
1,1,0,0,1,0,1,2542
0,0,1,0,1,0,1,2543
1,1,2,0,3,0,3,2543
2,2,3,0,6,0,6,2543
3,3,1,1,7,1,8,2543
4,4,2,2,9,3,12,2543
5,5,0,2,9,5,14,2543
6,6,0,2,9,7,16,2543
7,7,2,2,11,9,20,2543
8,8,0,0,11,9,20,2543
0,0,1,0,1,0,1,2544
1,1,0,0,1,0,1,2544
0,0,1,0,1,0,1,2545
1,1,0,0,1,0,1,2545
0,0,1,0,1,0,1,2546
1,1,1,0,2,0,2,2546
2,2,1,0,3,0,3,2546
3,3,0,0,3,0,3,2546
0,0,1,0,1,0,1,2547
1,1,2,0,3,0,3,2547
2,2,5,0,8,0,8,2547
3,3,3,0,11,0,11,2547
4,4,6,2,17,2,19,2547
5,5,7,2,24,4,28,2547
6,6,8,3,32,7,39,2547
7,7,6,1,38,8,46,2547
8,8,6,1,44,9,53,2547
9,9,3,2,47,11,58,2547
10,10,7,1,54,12,66,2547
11,11,1,4,55,16,71,2547
12,12,0,3,55,19,74,2547
13,13,1,4,56,23,79,2547
14,14,1,2,57,25,82,2547
15,15,0,1,57,26,83,2547
16,16,0,1,57,27,84,2547
17,17,0,0,57,27,84,2547
0,0,1,0,1,0,1,2548
1,1,0,0,1,0,1,2548
0,0,1,0,1,0,1,2549
1,1,0,0,1,0,1,2549
0,0,1,0,1,0,1,2550
1,1,1,0,2,0,2,2550
2,2,2,0,4,0,4,2550
3,3,0,1,4,1,5,2550
4,4,0,1,4,2,6,2550
5,5,0,1,4,3,7,2550
6,6,0,2,4,5,9,2550
7,7,1,2,5,7,12,2550
8,8,2,3,7,10,17,2550
9,9,2,2,9,12,21,2550
10,10,3,5,12,17,29,2550
11,11,4,1,16,18,34,2550
12,12,4,0,20,18,38,2550
13,13,4,1,24,19,43,2550
14,14,3,0,27,19,46,2550
15,15,1,0,28,19,47,2550
16,16,0,0,28,19,47,2550
0,0,1,0,1,0,1,2551
1,1,2,0,3,0,3,2551
2,2,2,0,5,0,5,2551
3,3,0,0,5,0,5,2551
0,0,1,0,1,0,1,2552
1,1,1,0,2,0,2,2552
2,2,0,0,2,0,2,2552
0,0,1,0,1,0,1,2553
1,1,0,1,1,1,2,2553
2,2,0,1,1,2,3,2553
3,3,1,1,2,3,5,2553
4,4,1,0,3,3,6,2553
5,5,0,0,3,3,6,2553
0,0,1,0,1,0,1,2554
1,1,0,1,1,1,2,2554
2,2,0,1,1,2,3,2554
3,3,0,0,1,2,3,2554
0,0,1,0,1,0,1,2555
1,1,0,0,1,0,1,2555
0,0,1,0,1,0,1,2556
1,1,0,1,1,1,2,2556
2,2,0,3,1,4,5,2556
3,3,2,1,3,5,8,2556
4,4,3,4,6,9,15,2556
5,5,1,7,7,16,23,2556
6,6,1,5,8,21,29,2556
7,7,3,6,11,27,38,2556
8,8,3,4,14,31,45,2556
9,9,5,7,19,38,57,2556
10,10,9,7,28,45,73,2556
11,11,6,7,34,52,86,2556
12,12,8,9,42,61,103,2556
13,13,7,7,49,68,117,2556
14,14,8,6,57,74,131,2556
15,15,10,5,67,79,146,2556
16,16,6,8,73,87,160,2556
17,17,4,8,77,95,172,2556
18,18,7,8,84,103,187,2556
19,19,3,8,87,111,198,2556
20,20,7,7,94,118,212,2556
21,21,4,8,98,126,224,2556
22,22,2,3,100,129,229,2556
23,23,5,1,105,130,235,2556
24,24,6,1,111,131,242,2556
25,25,4,1,115,132,247,2556
26,26,2,0,117,132,249,2556
27,27,1,1,118,133,251,2556
28,28,2,0,120,133,253,2556
29,29,2,0,122,133,255,2556
30,30,1,1,123,134,257,2556
31,31,1,1,124,135,259,2556
32,32,1,1,125,136,261,2556
33,33,2,2,127,138,265,2556
34,34,0,3,127,141,268,2556
35,35,0,3,127,144,271,2556
36,36,1,1,128,145,273,2556
37,37,0,1,128,146,274,2556
38,38,0,1,128,147,275,2556
39,39,0,0,128,147,275,2556
0,0,1,0,1,0,1,2557
1,1,2,1,3,1,4,2557
2,2,3,2,6,3,9,2557
3,3,3,4,9,7,16,2557
4,4,9,4,18,11,29,2557
5,5,7,2,25,13,38,2557
6,6,9,0,34,13,47,2557
7,7,8,0,42,13,55,2557
8,8,4,1,46,14,60,2557
9,9,6,2,52,16,68,2557
10,10,0,1,52,17,69,2557
11,11,1,1,53,18,71,2557
12,12,2,0,55,18,73,2557
13,13,0,0,55,18,73,2557
0,0,1,0,1,0,1,2558
1,1,0,0,1,0,1,2558
0,0,1,0,1,0,1,2559
1,1,0,1,1,1,2,2559
2,2,1,2,2,3,5,2559
3,3,2,0,4,3,7,2559
4,4,2,0,6,3,9,2559
5,5,0,1,6,4,10,2559
6,6,0,1,6,5,11,2559
7,7,0,2,6,7,13,2559
8,8,1,1,7,8,15,2559
9,9,0,0,7,8,15,2559
0,0,1,0,1,0,1,2560
1,1,0,0,1,0,1,2560
0,0,1,0,1,0,1,2561
1,1,2,0,3,0,3,2561
2,2,0,1,3,1,4,2561
3,3,0,2,3,3,6,2561
4,4,0,2,3,5,8,2561
5,5,0,0,3,5,8,2561
0,0,1,0,1,0,1,2562
1,1,2,0,3,0,3,2562
2,2,2,0,5,0,5,2562
3,3,2,1,7,1,8,2562
4,4,0,0,7,1,8,2562
0,0,1,0,1,0,1,2563
1,1,2,3,3,3,6,2563
2,2,1,2,4,5,9,2563
3,3,1,2,5,7,12,2563
4,4,1,0,6,7,13,2563
5,5,1,0,7,7,14,2563
6,6,0,0,7,7,14,2563
0,0,1,0,1,0,1,2564
1,1,1,0,2,0,2,2564
2,2,0,0,2,0,2,2564
0,0,1,0,1,0,1,2565
1,1,1,0,2,0,2,2565
2,2,0,0,2,0,2,2565
0,0,1,0,1,0,1,2566
1,1,2,0,3,0,3,2566
2,2,0,0,3,0,3,2566
0,0,1,0,1,0,1,2567
1,1,2,0,3,0,3,2567
2,2,3,1,6,1,7,2567
3,3,1,3,7,4,11,2567
4,4,1,4,8,8,16,2567
5,5,3,2,11,10,21,2567
6,6,3,2,14,12,26,2567
7,7,5,2,19,14,33,2567
8,8,5,2,24,16,40,2567
9,9,5,3,29,19,48,2567
10,10,3,3,32,22,54,2567
11,11,1,5,33,27,60,2567
12,12,0,8,33,35,68,2567
13,13,2,7,35,42,77,2567
14,14,2,4,37,46,83,2567
15,15,5,3,42,49,91,2567
16,16,3,2,45,51,96,2567
17,17,4,1,49,52,101,2567
18,18,1,1,50,53,103,2567
19,19,1,0,51,53,104,2567
20,20,0,0,51,53,104,2567
0,0,1,0,1,0,1,2568
1,1,3,0,4,0,4,2568
2,2,0,1,4,1,5,2568
3,3,1,0,5,1,6,2568
4,4,1,0,6,1,7,2568
5,5,1,0,7,1,8,2568
6,6,1,0,8,1,9,2568
7,7,0,0,8,1,9,2568
0,0,1,0,1,0,1,2569
1,1,1,0,2,0,2,2569
2,2,1,0,3,0,3,2569
3,3,1,0,4,0,4,2569
4,4,0,0,4,0,4,2569
0,0,1,0,1,0,1,2570
1,1,1,0,2,0,2,2570
2,2,1,0,3,0,3,2570
3,3,1,0,4,0,4,2570
4,4,2,0,6,0,6,2570
5,5,1,0,7,0,7,2570
6,6,0,0,7,0,7,2570
0,0,1,0,1,0,1,2571
1,1,3,0,4,0,4,2571
2,2,3,0,7,0,7,2571
3,3,2,1,9,1,10,2571
4,4,2,0,11,1,12,2571
5,5,2,1,13,2,15,2571
6,6,0,3,13,5,18,2571
7,7,0,3,13,8,21,2571
8,8,0,2,13,10,23,2571
9,9,0,3,13,13,26,2571
10,10,2,0,15,13,28,2571
11,11,1,1,16,14,30,2571
12,12,0,0,16,14,30,2571
0,0,1,0,1,0,1,2572
1,1,1,1,2,1,3,2572
2,2,2,0,4,1,5,2572
3,3,1,3,5,4,9,2572
4,4,0,5,5,9,14,2572
5,5,0,1,5,10,15,2572
6,6,0,1,5,11,16,2572
7,7,0,1,5,12,17,2572
8,8,0,1,5,13,18,2572
9,9,0,0,5,13,18,2572
0,0,1,0,1,0,1,2573
1,1,0,1,1,1,2,2573
2,2,0,1,1,2,3,2573
3,3,0,0,1,2,3,2573
0,0,1,0,1,0,1,2574
1,1,0,0,1,0,1,2574
0,0,1,0,1,0,1,2575
1,1,0,0,1,0,1,2575
0,0,1,0,1,0,1,2576
1,1,1,0,2,0,2,2576
2,2,0,0,2,0,2,2576
0,0,1,0,1,0,1,2577
1,1,1,0,2,0,2,2577
2,2,0,0,2,0,2,2577
0,0,1,0,1,0,1,2578
1,1,1,0,2,0,2,2578
2,2,2,0,4,0,4,2578
3,3,1,2,5,2,7,2578
4,4,0,1,5,3,8,2578
5,5,0,0,5,3,8,2578
0,0,1,0,1,0,1,2579
1,1,0,0,1,0,1,2579
0,0,1,0,1,0,1,2580
1,1,0,0,1,0,1,2580
0,0,1,0,1,0,1,2581
1,1,0,0,1,0,1,2581
0,0,1,0,1,0,1,2582
1,1,4,1,5,1,6,2582
2,2,3,3,8,4,12,2582
3,3,4,4,12,8,20,2582
4,4,3,4,15,12,27,2582
5,5,3,2,18,14,32,2582
6,6,2,4,20,18,38,2582
7,7,1,4,21,22,43,2582
8,8,0,1,21,23,44,2582
9,9,0,2,21,25,46,2582
10,10,0,0,21,25,46,2582
0,0,1,0,1,0,1,2583
1,1,0,0,1,0,1,2583
0,0,1,0,1,0,1,2584
1,1,2,1,3,1,4,2584
2,2,2,0,5,1,6,2584
3,3,1,1,6,2,8,2584
4,4,1,0,7,2,9,2584
5,5,0,1,7,3,10,2584
6,6,0,2,7,5,12,2584
7,7,0,1,7,6,13,2584
8,8,0,0,7,6,13,2584
0,0,1,0,1,0,1,2585
1,1,0,0,1,0,1,2585
0,0,1,0,1,0,1,2586
1,1,0,0,1,0,1,2586
0,0,1,0,1,0,1,2587
1,1,0,0,1,0,1,2587
0,0,1,0,1,0,1,2588
1,1,1,0,2,0,2,2588
2,2,1,0,3,0,3,2588
3,3,1,1,4,1,5,2588
4,4,0,2,4,3,7,2588
5,5,1,0,5,3,8,2588
6,6,1,0,6,3,9,2588
7,7,1,0,7,3,10,2588
8,8,1,0,8,3,11,2588
9,9,1,0,9,3,12,2588
10,10,1,1,10,4,14,2588
11,11,0,2,10,6,16,2588
12,12,0,1,10,7,17,2588
13,13,1,1,11,8,19,2588
14,14,1,0,12,8,20,2588
15,15,0,0,12,8,20,2588
0,0,1,0,1,0,1,2589
1,1,0,1,1,1,2,2589
2,2,0,0,1,1,2,2589
0,0,1,0,1,0,1,2590
1,1,0,0,1,0,1,2590
0,0,1,0,1,0,1,2591
1,1,0,0,1,0,1,2591
0,0,1,0,1,0,1,2592
1,1,1,1,2,1,3,2592
2,2,2,0,4,1,5,2592
3,3,1,1,5,2,7,2592
4,4,0,2,5,4,9,2592
5,5,0,0,5,4,9,2592
0,0,1,0,1,0,1,2593
1,1,1,0,2,0,2,2593
2,2,0,0,2,0,2,2593
0,0,1,0,1,0,1,2594
1,1,2,1,3,1,4,2594
2,2,1,0,4,1,5,2594
3,3,0,0,4,1,5,2594
0,0,1,0,1,0,1,2595
1,1,0,0,1,0,1,2595
0,0,1,0,1,0,1,2596
1,1,0,0,1,0,1,2596
0,0,1,0,1,0,1,2597
1,1,2,0,3,0,3,2597
2,2,2,0,5,0,5,2597
3,3,1,0,6,0,6,2597
4,4,1,0,7,0,7,2597
5,5,1,0,8,0,8,2597
6,6,1,0,9,0,9,2597
7,7,1,0,10,0,10,2597
8,8,2,0,12,0,12,2597
9,9,0,0,12,0,12,2597
0,0,1,0,1,0,1,2598
1,1,0,0,1,0,1,2598
0,0,1,0,1,0,1,2599
1,1,0,0,1,0,1,2599
0,0,1,0,1,0,1,2600
1,1,0,0,1,0,1,2600
0,0,1,0,1,0,1,2601
1,1,0,1,1,1,2,2601
2,2,0,1,1,2,3,2601
3,3,0,1,1,3,4,2601
4,4,0,1,1,4,5,2601
5,5,0,0,1,4,5,2601
0,0,1,0,1,0,1,2602
1,1,1,0,2,0,2,2602
2,2,2,1,4,1,5,2602
3,3,1,0,5,1,6,2602
4,4,0,1,5,2,7,2602
5,5,0,1,5,3,8,2602
6,6,0,0,5,3,8,2602
0,0,1,0,1,0,1,2603
1,1,0,1,1,1,2,2603
2,2,1,0,2,1,3,2603
3,3,0,0,2,1,3,2603
0,0,1,0,1,0,1,2604
1,1,2,0,3,0,3,2604
2,2,2,0,5,0,5,2604
3,3,3,0,8,0,8,2604
4,4,2,2,10,2,12,2604
5,5,1,0,11,2,13,2604
6,6,1,0,12,2,14,2604
7,7,1,0,13,2,15,2604
8,8,0,0,13,2,15,2604
0,0,1,0,1,0,1,2605
1,1,1,0,2,0,2,2605
2,2,1,0,3,0,3,2605
3,3,1,1,4,1,5,2605
4,4,2,0,6,1,7,2605
5,5,0,1,6,2,8,2605
6,6,0,0,6,2,8,2605
0,0,1,0,1,0,1,2606
1,1,1,0,2,0,2,2606
2,2,0,0,2,0,2,2606
0,0,1,0,1,0,1,2607
1,1,0,0,1,0,1,2607
0,0,1,0,1,0,1,2608
1,1,1,0,2,0,2,2608
2,2,1,1,3,1,4,2608
3,3,2,1,5,2,7,2608
4,4,2,0,7,2,9,2608
5,5,3,0,10,2,12,2608
6,6,3,0,13,2,15,2608
7,7,2,2,15,4,19,2608
8,8,3,0,18,4,22,2608
9,9,4,0,22,4,26,2608
10,10,0,2,22,6,28,2608
11,11,0,2,22,8,30,2608
12,12,0,2,22,10,32,2608
13,13,0,1,22,11,33,2608
14,14,0,1,22,12,34,2608
15,15,0,0,22,12,34,2608
0,0,1,0,1,0,1,2609
1,1,0,1,1,1,2,2609
2,2,0,1,1,2,3,2609
3,3,0,0,1,2,3,2609
0,0,1,0,1,0,1,2610
1,1,1,0,2,0,2,2610
2,2,0,0,2,0,2,2610
0,0,1,0,1,0,1,2611
1,1,1,3,2,3,5,2611
2,2,1,1,3,4,7,2611
3,3,1,2,4,6,10,2611
4,4,3,1,7,7,14,2611
5,5,2,3,9,10,19,2611
6,6,1,0,10,10,20,2611
7,7,0,0,10,10,20,2611
0,0,1,0,1,0,1,2612
1,1,0,0,1,0,1,2612
0,0,1,0,1,0,1,2613
1,1,1,0,2,0,2,2613
2,2,2,1,4,1,5,2613
3,3,0,1,4,2,6,2613
4,4,0,0,4,2,6,2613
0,0,1,0,1,0,1,2614
1,1,2,0,3,0,3,2614
2,2,3,0,6,0,6,2614
3,3,2,0,8,0,8,2614
4,4,0,0,8,0,8,2614
0,0,1,0,1,0,1,2615
1,1,0,0,1,0,1,2615
0,0,1,0,1,0,1,2616
1,1,0,0,1,0,1,2616
0,0,1,0,1,0,1,2617
1,1,0,0,1,0,1,2617
0,0,1,0,1,0,1,2618
1,1,1,1,2,1,3,2618
2,2,1,4,3,5,8,2618
3,3,2,1,5,6,11,2618
4,4,0,1,5,7,12,2618
5,5,0,0,5,7,12,2618
0,0,1,0,1,0,1,2619
1,1,0,0,1,0,1,2619
0,0,1,0,1,0,1,2620
1,1,0,0,1,0,1,2620
0,0,1,0,1,0,1,2621
1,1,0,0,1,0,1,2621
0,0,1,0,1,0,1,2622
1,1,0,1,1,1,2,2622
2,2,0,0,1,1,2,2622
0,0,1,0,1,0,1,2623
1,1,1,0,2,0,2,2623
2,2,1,0,3,0,3,2623
3,3,0,0,3,0,3,2623
0,0,1,0,1,0,1,2624
1,1,0,0,1,0,1,2624
0,0,1,0,1,0,1,2625
1,1,0,1,1,1,2,2625
2,2,0,0,1,1,2,2625
0,0,1,0,1,0,1,2626
1,1,1,1,2,1,3,2626
2,2,0,0,2,1,3,2626
0,0,1,0,1,0,1,2627
1,1,0,0,1,0,1,2627
0,0,1,0,1,0,1,2628
1,1,1,0,2,0,2,2628
2,2,0,0,2,0,2,2628
0,0,1,0,1,0,1,2629
1,1,0,0,1,0,1,2629
0,0,1,0,1,0,1,2630
1,1,0,0,1,0,1,2630
0,0,1,0,1,0,1,2631
1,1,1,1,2,1,3,2631
2,2,2,0,4,1,5,2631
3,3,1,0,5,1,6,2631
4,4,0,1,5,2,7,2631
5,5,0,1,5,3,8,2631
6,6,0,0,5,3,8,2631
0,0,1,0,1,0,1,2632
1,1,0,0,1,0,1,2632
0,0,1,0,1,0,1,2633
1,1,0,0,1,0,1,2633
0,0,1,0,1,0,1,2634
1,1,2,0,3,0,3,2634
2,2,1,0,4,0,4,2634
3,3,2,0,6,0,6,2634
4,4,2,0,8,0,8,2634
5,5,2,0,10,0,10,2634
6,6,0,0,10,0,10,2634
0,0,1,0,1,0,1,2635
1,1,1,0,2,0,2,2635
2,2,1,0,3,0,3,2635
3,3,0,0,3,0,3,2635
0,0,1,0,1,0,1,2636
1,1,0,0,1,0,1,2636
0,0,1,0,1,0,1,2637
1,1,2,0,3,0,3,2637
2,2,2,0,5,0,5,2637
3,3,4,1,9,1,10,2637
4,4,3,2,12,3,15,2637
5,5,1,4,13,7,20,2637
6,6,2,2,15,9,24,2637
7,7,2,2,17,11,28,2637
8,8,0,0,17,11,28,2637
0,0,1,0,1,0,1,2638
1,1,1,0,2,0,2,2638
2,2,0,0,2,0,2,2638
0,0,1,0,1,0,1,2639
1,1,1,0,2,0,2,2639
2,2,0,0,2,0,2,2639
0,0,1,0,1,0,1,2640
1,1,2,0,3,0,3,2640
2,2,2,0,5,0,5,2640
3,3,2,0,7,0,7,2640
4,4,2,1,9,1,10,2640
5,5,2,1,11,2,13,2640
6,6,1,0,12,2,14,2640
7,7,1,0,13,2,15,2640
8,8,1,0,14,2,16,2640
9,9,2,0,16,2,18,2640
10,10,1,0,17,2,19,2640
11,11,0,0,17,2,19,2640
0,0,1,0,1,0,1,2641
1,1,0,0,1,0,1,2641
0,0,1,0,1,0,1,2642
1,1,0,1,1,1,2,2642
2,2,0,1,1,2,3,2642
3,3,0,2,1,4,5,2642
4,4,0,1,1,5,6,2642
5,5,2,2,3,7,10,2642
6,6,1,2,4,9,13,2642
7,7,2,3,6,12,18,2642
8,8,2,4,8,16,24,2642
9,9,7,2,15,18,33,2642
10,10,4,4,19,22,41,2642
11,11,1,4,20,26,46,2642
12,12,0,0,20,26,46,2642
0,0,1,0,1,0,1,2643
1,1,0,0,1,0,1,2643
0,0,1,0,1,0,1,2644
1,1,0,0,1,0,1,2644
0,0,1,0,1,0,1,2645
1,1,4,0,5,0,5,2645
2,2,3,2,8,2,10,2645
3,3,3,2,11,4,15,2645
4,4,2,2,13,6,19,2645
5,5,3,1,16,7,23,2645
6,6,0,1,16,8,24,2645
7,7,0,0,16,8,24,2645
0,0,1,0,1,0,1,2646
1,1,1,0,2,0,2,2646
2,2,3,1,5,1,6,2646
3,3,1,3,6,4,10,2646
4,4,0,2,6,6,12,2646
5,5,0,0,6,6,12,2646
0,0,1,0,1,0,1,2647
1,1,0,0,1,0,1,2647
0,0,1,0,1,0,1,2648
1,1,2,0,3,0,3,2648
2,2,1,0,4,0,4,2648
3,3,1,0,5,0,5,2648
4,4,1,0,6,0,6,2648
5,5,1,0,7,0,7,2648
6,6,2,0,9,0,9,2648
7,7,3,1,12,1,13,2648
8,8,1,2,13,3,16,2648
9,9,1,0,14,3,17,2648
10,10,0,0,14,3,17,2648
0,0,1,0,1,0,1,2649
1,1,0,0,1,0,1,2649
0,0,1,0,1,0,1,2650
1,1,0,0,1,0,1,2650
0,0,1,0,1,0,1,2651
1,1,0,0,1,0,1,2651
0,0,1,0,1,0,1,2652
1,1,0,0,1,0,1,2652
0,0,1,0,1,0,1,2653
1,1,0,0,1,0,1,2653
0,0,1,0,1,0,1,2654
1,1,1,0,2,0,2,2654
2,2,1,0,3,0,3,2654
3,3,1,0,4,0,4,2654
4,4,0,0,4,0,4,2654
0,0,1,0,1,0,1,2655
1,1,0,0,1,0,1,2655
0,0,1,0,1,0,1,2656
1,1,0,0,1,0,1,2656
0,0,1,0,1,0,1,2657
1,1,0,0,1,0,1,2657
0,0,1,0,1,0,1,2658
1,1,0,0,1,0,1,2658
0,0,1,0,1,0,1,2659
1,1,3,0,4,0,4,2659
2,2,2,0,6,0,6,2659
3,3,2,1,8,1,9,2659
4,4,1,4,9,5,14,2659
5,5,3,5,12,10,22,2659
6,6,1,4,13,14,27,2659
7,7,1,5,14,19,33,2659
8,8,1,5,15,24,39,2659
9,9,1,3,16,27,43,2659
10,10,0,2,16,29,45,2659
11,11,0,1,16,30,46,2659
12,12,0,0,16,30,46,2659
0,0,1,0,1,0,1,2660
1,1,2,0,3,0,3,2660
2,2,2,0,5,0,5,2660
3,3,3,1,8,1,9,2660
4,4,3,0,11,1,12,2660
5,5,4,1,15,2,17,2660
6,6,4,0,19,2,21,2660
7,7,5,0,24,2,26,2660
8,8,1,2,25,4,29,2660
9,9,0,2,25,6,31,2660
10,10,1,1,26,7,33,2660
11,11,0,1,26,8,34,2660
12,12,1,2,27,10,37,2660
13,13,1,3,28,13,41,2660
14,14,1,4,29,17,46,2660
15,15,2,1,31,18,49,2660
16,16,1,0,32,18,50,2660
17,17,1,0,33,18,51,2660
18,18,2,0,35,18,53,2660
19,19,1,1,36,19,55,2660
20,20,0,0,36,19,55,2660
0,0,1,0,1,0,1,2661
1,1,1,0,2,0,2,2661
2,2,1,0,3,0,3,2661
3,3,0,0,3,0,3,2661
0,0,1,0,1,0,1,2662
1,1,0,0,1,0,1,2662
0,0,1,0,1,0,1,2663
1,1,0,1,1,1,2,2663
2,2,0,2,1,3,4,2663
3,3,0,1,1,4,5,2663
4,4,0,1,1,5,6,2663
5,5,0,0,1,5,6,2663
0,0,1,0,1,0,1,2664
1,1,1,0,2,0,2,2664
2,2,1,0,3,0,3,2664
3,3,0,1,3,1,4,2664
4,4,0,0,3,1,4,2664
0,0,1,0,1,0,1,2665
1,1,0,1,1,1,2,2665
2,2,0,1,1,2,3,2665
3,3,0,1,1,3,4,2665
4,4,0,0,1,3,4,2665
0,0,1,0,1,0,1,2666
1,1,0,0,1,0,1,2666
0,0,1,0,1,0,1,2667
1,1,1,0,2,0,2,2667
2,2,1,0,3,0,3,2667
3,3,0,0,3,0,3,2667
0,0,1,0,1,0,1,2668
1,1,1,0,2,0,2,2668
2,2,1,0,3,0,3,2668
3,3,2,0,5,0,5,2668
4,4,3,0,8,0,8,2668
5,5,4,1,12,1,13,2668
6,6,4,2,16,3,19,2668
7,7,4,2,20,5,25,2668
8,8,5,1,25,6,31,2668
9,9,3,3,28,9,37,2668
10,10,1,3,29,12,41,2668
11,11,1,7,30,19,49,2668
12,12,2,4,32,23,55,2668
13,13,0,5,32,28,60,2668
14,14,1,4,33,32,65,2668
15,15,2,5,35,37,72,2668
16,16,4,7,39,44,83,2668
17,17,5,7,44,51,95,2668
18,18,5,3,49,54,103,2668
19,19,6,2,55,56,111,2668
20,20,6,5,61,61,122,2668
21,21,6,4,67,65,132,2668
22,22,7,2,74,67,141,2668
23,23,7,3,81,70,151,2668
24,24,6,4,87,74,161,2668
25,25,7,3,94,77,171,2668
26,26,3,3,97,80,177,2668
27,27,5,3,102,83,185,2668
28,28,4,3,106,86,192,2668
29,29,4,4,110,90,200,2668
30,30,3,4,113,94,207,2668
31,31,4,0,117,94,211,2668
32,32,4,1,121,95,216,2668
33,33,2,1,123,96,219,2668
34,34,3,2,126,98,224,2668
35,35,0,4,126,102,228,2668
36,36,2,1,128,103,231,2668
37,37,0,1,128,104,232,2668
38,38,0,1,128,105,233,2668
39,39,0,0,128,105,233,2668
0,0,1,0,1,0,1,2669
1,1,2,0,3,0,3,2669
2,2,4,1,7,1,8,2669
3,3,4,0,11,1,12,2669
4,4,4,0,15,1,16,2669
5,5,3,0,18,1,19,2669
6,6,3,1,21,2,23,2669
7,7,1,0,22,2,24,2669
8,8,1,0,23,2,25,2669
9,9,2,0,25,2,27,2669
10,10,1,0,26,2,28,2669
11,11,1,0,27,2,29,2669
12,12,1,0,28,2,30,2669
13,13,0,0,28,2,30,2669
0,0,1,0,1,0,1,2670
1,1,2,0,3,0,3,2670
2,2,0,1,3,1,4,2670
3,3,0,2,3,3,6,2670
4,4,1,1,4,4,8,2670
5,5,1,0,5,4,9,2670
6,6,1,0,6,4,10,2670
7,7,0,0,6,4,10,2670
0,0,1,0,1,0,1,2671
1,1,1,0,2,0,2,2671
2,2,2,1,4,1,5,2671
3,3,3,0,7,1,8,2671
4,4,2,0,9,1,10,2671
5,5,0,1,9,2,11,2671
6,6,0,2,9,4,13,2671
7,7,0,1,9,5,14,2671
8,8,2,1,11,6,17,2671
9,9,0,1,11,7,18,2671
10,10,0,2,11,9,20,2671
11,11,0,2,11,11,22,2671
12,12,1,3,12,14,26,2671
13,13,1,1,13,15,28,2671
14,14,0,2,13,17,30,2671
15,15,0,2,13,19,32,2671
16,16,0,1,13,20,33,2671
17,17,0,1,13,21,34,2671
18,18,0,0,13,21,34,2671
0,0,1,0,1,0,1,2672
1,1,2,0,3,0,3,2672
2,2,1,1,4,1,5,2672
3,3,0,2,4,3,7,2672
4,4,2,2,6,5,11,2672
5,5,1,2,7,7,14,2672
6,6,0,2,7,9,16,2672
7,7,1,3,8,12,20,2672
8,8,2,5,10,17,27,2672
9,9,3,5,13,22,35,2672
10,10,2,5,15,27,42,2672
11,11,2,6,17,33,50,2672
12,12,2,4,19,37,56,2672
13,13,5,2,24,39,63,2672
14,14,4,3,28,42,70,2672
15,15,7,4,35,46,81,2672
16,16,8,3,43,49,92,2672
17,17,9,6,52,55,107,2672
18,18,7,9,59,64,123,2672
19,19,12,8,71,72,143,2672
20,20,8,7,79,79,158,2672
21,21,10,5,89,84,173,2672
22,22,6,3,95,87,182,2672
23,23,6,7,101,94,195,2672
24,24,3,7,104,101,205,2672
25,25,4,8,108,109,217,2672
26,26,5,4,113,113,226,2672
27,27,3,1,116,114,230,2672
28,28,0,1,116,115,231,2672
29,29,0,1,116,116,232,2672
30,30,0,2,116,118,234,2672
31,31,0,1,116,119,235,2672
32,32,0,2,116,121,237,2672
33,33,0,2,116,123,239,2672
34,34,1,0,117,123,240,2672
35,35,4,1,121,124,245,2672
36,36,2,2,123,126,249,2672
37,37,3,2,126,128,254,2672
38,38,3,2,129,130,259,2672
39,39,2,1,131,131,262,2672
40,40,3,2,134,133,267,2672
41,41,3,3,137,136,273,2672
42,42,0,1,137,137,274,2672
43,43,0,0,137,137,274,2672
0,0,1,0,1,0,1,2673
1,1,0,0,1,0,1,2673
0,0,1,0,1,0,1,2674
1,1,2,0,3,0,3,2674
2,2,1,0,4,0,4,2674
3,3,0,0,4,0,4,2674
0,0,1,0,1,0,1,2675
1,1,1,0,2,0,2,2675
2,2,0,0,2,0,2,2675
0,0,1,0,1,0,1,2676
1,1,3,0,4,0,4,2676
2,2,3,0,7,0,7,2676
3,3,2,1,9,1,10,2676
4,4,7,2,16,3,19,2676
5,5,2,3,18,6,24,2676
6,6,0,3,18,9,27,2676
7,7,1,1,19,10,29,2676
8,8,2,1,21,11,32,2676
9,9,4,1,25,12,37,2676
10,10,4,2,29,14,43,2676
11,11,4,2,33,16,49,2676
12,12,6,2,39,18,57,2676
13,13,2,1,41,19,60,2676
14,14,1,0,42,19,61,2676
15,15,0,0,42,19,61,2676
0,0,1,0,1,0,1,2677
1,1,0,0,1,0,1,2677
0,0,1,0,1,0,1,2678
1,1,0,0,1,0,1,2678
0,0,1,0,1,0,1,2679
1,1,1,0,2,0,2,2679
2,2,1,0,3,0,3,2679
3,3,0,0,3,0,3,2679
0,0,1,0,1,0,1,2680
1,1,0,0,1,0,1,2680
0,0,1,0,1,0,1,2681
1,1,1,0,2,0,2,2681
2,2,2,0,4,0,4,2681
3,3,1,0,5,0,5,2681
4,4,0,0,5,0,5,2681
0,0,1,0,1,0,1,2682
1,1,0,0,1,0,1,2682
0,0,1,0,1,0,1,2683
1,1,2,0,3,0,3,2683
2,2,2,1,5,1,6,2683
3,3,4,0,9,1,10,2683
4,4,3,0,12,1,13,2683
5,5,5,0,17,1,18,2683
6,6,6,0,23,1,24,2683
7,7,1,4,24,5,29,2683
8,8,0,2,24,7,31,2683
9,9,0,1,24,8,32,2683
10,10,0,0,24,8,32,2683
0,0,1,0,1,0,1,2684
1,1,0,0,1,0,1,2684
0,0,1,0,1,0,1,2685
1,1,1,0,2,0,2,2685
2,2,0,0,2,0,2,2685
0,0,1,0,1,0,1,2686
1,1,3,0,4,0,4,2686
2,2,3,0,7,0,7,2686
3,3,0,1,7,1,8,2686
4,4,0,0,7,1,8,2686
0,0,1,0,1,0,1,2687
1,1,0,0,1,0,1,2687
0,0,1,0,1,0,1,2688
1,1,0,0,1,0,1,2688
0,0,1,0,1,0,1,2689
1,1,1,0,2,0,2,2689
2,2,0,0,2,0,2,2689
0,0,1,0,1,0,1,2690
1,1,0,0,1,0,1,2690
0,0,1,0,1,0,1,2691
1,1,0,0,1,0,1,2691
0,0,1,0,1,0,1,2692
1,1,2,0,3,0,3,2692
2,2,0,2,3,2,5,2692
3,3,1,1,4,3,7,2692
4,4,1,0,5,3,8,2692
5,5,0,0,5,3,8,2692
0,0,1,0,1,0,1,2693
1,1,0,1,1,1,2,2693
2,2,0,0,1,1,2,2693
0,0,1,0,1,0,1,2694
1,1,0,0,1,0,1,2694
0,0,1,0,1,0,1,2695
1,1,3,0,4,0,4,2695
2,2,4,0,8,0,8,2695
3,3,2,0,10,0,10,2695
4,4,1,0,11,0,11,2695
5,5,1,0,12,0,12,2695
6,6,0,0,12,0,12,2695
0,0,1,0,1,0,1,2696
1,1,1,0,2,0,2,2696
2,2,1,0,3,0,3,2696
3,3,0,1,3,1,4,2696
4,4,0,0,3,1,4,2696
0,0,1,0,1,0,1,2697
1,1,1,1,2,1,3,2697
2,2,0,2,2,3,5,2697
3,3,1,0,3,3,6,2697
4,4,1,0,4,3,7,2697
5,5,1,0,5,3,8,2697
6,6,1,0,6,3,9,2697
7,7,1,0,7,3,10,2697
8,8,0,0,7,3,10,2697
0,0,1,0,1,0,1,2698
1,1,0,0,1,0,1,2698
0,0,1,0,1,0,1,2699
1,1,1,0,2,0,2,2699
2,2,0,0,2,0,2,2699
0,0,1,0,1,0,1,2700
1,1,1,0,2,0,2,2700
2,2,0,1,2,1,3,2700
3,3,0,2,2,3,5,2700
4,4,2,0,4,3,7,2700
5,5,2,0,6,3,9,2700
6,6,0,0,6,3,9,2700
0,0,1,0,1,0,1,2701
1,1,1,1,2,1,3,2701
2,2,1,1,3,2,5,2701
3,3,1,0,4,2,6,2701
4,4,2,0,6,2,8,2701
5,5,3,1,9,3,12,2701
6,6,3,1,12,4,16,2701
7,7,5,2,17,6,23,2701
8,8,4,3,21,9,30,2701
9,9,5,5,26,14,40,2701
10,10,2,3,28,17,45,2701
11,11,2,3,30,20,50,2701
12,12,0,4,30,24,54,2701
13,13,1,4,31,28,59,2701
14,14,1,2,32,30,62,2701
15,15,1,3,33,33,66,2701
16,16,1,2,34,35,69,2701
17,17,0,2,34,37,71,2701
18,18,0,1,34,38,72,2701
19,19,0,1,34,39,73,2701
20,20,0,0,34,39,73,2701
0,0,1,0,1,0,1,2702
1,1,2,0,3,0,3,2702
2,2,1,0,4,0,4,2702
3,3,0,0,4,0,4,2702
0,0,1,0,1,0,1,2703
1,1,1,1,2,1,3,2703
2,2,0,0,2,1,3,2703
0,0,1,0,1,0,1,2704
1,1,0,0,1,0,1,2704
0,0,1,0,1,0,1,2705
1,1,1,0,2,0,2,2705
2,2,0,0,2,0,2,2705
0,0,1,0,1,0,1,2706
1,1,0,0,1,0,1,2706
0,0,1,0,1,0,1,2707
1,1,1,0,2,0,2,2707
2,2,0,0,2,0,2,2707
0,0,1,0,1,0,1,2708
1,1,0,1,1,1,2,2708
2,2,0,1,1,2,3,2708
3,3,0,2,1,4,5,2708
4,4,0,0,1,4,5,2708
0,0,1,0,1,0,1,2709
1,1,0,0,1,0,1,2709
0,0,1,0,1,0,1,2710
1,1,1,0,2,0,2,2710
2,2,0,2,2,2,4,2710
3,3,0,1,2,3,5,2710
4,4,1,0,3,3,6,2710
5,5,1,0,4,3,7,2710
6,6,2,1,6,4,10,2710
7,7,2,1,8,5,13,2710
8,8,5,1,13,6,19,2710
9,9,1,3,14,9,23,2710
10,10,1,2,15,11,26,2710
11,11,2,0,17,11,28,2710
12,12,1,0,18,11,29,2710
13,13,0,1,18,12,30,2710
14,14,0,1,18,13,31,2710
15,15,0,2,18,15,33,2710
16,16,0,2,18,17,35,2710
17,17,0,0,18,17,35,2710
0,0,1,0,1,0,1,2711
1,1,1,2,2,2,4,2711
2,2,2,3,4,5,9,2711
3,3,3,0,7,5,12,2711
4,4,3,3,10,8,18,2711
5,5,2,4,12,12,24,2711
6,6,2,5,14,17,31,2711
7,7,1,4,15,21,36,2711
8,8,0,3,15,24,39,2711
9,9,0,2,15,26,41,2711
10,10,0,1,15,27,42,2711
11,11,0,2,15,29,44,2711
12,12,2,2,17,31,48,2711
13,13,0,1,17,32,49,2711
14,14,0,0,17,32,49,2711
0,0,1,0,1,0,1,2712
1,1,2,0,3,0,3,2712
2,2,1,0,4,0,4,2712
3,3,2,0,6,0,6,2712
4,4,0,1,6,1,7,2712
5,5,1,1,7,2,9,2712
6,6,0,1,7,3,10,2712
7,7,0,2,7,5,12,2712
8,8,0,0,7,5,12,2712
0,0,1,0,1,0,1,2713
1,1,1,0,2,0,2,2713
2,2,0,0,2,0,2,2713
0,0,1,0,1,0,1,2714
1,1,3,0,4,0,4,2714
2,2,4,0,8,0,8,2714
3,3,3,1,11,1,12,2714
4,4,1,1,12,2,14,2714
5,5,1,1,13,3,16,2714
6,6,3,0,16,3,19,2714
7,7,2,1,18,4,22,2714
8,8,2,0,20,4,24,2714
9,9,2,0,22,4,26,2714
10,10,1,1,23,5,28,2714
11,11,1,1,24,6,30,2714
12,12,0,0,24,6,30,2714
0,0,1,0,1,0,1,2715
1,1,1,0,2,0,2,2715
2,2,0,0,2,0,2,2715
0,0,1,0,1,0,1,2716
1,1,0,0,1,0,1,2716
0,0,1,0,1,0,1,2717
1,1,2,0,3,0,3,2717
2,2,1,0,4,0,4,2717
3,3,0,1,4,1,5,2717
4,4,0,1,4,2,6,2717
5,5,0,0,4,2,6,2717
0,0,1,0,1,0,1,2718
1,1,0,0,1,0,1,2718
0,0,1,0,1,0,1,2719
1,1,0,0,1,0,1,2719
0,0,1,0,1,0,1,2720
1,1,1,0,2,0,2,2720
2,2,0,0,2,0,2,2720
0,0,1,0,1,0,1,2721
1,1,1,0,2,0,2,2721
2,2,1,0,3,0,3,2721
3,3,1,0,4,0,4,2721
4,4,1,1,5,1,6,2721
5,5,2,1,7,2,9,2721
6,6,2,1,9,3,12,2721
7,7,0,2,9,5,14,2721
8,8,0,1,9,6,15,2721
9,9,0,1,9,7,16,2721
10,10,0,1,9,8,17,2721
11,11,0,1,9,9,18,2721
12,12,0,0,9,9,18,2721
0,0,1,0,1,0,1,2722
1,1,0,0,1,0,1,2722
0,0,1,0,1,0,1,2723
1,1,2,0,3,0,3,2723
2,2,2,0,5,0,5,2723
3,3,1,0,6,0,6,2723
4,4,0,0,6,0,6,2723
0,0,1,0,1,0,1,2724
1,1,0,0,1,0,1,2724
0,0,1,0,1,0,1,2725
1,1,2,0,3,0,3,2725
2,2,0,0,3,0,3,2725
0,0,1,0,1,0,1,2726
1,1,0,0,1,0,1,2726
0,0,1,0,1,0,1,2727
1,1,0,0,1,0,1,2727
0,0,1,0,1,0,1,2728
1,1,3,0,4,0,4,2728
2,2,2,0,6,0,6,2728
3,3,2,1,8,1,9,2728
4,4,0,0,8,1,9,2728
0,0,1,0,1,0,1,2729
1,1,1,0,2,0,2,2729
2,2,2,1,4,1,5,2729
3,3,3,1,7,2,9,2729
4,4,2,1,9,3,12,2729
5,5,2,1,11,4,15,2729
6,6,2,2,13,6,19,2729
7,7,1,1,14,7,21,2729
8,8,1,3,15,10,25,2729
9,9,4,1,19,11,30,2729
10,10,5,4,24,15,39,2729
11,11,4,5,28,20,48,2729
12,12,4,5,32,25,57,2729
13,13,3,3,35,28,63,2729
14,14,3,0,38,28,66,2729
15,15,0,0,38,28,66,2729
0,0,1,0,1,0,1,2730
1,1,1,0,2,0,2,2730
2,2,0,0,2,0,2,2730
0,0,1,0,1,0,1,2731
1,1,0,0,1,0,1,2731
0,0,1,0,1,0,1,2732
1,1,0,0,1,0,1,2732
0,0,1,0,1,0,1,2733
1,1,0,0,1,0,1,2733
0,0,1,0,1,0,1,2734
1,1,1,1,2,1,3,2734
2,2,2,1,4,2,6,2734
3,3,2,0,6,2,8,2734
4,4,3,0,9,2,11,2734
5,5,4,2,13,4,17,2734
6,6,0,1,13,5,18,2734
7,7,1,0,14,5,19,2734
8,8,1,1,15,6,21,2734
9,9,1,2,16,8,24,2734
10,10,1,1,17,9,26,2734
11,11,3,0,20,9,29,2734
12,12,2,1,22,10,32,2734
13,13,0,0,22,10,32,2734
0,0,1,0,1,0,1,2735
1,1,0,0,1,0,1,2735
0,0,1,0,1,0,1,2736
1,1,2,1,3,1,4,2736
2,2,3,0,6,1,7,2736
3,3,2,0,8,1,9,2736
4,4,4,0,12,1,13,2736
5,5,1,2,13,3,16,2736
6,6,1,0,14,3,17,2736
7,7,0,0,14,3,17,2736
0,0,1,0,1,0,1,2737
1,1,1,0,2,0,2,2737
2,2,0,0,2,0,2,2737
0,0,1,0,1,0,1,2738
1,1,0,0,1,0,1,2738
0,0,1,0,1,0,1,2739
1,1,0,1,1,1,2,2739
2,2,1,1,2,2,4,2739
3,3,1,0,3,2,5,2739
4,4,1,0,4,2,6,2739
5,5,0,0,4,2,6,2739
0,0,1,0,1,0,1,2740
1,1,0,1,1,1,2,2740
2,2,0,0,1,1,2,2740
0,0,1,0,1,0,1,2741
1,1,0,0,1,0,1,2741
0,0,1,0,1,0,1,2742
1,1,1,0,2,0,2,2742
2,2,1,0,3,0,3,2742
3,3,0,0,3,0,3,2742
0,0,1,0,1,0,1,2743
1,1,0,0,1,0,1,2743
0,0,1,0,1,0,1,2744
1,1,0,0,1,0,1,2744
0,0,1,0,1,0,1,2745
1,1,1,1,2,1,3,2745
2,2,0,0,2,1,3,2745
0,0,1,0,1,0,1,2746
1,1,0,0,1,0,1,2746
0,0,1,0,1,0,1,2747
1,1,0,0,1,0,1,2747
0,0,1,0,1,0,1,2748
1,1,2,0,3,0,3,2748
2,2,4,0,7,0,7,2748
3,3,3,0,10,0,10,2748
4,4,3,1,13,1,14,2748
5,5,1,2,14,3,17,2748
6,6,2,2,16,5,21,2748
7,7,0,1,16,6,22,2748
8,8,0,1,16,7,23,2748
9,9,1,2,17,9,26,2748
10,10,2,1,19,10,29,2748
11,11,2,2,21,12,33,2748
12,12,2,0,23,12,35,2748
13,13,1,0,24,12,36,2748
14,14,0,0,24,12,36,2748
0,0,1,0,1,0,1,2749
1,1,0,0,1,0,1,2749
0,0,1,0,1,0,1,2750
1,1,0,0,1,0,1,2750
0,0,1,0,1,0,1,2751
1,1,1,1,2,1,3,2751
2,2,2,1,4,2,6,2751
3,3,0,0,4,2,6,2751
0,0,1,0,1,0,1,2752
1,1,0,1,1,1,2,2752
2,2,0,0,1,1,2,2752
0,0,1,0,1,0,1,2753
1,1,0,0,1,0,1,2753
0,0,1,0,1,0,1,2754
1,1,0,0,1,0,1,2754
0,0,1,0,1,0,1,2755
1,1,2,1,3,1,4,2755
2,2,2,1,5,2,7,2755
3,3,1,0,6,2,8,2755
4,4,1,0,7,2,9,2755
5,5,0,1,7,3,10,2755
6,6,0,1,7,4,11,2755
7,7,0,0,7,4,11,2755
0,0,1,0,1,0,1,2756
1,1,1,1,2,1,3,2756
2,2,1,0,3,1,4,2756
3,3,0,0,3,1,4,2756
0,0,1,0,1,0,1,2757
1,1,2,0,3,0,3,2757
2,2,2,0,5,0,5,2757
3,3,1,0,6,0,6,2757
4,4,1,0,7,0,7,2757
5,5,2,0,9,0,9,2757
6,6,2,1,11,1,12,2757
7,7,1,2,12,3,15,2757
8,8,0,2,12,5,17,2757
9,9,1,3,13,8,21,2757
10,10,2,2,15,10,25,2757
11,11,1,4,16,14,30,2757
12,12,2,0,18,14,32,2757
13,13,0,0,18,14,32,2757
0,0,1,0,1,0,1,2758
1,1,0,0,1,0,1,2758
0,0,1,0,1,0,1,2759
1,1,0,0,1,0,1,2759
0,0,1,0,1,0,1,2760
1,1,3,0,4,0,4,2760
2,2,4,1,8,1,9,2760
3,3,1,4,9,5,14,2760
4,4,1,4,10,9,19,2760
5,5,1,3,11,12,23,2760
6,6,2,6,13,18,31,2760
7,7,2,3,15,21,36,2760
8,8,5,1,20,22,42,2760
9,9,3,1,23,23,46,2760
10,10,3,0,26,23,49,2760
11,11,2,0,28,23,51,2760
12,12,0,1,28,24,52,2760
13,13,0,1,28,25,53,2760
14,14,0,0,28,25,53,2760
0,0,1,0,1,0,1,2761
1,1,0,0,1,0,1,2761
0,0,1,0,1,0,1,2762
1,1,0,1,1,1,2,2762
2,2,1,0,2,1,3,2762
3,3,0,0,2,1,3,2762
0,0,1,0,1,0,1,2763
1,1,0,0,1,0,1,2763
0,0,1,0,1,0,1,2764
1,1,0,1,1,1,2,2764
2,2,0,3,1,4,5,2764
3,3,0,4,1,8,9,2764
4,4,0,1,1,9,10,2764
5,5,0,0,1,9,10,2764
0,0,1,0,1,0,1,2765
1,1,1,0,2,0,2,2765
2,2,2,0,4,0,4,2765
3,3,1,0,5,0,5,2765
4,4,0,0,5,0,5,2765
0,0,1,0,1,0,1,2766
1,1,1,0,2,0,2,2766
2,2,1,1,3,1,4,2766
3,3,1,0,4,1,5,2766
4,4,0,0,4,1,5,2766
0,0,1,0,1,0,1,2767
1,1,0,1,1,1,2,2767
2,2,0,2,1,3,4,2767
3,3,0,2,1,5,6,2767
4,4,0,1,1,6,7,2767
5,5,0,1,1,7,8,2767
6,6,0,0,1,7,8,2767
0,0,1,0,1,0,1,2768
1,1,1,1,2,1,3,2768
2,2,1,0,3,1,4,2768
3,3,1,0,4,1,5,2768
4,4,0,0,4,1,5,2768
0,0,1,0,1,0,1,2769
1,1,3,0,4,0,4,2769
2,2,1,1,5,1,6,2769
3,3,1,0,6,1,7,2769
4,4,1,0,7,1,8,2769
5,5,1,0,8,1,9,2769
6,6,1,0,9,1,10,2769
7,7,0,1,9,2,11,2769
8,8,0,0,9,2,11,2769
0,0,1,0,1,0,1,2770
1,1,0,0,1,0,1,2770
0,0,1,0,1,0,1,2771
1,1,1,0,2,0,2,2771
2,2,0,1,2,1,3,2771
3,3,0,1,2,2,4,2771
4,4,0,0,2,2,4,2771
0,0,1,0,1,0,1,2772
1,1,4,0,5,0,5,2772
2,2,5,1,10,1,11,2772
3,3,5,2,15,3,18,2772
4,4,3,0,18,3,21,2772
5,5,3,0,21,3,24,2772
6,6,2,1,23,4,27,2772
7,7,2,2,25,6,31,2772
8,8,1,1,26,7,33,2772
9,9,1,1,27,8,35,2772
10,10,1,2,28,10,38,2772
11,11,3,3,31,13,44,2772
12,12,3,3,34,16,50,2772
13,13,1,2,35,18,53,2772
14,14,3,2,38,20,58,2772
15,15,1,4,39,24,63,2772
16,16,0,5,39,29,68,2772
17,17,2,2,41,31,72,2772
18,18,2,2,43,33,76,2772
19,19,0,3,43,36,79,2772
20,20,2,3,45,39,84,2772
21,21,2,3,47,42,89,2772
22,22,0,1,47,43,90,2772
23,23,0,1,47,44,91,2772
24,24,0,1,47,45,92,2772
25,25,0,2,47,47,94,2772
26,26,0,0,47,47,94,2772
0,0,1,0,1,0,1,2773
1,1,0,1,1,1,2,2773
2,2,0,0,1,1,2,2773
0,0,1,0,1,0,1,2774
1,1,0,0,1,0,1,2774
0,0,1,0,1,0,1,2775
1,1,0,0,1,0,1,2775
0,0,1,0,1,0,1,2776
1,1,0,0,1,0,1,2776
0,0,1,0,1,0,1,2777
1,1,0,0,1,0,1,2777
0,0,1,0,1,0,1,2778
1,1,0,0,1,0,1,2778
0,0,1,0,1,0,1,2779
1,1,0,0,1,0,1,2779
0,0,1,0,1,0,1,2780
1,1,1,0,2,0,2,2780
2,2,1,0,3,0,3,2780
3,3,0,0,3,0,3,2780
0,0,1,0,1,0,1,2781
1,1,0,0,1,0,1,2781
0,0,1,0,1,0,1,2782
1,1,3,0,4,0,4,2782
2,2,3,2,7,2,9,2782
3,3,2,1,9,3,12,2782
4,4,0,1,9,4,13,2782
5,5,1,0,10,4,14,2782
6,6,0,0,10,4,14,2782
0,0,1,0,1,0,1,2783
1,1,0,0,1,0,1,2783
0,0,1,0,1,0,1,2784
1,1,1,0,2,0,2,2784
2,2,1,0,3,0,3,2784
3,3,1,1,4,1,5,2784
4,4,0,0,4,1,5,2784
0,0,1,0,1,0,1,2785
1,1,0,0,1,0,1,2785
0,0,1,0,1,0,1,2786
1,1,0,0,1,0,1,2786
0,0,1,0,1,0,1,2787
1,1,0,1,1,1,2,2787
2,2,1,1,2,2,4,2787
3,3,1,1,3,3,6,2787
4,4,1,1,4,4,8,2787
5,5,1,2,5,6,11,2787
6,6,1,0,6,6,12,2787
7,7,2,0,8,6,14,2787
8,8,1,0,9,6,15,2787
9,9,1,1,10,7,17,2787
10,10,0,0,10,7,17,2787
0,0,1,0,1,0,1,2788
1,1,2,1,3,1,4,2788
2,2,2,0,5,1,6,2788
3,3,1,0,6,1,7,2788
4,4,0,0,6,1,7,2788
0,0,1,0,1,0,1,2789
1,1,1,0,2,0,2,2789
2,2,0,0,2,0,2,2789
0,0,1,0,1,0,1,2790
1,1,0,0,1,0,1,2790
0,0,1,0,1,0,1,2791
1,1,1,0,2,0,2,2791
2,2,0,0,2,0,2,2791
0,0,1,0,1,0,1,2792
1,1,0,0,1,0,1,2792
0,0,1,0,1,0,1,2793
1,1,1,0,2,0,2,2793
2,2,3,0,5,0,5,2793
3,3,2,0,7,0,7,2793
4,4,1,0,8,0,8,2793
5,5,1,0,9,0,9,2793
6,6,0,0,9,0,9,2793
0,0,1,0,1,0,1,2794
1,1,1,0,2,0,2,2794
2,2,0,0,2,0,2,2794
0,0,1,0,1,0,1,2795
1,1,0,0,1,0,1,2795
0,0,1,0,1,0,1,2796
1,1,0,0,1,0,1,2796
0,0,1,0,1,0,1,2797
1,1,0,0,1,0,1,2797
0,0,1,0,1,0,1,2798
1,1,0,0,1,0,1,2798
0,0,1,0,1,0,1,2799
1,1,0,0,1,0,1,2799
0,0,1,0,1,0,1,2800
1,1,0,0,1,0,1,2800
0,0,1,0,1,0,1,2801
1,1,0,0,1,0,1,2801
0,0,1,0,1,0,1,2802
1,1,0,1,1,1,2,2802
2,2,0,1,1,2,3,2802
3,3,0,1,1,3,4,2802
4,4,0,0,1,3,4,2802
0,0,1,0,1,0,1,2803
1,1,0,0,1,0,1,2803
0,0,1,0,1,0,1,2804
1,1,2,0,3,0,3,2804
2,2,1,0,4,0,4,2804
3,3,0,0,4,0,4,2804
0,0,1,0,1,0,1,2805
1,1,0,0,1,0,1,2805
0,0,1,0,1,0,1,2806
1,1,0,0,1,0,1,2806
0,0,1,0,1,0,1,2807
1,1,0,0,1,0,1,2807
0,0,1,0,1,0,1,2808
1,1,0,0,1,0,1,2808
0,0,1,0,1,0,1,2809
1,1,2,1,3,1,4,2809
2,2,2,2,5,3,8,2809
3,3,3,1,8,4,12,2809
4,4,1,2,9,6,15,2809
5,5,0,0,9,6,15,2809
0,0,1,0,1,0,1,2810
1,1,0,0,1,0,1,2810
0,0,1,0,1,0,1,2811
1,1,0,0,1,0,1,2811
0,0,1,0,1,0,1,2812
1,1,1,0,2,0,2,2812
2,2,0,0,2,0,2,2812
0,0,1,0,1,0,1,2813
1,1,1,0,2,0,2,2813
2,2,0,0,2,0,2,2813
0,0,1,0,1,0,1,2814
1,1,1,1,2,1,3,2814
2,2,1,0,3,1,4,2814
3,3,2,0,5,1,6,2814
4,4,3,0,8,1,9,2814
5,5,2,0,10,1,11,2814
6,6,2,0,12,1,13,2814
7,7,0,0,12,1,13,2814
0,0,1,0,1,0,1,2815
1,1,0,0,1,0,1,2815
0,0,1,0,1,0,1,2816
1,1,1,0,2,0,2,2816
2,2,0,0,2,0,2,2816
0,0,1,0,1,0,1,2817
1,1,0,0,1,0,1,2817
0,0,1,0,1,0,1,2818
1,1,1,0,2,0,2,2818
2,2,0,1,2,1,3,2818
3,3,0,0,2,1,3,2818
0,0,1,0,1,0,1,2819
1,1,2,0,3,0,3,2819
2,2,1,1,4,1,5,2819
3,3,2,1,6,2,8,2819
4,4,1,2,7,4,11,2819
5,5,0,1,7,5,12,2819
6,6,0,1,7,6,13,2819
7,7,0,1,7,7,14,2819
8,8,0,1,7,8,15,2819
9,9,0,0,7,8,15,2819
0,0,1,0,1,0,1,2820
1,1,1,0,2,0,2,2820
2,2,0,0,2,0,2,2820
0,0,1,0,1,0,1,2821
1,1,1,0,2,0,2,2821
2,2,1,0,3,0,3,2821
3,3,1,0,4,0,4,2821
4,4,0,1,4,1,5,2821
5,5,0,0,4,1,5,2821
0,0,1,0,1,0,1,2822
1,1,0,1,1,1,2,2822
2,2,0,2,1,3,4,2822
3,3,1,3,2,6,8,2822
4,4,2,1,4,7,11,2822
5,5,0,2,4,9,13,2822
6,6,1,6,5,15,20,2822
7,7,1,4,6,19,25,2822
8,8,1,6,7,25,32,2822
9,9,0,3,7,28,35,2822
10,10,2,4,9,32,41,2822
11,11,4,3,13,35,48,2822
12,12,2,0,15,35,50,2822
13,13,1,0,16,35,51,2822
14,14,1,1,17,36,53,2822
15,15,0,1,17,37,54,2822
16,16,0,0,17,37,54,2822
0,0,1,0,1,0,1,2823
1,1,1,1,2,1,3,2823
2,2,1,0,3,1,4,2823
3,3,0,0,3,1,4,2823
0,0,1,0,1,0,1,2824
1,1,0,0,1,0,1,2824
0,0,1,0,1,0,1,2825
1,1,0,0,1,0,1,2825
0,0,1,0,1,0,1,2826
1,1,2,0,3,0,3,2826
2,2,3,0,6,0,6,2826
3,3,1,0,7,0,7,2826
4,4,2,0,9,0,9,2826
5,5,2,0,11,0,11,2826
6,6,0,0,11,0,11,2826
0,0,1,0,1,0,1,2827
1,1,1,0,2,0,2,2827
2,2,1,0,3,0,3,2827
3,3,2,0,5,0,5,2827
4,4,0,0,5,0,5,2827
0,0,1,0,1,0,1,2828
1,1,0,0,1,0,1,2828
0,0,1,0,1,0,1,2829
1,1,0,0,1,0,1,2829
0,0,1,0,1,0,1,2830
1,1,0,0,1,0,1,2830
0,0,1,0,1,0,1,2831
1,1,1,0,2,0,2,2831
2,2,1,0,3,0,3,2831
3,3,0,0,3,0,3,2831
0,0,1,0,1,0,1,2832
1,1,0,0,1,0,1,2832
0,0,1,0,1,0,1,2833
1,1,0,0,1,0,1,2833
0,0,1,0,1,0,1,2834
1,1,2,0,3,0,3,2834
2,2,1,0,4,0,4,2834
3,3,1,0,5,0,5,2834
4,4,1,0,6,0,6,2834
5,5,0,0,6,0,6,2834
0,0,1,0,1,0,1,2835
1,1,0,0,1,0,1,2835
0,0,1,0,1,0,1,2836
1,1,0,0,1,0,1,2836
0,0,1,0,1,0,1,2837
1,1,0,1,1,1,2,2837
2,2,0,1,1,2,3,2837
3,3,0,1,1,3,4,2837
4,4,0,1,1,4,5,2837
5,5,0,1,1,5,6,2837
6,6,0,0,1,5,6,2837
0,0,1,0,1,0,1,2838
1,1,0,1,1,1,2,2838
2,2,0,0,1,1,2,2838
0,0,1,0,1,0,1,2839
1,1,1,0,2,0,2,2839
2,2,0,0,2,0,2,2839
0,0,1,0,1,0,1,2840
1,1,1,0,2,0,2,2840
2,2,1,0,3,0,3,2840
3,3,0,0,3,0,3,2840
0,0,1,0,1,0,1,2841
1,1,0,0,1,0,1,2841
0,0,1,0,1,0,1,2842
1,1,0,0,1,0,1,2842
0,0,1,0,1,0,1,2843
1,1,2,1,3,1,4,2843
2,2,2,1,5,2,7,2843
3,3,0,3,5,5,10,2843
4,4,1,2,6,7,13,2843
5,5,1,0,7,7,14,2843
6,6,0,0,7,7,14,2843
0,0,1,0,1,0,1,2844
1,1,1,0,2,0,2,2844
2,2,0,1,2,1,3,2844
3,3,1,0,3,1,4,2844
4,4,0,0,3,1,4,2844
0,0,1,0,1,0,1,2845
1,1,0,1,1,1,2,2845
2,2,1,1,2,2,4,2845
3,3,0,0,2,2,4,2845
0,0,1,0,1,0,1,2846
1,1,3,1,4,1,5,2846
2,2,2,2,6,3,9,2846
3,3,3,3,9,6,15,2846
4,4,2,3,11,9,20,2846
5,5,2,4,13,13,26,2846
6,6,2,3,15,16,31,2846
7,7,2,3,17,19,36,2846
8,8,1,1,18,20,38,2846
9,9,1,0,19,20,39,2846
10,10,0,0,19,20,39,2846
0,0,1,0,1,0,1,2847
1,1,0,0,1,0,1,2847
0,0,1,0,1,0,1,2848
1,1,0,0,1,0,1,2848
0,0,1,0,1,0,1,2849
1,1,0,1,1,1,2,2849
2,2,0,0,1,1,2,2849
0,0,1,0,1,0,1,2850
1,1,0,0,1,0,1,2850
0,0,1,0,1,0,1,2851
1,1,0,0,1,0,1,2851
0,0,1,0,1,0,1,2852
1,1,2,0,3,0,3,2852
2,2,1,2,4,2,6,2852
3,3,2,1,6,3,9,2852
4,4,0,1,6,4,10,2852
5,5,0,1,6,5,11,2852
6,6,0,1,6,6,12,2852
7,7,0,0,6,6,12,2852
0,0,1,0,1,0,1,2853
1,1,2,2,3,2,5,2853
2,2,0,0,3,2,5,2853
0,0,1,0,1,0,1,2854
1,1,0,0,1,0,1,2854
0,0,1,0,1,0,1,2855
1,1,2,0,3,0,3,2855
2,2,2,0,5,0,5,2855
3,3,1,1,6,1,7,2855
4,4,3,0,9,1,10,2855
5,5,2,0,11,1,12,2855
6,6,2,1,13,2,15,2855
7,7,0,0,13,2,15,2855
0,0,1,0,1,0,1,2856
1,1,0,0,1,0,1,2856
0,0,1,0,1,0,1,2857
1,1,0,0,1,0,1,2857
0,0,1,0,1,0,1,2858
1,1,0,0,1,0,1,2858
0,0,1,0,1,0,1,2859
1,1,1,0,2,0,2,2859
2,2,1,0,3,0,3,2859
3,3,1,0,4,0,4,2859
4,4,1,1,5,1,6,2859
5,5,1,3,6,4,10,2859
6,6,1,0,7,4,11,2859
7,7,1,0,8,4,12,2859
8,8,0,0,8,4,12,2859
0,0,1,0,1,0,1,2860
1,1,0,0,1,0,1,2860
0,0,1,0,1,0,1,2861
1,1,1,0,2,0,2,2861
2,2,0,0,2,0,2,2861
0,0,1,0,1,0,1,2862
1,1,1,0,2,0,2,2862
2,2,1,0,3,0,3,2862
3,3,0,1,3,1,4,2862
4,4,0,1,3,2,5,2862
5,5,0,1,3,3,6,2862
6,6,0,0,3,3,6,2862
0,0,1,0,1,0,1,2863
1,1,2,0,3,0,3,2863
2,2,1,0,4,0,4,2863
3,3,1,0,5,0,5,2863
4,4,0,0,5,0,5,2863
0,0,1,0,1,0,1,2864
1,1,1,0,2,0,2,2864
2,2,1,0,3,0,3,2864
3,3,1,0,4,0,4,2864
4,4,1,0,5,0,5,2864
5,5,0,1,5,1,6,2864
6,6,0,0,5,1,6,2864
0,0,1,0,1,0,1,2865
1,1,0,0,1,0,1,2865
0,0,1,0,1,0,1,2866
1,1,0,1,1,1,2,2866
2,2,0,1,1,2,3,2866
3,3,1,0,2,2,4,2866
4,4,0,0,2,2,4,2866
0,0,1,0,1,0,1,2867
1,1,1,0,2,0,2,2867
2,2,0,0,2,0,2,2867
0,0,1,0,1,0,1,2868
1,1,0,0,1,0,1,2868
0,0,1,0,1,0,1,2869
1,1,2,0,3,0,3,2869
2,2,2,0,5,0,5,2869
3,3,0,1,5,1,6,2869
4,4,0,0,5,1,6,2869
0,0,1,0,1,0,1,2870
1,1,0,0,1,0,1,2870
0,0,1,0,1,0,1,2871
1,1,0,0,1,0,1,2871
0,0,1,0,1,0,1,2872
1,1,2,0,3,0,3,2872
2,2,0,0,3,0,3,2872
0,0,1,0,1,0,1,2873
1,1,1,0,2,0,2,2873
2,2,0,0,2,0,2,2873
0,0,1,0,1,0,1,2874
1,1,1,0,2,0,2,2874
2,2,0,0,2,0,2,2874
0,0,1,0,1,0,1,2875
1,1,0,0,1,0,1,2875
0,0,1,0,1,0,1,2876
1,1,0,2,1,2,3,2876
2,2,1,1,2,3,5,2876
3,3,1,0,3,3,6,2876
4,4,1,0,4,3,7,2876
5,5,0,0,4,3,7,2876
0,0,1,0,1,0,1,2877
1,1,0,0,1,0,1,2877
0,0,1,0,1,0,1,2878
1,1,1,0,2,0,2,2878
2,2,1,0,3,0,3,2878
3,3,0,0,3,0,3,2878
0,0,1,0,1,0,1,2879
1,1,0,1,1,1,2,2879
2,2,0,1,1,2,3,2879
3,3,0,1,1,3,4,2879
4,4,0,1,1,4,5,2879
5,5,0,0,1,4,5,2879
0,0,1,0,1,0,1,2880
1,1,1,0,2,0,2,2880
2,2,2,0,4,0,4,2880
3,3,4,1,8,1,9,2880
4,4,2,0,10,1,11,2880
5,5,1,0,11,1,12,2880
6,6,1,1,12,2,14,2880
7,7,2,0,14,2,16,2880
8,8,3,0,17,2,19,2880
9,9,3,1,20,3,23,2880
10,10,3,3,23,6,29,2880
11,11,8,5,31,11,42,2880
12,12,6,4,37,15,52,2880
13,13,6,7,43,22,65,2880
14,14,6,3,49,25,74,2880
15,15,5,3,54,28,82,2880
16,16,3,3,57,31,88,2880
17,17,3,1,60,32,92,2880
18,18,3,1,63,33,96,2880
19,19,1,0,64,33,97,2880
20,20,0,0,64,33,97,2880
0,0,1,0,1,0,1,2881
1,1,2,0,3,0,3,2881
2,2,3,0,6,0,6,2881
3,3,2,0,8,0,8,2881
4,4,1,2,9,2,11,2881
5,5,0,3,9,5,14,2881
6,6,0,0,9,5,14,2881
0,0,1,0,1,0,1,2882
1,1,0,0,1,0,1,2882
0,0,1,0,1,0,1,2883
1,1,3,0,4,0,4,2883
2,2,2,0,6,0,6,2883
3,3,1,1,7,1,8,2883
4,4,1,1,8,2,10,2883
5,5,1,0,9,2,11,2883
6,6,0,0,9,2,11,2883
0,0,1,0,1,0,1,2884
1,1,1,0,2,0,2,2884
2,2,1,0,3,0,3,2884
3,3,2,1,5,1,6,2884
4,4,4,0,9,1,10,2884
5,5,2,0,11,1,12,2884
6,6,1,0,12,1,13,2884
7,7,0,1,12,2,14,2884
8,8,1,0,13,2,15,2884
9,9,0,0,13,2,15,2884
0,0,1,0,1,0,1,2885
1,1,0,0,1,0,1,2885
0,0,1,0,1,0,1,2886
1,1,1,0,2,0,2,2886
2,2,1,0,3,0,3,2886
3,3,2,0,5,0,5,2886
4,4,0,0,5,0,5,2886
0,0,1,0,1,0,1,2887
1,1,0,0,1,0,1,2887
0,0,1,0,1,0,1,2888
1,1,1,0,2,0,2,2888
2,2,0,1,2,1,3,2888
3,3,0,1,2,2,4,2888
4,4,1,1,3,3,6,2888
5,5,1,1,4,4,8,2888
6,6,1,1,5,5,10,2888
7,7,1,0,6,5,11,2888
8,8,0,0,6,5,11,2888
0,0,1,0,1,0,1,2889
1,1,0,0,1,0,1,2889
0,0,1,0,1,0,1,2890
1,1,1,0,2,0,2,2890
2,2,0,1,2,1,3,2890
3,3,0,3,2,4,6,2890
4,4,1,2,3,6,9,2890
5,5,0,1,3,7,10,2890
6,6,1,0,4,7,11,2890
7,7,0,0,4,7,11,2890
0,0,1,0,1,0,1,2891
1,1,1,0,2,0,2,2891
2,2,0,0,2,0,2,2891
0,0,1,0,1,0,1,2892
1,1,0,0,1,0,1,2892
0,0,1,0,1,0,1,2893
1,1,1,0,2,0,2,2893
2,2,0,0,2,0,2,2893
0,0,1,0,1,0,1,2894
1,1,2,0,3,0,3,2894
2,2,3,0,6,0,6,2894
3,3,4,0,10,0,10,2894
4,4,2,1,12,1,13,2894
5,5,1,0,13,1,14,2894
6,6,0,0,13,1,14,2894
0,0,1,0,1,0,1,2895
1,1,0,3,1,3,4,2895
2,2,0,3,1,6,7,2895
3,3,1,0,2,6,8,2895
4,4,1,0,3,6,9,2895
5,5,1,0,4,6,10,2895
6,6,3,1,7,7,14,2895
7,7,4,1,11,8,19,2895
8,8,1,1,12,9,21,2895
9,9,1,0,13,9,22,2895
10,10,0,0,13,9,22,2895
0,0,1,0,1,0,1,2896
1,1,2,0,3,0,3,2896
2,2,4,1,7,1,8,2896
3,3,2,0,9,1,10,2896
4,4,1,0,10,1,11,2896
5,5,3,0,13,1,14,2896
6,6,1,1,14,2,16,2896
7,7,1,3,15,5,20,2896
8,8,1,4,16,9,25,2896
9,9,1,1,17,10,27,2896
10,10,1,1,18,11,29,2896
11,11,1,0,19,11,30,2896
12,12,1,0,20,11,31,2896
13,13,0,0,20,11,31,2896
0,0,1,0,1,0,1,2897
1,1,0,0,1,0,1,2897
0,0,1,0,1,0,1,2898
1,1,0,0,1,0,1,2898
0,0,1,0,1,0,1,2899
1,1,0,0,1,0,1,2899
0,0,1,0,1,0,1,2900
1,1,2,1,3,1,4,2900
2,2,4,1,7,2,9,2900
3,3,3,1,10,3,13,2900
4,4,3,1,13,4,17,2900
5,5,2,2,15,6,21,2900
6,6,4,1,19,7,26,2900
7,7,1,1,20,8,28,2900
8,8,0,1,20,9,29,2900
9,9,0,1,20,10,30,2900
10,10,0,0,20,10,30,2900
0,0,1,0,1,0,1,2901
1,1,1,0,2,0,2,2901
2,2,2,0,4,0,4,2901
3,3,0,1,4,1,5,2901
4,4,0,3,4,4,8,2901
5,5,2,4,6,8,14,2901
6,6,0,6,6,14,20,2901
7,7,0,2,6,16,22,2901
8,8,0,2,6,18,24,2901
9,9,0,1,6,19,25,2901
10,10,0,0,6,19,25,2901
0,0,1,0,1,0,1,2902
1,1,0,0,1,0,1,2902
0,0,1,0,1,0,1,2903
1,1,0,0,1,0,1,2903
0,0,1,0,1,0,1,2904
1,1,1,0,2,0,2,2904
2,2,0,0,2,0,2,2904
0,0,1,0,1,0,1,2905
1,1,2,0,3,0,3,2905
2,2,1,0,4,0,4,2905
3,3,0,0,4,0,4,2905
0,0,1,0,1,0,1,2906
1,1,1,0,2,0,2,2906
2,2,2,0,4,0,4,2906
3,3,4,0,8,0,8,2906
4,4,1,2,9,2,11,2906
5,5,0,3,9,5,14,2906
6,6,0,2,9,7,16,2906
7,7,0,2,9,9,18,2906
8,8,1,0,10,9,19,2906
9,9,1,0,11,9,20,2906
10,10,1,0,12,9,21,2906
11,11,1,0,13,9,22,2906
12,12,3,0,16,9,25,2906
13,13,4,1,20,10,30,2906
14,14,4,1,24,11,35,2906
15,15,2,2,26,13,39,2906
16,16,2,0,28,13,41,2906
17,17,2,0,30,13,43,2906
18,18,1,0,31,13,44,2906
19,19,0,0,31,13,44,2906
0,0,1,0,1,0,1,2907
1,1,0,1,1,1,2,2907
2,2,0,0,1,1,2,2907
0,0,1,0,1,0,1,2908
1,1,0,0,1,0,1,2908
0,0,1,0,1,0,1,2909
1,1,0,0,1,0,1,2909
0,0,1,0,1,0,1,2910
1,1,2,0,3,0,3,2910
2,2,0,0,3,0,3,2910
0,0,1,0,1,0,1,2911
1,1,0,0,1,0,1,2911
0,0,1,0,1,0,1,2912
1,1,0,0,1,0,1,2912
0,0,1,0,1,0,1,2913
1,1,1,0,2,0,2,2913
2,2,0,1,2,1,3,2913
3,3,0,2,2,3,5,2913
4,4,0,1,2,4,6,2913
5,5,1,2,3,6,9,2913
6,6,1,0,4,6,10,2913
7,7,1,0,5,6,11,2913
8,8,0,0,5,6,11,2913
0,0,1,0,1,0,1,2914
1,1,0,0,1,0,1,2914
0,0,1,0,1,0,1,2915
1,1,0,0,1,0,1,2915
0,0,1,0,1,0,1,2916
1,1,0,0,1,0,1,2916
0,0,1,0,1,0,1,2917
1,1,0,1,1,1,2,2917
2,2,0,1,1,2,3,2917
3,3,0,1,1,3,4,2917
4,4,0,1,1,4,5,2917
5,5,0,1,1,5,6,2917
6,6,0,1,1,6,7,2917
7,7,0,0,1,6,7,2917
0,0,1,0,1,0,1,2918
1,1,0,0,1,0,1,2918
0,0,1,0,1,0,1,2919
1,1,1,0,2,0,2,2919
2,2,2,0,4,0,4,2919
3,3,1,0,5,0,5,2919
4,4,0,0,5,0,5,2919
0,0,1,0,1,0,1,2920
1,1,0,1,1,1,2,2920
2,2,0,0,1,1,2,2920
0,0,1,0,1,0,1,2921
1,1,3,0,4,0,4,2921
2,2,3,1,7,1,8,2921
3,3,1,2,8,3,11,2921
4,4,0,4,8,7,15,2921
5,5,0,4,8,11,19,2921
6,6,0,1,8,12,20,2921
7,7,0,0,8,12,20,2921
0,0,1,0,1,0,1,2922
1,1,1,0,2,0,2,2922
2,2,1,0,3,0,3,2922
3,3,0,1,3,1,4,2922
4,4,0,1,3,2,5,2922
5,5,2,1,5,3,8,2922
6,6,1,0,6,3,9,2922
7,7,0,1,6,4,10,2922
8,8,0,1,6,5,11,2922
9,9,1,0,7,5,12,2922
10,10,0,0,7,5,12,2922
0,0,1,0,1,0,1,2923
1,1,0,0,1,0,1,2923
0,0,1,0,1,0,1,2924
1,1,1,0,2,0,2,2924
2,2,1,0,3,0,3,2924
3,3,1,0,4,0,4,2924
4,4,2,0,6,0,6,2924
5,5,1,0,7,0,7,2924
6,6,1,0,8,0,8,2924
7,7,0,0,8,0,8,2924
0,0,1,0,1,0,1,2925
1,1,3,0,4,0,4,2925
2,2,4,1,8,1,9,2925
3,3,2,2,10,3,13,2925
4,4,2,4,12,7,19,2925
5,5,5,1,17,8,25,2925
6,6,5,2,22,10,32,2925
7,7,3,1,25,11,36,2925
8,8,2,1,27,12,39,2925
9,9,2,0,29,12,41,2925
10,10,1,0,30,12,42,2925
11,11,0,0,30,12,42,2925
0,0,1,0,1,0,1,2926
1,1,0,0,1,0,1,2926
0,0,1,0,1,0,1,2927
1,1,0,0,1,0,1,2927
0,0,1,0,1,0,1,2928
1,1,1,0,2,0,2,2928
2,2,0,0,2,0,2,2928
0,0,1,0,1,0,1,2929
1,1,1,0,2,0,2,2929
2,2,0,0,2,0,2,2929
0,0,1,0,1,0,1,2930
1,1,1,0,2,0,2,2930
2,2,0,0,2,0,2,2930
0,0,1,0,1,0,1,2931
1,1,1,0,2,0,2,2931
2,2,2,0,4,0,4,2931
3,3,5,0,9,0,9,2931
4,4,4,2,13,2,15,2931
5,5,5,1,18,3,21,2931
6,6,5,2,23,5,28,2931
7,7,3,3,26,8,34,2931
8,8,3,5,29,13,42,2931
9,9,2,3,31,16,47,2931
10,10,0,2,31,18,49,2931
11,11,1,4,32,22,54,2931
12,12,1,1,33,23,56,2931
13,13,1,2,34,25,59,2931
14,14,2,6,36,31,67,2931
15,15,5,8,41,39,80,2931
16,16,5,4,46,43,89,2931
17,17,2,3,48,46,94,2931
18,18,5,3,53,49,102,2931
19,19,5,4,58,53,111,2931
20,20,2,3,60,56,116,2931
21,21,3,2,63,58,121,2931
22,22,2,7,65,65,130,2931
23,23,6,5,71,70,141,2931
24,24,2,4,73,74,147,2931
25,25,3,3,76,77,153,2931
26,26,0,3,76,80,156,2931
27,27,1,1,77,81,158,2931
28,28,1,2,78,83,161,2931
29,29,1,5,79,88,167,2931
30,30,0,6,79,94,173,2931
31,31,2,2,81,96,177,2931
32,32,4,1,85,97,182,2931
33,33,2,3,87,100,187,2931
34,34,0,2,87,102,189,2931
35,35,0,0,87,102,189,2931
0,0,1,0,1,0,1,2932
1,1,1,0,2,0,2,2932
2,2,0,0,2,0,2,2932
0,0,1,0,1,0,1,2933
1,1,0,0,1,0,1,2933
0,0,1,0,1,0,1,2934
1,1,1,0,2,0,2,2934
2,2,3,0,5,0,5,2934
3,3,5,0,10,0,10,2934
4,4,3,1,13,1,14,2934
5,5,0,0,13,1,14,2934
0,0,1,0,1,0,1,2935
1,1,4,1,5,1,6,2935
2,2,1,2,6,3,9,2935
3,3,2,4,8,7,15,2935
4,4,2,3,10,10,20,2935
5,5,4,3,14,13,27,2935
6,6,2,6,16,19,35,2935
7,7,4,4,20,23,43,2935
8,8,7,4,27,27,54,2935
9,9,4,4,31,31,62,2935
10,10,1,5,32,36,68,2935
11,11,0,1,32,37,69,2935
12,12,0,2,32,39,71,2935
13,13,1,0,33,39,72,2935
14,14,0,0,33,39,72,2935
0,0,1,0,1,0,1,2936
1,1,1,0,2,0,2,2936
2,2,1,0,3,0,3,2936
3,3,0,0,3,0,3,2936
0,0,1,0,1,0,1,2937
1,1,0,0,1,0,1,2937
0,0,1,0,1,0,1,2938
1,1,4,0,5,0,5,2938
2,2,3,1,8,1,9,2938
3,3,0,1,8,2,10,2938
4,4,0,2,8,4,12,2938
5,5,0,3,8,7,15,2938
6,6,0,2,8,9,17,2938
7,7,2,0,10,9,19,2938
8,8,0,0,10,9,19,2938
0,0,1,0,1,0,1,2939
1,1,0,0,1,0,1,2939
0,0,1,0,1,0,1,2940
1,1,0,0,1,0,1,2940
0,0,1,0,1,0,1,2941
1,1,2,0,3,0,3,2941
2,2,4,0,7,0,7,2941
3,3,6,1,13,1,14,2941
4,4,1,2,14,3,17,2941
5,5,1,3,15,6,21,2941
6,6,0,6,15,12,27,2941
7,7,1,4,16,16,32,2941
8,8,1,3,17,19,36,2941
9,9,1,4,18,23,41,2941
10,10,2,5,20,28,48,2941
11,11,2,3,22,31,53,2941
12,12,2,2,24,33,57,2941
13,13,3,4,27,37,64,2941
14,14,4,5,31,42,73,2941
15,15,3,4,34,46,80,2941
16,16,2,5,36,51,87,2941
17,17,1,3,37,54,91,2941
18,18,2,1,39,55,94,2941
19,19,1,1,40,56,96,2941
20,20,0,0,40,56,96,2941
0,0,1,0,1,0,1,2942
1,1,0,0,1,0,1,2942
0,0,1,0,1,0,1,2943
1,1,1,1,2,1,3,2943
2,2,1,1,3,2,5,2943
3,3,2,0,5,2,7,2943
4,4,1,1,6,3,9,2943
5,5,2,0,8,3,11,2943
6,6,1,1,9,4,13,2943
7,7,2,0,11,4,15,2943
8,8,0,0,11,4,15,2943
0,0,1,0,1,0,1,2944
1,1,0,0,1,0,1,2944
0,0,1,0,1,0,1,2945
1,1,1,0,2,0,2,2945
2,2,0,0,2,0,2,2945
0,0,1,0,1,0,1,2946
1,1,0,0,1,0,1,2946
0,0,1,0,1,0,1,2947
1,1,3,0,4,0,4,2947
2,2,1,1,5,1,6,2947
3,3,1,0,6,1,7,2947
4,4,1,0,7,1,8,2947
5,5,2,0,9,1,10,2947
6,6,2,0,11,1,12,2947
7,7,2,0,13,1,14,2947
8,8,1,2,14,3,17,2947
9,9,0,3,14,6,20,2947
10,10,2,3,16,9,25,2947
11,11,1,3,17,12,29,2947
12,12,3,0,20,12,32,2947
13,13,5,0,25,12,37,2947
14,14,5,0,30,12,42,2947
15,15,2,1,32,13,45,2947
16,16,2,2,34,15,49,2947
17,17,0,2,34,17,51,2947
18,18,0,1,34,18,52,2947
19,19,0,2,34,20,54,2947
20,20,0,1,34,21,55,2947
21,21,0,0,34,21,55,2947
0,0,1,0,1,0,1,2948
1,1,1,0,2,0,2,2948
2,2,1,0,3,0,3,2948
3,3,0,0,3,0,3,2948
0,0,1,0,1,0,1,2949
1,1,2,0,3,0,3,2949
2,2,1,0,4,0,4,2949
3,3,0,0,4,0,4,2949
0,0,1,0,1,0,1,2950
1,1,0,2,1,2,3,2950
2,2,1,1,2,3,5,2950
3,3,1,2,3,5,8,2950
4,4,1,2,4,7,11,2950
5,5,0,0,4,7,11,2950
0,0,1,0,1,0,1,2951
1,1,1,0,2,0,2,2951
2,2,0,1,2,1,3,2951
3,3,0,2,2,3,5,2951
4,4,0,2,2,5,7,2951
5,5,0,0,2,5,7,2951
0,0,1,0,1,0,1,2952
1,1,0,0,1,0,1,2952
0,0,1,0,1,0,1,2953
1,1,0,2,1,2,3,2953
2,2,1,0,2,2,4,2953
3,3,0,0,2,2,4,2953
0,0,1,0,1,0,1,2954
1,1,1,0,2,0,2,2954
2,2,0,0,2,0,2,2954
0,0,1,0,1,0,1,2955
1,1,0,0,1,0,1,2955
0,0,1,0,1,0,1,2956
1,1,1,0,2,0,2,2956
2,2,1,0,3,0,3,2956
3,3,1,0,4,0,4,2956
4,4,1,0,5,0,5,2956
5,5,1,1,6,1,7,2956
6,6,1,2,7,3,10,2956
7,7,2,1,9,4,13,2956
8,8,1,0,10,4,14,2956
9,9,1,0,11,4,15,2956
10,10,1,0,12,4,16,2956
11,11,0,1,12,5,17,2956
12,12,0,3,12,8,20,2956
13,13,0,2,12,10,22,2956
14,14,1,4,13,14,27,2956
15,15,1,2,14,16,30,2956
16,16,0,0,14,16,30,2956
0,0,1,0,1,0,1,2957
1,1,1,0,2,0,2,2957
2,2,1,0,3,0,3,2957
3,3,1,0,4,0,4,2957
4,4,0,0,4,0,4,2957
0,0,1,0,1,0,1,2958
1,1,1,0,2,0,2,2958
2,2,0,0,2,0,2,2958
0,0,1,0,1,0,1,2959
1,1,0,0,1,0,1,2959
0,0,1,0,1,0,1,2960
1,1,2,0,3,0,3,2960
2,2,2,0,5,0,5,2960
3,3,0,0,5,0,5,2960
0,0,1,0,1,0,1,2961
1,1,2,0,3,0,3,2961
2,2,2,2,5,2,7,2961
3,3,1,0,6,2,8,2961
4,4,0,0,6,2,8,2961
0,0,1,0,1,0,1,2962
1,1,0,0,1,0,1,2962
0,0,1,0,1,0,1,2963
1,1,2,0,3,0,3,2963
2,2,2,0,5,0,5,2963
3,3,0,0,5,0,5,2963
0,0,1,0,1,0,1,2964
1,1,0,0,1,0,1,2964
0,0,1,0,1,0,1,2965
1,1,0,0,1,0,1,2965
0,0,1,0,1,0,1,2966
1,1,1,0,2,0,2,2966
2,2,1,0,3,0,3,2966
3,3,0,0,3,0,3,2966
0,0,1,0,1,0,1,2967
1,1,0,1,1,1,2,2967
2,2,1,1,2,2,4,2967
3,3,0,1,2,3,5,2967
4,4,1,0,3,3,6,2967
5,5,0,0,3,3,6,2967
0,0,1,0,1,0,1,2968
1,1,1,0,2,0,2,2968
2,2,1,0,3,0,3,2968
3,3,1,0,4,0,4,2968
4,4,0,0,4,0,4,2968
0,0,1,0,1,0,1,2969
1,1,1,0,2,0,2,2969
2,2,1,0,3,0,3,2969
3,3,1,0,4,0,4,2969
4,4,0,0,4,0,4,2969
0,0,1,0,1,0,1,2970
1,1,0,0,1,0,1,2970
0,0,1,0,1,0,1,2971
1,1,1,0,2,0,2,2971
2,2,0,1,2,1,3,2971
3,3,0,0,2,1,3,2971
0,0,1,0,1,0,1,2972
1,1,0,0,1,0,1,2972
0,0,1,0,1,0,1,2973
1,1,1,0,2,0,2,2973
2,2,1,0,3,0,3,2973
3,3,1,0,4,0,4,2973
4,4,0,0,4,0,4,2973
0,0,1,0,1,0,1,2974
1,1,0,1,1,1,2,2974
2,2,2,0,3,1,4,2974
3,3,2,0,5,1,6,2974
4,4,0,0,5,1,6,2974
0,0,1,0,1,0,1,2975
1,1,1,0,2,0,2,2975
2,2,0,0,2,0,2,2975
0,0,1,0,1,0,1,2976
1,1,1,1,2,1,3,2976
2,2,2,1,4,2,6,2976
3,3,2,1,6,3,9,2976
4,4,1,0,7,3,10,2976
5,5,0,0,7,3,10,2976
0,0,1,0,1,0,1,2977
1,1,0,0,1,0,1,2977
0,0,1,0,1,0,1,2978
1,1,2,1,3,1,4,2978
2,2,2,2,5,3,8,2978
3,3,0,4,5,7,12,2978
4,4,0,3,5,10,15,2978
5,5,3,0,8,10,18,2978
6,6,3,0,11,10,21,2978
7,7,2,2,13,12,25,2978
8,8,1,2,14,14,28,2978
9,9,1,0,15,14,29,2978
10,10,1,1,16,15,31,2978
11,11,1,0,17,15,32,2978
12,12,0,0,17,15,32,2978
0,0,1,0,1,0,1,2979
1,1,4,0,5,0,5,2979
2,2,2,0,7,0,7,2979
3,3,2,0,9,0,9,2979
4,4,0,0,9,0,9,2979
0,0,1,0,1,0,1,2980
1,1,0,1,1,1,2,2980
2,2,0,1,1,2,3,2980
3,3,0,1,1,3,4,2980
4,4,0,1,1,4,5,2980
5,5,0,0,1,4,5,2980
0,0,1,0,1,0,1,2981
1,1,1,1,2,1,3,2981
2,2,1,0,3,1,4,2981
3,3,2,0,5,1,6,2981
4,4,1,1,6,2,8,2981
5,5,0,1,6,3,9,2981
6,6,1,2,7,5,12,2981
7,7,3,3,10,8,18,2981
8,8,3,3,13,11,24,2981
9,9,4,2,17,13,30,2981
10,10,2,3,19,16,35,2981
11,11,0,2,19,18,37,2981
12,12,0,0,19,18,37,2981
0,0,1,0,1,0,1,2982
1,1,1,1,2,1,3,2982
2,2,2,2,4,3,7,2982
3,3,0,0,4,3,7,2982
0,0,1,0,1,0,1,2983
1,1,2,0,3,0,3,2983
2,2,0,0,3,0,3,2983
0,0,1,0,1,0,1,2984
1,1,0,0,1,0,1,2984
0,0,1,0,1,0,1,2985
1,1,0,0,1,0,1,2985
0,0,1,0,1,0,1,2986
1,1,0,0,1,0,1,2986
0,0,1,0,1,0,1,2987
1,1,0,0,1,0,1,2987
0,0,1,0,1,0,1,2988
1,1,1,1,2,1,3,2988
2,2,1,1,3,2,5,2988
3,3,1,1,4,3,7,2988
4,4,1,0,5,3,8,2988
5,5,1,0,6,3,9,2988
6,6,0,1,6,4,10,2988
7,7,0,0,6,4,10,2988
0,0,1,0,1,0,1,2989
1,1,0,0,1,0,1,2989
0,0,1,0,1,0,1,2990
1,1,1,0,2,0,2,2990
2,2,0,0,2,0,2,2990
0,0,1,0,1,0,1,2991
1,1,2,0,3,0,3,2991
2,2,4,0,7,0,7,2991
3,3,4,2,11,2,13,2991
4,4,8,2,19,4,23,2991
5,5,6,7,25,11,36,2991
6,6,3,4,28,15,43,2991
7,7,1,0,29,15,44,2991
8,8,0,0,29,15,44,2991
0,0,1,0,1,0,1,2992
1,1,3,0,4,0,4,2992
2,2,3,0,7,0,7,2992
3,3,6,0,13,0,13,2992
4,4,4,0,17,0,17,2992
5,5,3,1,20,1,21,2992
6,6,3,2,23,3,26,2992
7,7,7,1,30,4,34,2992
8,8,6,1,36,5,41,2992
9,9,6,2,42,7,49,2992
10,10,7,0,49,7,56,2992
11,11,5,1,54,8,62,2992
12,12,3,2,57,10,67,2992
13,13,1,2,58,12,70,2992
14,14,1,5,59,17,76,2992
15,15,1,3,60,20,80,2992
16,16,2,0,62,20,82,2992
17,17,3,1,65,21,86,2992
18,18,1,0,66,21,87,2992
19,19,1,0,67,21,88,2992
20,20,3,1,70,22,92,2992
21,21,2,3,72,25,97,2992
22,22,1,1,73,26,99,2992
23,23,3,1,76,27,103,2992
24,24,4,1,80,28,108,2992
25,25,3,1,83,29,112,2992
26,26,2,1,85,30,115,2992
27,27,1,1,86,31,117,2992
28,28,1,1,87,32,119,2992
29,29,1,2,88,34,122,2992
30,30,0,0,88,34,122,2992
0,0,1,0,1,0,1,2993
1,1,0,0,1,0,1,2993
0,0,1,0,1,0,1,2994
1,1,0,0,1,0,1,2994
0,0,1,0,1,0,1,2995
1,1,0,1,1,1,2,2995
2,2,0,0,1,1,2,2995
0,0,1,0,1,0,1,2996
1,1,0,0,1,0,1,2996
0,0,1,0,1,0,1,2997
1,1,0,1,1,1,2,2997
2,2,0,0,1,1,2,2997
0,0,1,0,1,0,1,2998
1,1,0,0,1,0,1,2998
0,0,1,0,1,0,1,2999
1,1,0,0,1,0,1,2999
0,0,1,0,1,0,1,3000
1,1,1,0,2,0,2,3000
2,2,2,0,4,0,4,3000
3,3,0,1,4,1,5,3000
4,4,0,1,4,2,6,3000
5,5,0,2,4,4,8,3000
6,6,0,0,4,4,8,3000
0,0,1,0,1,0,1,3001
1,1,0,0,1,0,1,3001
0,0,1,0,1,0,1,3002
1,1,1,0,2,0,2,3002
2,2,0,0,2,0,2,3002
0,0,1,0,1,0,1,3003
1,1,0,0,1,0,1,3003
0,0,1,0,1,0,1,3004
1,1,0,0,1,0,1,3004
0,0,1,0,1,0,1,3005
1,1,2,0,3,0,3,3005
2,2,4,0,7,0,7,3005
3,3,2,0,9,0,9,3005
4,4,1,0,10,0,10,3005
5,5,1,0,11,0,11,3005
6,6,0,0,11,0,11,3005
0,0,1,0,1,0,1,3006
1,1,1,0,2,0,2,3006
2,2,0,0,2,0,2,3006
0,0,1,0,1,0,1,3007
1,1,0,0,1,0,1,3007
0,0,1,0,1,0,1,3008
1,1,1,0,2,0,2,3008
2,2,1,0,3,0,3,3008
3,3,0,0,3,0,3,3008
0,0,1,0,1,0,1,3009
1,1,1,1,2,1,3,3009
2,2,1,1,3,2,5,3009
3,3,0,2,3,4,7,3009
4,4,0,6,3,10,13,3009
5,5,1,8,4,18,22,3009
6,6,1,5,5,23,28,3009
7,7,4,6,9,29,38,3009
8,8,7,6,16,35,51,3009
9,9,5,7,21,42,63,3009
10,10,7,2,28,44,72,3009
11,11,3,5,31,49,80,3009
12,12,6,5,37,54,91,3009
13,13,7,3,44,57,101,3009
14,14,6,6,50,63,113,3009
15,15,6,6,56,69,125,3009
16,16,6,3,62,72,134,3009
17,17,6,4,68,76,144,3009
18,18,6,6,74,82,156,3009
19,19,6,8,80,90,170,3009
20,20,4,6,84,96,180,3009
21,21,2,8,86,104,190,3009
22,22,1,7,87,111,198,3009
23,23,1,6,88,117,205,3009
24,24,3,6,91,123,214,3009
25,25,3,5,94,128,222,3009
26,26,3,4,97,132,229,3009
27,27,3,3,100,135,235,3009
28,28,1,4,101,139,240,3009
29,29,1,2,102,141,243,3009
30,30,1,0,103,141,244,3009
31,31,0,0,103,141,244,3009
0,0,1,0,1,0,1,3010
1,1,1,0,2,0,2,3010
2,2,0,0,2,0,2,3010
0,0,1,0,1,0,1,3011
1,1,2,0,3,0,3,3011
2,2,0,1,3,1,4,3011
3,3,0,0,3,1,4,3011
0,0,1,0,1,0,1,3012
1,1,1,0,2,0,2,3012
2,2,1,0,3,0,3,3012
3,3,1,0,4,0,4,3012
4,4,0,0,4,0,4,3012
0,0,1,0,1,0,1,3013
1,1,0,0,1,0,1,3013
0,0,1,0,1,0,1,3014
1,1,0,0,1,0,1,3014
0,0,1,0,1,0,1,3015
1,1,0,0,1,0,1,3015
0,0,1,0,1,0,1,3016
1,1,0,0,1,0,1,3016
0,0,1,0,1,0,1,3017
1,1,0,0,1,0,1,3017
0,0,1,0,1,0,1,3018
1,1,1,0,2,0,2,3018
2,2,0,0,2,0,2,3018
0,0,1,0,1,0,1,3019
1,1,1,0,2,0,2,3019
2,2,1,0,3,0,3,3019
3,3,0,0,3,0,3,3019
0,0,1,0,1,0,1,3020
1,1,1,0,2,0,2,3020
2,2,0,0,2,0,2,3020
0,0,1,0,1,0,1,3021
1,1,1,0,2,0,2,3021
2,2,3,0,5,0,5,3021
3,3,0,1,5,1,6,3021
4,4,0,0,5,1,6,3021
0,0,1,0,1,0,1,3022
1,1,2,0,3,0,3,3022
2,2,0,0,3,0,3,3022
0,0,1,0,1,0,1,3023
1,1,3,0,4,0,4,3023
2,2,3,0,7,0,7,3023
3,3,1,2,8,2,10,3023
4,4,1,4,9,6,15,3023
5,5,1,2,10,8,18,3023
6,6,0,0,10,8,18,3023
0,0,1,0,1,0,1,3024
1,1,0,0,1,0,1,3024
0,0,1,0,1,0,1,3025
1,1,0,0,1,0,1,3025
0,0,1,0,1,0,1,3026
1,1,1,0,2,0,2,3026
2,2,1,0,3,0,3,3026
3,3,0,1,3,1,4,3026
4,4,0,1,3,2,5,3026
5,5,0,0,3,2,5,3026
0,0,1,0,1,0,1,3027
1,1,0,1,1,1,2,3027
2,2,0,2,1,3,4,3027
3,3,0,0,1,3,4,3027
0,0,1,0,1,0,1,3028
1,1,0,0,1,0,1,3028
0,0,1,0,1,0,1,3029
1,1,1,0,2,0,2,3029
2,2,0,0,2,0,2,3029
0,0,1,0,1,0,1,3030
1,1,0,0,1,0,1,3030
0,0,1,0,1,0,1,3031
1,1,2,1,3,1,4,3031
2,2,1,2,4,3,7,3031
3,3,3,0,7,3,10,3031
4,4,2,1,9,4,13,3031
5,5,0,1,9,5,14,3031
6,6,1,0,10,5,15,3031
7,7,0,0,10,5,15,3031
0,0,1,0,1,0,1,3032
1,1,1,0,2,0,2,3032
2,2,3,0,5,0,5,3032
3,3,0,1,5,1,6,3032
4,4,0,0,5,1,6,3032
0,0,1,0,1,0,1,3033
1,1,2,0,3,0,3,3033
2,2,1,0,4,0,4,3033
3,3,0,0,4,0,4,3033
0,0,1,0,1,0,1,3034
1,1,2,0,3,0,3,3034
2,2,2,1,5,1,6,3034
3,3,2,0,7,1,8,3034
4,4,2,0,9,1,10,3034
5,5,4,1,13,2,15,3034
6,6,4,1,17,3,20,3034
7,7,5,3,22,6,28,3034
8,8,6,1,28,7,35,3034
9,9,2,2,30,9,39,3034
10,10,2,3,32,12,44,3034
11,11,2,2,34,14,48,3034
12,12,0,3,34,17,51,3034
13,13,0,2,34,19,53,3034
14,14,1,1,35,20,55,3034
15,15,2,1,37,21,58,3034
16,16,2,1,39,22,61,3034
17,17,1,0,40,22,62,3034
18,18,0,0,40,22,62,3034
0,0,1,0,1,0,1,3035
1,1,0,0,1,0,1,3035
0,0,1,0,1,0,1,3036
1,1,1,0,2,0,2,3036
2,2,1,0,3,0,3,3036
3,3,0,0,3,0,3,3036
0,0,1,0,1,0,1,3037
1,1,0,0,1,0,1,3037
0,0,1,0,1,0,1,3038
1,1,2,0,3,0,3,3038
2,2,1,0,4,0,4,3038
3,3,0,0,4,0,4,3038
0,0,1,0,1,0,1,3039
1,1,1,1,2,1,3,3039
2,2,1,0,3,1,4,3039
3,3,1,1,4,2,6,3039
4,4,0,0,4,2,6,3039
0,0,1,0,1,0,1,3040
1,1,0,0,1,0,1,3040
0,0,1,0,1,0,1,3041
1,1,0,0,1,0,1,3041
0,0,1,0,1,0,1,3042
1,1,0,0,1,0,1,3042
0,0,1,0,1,0,1,3043
1,1,3,0,4,0,4,3043
2,2,0,0,4,0,4,3043
0,0,1,0,1,0,1,3044
1,1,1,0,2,0,2,3044
2,2,2,1,4,1,5,3044
3,3,1,2,5,3,8,3044
4,4,0,2,5,5,10,3044
5,5,0,1,5,6,11,3044
6,6,0,0,5,6,11,3044
0,0,1,0,1,0,1,3045
1,1,1,1,2,1,3,3045
2,2,1,2,3,3,6,3045
3,3,0,1,3,4,7,3045
4,4,0,0,3,4,7,3045
0,0,1,0,1,0,1,3046
1,1,1,0,2,0,2,3046
2,2,0,1,2,1,3,3046
3,3,0,2,2,3,5,3046
4,4,0,1,2,4,6,3046
5,5,0,2,2,6,8,3046
6,6,0,1,2,7,9,3046
7,7,0,2,2,9,11,3046
8,8,1,0,3,9,12,3046
9,9,1,1,4,10,14,3046
10,10,2,0,6,10,16,3046
11,11,3,0,9,10,19,3046
12,12,2,2,11,12,23,3046
13,13,1,3,12,15,27,3046
14,14,1,4,13,19,32,3046
15,15,0,1,13,20,33,3046
16,16,0,2,13,22,35,3046
17,17,0,2,13,24,37,3046
18,18,0,2,13,26,39,3046
19,19,0,0,13,26,39,3046
0,0,1,0,1,0,1,3047
1,1,0,0,1,0,1,3047
0,0,1,0,1,0,1,3048
1,1,2,0,3,0,3,3048
2,2,3,0,6,0,6,3048
3,3,3,1,9,1,10,3048
4,4,3,2,12,3,15,3048
5,5,2,2,14,5,19,3048
6,6,1,0,15,5,20,3048
7,7,0,0,15,5,20,3048
0,0,1,0,1,0,1,3049
1,1,1,0,2,0,2,3049
2,2,1,0,3,0,3,3049
3,3,1,0,4,0,4,3049
4,4,2,0,6,0,6,3049
5,5,1,0,7,0,7,3049
6,6,0,0,7,0,7,3049
0,0,1,0,1,0,1,3050
1,1,1,1,2,1,3,3050
2,2,0,1,2,2,4,3050
3,3,0,1,2,3,5,3050
4,4,0,0,2,3,5,3050
0,0,1,0,1,0,1,3051
1,1,0,0,1,0,1,3051
0,0,1,0,1,0,1,3052
1,1,1,0,2,0,2,3052
2,2,0,1,2,1,3,3052
3,3,0,1,2,2,4,3052
4,4,0,0,2,2,4,3052
0,0,1,0,1,0,1,3053
1,1,1,0,2,0,2,3053
2,2,2,0,4,0,4,3053
3,3,1,0,5,0,5,3053
4,4,1,0,6,0,6,3053
5,5,2,0,8,0,8,3053
6,6,1,0,9,0,9,3053
7,7,0,0,9,0,9,3053
0,0,1,0,1,0,1,3054
1,1,0,0,1,0,1,3054
0,0,1,0,1,0,1,3055
1,1,1,0,2,0,2,3055
2,2,0,0,2,0,2,3055
0,0,1,0,1,0,1,3056
1,1,0,0,1,0,1,3056
0,0,1,0,1,0,1,3057
1,1,0,1,1,1,2,3057
2,2,0,0,1,1,2,3057
0,0,1,0,1,0,1,3058
1,1,2,0,3,0,3,3058
2,2,2,0,5,0,5,3058
3,3,2,0,7,0,7,3058
4,4,2,0,9,0,9,3058
5,5,1,0,10,0,10,3058
6,6,0,1,10,1,11,3058
7,7,0,3,10,4,14,3058
8,8,0,2,10,6,16,3058
9,9,1,1,11,7,18,3058
10,10,0,0,11,7,18,3058
0,0,1,0,1,0,1,3059
1,1,1,1,2,1,3,3059
2,2,3,2,5,3,8,3059
3,3,4,0,9,3,12,3059
4,4,3,0,12,3,15,3059
5,5,1,0,13,3,16,3059
6,6,1,0,14,3,17,3059
7,7,2,0,16,3,19,3059
8,8,2,1,18,4,22,3059
9,9,1,0,19,4,23,3059
10,10,2,0,21,4,25,3059
11,11,0,0,21,4,25,3059
0,0,1,0,1,0,1,3060
1,1,0,0,1,0,1,3060
0,0,1,0,1,0,1,3061
1,1,0,0,1,0,1,3061
0,0,1,0,1,0,1,3062
1,1,0,0,1,0,1,3062
0,0,1,0,1,0,1,3063
1,1,1,0,2,0,2,3063
2,2,0,0,2,0,2,3063
0,0,1,0,1,0,1,3064
1,1,1,0,2,0,2,3064
2,2,0,1,2,1,3,3064
3,3,0,0,2,1,3,3064
0,0,1,0,1,0,1,3065
1,1,0,0,1,0,1,3065
0,0,1,0,1,0,1,3066
1,1,1,2,2,2,4,3066
2,2,0,2,2,4,6,3066
3,3,0,1,2,5,7,3066
4,4,0,1,2,6,8,3066
5,5,0,0,2,6,8,3066
0,0,1,0,1,0,1,3067
1,1,0,0,1,0,1,3067
0,0,1,0,1,0,1,3068
1,1,0,0,1,0,1,3068
0,0,1,0,1,0,1,3069
1,1,0,1,1,1,2,3069
2,2,0,0,1,1,2,3069
0,0,1,0,1,0,1,3070
1,1,1,0,2,0,2,3070
2,2,1,0,3,0,3,3070
3,3,0,0,3,0,3,3070
0,0,1,0,1,0,1,3071
1,1,1,0,2,0,2,3071
2,2,0,0,2,0,2,3071
0,0,1,0,1,0,1,3072
1,1,0,0,1,0,1,3072
0,0,1,0,1,0,1,3073
1,1,1,0,2,0,2,3073
2,2,2,0,4,0,4,3073
3,3,1,0,5,0,5,3073
4,4,1,0,6,0,6,3073
5,5,2,0,8,0,8,3073
6,6,3,1,11,1,12,3073
7,7,3,0,14,1,15,3073
8,8,2,0,16,1,17,3073
9,9,2,0,18,1,19,3073
10,10,1,0,19,1,20,3073
11,11,1,0,20,1,21,3073
12,12,4,0,24,1,25,3073
13,13,2,1,26,2,28,3073
14,14,0,1,26,3,29,3073
15,15,0,0,26,3,29,3073
0,0,1,0,1,0,1,3074
1,1,0,0,1,0,1,3074
0,0,1,0,1,0,1,3075
1,1,0,0,1,0,1,3075
0,0,1,0,1,0,1,3076
1,1,1,0,2,0,2,3076
2,2,0,0,2,0,2,3076
0,0,1,0,1,0,1,3077
1,1,3,0,4,0,4,3077
2,2,2,0,6,0,6,3077
3,3,3,1,9,1,10,3077
4,4,3,2,12,3,15,3077
5,5,4,2,16,5,21,3077
6,6,4,2,20,7,27,3077
7,7,2,4,22,11,33,3077
8,8,3,5,25,16,41,3077
9,9,5,6,30,22,52,3077
10,10,4,7,34,29,63,3077
11,11,3,7,37,36,73,3077
12,12,7,3,44,39,83,3077
13,13,6,4,50,43,93,3077
14,14,2,5,52,48,100,3077
15,15,8,7,60,55,115,3077
16,16,8,8,68,63,131,3077
17,17,8,6,76,69,145,3077
18,18,8,12,84,81,165,3077
19,19,5,15,89,96,185,3077
20,20,2,4,91,100,191,3077
21,21,2,1,93,101,194,3077
22,22,1,1,94,102,196,3077
23,23,1,2,95,104,199,3077
24,24,0,0,95,104,199,3077
0,0,1,0,1,0,1,3078
1,1,0,0,1,0,1,3078
0,0,1,0,1,0,1,3079
1,1,0,0,1,0,1,3079
0,0,1,0,1,0,1,3080
1,1,1,0,2,0,2,3080
2,2,1,0,3,0,3,3080
3,3,1,0,4,0,4,3080
4,4,3,1,7,1,8,3080
5,5,3,1,10,2,12,3080
6,6,3,2,13,4,17,3080
7,7,1,0,14,4,18,3080
8,8,0,0,14,4,18,3080
0,0,1,0,1,0,1,3081
1,1,1,0,2,0,2,3081
2,2,0,0,2,0,2,3081
0,0,1,0,1,0,1,3082
1,1,1,0,2,0,2,3082
2,2,0,0,2,0,2,3082
0,0,1,0,1,0,1,3083
1,1,2,1,3,1,4,3083
2,2,1,0,4,1,5,3083
3,3,2,0,6,1,7,3083
4,4,2,1,8,2,10,3083
5,5,0,1,8,3,11,3083
6,6,0,0,8,3,11,3083
0,0,1,0,1,0,1,3084
1,1,2,0,3,0,3,3084
2,2,0,0,3,0,3,3084
0,0,1,0,1,0,1,3085
1,1,0,0,1,0,1,3085
0,0,1,0,1,0,1,3086
1,1,2,0,3,0,3,3086
2,2,1,0,4,0,4,3086
3,3,0,0,4,0,4,3086
0,0,1,0,1,0,1,3087
1,1,2,0,3,0,3,3087
2,2,0,0,3,0,3,3087
0,0,1,0,1,0,1,3088
1,1,0,0,1,0,1,3088
0,0,1,0,1,0,1,3089
1,1,1,1,2,1,3,3089
2,2,1,1,3,2,5,3089
3,3,0,1,3,3,6,3089
4,4,0,1,3,4,7,3089
5,5,0,2,3,6,9,3089
6,6,0,1,3,7,10,3089
7,7,0,0,3,7,10,3089
0,0,1,0,1,0,1,3090
1,1,1,0,2,0,2,3090
2,2,1,0,3,0,3,3090
3,3,0,2,3,2,5,3090
4,4,0,1,3,3,6,3090
5,5,0,0,3,3,6,3090
0,0,1,0,1,0,1,3091
1,1,1,1,2,1,3,3091
2,2,2,1,4,2,6,3091
3,3,0,0,4,2,6,3091
0,0,1,0,1,0,1,3092
1,1,0,0,1,0,1,3092
0,0,1,0,1,0,1,3093
1,1,1,0,2,0,2,3093
2,2,2,0,4,0,4,3093
3,3,0,0,4,0,4,3093
0,0,1,0,1,0,1,3094
1,1,3,0,4,0,4,3094
2,2,2,0,6,0,6,3094
3,3,1,0,7,0,7,3094
4,4,2,2,9,2,11,3094
5,5,2,1,11,3,14,3094
6,6,0,0,11,3,14,3094
0,0,1,0,1,0,1,3095
1,1,0,0,1,0,1,3095
0,0,1,0,1,0,1,3096
1,1,0,0,1,0,1,3096
0,0,1,0,1,0,1,3097
1,1,1,0,2,0,2,3097
2,2,0,0,2,0,2,3097
0,0,1,0,1,0,1,3098
1,1,0,0,1,0,1,3098
0,0,1,0,1,0,1,3099
1,1,2,0,3,0,3,3099
2,2,2,0,5,0,5,3099
3,3,3,0,8,0,8,3099
4,4,0,0,8,0,8,3099
0,0,1,0,1,0,1,3100
1,1,0,0,1,0,1,3100
0,0,1,0,1,0,1,3101
1,1,1,0,2,0,2,3101
2,2,0,1,2,1,3,3101
3,3,1,0,3,1,4,3101
4,4,1,2,4,3,7,3101
5,5,1,2,5,5,10,3101
6,6,1,3,6,8,14,3101
7,7,1,2,7,10,17,3101
8,8,2,0,9,10,19,3101
9,9,1,0,10,10,20,3101
10,10,0,0,10,10,20,3101
0,0,1,0,1,0,1,3102
1,1,1,0,2,0,2,3102
2,2,0,0,2,0,2,3102
0,0,1,0,1,0,1,3103
1,1,1,0,2,0,2,3103
2,2,0,0,2,0,2,3103
0,0,1,0,1,0,1,3104
1,1,0,0,1,0,1,3104
0,0,1,0,1,0,1,3105
1,1,0,0,1,0,1,3105
0,0,1,0,1,0,1,3106
1,1,0,0,1,0,1,3106
0,0,1,0,1,0,1,3107
1,1,0,0,1,0,1,3107
0,0,1,0,1,0,1,3108
1,1,0,0,1,0,1,3108
0,0,1,0,1,0,1,3109
1,1,1,0,2,0,2,3109
2,2,0,0,2,0,2,3109
0,0,1,0,1,0,1,3110
1,1,1,0,2,0,2,3110
2,2,1,0,3,0,3,3110
3,3,2,0,5,0,5,3110
4,4,1,0,6,0,6,3110
5,5,2,0,8,0,8,3110
6,6,1,0,9,0,9,3110
7,7,2,0,11,0,11,3110
8,8,1,1,12,1,13,3110
9,9,0,0,12,1,13,3110
0,0,1,0,1,0,1,3111
1,1,1,2,2,2,4,3111
2,2,1,0,3,2,5,3111
3,3,1,0,4,2,6,3111
4,4,0,0,4,2,6,3111
0,0,1,0,1,0,1,3112
1,1,0,0,1,0,1,3112
0,0,1,0,1,0,1,3113
1,1,1,0,2,0,2,3113
2,2,0,0,2,0,2,3113
0,0,1,0,1,0,1,3114
1,1,2,0,3,0,3,3114
2,2,1,0,4,0,4,3114
3,3,0,0,4,0,4,3114
0,0,1,0,1,0,1,3115
1,1,1,0,2,0,2,3115
2,2,1,0,3,0,3,3115
3,3,0,0,3,0,3,3115
0,0,1,0,1,0,1,3116
1,1,0,0,1,0,1,3116
0,0,1,0,1,0,1,3117
1,1,4,0,5,0,5,3117
2,2,2,0,7,0,7,3117
3,3,0,1,7,1,8,3117
4,4,0,0,7,1,8,3117
0,0,1,0,1,0,1,3118
1,1,0,0,1,0,1,3118
0,0,1,0,1,0,1,3119
1,1,1,1,2,1,3,3119
2,2,2,1,4,2,6,3119
3,3,1,2,5,4,9,3119
4,4,0,2,5,6,11,3119
5,5,1,2,6,8,14,3119
6,6,1,2,7,10,17,3119
7,7,2,0,9,10,19,3119
8,8,3,1,12,11,23,3119
9,9,1,1,13,12,25,3119
10,10,1,1,14,13,27,3119
11,11,1,1,15,14,29,3119
12,12,2,0,17,14,31,3119
13,13,0,0,17,14,31,3119
0,0,1,0,1,0,1,3120
1,1,1,0,2,0,2,3120
2,2,0,0,2,0,2,3120
0,0,1,0,1,0,1,3121
1,1,1,0,2,0,2,3121
2,2,0,0,2,0,2,3121
0,0,1,0,1,0,1,3122
1,1,0,0,1,0,1,3122
0,0,1,0,1,0,1,3123
1,1,1,0,2,0,2,3123
2,2,2,0,4,0,4,3123
3,3,2,0,6,0,6,3123
4,4,0,0,6,0,6,3123
0,0,1,0,1,0,1,3124
1,1,1,1,2,1,3,3124
2,2,0,1,2,2,4,3124
3,3,1,1,3,3,6,3124
4,4,2,1,5,4,9,3124
5,5,0,1,5,5,10,3124
6,6,0,0,5,5,10,3124
0,0,1,0,1,0,1,3125
1,1,0,0,1,0,1,3125
0,0,1,0,1,0,1,3126
1,1,0,0,1,0,1,3126
0,0,1,0,1,0,1,3127
1,1,1,0,2,0,2,3127
2,2,0,0,2,0,2,3127
0,0,1,0,1,0,1,3128
1,1,1,0,2,0,2,3128
2,2,1,0,3,0,3,3128
3,3,0,0,3,0,3,3128
0,0,1,0,1,0,1,3129
1,1,0,0,1,0,1,3129
0,0,1,0,1,0,1,3130
1,1,0,1,1,1,2,3130
2,2,0,0,1,1,2,3130
0,0,1,0,1,0,1,3131
1,1,0,0,1,0,1,3131
0,0,1,0,1,0,1,3132
1,1,0,0,1,0,1,3132
0,0,1,0,1,0,1,3133
1,1,1,0,2,0,2,3133
2,2,1,0,3,0,3,3133
3,3,1,1,4,1,5,3133
4,4,0,1,4,2,6,3133
5,5,0,2,4,4,8,3133
6,6,0,2,4,6,10,3133
7,7,0,1,4,7,11,3133
8,8,0,0,4,7,11,3133
0,0,1,0,1,0,1,3134
1,1,1,1,2,1,3,3134
2,2,0,0,2,1,3,3134
0,0,1,0,1,0,1,3135
1,1,0,0,1,0,1,3135
0,0,1,0,1,0,1,3136
1,1,0,0,1,0,1,3136
0,0,1,0,1,0,1,3137
1,1,1,0,2,0,2,3137
2,2,0,0,2,0,2,3137
0,0,1,0,1,0,1,3138
1,1,2,1,3,1,4,3138
2,2,3,0,6,1,7,3138
3,3,3,0,9,1,10,3138
4,4,1,1,10,2,12,3138
5,5,0,0,10,2,12,3138
0,0,1,0,1,0,1,3139
1,1,2,0,3,0,3,3139
2,2,0,1,3,1,4,3139
3,3,0,1,3,2,5,3139
4,4,0,1,3,3,6,3139
5,5,0,0,3,3,6,3139
0,0,1,0,1,0,1,3140
1,1,0,0,1,0,1,3140
0,0,1,0,1,0,1,3141
1,1,2,0,3,0,3,3141
2,2,3,2,6,2,8,3141
3,3,4,2,10,4,14,3141
4,4,1,0,11,4,15,3141
5,5,0,0,11,4,15,3141
0,0,1,0,1,0,1,3142
1,1,2,0,3,0,3,3142
2,2,0,1,3,1,4,3142
3,3,0,0,3,1,4,3142
0,0,1,0,1,0,1,3143
1,1,0,0,1,0,1,3143
0,0,1,0,1,0,1,3144
1,1,2,0,3,0,3,3144
2,2,2,0,5,0,5,3144
3,3,4,0,9,0,9,3144
4,4,1,0,10,0,10,3144
5,5,0,0,10,0,10,3144
0,0,1,0,1,0,1,3145
1,1,0,0,1,0,1,3145
0,0,1,0,1,0,1,3146
1,1,0,0,1,0,1,3146
0,0,1,0,1,0,1,3147
1,1,0,0,1,0,1,3147
0,0,1,0,1,0,1,3148
1,1,0,0,1,0,1,3148
0,0,1,0,1,0,1,3149
1,1,1,0,2,0,2,3149
2,2,0,0,2,0,2,3149
0,0,1,0,1,0,1,3150
1,1,0,0,1,0,1,3150
0,0,1,0,1,0,1,3151
1,1,0,0,1,0,1,3151
0,0,1,0,1,0,1,3152
1,1,1,0,2,0,2,3152
2,2,1,0,3,0,3,3152
3,3,0,0,3,0,3,3152
0,0,1,0,1,0,1,3153
1,1,1,2,2,2,4,3153
2,2,2,1,4,3,7,3153
3,3,0,0,4,3,7,3153
0,0,1,0,1,0,1,3154
1,1,3,0,4,0,4,3154
2,2,6,0,10,0,10,3154
3,3,3,1,13,1,14,3154
4,4,4,1,17,2,19,3154
5,5,4,2,21,4,25,3154
6,6,6,3,27,7,34,3154
7,7,7,5,34,12,46,3154
8,8,5,4,39,16,55,3154
9,9,3,3,42,19,61,3154
10,10,5,3,47,22,69,3154
11,11,4,1,51,23,74,3154
12,12,5,0,56,23,79,3154
13,13,7,0,63,23,86,3154
14,14,5,0,68,23,91,3154
15,15,2,1,70,24,94,3154
16,16,2,1,72,25,97,3154
17,17,1,1,73,26,99,3154
18,18,0,1,73,27,100,3154
19,19,0,1,73,28,101,3154
20,20,1,0,74,28,102,3154
21,21,1,1,75,29,104,3154
22,22,1,2,76,31,107,3154
23,23,0,3,76,34,110,3154
24,24,0,2,76,36,112,3154
25,25,0,2,76,38,114,3154
26,26,0,1,76,39,115,3154
27,27,0,1,76,40,116,3154
28,28,0,3,76,43,119,3154
29,29,0,6,76,49,125,3154
30,30,0,4,76,53,129,3154
31,31,1,2,77,55,132,3154
32,32,0,0,77,55,132,3154
0,0,1,0,1,0,1,3155
1,1,2,0,3,0,3,3155
2,2,3,0,6,0,6,3155
3,3,4,0,10,0,10,3155
4,4,5,1,15,1,16,3155
5,5,2,0,17,1,18,3155
6,6,2,0,19,1,20,3155
7,7,1,0,20,1,21,3155
8,8,1,0,21,1,22,3155
9,9,4,1,25,2,27,3155
10,10,3,2,28,4,32,3155
11,11,5,2,33,6,39,3155
12,12,1,1,34,7,41,3155
13,13,0,1,34,8,42,3155
14,14,1,0,35,8,43,3155
15,15,0,0,35,8,43,3155
0,0,1,0,1,0,1,3156
1,1,0,0,1,0,1,3156
0,0,1,0,1,0,1,3157
1,1,4,0,5,0,5,3157
2,2,5,0,10,0,10,3157
3,3,3,1,13,1,14,3157
4,4,0,0,13,1,14,3157
0,0,1,0,1,0,1,3158
1,1,2,0,3,0,3,3158
2,2,1,0,4,0,4,3158
3,3,0,0,4,0,4,3158
0,0,1,0,1,0,1,3159
1,1,1,0,2,0,2,3159
2,2,0,0,2,0,2,3159
0,0,1,0,1,0,1,3160
1,1,2,1,3,1,4,3160
2,2,1,1,4,2,6,3160
3,3,2,1,6,3,9,3160
4,4,0,0,6,3,9,3160
0,0,1,0,1,0,1,3161
1,1,2,0,3,0,3,3161
2,2,3,0,6,0,6,3161
3,3,3,0,9,0,9,3161
4,4,5,0,14,0,14,3161
5,5,2,1,16,1,17,3161
6,6,3,2,19,3,22,3161
7,7,1,2,20,5,25,3161
8,8,3,1,23,6,29,3161
9,9,3,0,26,6,32,3161
10,10,3,1,29,7,36,3161
11,11,1,1,30,8,38,3161
12,12,2,0,32,8,40,3161
13,13,1,0,33,8,41,3161
14,14,2,0,35,8,43,3161
15,15,3,1,38,9,47,3161
16,16,4,2,42,11,53,3161
17,17,1,2,43,13,56,3161
18,18,2,0,45,13,58,3161
19,19,1,0,46,13,59,3161
20,20,0,0,46,13,59,3161
0,0,1,0,1,0,1,3162
1,1,1,0,2,0,2,3162
2,2,0,0,2,0,2,3162
0,0,1,0,1,0,1,3163
1,1,0,1,1,1,2,3163
2,2,0,1,1,2,3,3163
3,3,0,1,1,3,4,3163
4,4,0,2,1,5,6,3163
5,5,1,0,2,5,7,3163
6,6,0,1,2,6,8,3163
7,7,0,0,2,6,8,3163
0,0,1,0,1,0,1,3164
1,1,0,2,1,2,3,3164
2,2,0,4,1,6,7,3164
3,3,1,5,2,11,13,3164
4,4,3,7,5,18,23,3164
5,5,2,5,7,23,30,3164
6,6,0,0,7,23,30,3164
0,0,1,0,1,0,1,3165
1,1,0,0,1,0,1,3165
0,0,1,0,1,0,1,3166
1,1,0,0,1,0,1,3166
0,0,1,0,1,0,1,3167
1,1,0,1,1,1,2,3167
2,2,0,0,1,1,2,3167
0,0,1,0,1,0,1,3168
1,1,1,1,2,1,3,3168
2,2,0,1,2,2,4,3168
3,3,0,0,2,2,4,3168
0,0,1,0,1,0,1,3169
1,1,1,0,2,0,2,3169
2,2,1,2,3,2,5,3169
3,3,2,1,5,3,8,3169
4,4,1,0,6,3,9,3169
5,5,0,1,6,4,10,3169
6,6,0,1,6,5,11,3169
7,7,1,0,7,5,12,3169
8,8,1,0,8,5,13,3169
9,9,0,0,8,5,13,3169
0,0,1,0,1,0,1,3170
1,1,2,1,3,1,4,3170
2,2,1,1,4,2,6,3170
3,3,1,0,5,2,7,3170
4,4,0,0,5,2,7,3170
0,0,1,0,1,0,1,3171
1,1,0,2,1,2,3,3171
2,2,0,3,1,5,6,3171
3,3,2,1,3,6,9,3171
4,4,2,0,5,6,11,3171
5,5,3,0,8,6,14,3171
6,6,0,2,8,8,16,3171
7,7,0,1,8,9,17,3171
8,8,0,0,8,9,17,3171
0,0,1,0,1,0,1,3172
1,1,1,0,2,0,2,3172
2,2,1,0,3,0,3,3172
3,3,0,0,3,0,3,3172
0,0,1,0,1,0,1,3173
1,1,0,0,1,0,1,3173
0,0,1,0,1,0,1,3174
1,1,2,1,3,1,4,3174
2,2,1,2,4,3,7,3174
3,3,1,0,5,3,8,3174
4,4,1,0,6,3,9,3174
5,5,0,0,6,3,9,3174
0,0,1,0,1,0,1,3175
1,1,0,1,1,1,2,3175
2,2,0,2,1,3,4,3175
3,3,1,2,2,5,7,3175
4,4,0,2,2,7,9,3175
5,5,2,1,4,8,12,3175
6,6,1,0,5,8,13,3175
7,7,0,0,5,8,13,3175
0,0,1,0,1,0,1,3176
1,1,4,1,5,1,6,3176
2,2,2,2,7,3,10,3176
3,3,4,1,11,4,15,3176
4,4,5,2,16,6,22,3176
5,5,6,0,22,6,28,3176
6,6,3,5,25,11,36,3176
7,7,3,6,28,17,45,3176
8,8,3,5,31,22,53,3176
9,9,1,6,32,28,60,3176
10,10,3,3,35,31,66,3176
11,11,1,6,36,37,73,3176
12,12,0,5,36,42,78,3176
13,13,2,6,38,48,86,3176
14,14,2,3,40,51,91,3176
15,15,2,2,42,53,95,3176
16,16,1,3,43,56,99,3176
17,17,1,1,44,57,101,3176
18,18,2,1,46,58,104,3176
19,19,4,1,50,59,109,3176
20,20,3,2,53,61,114,3176
21,21,3,2,56,63,119,3176
22,22,3,2,59,65,124,3176
23,23,3,2,62,67,129,3176
24,24,6,2,68,69,137,3176
25,25,1,5,69,74,143,3176
26,26,1,8,70,82,152,3176
27,27,1,4,71,86,157,3176
28,28,2,4,73,90,163,3176
29,29,3,4,76,94,170,3176
30,30,0,2,76,96,172,3176
31,31,1,0,77,96,173,3176
32,32,2,0,79,96,175,3176
33,33,1,0,80,96,176,3176
34,34,0,0,80,96,176,3176
0,0,1,0,1,0,1,3177
1,1,1,0,2,0,2,3177
2,2,0,0,2,0,2,3177
0,0,1,0,1,0,1,3178
1,1,1,0,2,0,2,3178
2,2,0,0,2,0,2,3178
0,0,1,0,1,0,1,3179
1,1,0,0,1,0,1,3179
0,0,1,0,1,0,1,3180
1,1,2,0,3,0,3,3180
2,2,1,0,4,0,4,3180
3,3,0,0,4,0,4,3180
0,0,1,0,1,0,1,3181
1,1,2,0,3,0,3,3181
2,2,1,1,4,1,5,3181
3,3,0,1,4,2,6,3181
4,4,1,1,5,3,8,3181
5,5,2,3,7,6,13,3181
6,6,2,1,9,7,16,3181
7,7,0,2,9,9,18,3181
8,8,0,0,9,9,18,3181
0,0,1,0,1,0,1,3182
1,1,0,0,1,0,1,3182
0,0,1,0,1,0,1,3183
1,1,0,0,1,0,1,3183
0,0,1,0,1,0,1,3184
1,1,0,1,1,1,2,3184
2,2,0,0,1,1,2,3184
0,0,1,0,1,0,1,3185
1,1,0,0,1,0,1,3185
0,0,1,0,1,0,1,3186
1,1,0,1,1,1,2,3186
2,2,0,1,1,2,3,3186
3,3,0,0,1,2,3,3186
0,0,1,0,1,0,1,3187
1,1,0,0,1,0,1,3187
0,0,1,0,1,0,1,3188
1,1,2,0,3,0,3,3188
2,2,1,0,4,0,4,3188
3,3,0,0,4,0,4,3188
0,0,1,0,1,0,1,3189
1,1,2,0,3,0,3,3189
2,2,0,1,3,1,4,3189
3,3,0,1,3,2,5,3189
4,4,0,1,3,3,6,3189
5,5,0,0,3,3,6,3189
0,0,1,0,1,0,1,3190
1,1,2,0,3,0,3,3190
2,2,0,0,3,0,3,3190
0,0,1,0,1,0,1,3191
1,1,3,1,4,1,5,3191
2,2,2,0,6,1,7,3191
3,3,3,0,9,1,10,3191
4,4,2,1,11,2,13,3191
5,5,0,0,11,2,13,3191
0,0,1,0,1,0,1,3192
1,1,0,0,1,0,1,3192
0,0,1,0,1,0,1,3193
1,1,0,1,1,1,2,3193
2,2,0,0,1,1,2,3193
0,0,1,0,1,0,1,3194
1,1,1,0,2,0,2,3194
2,2,0,0,2,0,2,3194
0,0,1,0,1,0,1,3195
1,1,1,0,2,0,2,3195
2,2,0,0,2,0,2,3195
0,0,1,0,1,0,1,3196
1,1,0,0,1,0,1,3196
0,0,1,0,1,0,1,3197
1,1,0,0,1,0,1,3197
0,0,1,0,1,0,1,3198
1,1,1,0,2,0,2,3198
2,2,3,0,5,0,5,3198
3,3,5,0,10,0,10,3198
4,4,5,0,15,0,15,3198
5,5,3,0,18,0,18,3198
6,6,3,1,21,1,22,3198
7,7,0,3,21,4,25,3198
8,8,2,1,23,5,28,3198
9,9,2,0,25,5,30,3198
10,10,1,1,26,6,32,3198
11,11,1,1,27,7,34,3198
12,12,0,1,27,8,35,3198
13,13,0,0,27,8,35,3198
0,0,1,0,1,0,1,3199
1,1,0,0,1,0,1,3199
0,0,1,0,1,0,1,3200
1,1,1,1,2,1,3,3200
2,2,2,0,4,1,5,3200
3,3,0,1,4,2,6,3200
4,4,1,0,5,2,7,3200
5,5,1,1,6,3,9,3200
6,6,1,1,7,4,11,3200
7,7,2,1,9,5,14,3200
8,8,2,1,11,6,17,3200
9,9,0,1,11,7,18,3200
10,10,0,0,11,7,18,3200
0,0,1,0,1,0,1,3201
1,1,0,1,1,1,2,3201
2,2,0,1,1,2,3,3201
3,3,1,0,2,2,4,3201
4,4,0,0,2,2,4,3201
0,0,1,0,1,0,1,3202
1,1,1,0,2,0,2,3202
2,2,0,0,2,0,2,3202
0,0,1,0,1,0,1,3203
1,1,0,0,1,0,1,3203
0,0,1,0,1,0,1,3204
1,1,1,1,2,1,3,3204
2,2,1,3,3,4,7,3204
3,3,1,0,4,4,8,3204
4,4,0,0,4,4,8,3204
0,0,1,0,1,0,1,3205
1,1,1,1,2,1,3,3205
2,2,0,1,2,2,4,3205
3,3,0,0,2,2,4,3205
0,0,1,0,1,0,1,3206
1,1,3,0,4,0,4,3206
2,2,3,0,7,0,7,3206
3,3,2,0,9,0,9,3206
4,4,3,0,12,0,12,3206
5,5,2,1,14,1,15,3206
6,6,1,2,15,3,18,3206
7,7,1,1,16,4,20,3206
8,8,1,3,17,7,24,3206
9,9,0,2,17,9,26,3206
10,10,0,0,17,9,26,3206
0,0,1,0,1,0,1,3207
1,1,1,0,2,0,2,3207
2,2,1,0,3,0,3,3207
3,3,0,0,3,0,3,3207
0,0,1,0,1,0,1,3208
1,1,0,0,1,0,1,3208
0,0,1,0,1,0,1,3209
1,1,0,1,1,1,2,3209
2,2,0,0,1,1,2,3209
0,0,1,0,1,0,1,3210
1,1,2,0,3,0,3,3210
2,2,1,0,4,0,4,3210
3,3,1,0,5,0,5,3210
4,4,0,2,5,2,7,3210
5,5,0,1,5,3,8,3210
6,6,0,0,5,3,8,3210
0,0,1,0,1,0,1,3211
1,1,1,1,2,1,3,3211
2,2,2,2,4,3,7,3211
3,3,1,0,5,3,8,3211
4,4,0,0,5,3,8,3211
0,0,1,0,1,0,1,3212
1,1,1,1,2,1,3,3212
2,2,1,2,3,3,6,3212
3,3,0,2,3,5,8,3212
4,4,0,2,3,7,10,3212
5,5,0,0,3,7,10,3212
0,0,1,0,1,0,1,3213
1,1,1,0,2,0,2,3213
2,2,1,0,3,0,3,3213
3,3,0,1,3,1,4,3213
4,4,0,2,3,3,6,3213
5,5,0,1,3,4,7,3213
6,6,0,0,3,4,7,3213
0,0,1,0,1,0,1,3214
1,1,0,0,1,0,1,3214
0,0,1,0,1,0,1,3215
1,1,3,0,4,0,4,3215
2,2,3,0,7,0,7,3215
3,3,3,0,10,0,10,3215
4,4,2,0,12,0,12,3215
5,5,0,0,12,0,12,3215
0,0,1,0,1,0,1,3216
1,1,0,0,1,0,1,3216
0,0,1,0,1,0,1,3217
1,1,0,0,1,0,1,3217
0,0,1,0,1,0,1,3218
1,1,1,0,2,0,2,3218
2,2,1,0,3,0,3,3218
3,3,2,0,5,0,5,3218
4,4,4,0,9,0,9,3218
5,5,2,2,11,2,13,3218
6,6,3,3,14,5,19,3218
7,7,2,2,16,7,23,3218
8,8,2,1,18,8,26,3218
9,9,3,3,21,11,32,3218
10,10,1,4,22,15,37,3218
11,11,0,5,22,20,42,3218
12,12,1,2,23,22,45,3218
13,13,1,2,24,24,48,3218
14,14,2,1,26,25,51,3218
15,15,3,0,29,25,54,3218
16,16,0,1,29,26,55,3218
17,17,0,0,29,26,55,3218
0,0,1,0,1,0,1,3219
1,1,0,0,1,0,1,3219
0,0,1,0,1,0,1,3220
1,1,0,0,1,0,1,3220
0,0,1,0,1,0,1,3221
1,1,0,0,1,0,1,3221
0,0,1,0,1,0,1,3222
1,1,1,0,2,0,2,3222
2,2,0,0,2,0,2,3222
0,0,1,0,1,0,1,3223
1,1,2,0,3,0,3,3223
2,2,1,0,4,0,4,3223
3,3,0,1,4,1,5,3223
4,4,0,2,4,3,7,3223
5,5,0,0,4,3,7,3223
0,0,1,0,1,0,1,3224
1,1,0,0,1,0,1,3224
0,0,1,0,1,0,1,3225
1,1,1,0,2,0,2,3225
2,2,1,0,3,0,3,3225
3,3,1,0,4,0,4,3225
4,4,2,0,6,0,6,3225
5,5,1,0,7,0,7,3225
6,6,1,0,8,0,8,3225
7,7,0,0,8,0,8,3225
0,0,1,0,1,0,1,3226
1,1,1,0,2,0,2,3226
2,2,1,1,3,1,4,3226
3,3,3,0,6,1,7,3226
4,4,3,0,9,1,10,3226
5,5,3,0,12,1,13,3226
6,6,1,0,13,1,14,3226
7,7,1,0,14,1,15,3226
8,8,0,0,14,1,15,3226
0,0,1,0,1,0,1,3227
1,1,0,0,1,0,1,3227
0,0,1,0,1,0,1,3228
1,1,2,1,3,1,4,3228
2,2,4,0,7,1,8,3228
3,3,3,1,10,2,12,3228
4,4,3,1,13,3,16,3228
5,5,1,1,14,4,18,3228
6,6,3,1,17,5,22,3228
7,7,1,1,18,6,24,3228
8,8,1,1,19,7,26,3228
9,9,0,0,19,7,26,3228
0,0,1,0,1,0,1,3229
1,1,0,2,1,2,3,3229
2,2,0,1,1,3,4,3229
3,3,0,0,1,3,4,3229
0,0,1,0,1,0,1,3230
1,1,3,0,4,0,4,3230
2,2,2,0,6,0,6,3230
3,3,0,1,6,1,7,3230
4,4,0,0,6,1,7,3230
0,0,1,0,1,0,1,3231
1,1,0,0,1,0,1,3231
0,0,1,0,1,0,1,3232
1,1,0,1,1,1,2,3232
2,2,0,0,1,1,2,3232
0,0,1,0,1,0,1,3233
1,1,2,0,3,0,3,3233
2,2,0,0,3,0,3,3233
0,0,1,0,1,0,1,3234
1,1,1,0,2,0,2,3234
2,2,1,0,3,0,3,3234
3,3,1,0,4,0,4,3234
4,4,0,0,4,0,4,3234
0,0,1,0,1,0,1,3235
1,1,1,0,2,0,2,3235
2,2,0,0,2,0,2,3235
0,0,1,0,1,0,1,3236
1,1,1,0,2,0,2,3236
2,2,0,0,2,0,2,3236
0,0,1,0,1,0,1,3237
1,1,1,0,2,0,2,3237
2,2,0,0,2,0,2,3237
0,0,1,0,1,0,1,3238
1,1,1,1,2,1,3,3238
2,2,1,0,3,1,4,3238
3,3,1,1,4,2,6,3238
4,4,1,0,5,2,7,3238
5,5,0,0,5,2,7,3238
0,0,1,0,1,0,1,3239
1,1,0,0,1,0,1,3239
0,0,1,0,1,0,1,3240
1,1,0,1,1,1,2,3240
2,2,0,1,1,2,3,3240
3,3,0,0,1,2,3,3240
0,0,1,0,1,0,1,3241
1,1,3,0,4,0,4,3241
2,2,0,0,4,0,4,3241
0,0,1,0,1,0,1,3242
1,1,0,1,1,1,2,3242
2,2,0,1,1,2,3,3242
3,3,0,0,1,2,3,3242
0,0,1,0,1,0,1,3243
1,1,0,0,1,0,1,3243
0,0,1,0,1,0,1,3244
1,1,1,0,2,0,2,3244
2,2,0,2,2,2,4,3244
3,3,0,0,2,2,4,3244
0,0,1,0,1,0,1,3245
1,1,0,0,1,0,1,3245
0,0,1,0,1,0,1,3246
1,1,1,0,2,0,2,3246
2,2,1,0,3,0,3,3246
3,3,2,1,5,1,6,3246
4,4,0,1,5,2,7,3246
5,5,1,1,6,3,9,3246
6,6,1,1,7,4,11,3246
7,7,2,1,9,5,14,3246
8,8,2,2,11,7,18,3246
9,9,3,1,14,8,22,3246
10,10,5,1,19,9,28,3246
11,11,5,3,24,12,36,3246
12,12,1,3,25,15,40,3246
13,13,2,5,27,20,47,3246
14,14,3,7,30,27,57,3246
15,15,3,4,33,31,64,3246
16,16,5,7,38,38,76,3246
17,17,2,7,40,45,85,3246
18,18,2,9,42,54,96,3246
19,19,2,4,44,58,102,3246
20,20,0,1,44,59,103,3246
21,21,0,1,44,60,104,3246
22,22,0,0,44,60,104,3246
0,0,1,0,1,0,1,3247
1,1,0,0,1,0,1,3247
0,0,1,0,1,0,1,3248
1,1,2,0,3,0,3,3248
2,2,0,0,3,0,3,3248
0,0,1,0,1,0,1,3249
1,1,1,0,2,0,2,3249
2,2,3,0,5,0,5,3249
3,3,1,1,6,1,7,3249
4,4,2,1,8,2,10,3249
5,5,1,2,9,4,13,3249
6,6,0,0,9,4,13,3249
0,0,1,0,1,0,1,3250
1,1,1,0,2,0,2,3250
2,2,0,0,2,0,2,3250
0,0,1,0,1,0,1,3251
1,1,0,0,1,0,1,3251
0,0,1,0,1,0,1,3252
1,1,1,0,2,0,2,3252
2,2,0,0,2,0,2,3252
0,0,1,0,1,0,1,3253
1,1,0,0,1,0,1,3253
0,0,1,0,1,0,1,3254
1,1,1,0,2,0,2,3254
2,2,1,0,3,0,3,3254
3,3,0,0,3,0,3,3254
0,0,1,0,1,0,1,3255
1,1,1,1,2,1,3,3255
2,2,1,0,3,1,4,3255
3,3,0,1,3,2,5,3255
4,4,0,2,3,4,7,3255
5,5,0,1,3,5,8,3255
6,6,0,2,3,7,10,3255
7,7,0,2,3,9,12,3255
8,8,0,1,3,10,13,3255
9,9,1,0,4,10,14,3255
10,10,0,1,4,11,15,3255
11,11,0,0,4,11,15,3255
0,0,1,0,1,0,1,3256
1,1,0,0,1,0,1,3256
0,0,1,0,1,0,1,3257
1,1,2,0,3,0,3,3257
2,2,0,0,3,0,3,3257
0,0,1,0,1,0,1,3258
1,1,1,0,2,0,2,3258
2,2,1,0,3,0,3,3258
3,3,0,0,3,0,3,3258
0,0,1,0,1,0,1,3259
1,1,0,1,1,1,2,3259
2,2,0,1,1,2,3,3259
3,3,0,1,1,3,4,3259
4,4,0,1,1,4,5,3259
5,5,0,0,1,4,5,3259
0,0,1,0,1,0,1,3260
1,1,1,0,2,0,2,3260
2,2,2,1,4,1,5,3260
3,3,3,1,7,2,9,3260
4,4,3,0,10,2,12,3260
5,5,3,0,13,2,15,3260
6,6,3,0,16,2,18,3260
7,7,4,1,20,3,23,3260
8,8,2,3,22,6,28,3260
9,9,3,2,25,8,33,3260
10,10,7,2,32,10,42,3260
11,11,9,5,41,15,56,3260
12,12,7,15,48,30,78,3260
13,13,7,11,55,41,96,3260
14,14,10,6,65,47,112,3260
15,15,15,7,80,54,134,3260
16,16,12,6,92,60,152,3260
17,17,10,6,102,66,168,3260
18,18,4,11,106,77,183,3260
19,19,3,12,109,89,198,3260
20,20,2,8,111,97,208,3260
21,21,4,4,115,101,216,3260
22,22,6,4,121,105,226,3260
23,23,7,7,128,112,240,3260
24,24,10,9,138,121,259,3260
25,25,8,7,146,128,274,3260
26,26,5,6,151,134,285,3260
27,27,5,5,156,139,295,3260
28,28,8,3,164,142,306,3260
29,29,5,5,169,147,316,3260
30,30,4,3,173,150,323,3260
31,31,3,2,176,152,328,3260
32,32,2,6,178,158,336,3260
33,33,2,6,180,164,344,3260
34,34,4,8,184,172,356,3260
35,35,7,8,191,180,371,3260
36,36,5,5,196,185,381,3260
37,37,2,5,198,190,388,3260
38,38,0,6,198,196,394,3260
39,39,3,3,201,199,400,3260
40,40,2,1,203,200,403,3260
41,41,2,1,205,201,406,3260
42,42,2,0,207,201,408,3260
43,43,2,0,209,201,410,3260
44,44,1,0,210,201,411,3260
45,45,0,1,210,202,412,3260
46,46,1,1,211,203,414,3260
47,47,0,2,211,205,416,3260
48,48,0,1,211,206,417,3260
49,49,0,0,211,206,417,3260
0,0,1,0,1,0,1,3261
1,1,2,0,3,0,3,3261
2,2,1,0,4,0,4,3261
3,3,0,0,4,0,4,3261
0,0,1,0,1,0,1,3262
1,1,0,0,1,0,1,3262
0,0,1,0,1,0,1,3263
1,1,1,0,2,0,2,3263
2,2,1,0,3,0,3,3263
3,3,1,0,4,0,4,3263
4,4,0,1,4,1,5,3263
5,5,1,1,5,2,7,3263
6,6,0,3,5,5,10,3263
7,7,1,3,6,8,14,3263
8,8,0,2,6,10,16,3263
9,9,1,0,7,10,17,3263
10,10,0,0,7,10,17,3263
0,0,1,0,1,0,1,3264
1,1,1,0,2,0,2,3264
2,2,3,0,5,0,5,3264
3,3,2,0,7,0,7,3264
4,4,1,0,8,0,8,3264
5,5,1,0,9,0,9,3264
6,6,2,1,11,1,12,3264
7,7,0,4,11,5,16,3264
8,8,0,5,11,10,21,3264
9,9,2,2,13,12,25,3264
10,10,0,0,13,12,25,3264
0,0,1,0,1,0,1,3265
1,1,1,0,2,0,2,3265
2,2,0,0,2,0,2,3265
0,0,1,0,1,0,1,3266
1,1,0,0,1,0,1,3266
0,0,1,0,1,0,1,3267
1,1,0,0,1,0,1,3267
0,0,1,0,1,0,1,3268
1,1,0,0,1,0,1,3268
0,0,1,0,1,0,1,3269
1,1,1,0,2,0,2,3269
2,2,1,1,3,1,4,3269
3,3,1,0,4,1,5,3269
4,4,0,0,4,1,5,3269
0,0,1,0,1,0,1,3270
1,1,0,0,1,0,1,3270
0,0,1,0,1,0,1,3271
1,1,1,0,2,0,2,3271
2,2,1,0,3,0,3,3271
3,3,0,0,3,0,3,3271
0,0,1,0,1,0,1,3272
1,1,0,1,1,1,2,3272
2,2,0,1,1,2,3,3272
3,3,0,1,1,3,4,3272
4,4,0,0,1,3,4,3272
0,0,1,0,1,0,1,3273
1,1,1,0,2,0,2,3273
2,2,0,0,2,0,2,3273
0,0,1,0,1,0,1,3274
1,1,0,0,1,0,1,3274
0,0,1,0,1,0,1,3275
1,1,0,0,1,0,1,3275
0,0,1,0,1,0,1,3276
1,1,0,1,1,1,2,3276
2,2,0,0,1,1,2,3276
0,0,1,0,1,0,1,3277
1,1,1,0,2,0,2,3277
2,2,1,0,3,0,3,3277
3,3,1,0,4,0,4,3277
4,4,0,0,4,0,4,3277
0,0,1,0,1,0,1,3278
1,1,0,1,1,1,2,3278
2,2,0,1,1,2,3,3278
3,3,0,3,1,5,6,3278
4,4,0,1,1,6,7,3278
5,5,0,0,1,6,7,3278
0,0,1,0,1,0,1,3279
1,1,2,0,3,0,3,3279
2,2,0,0,3,0,3,3279
0,0,1,0,1,0,1,3280
1,1,0,0,1,0,1,3280
0,0,1,0,1,0,1,3281
1,1,3,0,4,0,4,3281
2,2,2,0,6,0,6,3281
3,3,0,0,6,0,6,3281
0,0,1,0,1,0,1,3282
1,1,1,1,2,1,3,3282
2,2,0,0,2,1,3,3282
0,0,1,0,1,0,1,3283
1,1,0,0,1,0,1,3283
0,0,1,0,1,0,1,3284
1,1,1,1,2,1,3,3284
2,2,0,1,2,2,4,3284
3,3,0,0,2,2,4,3284
0,0,1,0,1,0,1,3285
1,1,0,0,1,0,1,3285
0,0,1,0,1,0,1,3286
1,1,1,1,2,1,3,3286
2,2,0,0,2,1,3,3286
0,0,1,0,1,0,1,3287
1,1,0,0,1,0,1,3287
0,0,1,0,1,0,1,3288
1,1,0,0,1,0,1,3288
0,0,1,0,1,0,1,3289
1,1,1,1,2,1,3,3289
2,2,0,1,2,2,4,3289
3,3,0,1,2,3,5,3289
4,4,0,0,2,3,5,3289
0,0,1,0,1,0,1,3290
1,1,0,0,1,0,1,3290
0,0,1,0,1,0,1,3291
1,1,0,0,1,0,1,3291
0,0,1,0,1,0,1,3292
1,1,2,0,3,0,3,3292
2,2,1,0,4,0,4,3292
3,3,0,0,4,0,4,3292
0,0,1,0,1,0,1,3293
1,1,1,0,2,0,2,3293
2,2,1,0,3,0,3,3293
3,3,1,0,4,0,4,3293
4,4,0,0,4,0,4,3293
0,0,1,0,1,0,1,3294
1,1,2,0,3,0,3,3294
2,2,3,0,6,0,6,3294
3,3,1,1,7,1,8,3294
4,4,3,5,10,6,16,3294
5,5,2,3,12,9,21,3294
6,6,1,3,13,12,25,3294
7,7,1,4,14,16,30,3294
8,8,1,3,15,19,34,3294
9,9,1,3,16,22,38,3294
10,10,3,3,19,25,44,3294
11,11,1,5,20,30,50,3294
12,12,1,1,21,31,52,3294
13,13,2,4,23,35,58,3294
14,14,5,8,28,43,71,3294
15,15,3,5,31,48,79,3294
16,16,3,1,34,49,83,3294
17,17,0,3,34,52,86,3294
18,18,0,1,34,53,87,3294
19,19,0,1,34,54,88,3294
20,20,0,1,34,55,89,3294
21,21,0,2,34,57,91,3294
22,22,0,1,34,58,92,3294
23,23,1,1,35,59,94,3294
24,24,1,3,36,62,98,3294
25,25,3,4,39,66,105,3294
26,26,4,2,43,68,111,3294
27,27,2,3,45,71,116,3294
28,28,1,1,46,72,118,3294
29,29,3,1,49,73,122,3294
30,30,4,1,53,74,127,3294
31,31,4,3,57,77,134,3294
32,32,6,3,63,80,143,3294
33,33,6,1,69,81,150,3294
34,34,3,3,72,84,156,3294
35,35,6,3,78,87,165,3294
36,36,4,1,82,88,170,3294
37,37,6,2,88,90,178,3294
38,38,4,2,92,92,184,3294
39,39,1,3,93,95,188,3294
40,40,2,3,95,98,193,3294
41,41,1,1,96,99,195,3294
42,42,3,0,99,99,198,3294
43,43,4,0,103,99,202,3294
44,44,1,0,104,99,203,3294
45,45,0,0,104,99,203,3294
0,0,1,0,1,0,1,3295
1,1,3,0,4,0,4,3295
2,2,0,0,4,0,4,3295
0,0,1,0,1,0,1,3296
1,1,0,0,1,0,1,3296
0,0,1,0,1,0,1,3297
1,1,1,0,2,0,2,3297
2,2,1,0,3,0,3,3297
3,3,1,0,4,0,4,3297
4,4,0,0,4,0,4,3297
0,0,1,0,1,0,1,3298
1,1,1,0,2,0,2,3298
2,2,0,0,2,0,2,3298
0,0,1,0,1,0,1,3299
1,1,2,0,3,0,3,3299
2,2,1,0,4,0,4,3299
3,3,1,0,5,0,5,3299
4,4,0,0,5,0,5,3299
0,0,1,0,1,0,1,3300
1,1,1,0,2,0,2,3300
2,2,0,0,2,0,2,3300
0,0,1,0,1,0,1,3301
1,1,0,0,1,0,1,3301
0,0,1,0,1,0,1,3302
1,1,0,0,1,0,1,3302
0,0,1,0,1,0,1,3303
1,1,0,0,1,0,1,3303
0,0,1,0,1,0,1,3304
1,1,0,0,1,0,1,3304
0,0,1,0,1,0,1,3305
1,1,0,0,1,0,1,3305
0,0,1,0,1,0,1,3306
1,1,1,3,2,3,5,3306
2,2,1,3,3,6,9,3306
3,3,3,3,6,9,15,3306
4,4,1,4,7,13,20,3306
5,5,1,5,8,18,26,3306
6,6,4,2,12,20,32,3306
7,7,5,3,17,23,40,3306
8,8,2,2,19,25,44,3306
9,9,2,3,21,28,49,3306
10,10,1,4,22,32,54,3306
11,11,1,2,23,34,57,3306
12,12,3,1,26,35,61,3306
13,13,2,0,28,35,63,3306
14,14,1,0,29,35,64,3306
15,15,0,1,29,36,65,3306
16,16,0,0,29,36,65,3306
0,0,1,0,1,0,1,3307
1,1,0,0,1,0,1,3307
0,0,1,0,1,0,1,3308
1,1,1,0,2,0,2,3308
2,2,1,0,3,0,3,3308
3,3,1,0,4,0,4,3308
4,4,1,0,5,0,5,3308
5,5,2,0,7,0,7,3308
6,6,3,0,10,0,10,3308
7,7,4,1,14,1,15,3308
8,8,2,2,16,3,19,3308
9,9,2,3,18,6,24,3308
10,10,1,0,19,6,25,3308
11,11,0,0,19,6,25,3308
0,0,1,0,1,0,1,3309
1,1,0,0,1,0,1,3309
0,0,1,0,1,0,1,3310
1,1,1,0,2,0,2,3310
2,2,3,0,5,0,5,3310
3,3,0,0,5,0,5,3310
0,0,1,0,1,0,1,3311
1,1,1,0,2,0,2,3311
2,2,1,1,3,1,4,3311
3,3,0,1,3,2,5,3311
4,4,0,0,3,2,5,3311
0,0,1,0,1,0,1,3312
1,1,0,0,1,0,1,3312
0,0,1,0,1,0,1,3313
1,1,1,0,2,0,2,3313
2,2,0,0,2,0,2,3313
0,0,1,0,1,0,1,3314
1,1,1,1,2,1,3,3314
2,2,0,1,2,2,4,3314
3,3,0,1,2,3,5,3314
4,4,0,1,2,4,6,3314
5,5,0,1,2,5,7,3314
6,6,0,3,2,8,10,3314
7,7,0,0,2,8,10,3314
0,0,1,0,1,0,1,3315
1,1,1,0,2,0,2,3315
2,2,0,0,2,0,2,3315
0,0,1,0,1,0,1,3316
1,1,0,0,1,0,1,3316
0,0,1,0,1,0,1,3317
1,1,0,0,1,0,1,3317
0,0,1,0,1,0,1,3318
1,1,2,0,3,0,3,3318
2,2,0,1,3,1,4,3318
3,3,0,1,3,2,5,3318
4,4,0,1,3,3,6,3318
5,5,1,1,4,4,8,3318
6,6,0,0,4,4,8,3318
0,0,1,0,1,0,1,3319
1,1,0,1,1,1,2,3319
2,2,0,0,1,1,2,3319
0,0,1,0,1,0,1,3320
1,1,0,0,1,0,1,3320
0,0,1,0,1,0,1,3321
1,1,1,0,2,0,2,3321
2,2,0,0,2,0,2,3321
0,0,1,0,1,0,1,3322
1,1,0,1,1,1,2,3322
2,2,0,0,1,1,2,3322
0,0,1,0,1,0,1,3323
1,1,0,0,1,0,1,3323
0,0,1,0,1,0,1,3324
1,1,0,1,1,1,2,3324
2,2,0,0,1,1,2,3324
0,0,1,0,1,0,1,3325
1,1,1,0,2,0,2,3325
2,2,0,0,2,0,2,3325
0,0,1,0,1,0,1,3326
1,1,0,0,1,0,1,3326
0,0,1,0,1,0,1,3327
1,1,3,1,4,1,5,3327
2,2,3,2,7,3,10,3327
3,3,1,3,8,6,14,3327
4,4,1,1,9,7,16,3327
5,5,2,0,11,7,18,3327
6,6,0,0,11,7,18,3327
0,0,1,0,1,0,1,3328
1,1,0,0,1,0,1,3328
0,0,1,0,1,0,1,3329
1,1,1,0,2,0,2,3329
2,2,1,0,3,0,3,3329
3,3,1,0,4,0,4,3329
4,4,6,0,10,0,10,3329
5,5,4,2,14,2,16,3329
6,6,4,4,18,6,24,3329
7,7,3,2,21,8,29,3329
8,8,1,1,22,9,31,3329
9,9,0,2,22,11,33,3329
10,10,2,0,24,11,35,3329
11,11,1,0,25,11,36,3329
12,12,1,1,26,12,38,3329
13,13,1,1,27,13,40,3329
14,14,0,0,27,13,40,3329
0,0,1,0,1,0,1,3330
1,1,0,0,1,0,1,3330
0,0,1,0,1,0,1,3331
1,1,2,1,3,1,4,3331
2,2,3,0,6,1,7,3331
3,3,4,0,10,1,11,3331
4,4,3,1,13,2,15,3331
5,5,1,2,14,4,18,3331
6,6,0,2,14,6,20,3331
7,7,0,0,14,6,20,3331
0,0,1,0,1,0,1,3332
1,1,0,0,1,0,1,3332
0,0,1,0,1,0,1,3333
1,1,0,0,1,0,1,3333
0,0,1,0,1,0,1,3334
1,1,0,0,1,0,1,3334
0,0,1,0,1,0,1,3335
1,1,1,0,2,0,2,3335
2,2,1,0,3,0,3,3335
3,3,0,1,3,1,4,3335
4,4,0,0,3,1,4,3335
0,0,1,0,1,0,1,3336
1,1,0,0,1,0,1,3336
0,0,1,0,1,0,1,3337
1,1,1,0,2,0,2,3337
2,2,2,0,4,0,4,3337
3,3,2,0,6,0,6,3337
4,4,1,0,7,0,7,3337
5,5,0,0,7,0,7,3337
0,0,1,0,1,0,1,3338
1,1,1,0,2,0,2,3338
2,2,1,0,3,0,3,3338
3,3,0,0,3,0,3,3338
0,0,1,0,1,0,1,3339
1,1,1,0,2,0,2,3339
2,2,1,0,3,0,3,3339
3,3,1,0,4,0,4,3339
4,4,1,1,5,1,6,3339
5,5,0,1,5,2,7,3339
6,6,0,1,5,3,8,3339
7,7,0,1,5,4,9,3339
8,8,1,1,6,5,11,3339
9,9,0,0,6,5,11,3339
0,0,1,0,1,0,1,3340
1,1,3,0,4,0,4,3340
2,2,0,1,4,1,5,3340
3,3,0,0,4,1,5,3340
0,0,1,0,1,0,1,3341
1,1,1,0,2,0,2,3341
2,2,0,1,2,1,3,3341
3,3,0,1,2,2,4,3341
4,4,1,1,3,3,6,3341
5,5,0,1,3,4,7,3341
6,6,0,0,3,4,7,3341
0,0,1,0,1,0,1,3342
1,1,1,0,2,0,2,3342
2,2,0,0,2,0,2,3342
0,0,1,0,1,0,1,3343
1,1,0,0,1,0,1,3343
0,0,1,0,1,0,1,3344
1,1,0,0,1,0,1,3344
0,0,1,0,1,0,1,3345
1,1,1,2,2,2,4,3345
2,2,2,0,4,2,6,3345
3,3,5,0,9,2,11,3345
4,4,1,1,10,3,13,3345
5,5,0,0,10,3,13,3345
0,0,1,0,1,0,1,3346
1,1,0,0,1,0,1,3346
0,0,1,0,1,0,1,3347
1,1,1,1,2,1,3,3347
2,2,2,0,4,1,5,3347
3,3,2,1,6,2,8,3347
4,4,4,0,10,2,12,3347
5,5,1,0,11,2,13,3347
6,6,0,1,11,3,14,3347
7,7,0,0,11,3,14,3347
0,0,1,0,1,0,1,3348
1,1,0,0,1,0,1,3348
0,0,1,0,1,0,1,3349
1,1,0,0,1,0,1,3349
0,0,1,0,1,0,1,3350
1,1,1,0,2,0,2,3350
2,2,1,0,3,0,3,3350
3,3,0,0,3,0,3,3350
0,0,1,0,1,0,1,3351
1,1,1,0,2,0,2,3351
2,2,1,0,3,0,3,3351
3,3,3,0,6,0,6,3351
4,4,5,0,11,0,11,3351
5,5,3,1,14,1,15,3351
6,6,2,1,16,2,18,3351
7,7,1,1,17,3,20,3351
8,8,1,0,18,3,21,3351
9,9,2,0,20,3,23,3351
10,10,1,0,21,3,24,3351
11,11,0,0,21,3,24,3351
0,0,1,0,1,0,1,3352
1,1,0,0,1,0,1,3352
0,0,1,0,1,0,1,3353
1,1,1,0,2,0,2,3353
2,2,0,0,2,0,2,3353
0,0,1,0,1,0,1,3354
1,1,1,0,2,0,2,3354
2,2,2,0,4,0,4,3354
3,3,0,0,4,0,4,3354
0,0,1,0,1,0,1,3355
1,1,1,0,2,0,2,3355
2,2,1,0,3,0,3,3355
3,3,1,0,4,0,4,3355
4,4,0,1,4,1,5,3355
5,5,0,2,4,3,7,3355
6,6,0,1,4,4,8,3355
7,7,0,2,4,6,10,3355
8,8,0,2,4,8,12,3355
9,9,0,0,4,8,12,3355
0,0,1,0,1,0,1,3356
1,1,0,0,1,0,1,3356
0,0,1,0,1,0,1,3357
1,1,1,1,2,1,3,3357
2,2,2,0,4,1,5,3357
3,3,1,0,5,1,6,3357
4,4,0,0,5,1,6,3357
0,0,1,0,1,0,1,3358
1,1,1,0,2,0,2,3358
2,2,2,0,4,0,4,3358
3,3,2,0,6,0,6,3358
4,4,2,2,8,2,10,3358
5,5,4,2,12,4,16,3358
6,6,2,3,14,7,21,3358
7,7,2,3,16,10,26,3358
8,8,1,0,17,10,27,3358
9,9,0,0,17,10,27,3358
0,0,1,0,1,0,1,3359
1,1,2,0,3,0,3,3359
2,2,0,0,3,0,3,3359
0,0,1,0,1,0,1,3360
1,1,1,0,2,0,2,3360
2,2,2,0,4,0,4,3360
3,3,5,1,9,1,10,3360
4,4,5,2,14,3,17,3360
5,5,5,0,19,3,22,3360
6,6,3,1,22,4,26,3360
7,7,3,1,25,5,30,3360
8,8,0,1,25,6,31,3360
9,9,0,1,25,7,32,3360
10,10,0,1,25,8,33,3360
11,11,0,3,25,11,36,3360
12,12,1,1,26,12,38,3360
13,13,2,0,28,12,40,3360
14,14,0,0,28,12,40,3360
0,0,1,0,1,0,1,3361
1,1,0,0,1,0,1,3361
0,0,1,0,1,0,1,3362
1,1,1,0,2,0,2,3362
2,2,0,0,2,0,2,3362
0,0,1,0,1,0,1,3363
1,1,0,1,1,1,2,3363
2,2,1,0,2,1,3,3363
3,3,0,0,2,1,3,3363
0,0,1,0,1,0,1,3364
1,1,1,0,2,0,2,3364
2,2,1,0,3,0,3,3364
3,3,2,0,5,0,5,3364
4,4,1,0,6,0,6,3364
5,5,1,0,7,0,7,3364
6,6,1,1,8,1,9,3364
7,7,0,1,8,2,10,3364
8,8,0,0,8,2,10,3364
0,0,1,0,1,0,1,3365
1,1,0,0,1,0,1,3365
0,0,1,0,1,0,1,3366
1,1,0,0,1,0,1,3366
0,0,1,0,1,0,1,3367
1,1,0,0,1,0,1,3367
0,0,1,0,1,0,1,3368
1,1,1,0,2,0,2,3368
2,2,0,0,2,0,2,3368
0,0,1,0,1,0,1,3369
1,1,0,0,1,0,1,3369
0,0,1,0,1,0,1,3370
1,1,0,0,1,0,1,3370
0,0,1,0,1,0,1,3371
1,1,0,0,1,0,1,3371
0,0,1,0,1,0,1,3372
1,1,0,1,1,1,2,3372
2,2,0,1,1,2,3,3372
3,3,1,2,2,4,6,3372
4,4,1,2,3,6,9,3372
5,5,2,3,5,9,14,3372
6,6,0,4,5,13,18,3372
7,7,0,5,5,18,23,3372
8,8,2,7,7,25,32,3372
9,9,2,8,9,33,42,3372
10,10,2,4,11,37,48,3372
11,11,2,7,13,44,57,3372
12,12,3,7,16,51,67,3372
13,13,5,4,21,55,76,3372
14,14,4,6,25,61,86,3372
15,15,3,8,28,69,97,3372
16,16,2,7,30,76,106,3372
17,17,0,5,30,81,111,3372
18,18,0,5,30,86,116,3372
19,19,1,5,31,91,122,3372
20,20,1,2,32,93,125,3372
21,21,4,0,36,93,129,3372
22,22,4,0,40,93,133,3372
23,23,3,0,43,93,136,3372
24,24,5,1,48,94,142,3372
25,25,6,2,54,96,150,3372
26,26,9,4,63,100,163,3372
27,27,9,3,72,103,175,3372
28,28,7,2,79,105,184,3372
29,29,4,4,83,109,192,3372
30,30,3,3,86,112,198,3372
31,31,4,3,90,115,205,3372
32,32,1,6,91,121,212,3372
33,33,1,8,92,129,221,3372
34,34,2,6,94,135,229,3372
35,35,0,7,94,142,236,3372
36,36,0,6,94,148,242,3372
37,37,0,5,94,153,247,3372
38,38,0,2,94,155,249,3372
39,39,0,2,94,157,251,3372
40,40,0,0,94,157,251,3372
0,0,1,0,1,0,1,3373
1,1,0,0,1,0,1,3373
0,0,1,0,1,0,1,3374
1,1,2,1,3,1,4,3374
2,2,2,1,5,2,7,3374
3,3,3,1,8,3,11,3374
4,4,4,1,12,4,16,3374
5,5,5,0,17,4,21,3374
6,6,2,1,19,5,24,3374
7,7,1,2,20,7,27,3374
8,8,1,0,21,7,28,3374
9,9,0,0,21,7,28,3374
0,0,1,0,1,0,1,3375
1,1,1,1,2,1,3,3375
2,2,2,1,4,2,6,3375
3,3,3,4,7,6,13,3375
4,4,1,4,8,10,18,3375
5,5,0,2,8,12,20,3375
6,6,1,4,9,16,25,3375
7,7,0,5,9,21,30,3375
8,8,1,6,10,27,37,3375
9,9,0,4,10,31,41,3375
10,10,0,4,10,35,45,3375
11,11,0,4,10,39,49,3375
12,12,2,5,12,44,56,3375
13,13,2,5,14,49,63,3375
14,14,2,6,16,55,71,3375
15,15,2,1,18,56,74,3375
16,16,1,0,19,56,75,3375
17,17,0,0,19,56,75,3375
0,0,1,0,1,0,1,3376
1,1,0,1,1,1,2,3376
2,2,0,2,1,3,4,3376
3,3,0,4,1,7,8,3376
4,4,0,1,1,8,9,3376
5,5,0,0,1,8,9,3376
0,0,1,0,1,0,1,3377
1,1,0,1,1,1,2,3377
2,2,0,0,1,1,2,3377
0,0,1,0,1,0,1,3378
1,1,0,0,1,0,1,3378
0,0,1,0,1,0,1,3379
1,1,0,0,1,0,1,3379
0,0,1,0,1,0,1,3380
1,1,3,0,4,0,4,3380
2,2,2,0,6,0,6,3380
3,3,2,1,8,1,9,3380
4,4,0,1,8,2,10,3380
5,5,0,1,8,3,11,3380
6,6,0,1,8,4,12,3380
7,7,0,0,8,4,12,3380
0,0,1,0,1,0,1,3381
1,1,0,0,1,0,1,3381
0,0,1,0,1,0,1,3382
1,1,0,0,1,0,1,3382
0,0,1,0,1,0,1,3383
1,1,1,0,2,0,2,3383
2,2,1,0,3,0,3,3383
3,3,1,0,4,0,4,3383
4,4,1,0,5,0,5,3383
5,5,0,0,5,0,5,3383
0,0,1,0,1,0,1,3384
1,1,0,0,1,0,1,3384
0,0,1,0,1,0,1,3385
1,1,1,0,2,0,2,3385
2,2,2,0,4,0,4,3385
3,3,0,0,4,0,4,3385
0,0,1,0,1,0,1,3386
1,1,1,0,2,0,2,3386
2,2,1,0,3,0,3,3386
3,3,0,0,3,0,3,3386
0,0,1,0,1,0,1,3387
1,1,1,0,2,0,2,3387
2,2,0,0,2,0,2,3387
0,0,1,0,1,0,1,3388
1,1,0,0,1,0,1,3388
0,0,1,0,1,0,1,3389
1,1,0,0,1,0,1,3389
0,0,1,0,1,0,1,3390
1,1,0,0,1,0,1,3390
0,0,1,0,1,0,1,3391
1,1,0,1,1,1,2,3391
2,2,1,1,2,2,4,3391
3,3,1,0,3,2,5,3391
4,4,1,0,4,2,6,3391
5,5,1,0,5,2,7,3391
6,6,0,0,5,2,7,3391
0,0,1,0,1,0,1,3392
1,1,0,0,1,0,1,3392
0,0,1,0,1,0,1,3393
1,1,0,0,1,0,1,3393
0,0,1,0,1,0,1,3394
1,1,0,0,1,0,1,3394
0,0,1,0,1,0,1,3395
1,1,1,0,2,0,2,3395
2,2,0,0,2,0,2,3395
0,0,1,0,1,0,1,3396
1,1,0,0,1,0,1,3396
0,0,1,0,1,0,1,3397
1,1,1,1,2,1,3,3397
2,2,0,1,2,2,4,3397
3,3,0,0,2,2,4,3397
0,0,1,0,1,0,1,3398
1,1,1,0,2,0,2,3398
2,2,0,0,2,0,2,3398
0,0,1,0,1,0,1,3399
1,1,0,0,1,0,1,3399
0,0,1,0,1,0,1,3400
1,1,0,0,1,0,1,3400
0,0,1,0,1,0,1,3401
1,1,0,0,1,0,1,3401
0,0,1,0,1,0,1,3402
1,1,0,0,1,0,1,3402
0,0,1,0,1,0,1,3403
1,1,0,0,1,0,1,3403
0,0,1,0,1,0,1,3404
1,1,1,0,2,0,2,3404
2,2,0,0,2,0,2,3404
0,0,1,0,1,0,1,3405
1,1,0,0,1,0,1,3405
0,0,1,0,1,0,1,3406
1,1,0,0,1,0,1,3406
0,0,1,0,1,0,1,3407
1,1,1,0,2,0,2,3407
2,2,1,0,3,0,3,3407
3,3,1,0,4,0,4,3407
4,4,0,1,4,1,5,3407
5,5,0,0,4,1,5,3407
0,0,1,0,1,0,1,3408
1,1,0,0,1,0,1,3408
0,0,1,0,1,0,1,3409
1,1,2,2,3,2,5,3409
2,2,1,1,4,3,7,3409
3,3,0,0,4,3,7,3409
0,0,1,0,1,0,1,3410
1,1,0,0,1,0,1,3410
0,0,1,0,1,0,1,3411
1,1,1,0,2,0,2,3411
2,2,3,0,5,0,5,3411
3,3,2,0,7,0,7,3411
4,4,2,0,9,0,9,3411
5,5,0,0,9,0,9,3411
0,0,1,0,1,0,1,3412
1,1,0,0,1,0,1,3412
0,0,1,0,1,0,1,3413
1,1,0,0,1,0,1,3413
0,0,1,0,1,0,1,3414
1,1,2,0,3,0,3,3414
2,2,1,0,4,0,4,3414
3,3,0,0,4,0,4,3414
0,0,1,0,1,0,1,3415
1,1,0,0,1,0,1,3415
0,0,1,0,1,0,1,3416
1,1,4,0,5,0,5,3416
2,2,2,0,7,0,7,3416
3,3,4,0,11,0,11,3416
4,4,1,0,12,0,12,3416
5,5,0,0,12,0,12,3416
0,0,1,0,1,0,1,3417
1,1,2,0,3,0,3,3417
2,2,0,1,3,1,4,3417
3,3,0,1,3,2,5,3417
4,4,0,1,3,3,6,3417
5,5,0,0,3,3,6,3417
0,0,1,0,1,0,1,3418
1,1,0,2,1,2,3,3418
2,2,0,3,1,5,6,3418
3,3,0,3,1,8,9,3418
4,4,0,4,1,12,13,3418
5,5,2,2,3,14,17,3418
6,6,1,0,4,14,18,3418
7,7,1,1,5,15,20,3418
8,8,2,1,7,16,23,3418
9,9,1,3,8,19,27,3418
10,10,4,3,12,22,34,3418
11,11,2,7,14,29,43,3418
12,12,3,6,17,35,52,3418
13,13,2,5,19,40,59,3418
14,14,4,6,23,46,69,3418
15,15,3,6,26,52,78,3418
16,16,2,2,28,54,82,3418
17,17,2,2,30,56,86,3418
18,18,1,1,31,57,88,3418
19,19,0,0,31,57,88,3418
0,0,1,0,1,0,1,3419
1,1,0,0,1,0,1,3419
0,0,1,0,1,0,1,3420
1,1,0,0,1,0,1,3420
0,0,1,0,1,0,1,3421
1,1,0,0,1,0,1,3421
0,0,1,0,1,0,1,3422
1,1,1,0,2,0,2,3422
2,2,1,0,3,0,3,3422
3,3,1,0,4,0,4,3422
4,4,0,0,4,0,4,3422
0,0,1,0,1,0,1,3423
1,1,1,1,2,1,3,3423
2,2,1,0,3,1,4,3423
3,3,0,1,3,2,5,3423
4,4,0,0,3,2,5,3423
0,0,1,0,1,0,1,3424
1,1,3,1,4,1,5,3424
2,2,2,1,6,2,8,3424
3,3,3,2,9,4,13,3424
4,4,3,2,12,6,18,3424
5,5,3,4,15,10,25,3424
6,6,3,1,18,11,29,3424
7,7,0,0,18,11,29,3424
0,0,1,0,1,0,1,3425
1,1,0,0,1,0,1,3425
0,0,1,0,1,0,1,3426
1,1,0,0,1,0,1,3426
0,0,1,0,1,0,1,3427
1,1,1,0,2,0,2,3427
2,2,1,0,3,0,3,3427
3,3,1,0,4,0,4,3427
4,4,1,0,5,0,5,3427
5,5,0,0,5,0,5,3427
0,0,1,0,1,0,1,3428
1,1,0,0,1,0,1,3428
0,0,1,0,1,0,1,3429
1,1,0,0,1,0,1,3429
0,0,1,0,1,0,1,3430
1,1,0,0,1,0,1,3430
0,0,1,0,1,0,1,3431
1,1,0,0,1,0,1,3431
0,0,1,0,1,0,1,3432
1,1,1,0,2,0,2,3432
2,2,2,0,4,0,4,3432
3,3,4,1,8,1,9,3432
4,4,4,1,12,2,14,3432
5,5,4,1,16,3,19,3432
6,6,5,0,21,3,24,3432
7,7,6,1,27,4,31,3432
8,8,2,1,29,5,34,3432
9,9,2,0,31,5,36,3432
10,10,0,0,31,5,36,3432
0,0,1,0,1,0,1,3433
1,1,0,0,1,0,1,3433
0,0,1,0,1,0,1,3434
1,1,0,0,1,0,1,3434
0,0,1,0,1,0,1,3435
1,1,1,1,2,1,3,3435
2,2,0,2,2,3,5,3435
3,3,0,6,2,9,11,3435
4,4,1,3,3,12,15,3435
5,5,1,1,4,13,17,3435
6,6,2,1,6,14,20,3435
7,7,0,0,6,14,20,3435
0,0,1,0,1,0,1,3436
1,1,0,0,1,0,1,3436
0,0,1,0,1,0,1,3437
1,1,0,0,1,0,1,3437
0,0,1,0,1,0,1,3438
1,1,0,0,1,0,1,3438
0,0,1,0,1,0,1,3439
1,1,1,0,2,0,2,3439
2,2,1,0,3,0,3,3439
3,3,2,0,5,0,5,3439
4,4,2,0,7,0,7,3439
5,5,0,0,7,0,7,3439
0,0,1,0,1,0,1,3440
1,1,1,0,2,0,2,3440
2,2,0,0,2,0,2,3440
0,0,1,0,1,0,1,3441
1,1,2,1,3,1,4,3441
2,2,2,3,5,4,9,3441
3,3,2,2,7,6,13,3441
4,4,1,2,8,8,16,3441
5,5,0,0,8,8,16,3441
0,0,1,0,1,0,1,3442
1,1,1,0,2,0,2,3442
2,2,1,0,3,0,3,3442
3,3,0,0,3,0,3,3442
0,0,1,0,1,0,1,3443
1,1,1,0,2,0,2,3443
2,2,0,0,2,0,2,3443
0,0,1,0,1,0,1,3444
1,1,1,1,2,1,3,3444
2,2,1,1,3,2,5,3444
3,3,1,0,4,2,6,3444
4,4,0,0,4,2,6,3444
0,0,1,0,1,0,1,3445
1,1,1,0,2,0,2,3445
2,2,1,0,3,0,3,3445
3,3,1,0,4,0,4,3445
4,4,0,0,4,0,4,3445
0,0,1,0,1,0,1,3446
1,1,0,0,1,0,1,3446
0,0,1,0,1,0,1,3447
1,1,0,0,1,0,1,3447
0,0,1,0,1,0,1,3448
1,1,0,0,1,0,1,3448
0,0,1,0,1,0,1,3449
1,1,1,0,2,0,2,3449
2,2,2,0,4,0,4,3449
3,3,2,1,6,1,7,3449
4,4,1,1,7,2,9,3449
5,5,1,0,8,2,10,3449
6,6,0,0,8,2,10,3449
0,0,1,0,1,0,1,3450
1,1,1,1,2,1,3,3450
2,2,2,1,4,2,6,3450
3,3,2,0,6,2,8,3450
4,4,0,1,6,3,9,3450
5,5,0,1,6,4,10,3450
6,6,0,1,6,5,11,3450
7,7,0,0,6,5,11,3450
0,0,1,0,1,0,1,3451
1,1,3,0,4,0,4,3451
2,2,5,1,9,1,10,3451
3,3,5,0,14,1,15,3451
4,4,4,3,18,4,22,3451
5,5,1,1,19,5,24,3451
6,6,1,1,20,6,26,3451
7,7,1,1,21,7,28,3451
8,8,1,0,22,7,29,3451
9,9,0,1,22,8,30,3451
10,10,0,1,22,9,31,3451
11,11,0,2,22,11,33,3451
12,12,0,0,22,11,33,3451
0,0,1,0,1,0,1,3452
1,1,1,0,2,0,2,3452
2,2,0,0,2,0,2,3452
0,0,1,0,1,0,1,3453
1,1,0,0,1,0,1,3453
0,0,1,0,1,0,1,3454
1,1,0,0,1,0,1,3454
0,0,1,0,1,0,1,3455
1,1,1,0,2,0,2,3455
2,2,0,0,2,0,2,3455
0,0,1,0,1,0,1,3456
1,1,0,0,1,0,1,3456
0,0,1,0,1,0,1,3457
1,1,1,0,2,0,2,3457
2,2,0,0,2,0,2,3457
0,0,1,0,1,0,1,3458
1,1,0,1,1,1,2,3458
2,2,0,1,1,2,3,3458
3,3,0,3,1,5,6,3458
4,4,0,1,1,6,7,3458
5,5,0,0,1,6,7,3458
0,0,1,0,1,0,1,3459
1,1,2,0,3,0,3,3459
2,2,3,1,6,1,7,3459
3,3,0,0,6,1,7,3459
0,0,1,0,1,0,1,3460
1,1,1,1,2,1,3,3460
2,2,2,1,4,2,6,3460
3,3,2,0,6,2,8,3460
4,4,4,0,10,2,12,3460
5,5,4,0,14,2,16,3460
6,6,3,1,17,3,20,3460
7,7,0,1,17,4,21,3460
8,8,0,0,17,4,21,3460
0,0,1,0,1,0,1,3461
1,1,4,0,5,0,5,3461
2,2,2,1,7,1,8,3461
3,3,1,0,8,1,9,3461
4,4,0,1,8,2,10,3461
5,5,0,1,8,3,11,3461
6,6,1,1,9,4,13,3461
7,7,1,2,10,6,16,3461
8,8,1,3,11,9,20,3461
9,9,1,2,12,11,23,3461
10,10,0,0,12,11,23,3461
0,0,1,0,1,0,1,3462
1,1,0,0,1,0,1,3462
0,0,1,0,1,0,1,3463
1,1,2,0,3,0,3,3463
2,2,0,0,3,0,3,3463
0,0,1,0,1,0,1,3464
1,1,0,0,1,0,1,3464
0,0,1,0,1,0,1,3465
1,1,0,0,1,0,1,3465
0,0,1,0,1,0,1,3466
1,1,0,1,1,1,2,3466
2,2,0,2,1,3,4,3466
3,3,1,2,2,5,7,3466
4,4,0,1,2,6,8,3466
5,5,0,0,2,6,8,3466
0,0,1,0,1,0,1,3467
1,1,1,0,2,0,2,3467
2,2,0,1,2,1,3,3467
3,3,0,2,2,3,5,3467
4,4,0,2,2,5,7,3467
5,5,2,0,4,5,9,3467
6,6,1,0,5,5,10,3467
7,7,1,0,6,5,11,3467
8,8,1,0,7,5,12,3467
9,9,3,0,10,5,15,3467
10,10,0,1,10,6,16,3467
11,11,1,0,11,6,17,3467
12,12,1,0,12,6,18,3467
13,13,1,1,13,7,20,3467
14,14,1,2,14,9,23,3467
15,15,1,3,15,12,27,3467
16,16,3,1,18,13,31,3467
17,17,6,0,24,13,37,3467
18,18,6,1,30,14,44,3467
19,19,5,0,35,14,49,3467
20,20,1,0,36,14,50,3467
21,21,3,0,39,14,53,3467
22,22,5,0,44,14,58,3467
23,23,6,0,50,14,64,3467
24,24,3,1,53,15,68,3467
25,25,2,3,55,18,73,3467
26,26,0,2,55,20,75,3467
27,27,2,4,57,24,81,3467
28,28,2,2,59,26,85,3467
29,29,2,3,61,29,90,3467
30,30,3,1,64,30,94,3467
31,31,2,2,66,32,98,3467
32,32,2,2,68,34,102,3467
33,33,5,0,73,34,107,3467
34,34,1,0,74,34,108,3467
35,35,1,0,75,34,109,3467
36,36,0,0,75,34,109,3467
0,0,1,0,1,0,1,3468
1,1,1,1,2,1,3,3468
2,2,1,2,3,3,6,3468
3,3,1,2,4,5,9,3468
4,4,0,2,4,7,11,3468
5,5,0,1,4,8,12,3468
6,6,0,0,4,8,12,3468
0,0,1,0,1,0,1,3469
1,1,0,0,1,0,1,3469
0,0,1,0,1,0,1,3470
1,1,1,1,2,1,3,3470
2,2,4,1,6,2,8,3470
3,3,6,0,12,2,14,3470
4,4,3,1,15,3,18,3470
5,5,1,2,16,5,21,3470
6,6,1,3,17,8,25,3470
7,7,1,2,18,10,28,3470
8,8,4,0,22,10,32,3470
9,9,4,1,26,11,37,3470
10,10,3,0,29,11,40,3470
11,11,0,0,29,11,40,3470
0,0,1,0,1,0,1,3471
1,1,1,0,2,0,2,3471
2,2,1,0,3,0,3,3471
3,3,0,0,3,0,3,3471
0,0,1,0,1,0,1,3472
1,1,1,0,2,0,2,3472
2,2,2,0,4,0,4,3472
3,3,2,1,6,1,7,3472
4,4,3,1,9,2,11,3472
5,5,1,0,10,2,12,3472
6,6,1,0,11,2,13,3472
7,7,0,0,11,2,13,3472
0,0,1,0,1,0,1,3473
1,1,0,0,1,0,1,3473
0,0,1,0,1,0,1,3474
1,1,0,0,1,0,1,3474
0,0,1,0,1,0,1,3475
1,1,1,0,2,0,2,3475
2,2,0,0,2,0,2,3475
0,0,1,0,1,0,1,3476
1,1,2,0,3,0,3,3476
2,2,1,0,4,0,4,3476
3,3,1,0,5,0,5,3476
4,4,0,0,5,0,5,3476
0,0,1,0,1,0,1,3477
1,1,0,1,1,1,2,3477
2,2,0,1,1,2,3,3477
3,3,0,0,1,2,3,3477
0,0,1,0,1,0,1,3478
1,1,0,0,1,0,1,3478
0,0,1,0,1,0,1,3479
1,1,0,0,1,0,1,3479
0,0,1,0,1,0,1,3480
1,1,2,0,3,0,3,3480
2,2,3,0,6,0,6,3480
3,3,6,1,12,1,13,3480
4,4,5,2,17,3,20,3480
5,5,3,1,20,4,24,3480
6,6,4,3,24,7,31,3480
7,7,4,5,28,12,40,3480
8,8,3,5,31,17,48,3480
9,9,2,5,33,22,55,3480
10,10,2,3,35,25,60,3480
11,11,3,2,38,27,65,3480
12,12,1,2,39,29,68,3480
13,13,2,2,41,31,72,3480
14,14,1,2,42,33,75,3480
15,15,2,3,44,36,80,3480
16,16,2,3,46,39,85,3480
17,17,2,3,48,42,90,3480
18,18,1,5,49,47,96,3480
19,19,1,11,50,58,108,3480
20,20,2,10,52,68,120,3480
21,21,1,5,53,73,126,3480
22,22,1,1,54,74,128,3480
23,23,1,2,55,76,131,3480
24,24,0,1,55,77,132,3480
25,25,1,0,56,77,133,3480
26,26,1,0,57,77,134,3480
27,27,0,0,57,77,134,3480
0,0,1,0,1,0,1,3481
1,1,0,0,1,0,1,3481
0,0,1,0,1,0,1,3482
1,1,1,0,2,0,2,3482
2,2,1,0,3,0,3,3482
3,3,1,0,4,0,4,3482
4,4,1,0,5,0,5,3482
5,5,3,0,8,0,8,3482
6,6,4,1,12,1,13,3482
7,7,5,3,17,4,21,3482
8,8,3,1,20,5,25,3482
9,9,1,1,21,6,27,3482
10,10,1,2,22,8,30,3482
11,11,1,3,23,11,34,3482
12,12,1,2,24,13,37,3482
13,13,0,1,24,14,38,3482
14,14,0,1,24,15,39,3482
15,15,1,0,25,15,40,3482
16,16,1,0,26,15,41,3482
17,17,1,0,27,15,42,3482
18,18,0,0,27,15,42,3482
0,0,1,0,1,0,1,3483
1,1,0,0,1,0,1,3483
0,0,1,0,1,0,1,3484
1,1,0,0,1,0,1,3484
0,0,1,0,1,0,1,3485
1,1,0,0,1,0,1,3485
0,0,1,0,1,0,1,3486
1,1,0,0,1,0,1,3486
0,0,1,0,1,0,1,3487
1,1,1,0,2,0,2,3487
2,2,1,0,3,0,3,3487
3,3,3,0,6,0,6,3487
4,4,6,1,12,1,13,3487
5,5,4,4,16,5,21,3487
6,6,3,1,19,6,25,3487
7,7,3,1,22,7,29,3487
8,8,4,2,26,9,35,3487
9,9,1,4,27,13,40,3487
10,10,2,3,29,16,45,3487
11,11,1,6,30,22,52,3487
12,12,3,5,33,27,60,3487
13,13,1,4,34,31,65,3487
14,14,0,3,34,34,68,3487
15,15,0,5,34,39,73,3487
16,16,2,5,36,44,80,3487
17,17,2,2,38,46,84,3487
18,18,1,1,39,47,86,3487
19,19,3,2,42,49,91,3487
20,20,2,3,44,52,96,3487
21,21,2,7,46,59,105,3487
22,22,3,4,49,63,112,3487
23,23,2,6,51,69,120,3487
24,24,2,5,53,74,127,3487
25,25,1,1,54,75,129,3487
26,26,2,1,56,76,132,3487
27,27,1,2,57,78,135,3487
28,28,1,1,58,79,137,3487
29,29,0,3,58,82,140,3487
30,30,2,2,60,84,144,3487
31,31,1,1,61,85,146,3487
32,32,2,1,63,86,149,3487
33,33,0,0,63,86,149,3487
0,0,1,0,1,0,1,3488
1,1,1,0,2,0,2,3488
2,2,1,0,3,0,3,3488
3,3,1,2,4,2,6,3488
4,4,0,1,4,3,7,3488
5,5,0,0,4,3,7,3488
0,0,1,0,1,0,1,3489
1,1,0,2,1,2,3,3489
2,2,0,2,1,4,5,3489
3,3,0,1,1,5,6,3489
4,4,0,0,1,5,6,3489
0,0,1,0,1,0,1,3490
1,1,0,0,1,0,1,3490
0,0,1,0,1,0,1,3491
1,1,1,0,2,0,2,3491
2,2,1,0,3,0,3,3491
3,3,1,0,4,0,4,3491
4,4,0,1,4,1,5,3491
5,5,0,1,4,2,6,3491
6,6,0,1,4,3,7,3491
7,7,0,1,4,4,8,3491
8,8,0,1,4,5,9,3491
9,9,0,0,4,5,9,3491
0,0,1,0,1,0,1,3492
1,1,0,0,1,0,1,3492
0,0,1,0,1,0,1,3493
1,1,0,0,1,0,1,3493
0,0,1,0,1,0,1,3494
1,1,0,0,1,0,1,3494
0,0,1,0,1,0,1,3495
1,1,0,2,1,2,3,3495
2,2,1,2,2,4,6,3495
3,3,2,1,4,5,9,3495
4,4,3,2,7,7,14,3495
5,5,2,2,9,9,18,3495
6,6,0,3,9,12,21,3495
7,7,1,4,10,16,26,3495
8,8,5,1,15,17,32,3495
9,9,1,0,16,17,33,3495
10,10,0,1,16,18,34,3495
11,11,0,1,16,19,35,3495
12,12,0,1,16,20,36,3495
13,13,0,1,16,21,37,3495
14,14,0,1,16,22,38,3495
15,15,1,1,17,23,40,3495
16,16,1,0,18,23,41,3495
17,17,1,0,19,23,42,3495
18,18,3,0,22,23,45,3495
19,19,2,1,24,24,48,3495
20,20,1,1,25,25,50,3495
21,21,0,1,25,26,51,3495
22,22,0,1,25,27,52,3495
23,23,0,0,25,27,52,3495
0,0,1,0,1,0,1,3496
1,1,0,0,1,0,1,3496
0,0,1,0,1,0,1,3497
1,1,1,1,2,1,3,3497
2,2,2,2,4,3,7,3497
3,3,0,3,4,6,10,3497
4,4,1,1,5,7,12,3497
5,5,1,1,6,8,14,3497
6,6,0,0,6,8,14,3497
0,0,1,0,1,0,1,3498
1,1,0,1,1,1,2,3498
2,2,0,0,1,1,2,3498
0,0,1,0,1,0,1,3499
1,1,1,0,2,0,2,3499
2,2,0,0,2,0,2,3499
0,0,1,0,1,0,1,3500
1,1,1,0,2,0,2,3500
2,2,1,1,3,1,4,3500
3,3,0,0,3,1,4,3500
0,0,1,0,1,0,1,3501
1,1,1,0,2,0,2,3501
2,2,0,0,2,0,2,3501
0,0,1,0,1,0,1,3502
1,1,0,0,1,0,1,3502
0,0,1,0,1,0,1,3503
1,1,0,1,1,1,2,3503
2,2,0,1,1,2,3,3503
3,3,0,1,1,3,4,3503
4,4,0,2,1,5,6,3503
5,5,1,2,2,7,9,3503
6,6,1,1,3,8,11,3503
7,7,0,2,3,10,13,3503
8,8,0,1,3,11,14,3503
9,9,0,0,3,11,14,3503
0,0,1,0,1,0,1,3504
1,1,0,0,1,0,1,3504
0,0,1,0,1,0,1,3505
1,1,2,0,3,0,3,3505
2,2,2,0,5,0,5,3505
3,3,2,1,7,1,8,3505
4,4,1,3,8,4,12,3505
5,5,1,1,9,5,14,3505
6,6,1,1,10,6,16,3505
7,7,0,0,10,6,16,3505
0,0,1,0,1,0,1,3506
1,1,0,0,1,0,1,3506
0,0,1,0,1,0,1,3507
1,1,0,1,1,1,2,3507
2,2,0,0,1,1,2,3507
0,0,1,0,1,0,1,3508
1,1,1,0,2,0,2,3508
2,2,2,0,4,0,4,3508
3,3,2,0,6,0,6,3508
4,4,0,0,6,0,6,3508
0,0,1,0,1,0,1,3509
1,1,0,0,1,0,1,3509
0,0,1,0,1,0,1,3510
1,1,0,0,1,0,1,3510
0,0,1,0,1,0,1,3511
1,1,1,1,2,1,3,3511
2,2,1,0,3,1,4,3511
3,3,1,0,4,1,5,3511
4,4,0,0,4,1,5,3511
0,0,1,0,1,0,1,3512
1,1,1,0,2,0,2,3512
2,2,0,0,2,0,2,3512
0,0,1,0,1,0,1,3513
1,1,2,0,3,0,3,3513
2,2,3,0,6,0,6,3513
3,3,2,3,8,3,11,3513
4,4,1,3,9,6,15,3513
5,5,2,3,11,9,20,3513
6,6,1,3,12,12,24,3513
7,7,0,2,12,14,26,3513
8,8,1,1,13,15,28,3513
9,9,1,0,14,15,29,3513
10,10,1,0,15,15,30,3513
11,11,0,0,15,15,30,3513
0,0,1,0,1,0,1,3514
1,1,0,2,1,2,3,3514
2,2,0,2,1,4,5,3514
3,3,2,1,3,5,8,3514
4,4,2,2,5,7,12,3514
5,5,3,4,8,11,19,3514
6,6,4,2,12,13,25,3514
7,7,4,0,16,13,29,3514
8,8,4,0,20,13,33,3514
9,9,0,0,20,13,33,3514
0,0,1,0,1,0,1,3515
1,1,0,0,1,0,1,3515
0,0,1,0,1,0,1,3516
1,1,0,1,1,1,2,3516
2,2,0,3,1,4,5,3516
3,3,0,4,1,8,9,3516
4,4,0,1,1,9,10,3516
5,5,0,1,1,10,11,3516
6,6,0,1,1,11,12,3516
7,7,0,1,1,12,13,3516
8,8,0,0,1,12,13,3516
0,0,1,0,1,0,1,3517
1,1,0,0,1,0,1,3517
0,0,1,0,1,0,1,3518
1,1,0,0,1,0,1,3518
0,0,1,0,1,0,1,3519
1,1,0,0,1,0,1,3519
0,0,1,0,1,0,1,3520
1,1,0,0,1,0,1,3520
0,0,1,0,1,0,1,3521
1,1,2,0,3,0,3,3521
2,2,3,0,6,0,6,3521
3,3,2,2,8,2,10,3521
4,4,2,5,10,7,17,3521
5,5,1,2,11,9,20,3521
6,6,1,2,12,11,23,3521
7,7,0,0,12,11,23,3521
0,0,1,0,1,0,1,3522
1,1,3,0,4,0,4,3522
2,2,0,1,4,1,5,3522
3,3,1,0,5,1,6,3522
4,4,0,0,5,1,6,3522
0,0,1,0,1,0,1,3523
1,1,0,0,1,0,1,3523
0,0,1,0,1,0,1,3524
1,1,1,0,2,0,2,3524
2,2,0,1,2,1,3,3524
3,3,0,0,2,1,3,3524
0,0,1,0,1,0,1,3525
1,1,0,0,1,0,1,3525
0,0,1,0,1,0,1,3526
1,1,0,0,1,0,1,3526
0,0,1,0,1,0,1,3527
1,1,0,0,1,0,1,3527
0,0,1,0,1,0,1,3528
1,1,0,0,1,0,1,3528
0,0,1,0,1,0,1,3529
1,1,0,1,1,1,2,3529
2,2,0,0,1,1,2,3529
0,0,1,0,1,0,1,3530
1,1,0,2,1,2,3,3530
2,2,0,4,1,6,7,3530
3,3,0,3,1,9,10,3530
4,4,0,2,1,11,12,3530
5,5,0,3,1,14,15,3530
6,6,0,3,1,17,18,3530
7,7,0,3,1,20,21,3530
8,8,1,2,2,22,24,3530
9,9,0,3,2,25,27,3530
10,10,0,3,2,28,30,3530
11,11,1,3,3,31,34,3530
12,12,1,1,4,32,36,3530
13,13,0,1,4,33,37,3530
14,14,0,1,4,34,38,3530
15,15,2,0,6,34,40,3530
16,16,2,0,8,34,42,3530
17,17,0,0,8,34,42,3530
0,0,1,0,1,0,1,3531
1,1,0,0,1,0,1,3531
0,0,1,0,1,0,1,3532
1,1,1,1,2,1,3,3532
2,2,1,2,3,3,6,3532
3,3,0,3,3,6,9,3532
4,4,2,2,5,8,13,3532
5,5,1,0,6,8,14,3532
6,6,0,0,6,8,14,3532
0,0,1,0,1,0,1,3533
1,1,1,0,2,0,2,3533
2,2,0,0,2,0,2,3533
0,0,1,0,1,0,1,3534
1,1,0,0,1,0,1,3534
0,0,1,0,1,0,1,3535
1,1,0,0,1,0,1,3535
0,0,1,0,1,0,1,3536
1,1,2,0,3,0,3,3536
2,2,0,0,3,0,3,3536
0,0,1,0,1,0,1,3537
1,1,2,0,3,0,3,3537
2,2,2,0,5,0,5,3537
3,3,0,1,5,1,6,3537
4,4,0,0,5,1,6,3537
0,0,1,0,1,0,1,3538
1,1,2,0,3,0,3,3538
2,2,1,0,4,0,4,3538
3,3,1,0,5,0,5,3538
4,4,3,0,8,0,8,3538
5,5,1,0,9,0,9,3538
6,6,0,0,9,0,9,3538
0,0,1,0,1,0,1,3539
1,1,0,0,1,0,1,3539
0,0,1,0,1,0,1,3540
1,1,1,0,2,0,2,3540
2,2,1,0,3,0,3,3540
3,3,0,0,3,0,3,3540
0,0,1,0,1,0,1,3541
1,1,0,0,1,0,1,3541
0,0,1,0,1,0,1,3542
1,1,0,0,1,0,1,3542
0,0,1,0,1,0,1,3543
1,1,0,0,1,0,1,3543
0,0,1,0,1,0,1,3544
1,1,0,1,1,1,2,3544
2,2,0,0,1,1,2,3544
0,0,1,0,1,0,1,3545
1,1,0,3,1,3,4,3545
2,2,0,2,1,5,6,3545
3,3,1,0,2,5,7,3545
4,4,0,0,2,5,7,3545
0,0,1,0,1,0,1,3546
1,1,0,0,1,0,1,3546
0,0,1,0,1,0,1,3547
1,1,2,1,3,1,4,3547
2,2,0,0,3,1,4,3547
0,0,1,0,1,0,1,3548
1,1,0,0,1,0,1,3548
0,0,1,0,1,0,1,3549
1,1,2,0,3,0,3,3549
2,2,1,0,4,0,4,3549
3,3,0,0,4,0,4,3549
0,0,1,0,1,0,1,3550
1,1,0,0,1,0,1,3550
0,0,1,0,1,0,1,3551
1,1,1,0,2,0,2,3551
2,2,0,1,2,1,3,3551
3,3,1,0,3,1,4,3551
4,4,1,0,4,1,5,3551
5,5,1,0,5,1,6,3551
6,6,3,0,8,1,9,3551
7,7,5,1,13,2,15,3551
8,8,2,2,15,4,19,3551
9,9,4,1,19,5,24,3551
10,10,6,3,25,8,33,3551
11,11,4,0,29,8,37,3551
12,12,2,1,31,9,40,3551
13,13,3,1,34,10,44,3551
14,14,2,3,36,13,49,3551
15,15,0,3,36,16,52,3551
16,16,1,2,37,18,55,3551
17,17,0,3,37,21,58,3551
18,18,0,1,37,22,59,3551
19,19,0,0,37,22,59,3551
0,0,1,0,1,0,1,3552
1,1,1,0,2,0,2,3552
2,2,0,0,2,0,2,3552
0,0,1,0,1,0,1,3553
1,1,0,1,1,1,2,3553
2,2,0,1,1,2,3,3553
3,3,1,1,2,3,5,3553
4,4,2,3,4,6,10,3553
5,5,1,1,5,7,12,3553
6,6,0,1,5,8,13,3553
7,7,0,1,5,9,14,3553
8,8,0,1,5,10,15,3553
9,9,0,0,5,10,15,3553
0,0,1,0,1,0,1,3554
1,1,0,0,1,0,1,3554
0,0,1,0,1,0,1,3555
1,1,0,1,1,1,2,3555
2,2,0,0,1,1,2,3555
0,0,1,0,1,0,1,3556
1,1,0,0,1,0,1,3556
0,0,1,0,1,0,1,3557
1,1,0,0,1,0,1,3557
0,0,1,0,1,0,1,3558
1,1,0,0,1,0,1,3558
0,0,1,0,1,0,1,3559
1,1,0,1,1,1,2,3559
2,2,0,2,1,3,4,3559
3,3,0,1,1,4,5,3559
4,4,0,0,1,4,5,3559
0,0,1,0,1,0,1,3560
1,1,0,0,1,0,1,3560
0,0,1,0,1,0,1,3561
1,1,1,0,2,0,2,3561
2,2,0,0,2,0,2,3561
0,0,1,0,1,0,1,3562
1,1,2,0,3,0,3,3562
2,2,1,1,4,1,5,3562
3,3,1,0,5,1,6,3562
4,4,1,0,6,1,7,3562
5,5,1,0,7,1,8,3562
6,6,1,0,8,1,9,3562
7,7,0,0,8,1,9,3562
0,0,1,0,1,0,1,3563
1,1,0,0,1,0,1,3563
0,0,1,0,1,0,1,3564
1,1,1,0,2,0,2,3564
2,2,0,0,2,0,2,3564
0,0,1,0,1,0,1,3565
1,1,2,0,3,0,3,3565
2,2,2,0,5,0,5,3565
3,3,3,0,8,0,8,3565
4,4,2,1,10,1,11,3565
5,5,3,1,13,2,15,3565
6,6,2,3,15,5,20,3565
7,7,2,4,17,9,26,3565
8,8,0,4,17,13,30,3565
9,9,0,5,17,18,35,3565
10,10,0,4,17,22,39,3565
11,11,0,4,17,26,43,3565
12,12,1,5,18,31,49,3565
13,13,2,7,20,38,58,3565
14,14,5,5,25,43,68,3565
15,15,4,6,29,49,78,3565
16,16,5,6,34,55,89,3565
17,17,4,6,38,61,99,3565
18,18,6,3,44,64,108,3565
19,19,8,3,52,67,119,3565
20,20,11,6,63,73,136,3565
21,21,5,6,68,79,147,3565
22,22,9,8,77,87,164,3565
23,23,6,8,83,95,178,3565
24,24,8,10,91,105,196,3565
25,25,13,10,104,115,219,3565
26,26,13,8,117,123,240,3565
27,27,9,4,126,127,253,3565
28,28,5,8,131,135,266,3565
29,29,3,5,134,140,274,3565
30,30,6,4,140,144,284,3565
31,31,5,4,145,148,293,3565
32,32,7,5,152,153,305,3565
33,33,4,2,156,155,311,3565
34,34,3,2,159,157,316,3565
35,35,5,2,164,159,323,3565
36,36,5,1,169,160,329,3565
37,37,4,2,173,162,335,3565
38,38,4,1,177,163,340,3565
39,39,5,2,182,165,347,3565
40,40,0,2,182,167,349,3565
41,41,1,2,183,169,352,3565
42,42,2,0,185,169,354,3565
43,43,1,0,186,169,355,3565
44,44,2,0,188,169,357,3565
45,45,1,1,189,170,359,3565
46,46,1,2,190,172,362,3565
47,47,0,2,190,174,364,3565
48,48,0,2,190,176,366,3565
49,49,0,2,190,178,368,3565
50,50,1,1,191,179,370,3565
51,51,2,0,193,179,372,3565
52,52,3,0,196,179,375,3565
53,53,0,0,196,179,375,3565
0,0,1,0,1,0,1,3566
1,1,1,0,2,0,2,3566
2,2,1,1,3,1,4,3566
3,3,0,3,3,4,7,3566
4,4,0,5,3,9,12,3566
5,5,0,4,3,13,16,3566
6,6,1,4,4,17,21,3566
7,7,1,5,5,22,27,3566
8,8,2,3,7,25,32,3566
9,9,3,2,10,27,37,3566
10,10,3,2,13,29,42,3566
11,11,1,1,14,30,44,3566
12,12,0,0,14,30,44,3566
0,0,1,0,1,0,1,3567
1,1,1,0,2,0,2,3567
2,2,1,0,3,0,3,3567
3,3,0,0,3,0,3,3567
0,0,1,0,1,0,1,3568
1,1,0,0,1,0,1,3568
0,0,1,0,1,0,1,3569
1,1,1,0,2,0,2,3569
2,2,1,0,3,0,3,3569
3,3,2,0,5,0,5,3569
4,4,2,0,7,0,7,3569
5,5,4,0,11,0,11,3569
6,6,4,0,15,0,15,3569
7,7,4,1,19,1,20,3569
8,8,2,1,21,2,23,3569
9,9,0,0,21,2,23,3569
0,0,1,0,1,0,1,3570
1,1,1,0,2,0,2,3570
2,2,1,0,3,0,3,3570
3,3,0,0,3,0,3,3570
0,0,1,0,1,0,1,3571
1,1,1,0,2,0,2,3571
2,2,1,0,3,0,3,3571
3,3,0,0,3,0,3,3571
0,0,1,0,1,0,1,3572
1,1,0,0,1,0,1,3572
0,0,1,0,1,0,1,3573
1,1,0,1,1,1,2,3573
2,2,1,0,2,1,3,3573
3,3,2,0,4,1,5,3573
4,4,0,1,4,2,6,3573
5,5,0,1,4,3,7,3573
6,6,0,2,4,5,9,3573
7,7,1,6,5,11,16,3573
8,8,0,2,5,13,18,3573
9,9,0,3,5,16,21,3573
10,10,0,2,5,18,23,3573
11,11,1,0,6,18,24,3573
12,12,0,1,6,19,25,3573
13,13,0,0,6,19,25,3573
0,0,1,0,1,0,1,3574
1,1,0,0,1,0,1,3574
0,0,1,0,1,0,1,3575
1,1,0,0,1,0,1,3575
0,0,1,0,1,0,1,3576
1,1,0,0,1,0,1,3576
0,0,1,0,1,0,1,3577
1,1,0,0,1,0,1,3577
0,0,1,0,1,0,1,3578
1,1,0,0,1,0,1,3578
0,0,1,0,1,0,1,3579
1,1,1,0,2,0,2,3579
2,2,0,0,2,0,2,3579
0,0,1,0,1,0,1,3580
1,1,3,0,4,0,4,3580
2,2,2,0,6,0,6,3580
3,3,1,0,7,0,7,3580
4,4,0,1,7,1,8,3580
5,5,0,2,7,3,10,3580
6,6,0,0,7,3,10,3580
0,0,1,0,1,0,1,3581
1,1,2,0,3,0,3,3581
2,2,2,0,5,0,5,3581
3,3,1,0,6,0,6,3581
4,4,3,0,9,0,9,3581
5,5,3,0,12,0,12,3581
6,6,2,2,14,2,16,3581
7,7,1,1,15,3,18,3581
8,8,0,0,15,3,18,3581
0,0,1,0,1,0,1,3582
1,1,2,1,3,1,4,3582
2,2,1,1,4,2,6,3582
3,3,2,1,6,3,9,3582
4,4,3,2,9,5,14,3582
5,5,1,1,10,6,16,3582
6,6,1,0,11,6,17,3582
7,7,2,0,13,6,19,3582
8,8,1,0,14,6,20,3582
9,9,1,0,15,6,21,3582
10,10,1,1,16,7,23,3582
11,11,2,1,18,8,26,3582
12,12,3,4,21,12,33,3582
13,13,3,3,24,15,39,3582
14,14,2,2,26,17,43,3582
15,15,3,2,29,19,48,3582
16,16,4,1,33,20,53,3582
17,17,5,0,38,20,58,3582
18,18,5,0,43,20,63,3582
19,19,2,0,45,20,65,3582
20,20,2,0,47,20,67,3582
21,21,2,0,49,20,69,3582
22,22,2,0,51,20,71,3582
23,23,1,0,52,20,72,3582
24,24,0,1,52,21,73,3582
25,25,0,1,52,22,74,3582
26,26,0,0,52,22,74,3582
0,0,1,0,1,0,1,3583
1,1,2,1,3,1,4,3583
2,2,0,1,3,2,5,3583
3,3,0,0,3,2,5,3583
0,0,1,0,1,0,1,3584
1,1,0,0,1,0,1,3584
0,0,1,0,1,0,1,3585
1,1,2,1,3,1,4,3585
2,2,2,1,5,2,7,3585
3,3,2,1,7,3,10,3585
4,4,0,0,7,3,10,3585
0,0,1,0,1,0,1,3586
1,1,1,0,2,0,2,3586
2,2,0,0,2,0,2,3586
0,0,1,0,1,0,1,3587
1,1,0,0,1,0,1,3587
0,0,1,0,1,0,1,3588
1,1,2,1,3,1,4,3588
2,2,0,2,3,3,6,3588
3,3,0,1,3,4,7,3588
4,4,0,2,3,6,9,3588
5,5,0,1,3,7,10,3588
6,6,0,1,3,8,11,3588
7,7,0,0,3,8,11,3588
0,0,1,0,1,0,1,3589
1,1,2,1,3,1,4,3589
2,2,1,3,4,4,8,3589
3,3,1,1,5,5,10,3589
4,4,2,1,7,6,13,3589
5,5,4,1,11,7,18,3589
6,6,3,0,14,7,21,3589
7,7,0,1,14,8,22,3589
8,8,0,0,14,8,22,3589
0,0,1,0,1,0,1,3590
1,1,0,0,1,0,1,3590
0,0,1,0,1,0,1,3591
1,1,1,0,2,0,2,3591
2,2,1,0,3,0,3,3591
3,3,1,0,4,0,4,3591
4,4,0,0,4,0,4,3591
0,0,1,0,1,0,1,3592
1,1,0,0,1,0,1,3592
0,0,1,0,1,0,1,3593
1,1,0,0,1,0,1,3593
0,0,1,0,1,0,1,3594
1,1,2,0,3,0,3,3594
2,2,1,0,4,0,4,3594
3,3,0,0,4,0,4,3594
0,0,1,0,1,0,1,3595
1,1,0,0,1,0,1,3595
0,0,1,0,1,0,1,3596
1,1,1,1,2,1,3,3596
2,2,0,0,2,1,3,3596
0,0,1,0,1,0,1,3597
1,1,0,0,1,0,1,3597
0,0,1,0,1,0,1,3598
1,1,1,0,2,0,2,3598
2,2,0,0,2,0,2,3598
0,0,1,0,1,0,1,3599
1,1,1,0,2,0,2,3599
2,2,2,0,4,0,4,3599
3,3,2,0,6,0,6,3599
4,4,2,0,8,0,8,3599
5,5,1,0,9,0,9,3599
6,6,0,0,9,0,9,3599
0,0,1,0,1,0,1,3600
1,1,0,0,1,0,1,3600
0,0,1,0,1,0,1,3601
1,1,0,0,1,0,1,3601
0,0,1,0,1,0,1,3602
1,1,0,0,1,0,1,3602
0,0,1,0,1,0,1,3603
1,1,1,1,2,1,3,3603
2,2,0,1,2,2,4,3603
3,3,0,0,2,2,4,3603
0,0,1,0,1,0,1,3604
1,1,0,0,1,0,1,3604
0,0,1,0,1,0,1,3605
1,1,1,0,2,0,2,3605
2,2,1,1,3,1,4,3605
3,3,1,2,4,3,7,3605
4,4,1,3,5,6,11,3605
5,5,3,3,8,9,17,3605
6,6,6,1,14,10,24,3605
7,7,8,3,22,13,35,3605
8,8,9,10,31,23,54,3605
9,9,12,14,43,37,80,3605
10,10,10,21,53,58,111,3605
11,11,7,12,60,70,130,3605
12,12,11,9,71,79,150,3605
13,13,9,9,80,88,168,3605
14,14,7,7,87,95,182,3605
15,15,5,10,92,105,197,3605
16,16,6,7,98,112,210,3605
17,17,7,4,105,116,221,3605
18,18,5,4,110,120,230,3605
19,19,3,4,113,124,237,3605
20,20,1,1,114,125,239,3605
21,21,2,1,116,126,242,3605
22,22,1,2,117,128,245,3605
23,23,1,3,118,131,249,3605
24,24,2,5,120,136,256,3605
25,25,3,3,123,139,262,3605
26,26,2,1,125,140,265,3605
27,27,0,1,125,141,266,3605
28,28,0,0,125,141,266,3605
0,0,1,0,1,0,1,3606
1,1,1,0,2,0,2,3606
2,2,2,0,4,0,4,3606
3,3,1,1,5,1,6,3606
4,4,1,1,6,2,8,3606
5,5,2,0,8,2,10,3606
6,6,0,0,8,2,10,3606
0,0,1,0,1,0,1,3607
1,1,0,0,1,0,1,3607
0,0,1,0,1,0,1,3608
1,1,1,0,2,0,2,3608
2,2,1,0,3,0,3,3608
3,3,1,0,4,0,4,3608
4,4,0,0,4,0,4,3608
0,0,1,0,1,0,1,3609
1,1,0,0,1,0,1,3609
0,0,1,0,1,0,1,3610
1,1,2,0,3,0,3,3610
2,2,1,0,4,0,4,3610
3,3,0,0,4,0,4,3610
0,0,1,0,1,0,1,3611
1,1,1,0,2,0,2,3611
2,2,1,0,3,0,3,3611
3,3,1,0,4,0,4,3611
4,4,1,0,5,0,5,3611
5,5,1,0,6,0,6,3611
6,6,2,0,8,0,8,3611
7,7,1,0,9,0,9,3611
8,8,0,0,9,0,9,3611
0,0,1,0,1,0,1,3612
1,1,1,0,2,0,2,3612
2,2,0,0,2,0,2,3612
0,0,1,0,1,0,1,3613
1,1,2,0,3,0,3,3613
2,2,3,0,6,0,6,3613
3,3,3,0,9,0,9,3613
4,4,1,1,10,1,11,3613
5,5,0,0,10,1,11,3613
0,0,1,0,1,0,1,3614
1,1,0,0,1,0,1,3614
0,0,1,0,1,0,1,3615
1,1,0,0,1,0,1,3615
0,0,1,0,1,0,1,3616
1,1,1,0,2,0,2,3616
2,2,0,0,2,0,2,3616
0,0,1,0,1,0,1,3617
1,1,0,0,1,0,1,3617
0,0,1,0,1,0,1,3618
1,1,1,0,2,0,2,3618
2,2,1,0,3,0,3,3618
3,3,2,0,5,0,5,3618
4,4,1,0,6,0,6,3618
5,5,1,0,7,0,7,3618
6,6,2,0,9,0,9,3618
7,7,2,0,11,0,11,3618
8,8,1,1,12,1,13,3618
9,9,2,0,14,1,15,3618
10,10,6,0,20,1,21,3618
11,11,1,0,21,1,22,3618
12,12,1,0,22,1,23,3618
13,13,2,2,24,3,27,3618
14,14,0,0,24,3,27,3618
0,0,1,0,1,0,1,3619
1,1,2,0,3,0,3,3619
2,2,0,0,3,0,3,3619
0,0,1,0,1,0,1,3620
1,1,0,1,1,1,2,3620
2,2,0,2,1,3,4,3620
3,3,0,3,1,6,7,3620
4,4,0,1,1,7,8,3620
5,5,0,0,1,7,8,3620
0,0,1,0,1,0,1,3621
1,1,0,1,1,1,2,3621
2,2,0,2,1,3,4,3621
3,3,1,2,2,5,7,3621
4,4,0,1,2,6,8,3621
5,5,0,1,2,7,9,3621
6,6,0,0,2,7,9,3621
0,0,1,0,1,0,1,3622
1,1,0,0,1,0,1,3622
0,0,1,0,1,0,1,3623
1,1,2,0,3,0,3,3623
2,2,2,1,5,1,6,3623
3,3,1,0,6,1,7,3623
4,4,0,0,6,1,7,3623
0,0,1,0,1,0,1,3624
1,1,0,0,1,0,1,3624
0,0,1,0,1,0,1,3625
1,1,0,0,1,0,1,3625
0,0,1,0,1,0,1,3626
1,1,0,0,1,0,1,3626
0,0,1,0,1,0,1,3627
1,1,2,0,3,0,3,3627
2,2,1,0,4,0,4,3627
3,3,0,0,4,0,4,3627
0,0,1,0,1,0,1,3628
1,1,2,0,3,0,3,3628
2,2,0,0,3,0,3,3628
0,0,1,0,1,0,1,3629
1,1,0,0,1,0,1,3629
0,0,1,0,1,0,1,3630
1,1,0,1,1,1,2,3630
2,2,0,0,1,1,2,3630
0,0,1,0,1,0,1,3631
1,1,0,1,1,1,2,3631
2,2,1,0,2,1,3,3631
3,3,1,1,3,2,5,3631
4,4,0,2,3,4,7,3631
5,5,0,0,3,4,7,3631
0,0,1,0,1,0,1,3632
1,1,0,0,1,0,1,3632
0,0,1,0,1,0,1,3633
1,1,0,0,1,0,1,3633
0,0,1,0,1,0,1,3634
1,1,2,0,3,0,3,3634
2,2,1,1,4,1,5,3634
3,3,2,2,6,3,9,3634
4,4,5,1,11,4,15,3634
5,5,4,0,15,4,19,3634
6,6,5,1,20,5,25,3634
7,7,3,1,23,6,29,3634
8,8,0,2,23,8,31,3634
9,9,0,2,23,10,33,3634
10,10,0,0,23,10,33,3634
0,0,1,0,1,0,1,3635
1,1,2,1,3,1,4,3635
2,2,1,1,4,2,6,3635
3,3,0,0,4,2,6,3635
0,0,1,0,1,0,1,3636
1,1,1,0,2,0,2,3636
2,2,3,0,5,0,5,3636
3,3,4,0,9,0,9,3636
4,4,1,0,10,0,10,3636
5,5,1,0,11,0,11,3636
6,6,1,0,12,0,12,3636
7,7,2,0,14,0,14,3636
8,8,2,1,16,1,17,3636
9,9,1,2,17,3,20,3636
10,10,1,0,18,3,21,3636
11,11,1,0,19,3,22,3636
12,12,0,0,19,3,22,3636
0,0,1,0,1,0,1,3637
1,1,1,0,2,0,2,3637
2,2,1,0,3,0,3,3637
3,3,1,0,4,0,4,3637
4,4,1,1,5,1,6,3637
5,5,0,1,5,2,7,3637
6,6,0,1,5,3,8,3637
7,7,0,3,5,6,11,3637
8,8,0,2,5,8,13,3637
9,9,0,4,5,12,17,3637
10,10,0,2,5,14,19,3637
11,11,0,3,5,17,22,3637
12,12,0,1,5,18,23,3637
13,13,0,0,5,18,23,3637
0,0,1,0,1,0,1,3638
1,1,1,1,2,1,3,3638
2,2,0,2,2,3,5,3638
3,3,1,1,3,4,7,3638
4,4,3,1,6,5,11,3638
5,5,3,0,9,5,14,3638
6,6,1,1,10,6,16,3638
7,7,0,1,10,7,17,3638
8,8,0,0,10,7,17,3638
0,0,1,0,1,0,1,3639
1,1,1,1,2,1,3,3639
2,2,0,1,2,2,4,3639
3,3,0,0,2,2,4,3639
0,0,1,0,1,0,1,3640
1,1,1,0,2,0,2,3640
2,2,0,0,2,0,2,3640
0,0,1,0,1,0,1,3641
1,1,1,0,2,0,2,3641
2,2,1,1,3,1,4,3641
3,3,1,3,4,4,8,3641
4,4,0,5,4,9,13,3641
5,5,2,6,6,15,21,3641
6,6,1,2,7,17,24,3641
7,7,0,1,7,18,25,3641
8,8,1,1,8,19,27,3641
9,9,1,2,9,21,30,3641
10,10,0,3,9,24,33,3641
11,11,0,3,9,27,36,3641
12,12,1,2,10,29,39,3641
13,13,1,0,11,29,40,3641
14,14,0,0,11,29,40,3641
0,0,1,0,1,0,1,3642
1,1,0,1,1,1,2,3642
2,2,0,0,1,1,2,3642
0,0,1,0,1,0,1,3643
1,1,1,0,2,0,2,3643
2,2,0,0,2,0,2,3643
0,0,1,0,1,0,1,3644
1,1,0,0,1,0,1,3644
0,0,1,0,1,0,1,3645
1,1,0,0,1,0,1,3645
0,0,1,0,1,0,1,3646
1,1,1,0,2,0,2,3646
2,2,0,0,2,0,2,3646
0,0,1,0,1,0,1,3647
1,1,0,1,1,1,2,3647
2,2,0,0,1,1,2,3647
0,0,1,0,1,0,1,3648
1,1,1,0,2,0,2,3648
2,2,1,0,3,0,3,3648
3,3,0,0,3,0,3,3648
0,0,1,0,1,0,1,3649
1,1,2,0,3,0,3,3649
2,2,0,0,3,0,3,3649
0,0,1,0,1,0,1,3650
1,1,1,1,2,1,3,3650
2,2,0,2,2,3,5,3650
3,3,0,2,2,5,7,3650
4,4,0,2,2,7,9,3650
5,5,1,3,3,10,13,3650
6,6,3,0,6,10,16,3650
7,7,6,0,12,10,22,3650
8,8,4,0,16,10,26,3650
9,9,2,1,18,11,29,3650
10,10,1,0,19,11,30,3650
11,11,1,0,20,11,31,3650
12,12,0,0,20,11,31,3650
0,0,1,0,1,0,1,3651
1,1,0,2,1,2,3,3651
2,2,0,4,1,6,7,3651
3,3,0,1,1,7,8,3651
4,4,0,1,1,8,9,3651
5,5,1,0,2,8,10,3651
6,6,0,0,2,8,10,3651
0,0,1,0,1,0,1,3652
1,1,1,0,2,0,2,3652
2,2,1,1,3,1,4,3652
3,3,2,1,5,2,7,3652
4,4,0,2,5,4,9,3652
5,5,1,1,6,5,11,3652
6,6,1,1,7,6,13,3652
7,7,0,1,7,7,14,3652
8,8,0,2,7,9,16,3652
9,9,0,2,7,11,18,3652
10,10,0,0,7,11,18,3652
0,0,1,0,1,0,1,3653
1,1,0,0,1,0,1,3653
0,0,1,0,1,0,1,3654
1,1,1,0,2,0,2,3654
2,2,1,0,3,0,3,3654
3,3,1,0,4,0,4,3654
4,4,0,1,4,1,5,3654
5,5,0,0,4,1,5,3654
0,0,1,0,1,0,1,3655
1,1,1,0,2,0,2,3655
2,2,1,0,3,0,3,3655
3,3,0,0,3,0,3,3655
0,0,1,0,1,0,1,3656
1,1,0,0,1,0,1,3656
0,0,1,0,1,0,1,3657
1,1,0,0,1,0,1,3657
0,0,1,0,1,0,1,3658
1,1,2,1,3,1,4,3658
2,2,2,2,5,3,8,3658
3,3,4,4,9,7,16,3658
4,4,7,2,16,9,25,3658
5,5,7,3,23,12,35,3658
6,6,6,2,29,14,43,3658
7,7,4,2,33,16,49,3658
8,8,2,2,35,18,53,3658
9,9,1,1,36,19,55,3658
10,10,1,0,37,19,56,3658
11,11,0,0,37,19,56,3658
0,0,1,0,1,0,1,3659
1,1,0,0,1,0,1,3659
0,0,1,0,1,0,1,3660
1,1,0,2,1,2,3,3660
2,2,0,0,1,2,3,3660
0,0,1,0,1,0,1,3661
1,1,0,0,1,0,1,3661
0,0,1,0,1,0,1,3662
1,1,1,0,2,0,2,3662
2,2,1,0,3,0,3,3662
3,3,0,0,3,0,3,3662
0,0,1,0,1,0,1,3663
1,1,0,0,1,0,1,3663
0,0,1,0,1,0,1,3664
1,1,0,0,1,0,1,3664
0,0,1,0,1,0,1,3665
1,1,1,1,2,1,3,3665
2,2,1,2,3,3,6,3665
3,3,2,4,5,7,12,3665
4,4,4,4,9,11,20,3665
5,5,3,1,12,12,24,3665
6,6,0,0,12,12,24,3665
0,0,1,0,1,0,1,3666
1,1,0,1,1,1,2,3666
2,2,0,2,1,3,4,3666
3,3,0,1,1,4,5,3666
4,4,0,1,1,5,6,3666
5,5,0,2,1,7,8,3666
6,6,1,3,2,10,12,3666
7,7,3,5,5,15,20,3666
8,8,1,8,6,23,29,3666
9,9,5,8,11,31,42,3666
10,10,6,14,17,45,62,3666
11,11,9,13,26,58,84,3666
12,12,8,5,34,63,97,3666
13,13,7,5,41,68,109,3666
14,14,4,8,45,76,121,3666
15,15,3,10,48,86,134,3666
16,16,4,9,52,95,147,3666
17,17,3,5,55,100,155,3666
18,18,2,3,57,103,160,3666
19,19,0,8,57,111,168,3666
20,20,1,4,58,115,173,3666
21,21,0,5,58,120,178,3666
22,22,0,2,58,122,180,3666
23,23,0,2,58,124,182,3666
24,24,1,1,59,125,184,3666
25,25,0,2,59,127,186,3666
26,26,0,0,59,127,186,3666
0,0,1,0,1,0,1,3667
1,1,1,1,2,1,3,3667
2,2,0,1,2,2,4,3667
3,3,0,2,2,4,6,3667
4,4,0,2,2,6,8,3667
5,5,0,1,2,7,9,3667
6,6,0,1,2,8,10,3667
7,7,0,1,2,9,11,3667
8,8,0,1,2,10,12,3667
9,9,0,0,2,10,12,3667
0,0,1,0,1,0,1,3668
1,1,0,0,1,0,1,3668
0,0,1,0,1,0,1,3669
1,1,1,0,2,0,2,3669
2,2,2,0,4,0,4,3669
3,3,1,1,5,1,6,3669
4,4,1,1,6,2,8,3669
5,5,0,0,6,2,8,3669
0,0,1,0,1,0,1,3670
1,1,0,1,1,1,2,3670
2,2,0,0,1,1,2,3670
0,0,1,0,1,0,1,3671
1,1,0,0,1,0,1,3671
0,0,1,0,1,0,1,3672
1,1,1,0,2,0,2,3672
2,2,3,0,5,0,5,3672
3,3,0,1,5,1,6,3672
4,4,0,3,5,4,9,3672
5,5,1,5,6,9,15,3672
6,6,3,4,9,13,22,3672
7,7,2,2,11,15,26,3672
8,8,1,2,12,17,29,3672
9,9,1,1,13,18,31,3672
10,10,2,0,15,18,33,3672
11,11,1,1,16,19,35,3672
12,12,2,1,18,20,38,3672
13,13,0,1,18,21,39,3672
14,14,0,0,18,21,39,3672
0,0,1,0,1,0,1,3673
1,1,1,0,2,0,2,3673
2,2,0,2,2,2,4,3673
3,3,0,2,2,4,6,3673
4,4,1,0,3,4,7,3673
5,5,2,0,5,4,9,3673
6,6,0,0,5,4,9,3673
0,0,1,0,1,0,1,3674
1,1,1,0,2,0,2,3674
2,2,0,0,2,0,2,3674
0,0,1,0,1,0,1,3675
1,1,1,1,2,1,3,3675
2,2,1,2,3,3,6,3675
3,3,1,2,4,5,9,3675
4,4,1,3,5,8,13,3675
5,5,1,2,6,10,16,3675
6,6,0,5,6,15,21,3675
7,7,1,3,7,18,25,3675
8,8,1,2,8,20,28,3675
9,9,0,3,8,23,31,3675
10,10,1,2,9,25,34,3675
11,11,2,0,11,25,36,3675
12,12,2,0,13,25,38,3675
13,13,0,0,13,25,38,3675
0,0,1,0,1,0,1,3676
1,1,0,0,1,0,1,3676
0,0,1,0,1,0,1,3677
1,1,2,0,3,0,3,3677
2,2,2,0,5,0,5,3677
3,3,2,1,7,1,8,3677
4,4,1,1,8,2,10,3677
5,5,0,1,8,3,11,3677
6,6,0,2,8,5,13,3677
7,7,0,3,8,8,16,3677
8,8,0,2,8,10,18,3677
9,9,0,1,8,11,19,3677
10,10,0,2,8,13,21,3677
11,11,0,1,8,14,22,3677
12,12,0,1,8,15,23,3677
13,13,0,1,8,16,24,3677
14,14,0,2,8,18,26,3677
15,15,1,2,9,20,29,3677
16,16,1,1,10,21,31,3677
17,17,0,0,10,21,31,3677
0,0,1,0,1,0,1,3678
1,1,1,1,2,1,3,3678
2,2,1,0,3,1,4,3678
3,3,1,0,4,1,5,3678
4,4,0,0,4,1,5,3678
0,0,1,0,1,0,1,3679
1,1,1,1,2,1,3,3679
2,2,0,1,2,2,4,3679
3,3,0,0,2,2,4,3679
0,0,1,0,1,0,1,3680
1,1,1,1,2,1,3,3680
2,2,1,0,3,1,4,3680
3,3,0,0,3,1,4,3680
0,0,1,0,1,0,1,3681
1,1,0,0,1,0,1,3681
0,0,1,0,1,0,1,3682
1,1,1,0,2,0,2,3682
2,2,0,0,2,0,2,3682
0,0,1,0,1,0,1,3683
1,1,0,0,1,0,1,3683
0,0,1,0,1,0,1,3684
1,1,1,0,2,0,2,3684
2,2,1,0,3,0,3,3684
3,3,0,0,3,0,3,3684
0,0,1,0,1,0,1,3685
1,1,2,1,3,1,4,3685
2,2,2,0,5,1,6,3685
3,3,1,0,6,1,7,3685
4,4,1,0,7,1,8,3685
5,5,0,0,7,1,8,3685
0,0,1,0,1,0,1,3686
1,1,0,0,1,0,1,3686
0,0,1,0,1,0,1,3687
1,1,1,0,2,0,2,3687
2,2,1,0,3,0,3,3687
3,3,0,0,3,0,3,3687
0,0,1,0,1,0,1,3688
1,1,0,0,1,0,1,3688
0,0,1,0,1,0,1,3689
1,1,0,0,1,0,1,3689
0,0,1,0,1,0,1,3690
1,1,1,0,2,0,2,3690
2,2,1,1,3,1,4,3690
3,3,1,0,4,1,5,3690
4,4,1,0,5,1,6,3690
5,5,1,0,6,1,7,3690
6,6,0,0,6,1,7,3690
0,0,1,0,1,0,1,3691
1,1,1,0,2,0,2,3691
2,2,0,0,2,0,2,3691
0,0,1,0,1,0,1,3692
1,1,0,0,1,0,1,3692
0,0,1,0,1,0,1,3693
1,1,0,1,1,1,2,3693
2,2,0,0,1,1,2,3693
0,0,1,0,1,0,1,3694
1,1,0,0,1,0,1,3694
0,0,1,0,1,0,1,3695
1,1,0,0,1,0,1,3695
0,0,1,0,1,0,1,3696
1,1,2,0,3,0,3,3696
2,2,2,0,5,0,5,3696
3,3,1,0,6,0,6,3696
4,4,0,0,6,0,6,3696
0,0,1,0,1,0,1,3697
1,1,1,0,2,0,2,3697
2,2,1,0,3,0,3,3697
3,3,1,0,4,0,4,3697
4,4,1,0,5,0,5,3697
5,5,0,0,5,0,5,3697
0,0,1,0,1,0,1,3698
1,1,0,0,1,0,1,3698
0,0,1,0,1,0,1,3699
1,1,0,0,1,0,1,3699
0,0,1,0,1,0,1,3700
1,1,1,1,2,1,3,3700
2,2,0,1,2,2,4,3700
3,3,0,1,2,3,5,3700
4,4,1,0,3,3,6,3700
5,5,1,0,4,3,7,3700
6,6,0,0,4,3,7,3700
0,0,1,0,1,0,1,3701
1,1,0,0,1,0,1,3701
0,0,1,0,1,0,1,3702
1,1,1,0,2,0,2,3702
2,2,0,0,2,0,2,3702
0,0,1,0,1,0,1,3703
1,1,1,1,2,1,3,3703
2,2,2,1,4,2,6,3703
3,3,2,1,6,3,9,3703
4,4,1,2,7,5,12,3703
5,5,1,2,8,7,15,3703
6,6,1,3,9,10,19,3703
7,7,1,0,10,10,20,3703
8,8,1,1,11,11,22,3703
9,9,1,1,12,12,24,3703
10,10,2,0,14,12,26,3703
11,11,1,0,15,12,27,3703
12,12,1,1,16,13,29,3703
13,13,0,1,16,14,30,3703
14,14,1,0,17,14,31,3703
15,15,1,0,18,14,32,3703
16,16,0,0,18,14,32,3703
0,0,1,0,1,0,1,3704
1,1,1,0,2,0,2,3704
2,2,1,0,3,0,3,3704
3,3,0,0,3,0,3,3704
0,0,1,0,1,0,1,3705
1,1,0,0,1,0,1,3705
0,0,1,0,1,0,1,3706
1,1,1,1,2,1,3,3706
2,2,1,0,3,1,4,3706
3,3,1,0,4,1,5,3706
4,4,1,0,5,1,6,3706
5,5,2,0,7,1,8,3706
6,6,1,0,8,1,9,3706
7,7,0,0,8,1,9,3706
0,0,1,0,1,0,1,3707
1,1,0,0,1,0,1,3707
0,0,1,0,1,0,1,3708
1,1,0,0,1,0,1,3708
0,0,1,0,1,0,1,3709
1,1,0,0,1,0,1,3709
0,0,1,0,1,0,1,3710
1,1,0,0,1,0,1,3710
0,0,1,0,1,0,1,3711
1,1,1,0,2,0,2,3711
2,2,0,0,2,0,2,3711
0,0,1,0,1,0,1,3712
1,1,0,0,1,0,1,3712
0,0,1,0,1,0,1,3713
1,1,1,0,2,0,2,3713
2,2,0,0,2,0,2,3713
0,0,1,0,1,0,1,3714
1,1,2,0,3,0,3,3714
2,2,0,1,3,1,4,3714
3,3,1,0,4,1,5,3714
4,4,0,0,4,1,5,3714
0,0,1,0,1,0,1,3715
1,1,1,0,2,0,2,3715
2,2,3,0,5,0,5,3715
3,3,1,0,6,0,6,3715
4,4,1,1,7,1,8,3715
5,5,1,4,8,5,13,3715
6,6,0,4,8,9,17,3715
7,7,1,4,9,13,22,3715
8,8,1,3,10,16,26,3715
9,9,0,3,10,19,29,3715
10,10,1,2,11,21,32,3715
11,11,3,2,14,23,37,3715
12,12,4,1,18,24,42,3715
13,13,1,0,19,24,43,3715
14,14,0,0,19,24,43,3715
0,0,1,0,1,0,1,3716
1,1,1,0,2,0,2,3716
2,2,0,0,2,0,2,3716
0,0,1,0,1,0,1,3717
1,1,0,0,1,0,1,3717
0,0,1,0,1,0,1,3718
1,1,0,0,1,0,1,3718
0,0,1,0,1,0,1,3719
1,1,1,0,2,0,2,3719
2,2,2,0,4,0,4,3719
3,3,1,0,5,0,5,3719
4,4,0,0,5,0,5,3719
0,0,1,0,1,0,1,3720
1,1,1,0,2,0,2,3720
2,2,2,0,4,0,4,3720
3,3,1,0,5,0,5,3720
4,4,0,0,5,0,5,3720
0,0,1,0,1,0,1,3721
1,1,0,0,1,0,1,3721
0,0,1,0,1,0,1,3722
1,1,0,0,1,0,1,3722
0,0,1,0,1,0,1,3723
1,1,1,0,2,0,2,3723
2,2,0,0,2,0,2,3723
0,0,1,0,1,0,1,3724
1,1,1,0,2,0,2,3724
2,2,0,1,2,1,3,3724
3,3,2,1,4,2,6,3724
4,4,3,1,7,3,10,3724
5,5,1,0,8,3,11,3724
6,6,1,1,9,4,13,3724
7,7,2,0,11,4,15,3724
8,8,2,2,13,6,19,3724
9,9,2,2,15,8,23,3724
10,10,3,2,18,10,28,3724
11,11,1,1,19,11,30,3724
12,12,1,1,20,12,32,3724
13,13,0,1,20,13,33,3724
14,14,0,0,20,13,33,3724
0,0,1,0,1,0,1,3725
1,1,2,0,3,0,3,3725
2,2,2,0,5,0,5,3725
3,3,3,0,8,0,8,3725
4,4,2,1,10,1,11,3725
5,5,1,1,11,2,13,3725
6,6,1,0,12,2,14,3725
7,7,1,0,13,2,15,3725
8,8,0,1,13,3,16,3725
9,9,0,0,13,3,16,3725
0,0,1,0,1,0,1,3726
1,1,0,0,1,0,1,3726
0,0,1,0,1,0,1,3727
1,1,1,0,2,0,2,3727
2,2,1,0,3,0,3,3727
3,3,2,0,5,0,5,3727
4,4,1,0,6,0,6,3727
5,5,1,0,7,0,7,3727
6,6,1,1,8,1,9,3727
7,7,2,2,10,3,13,3727
8,8,3,1,13,4,17,3727
9,9,3,0,16,4,20,3727
10,10,3,0,19,4,23,3727
11,11,2,0,21,4,25,3727
12,12,0,1,21,5,26,3727
13,13,0,1,21,6,27,3727
14,14,0,0,21,6,27,3727
0,0,1,0,1,0,1,3728
1,1,1,0,2,0,2,3728
2,2,0,0,2,0,2,3728
0,0,1,0,1,0,1,3729
1,1,0,0,1,0,1,3729
0,0,1,0,1,0,1,3730
1,1,2,0,3,0,3,3730
2,2,2,0,5,0,5,3730
3,3,1,0,6,0,6,3730
4,4,0,0,6,0,6,3730
0,0,1,0,1,0,1,3731
1,1,1,0,2,0,2,3731
2,2,1,0,3,0,3,3731
3,3,0,0,3,0,3,3731
0,0,1,0,1,0,1,3732
1,1,0,0,1,0,1,3732
0,0,1,0,1,0,1,3733
1,1,2,0,3,0,3,3733
2,2,0,0,3,0,3,3733
0,0,1,0,1,0,1,3734
1,1,0,0,1,0,1,3734
0,0,1,0,1,0,1,3735
1,1,0,0,1,0,1,3735
0,0,1,0,1,0,1,3736
1,1,0,0,1,0,1,3736
0,0,1,0,1,0,1,3737
1,1,2,0,3,0,3,3737
2,2,1,1,4,1,5,3737
3,3,0,3,4,4,8,3737
4,4,0,3,4,7,11,3737
5,5,1,4,5,11,16,3737
6,6,3,2,8,13,21,3737
7,7,1,3,9,16,25,3737
8,8,2,2,11,18,29,3737
9,9,2,2,13,20,33,3737
10,10,3,3,16,23,39,3737
11,11,2,4,18,27,45,3737
12,12,3,3,21,30,51,3737
13,13,3,4,24,34,58,3737
14,14,1,2,25,36,61,3737
15,15,0,1,25,37,62,3737
16,16,0,1,25,38,63,3737
17,17,1,2,26,40,66,3737
18,18,1,2,27,42,69,3737
19,19,0,1,27,43,70,3737
20,20,0,2,27,45,72,3737
21,21,0,1,27,46,73,3737
22,22,0,0,27,46,73,3737
0,0,1,0,1,0,1,3738
1,1,1,0,2,0,2,3738
2,2,1,0,3,0,3,3738
3,3,0,0,3,0,3,3738
0,0,1,0,1,0,1,3739
1,1,0,0,1,0,1,3739
0,0,1,0,1,0,1,3740
1,1,1,0,2,0,2,3740
2,2,0,0,2,0,2,3740
0,0,1,0,1,0,1,3741
1,1,1,1,2,1,3,3741
2,2,1,0,3,1,4,3741
3,3,0,0,3,1,4,3741
0,0,1,0,1,0,1,3742
1,1,0,1,1,1,2,3742
2,2,0,0,1,1,2,3742
0,0,1,0,1,0,1,3743
1,1,0,0,1,0,1,3743
0,0,1,0,1,0,1,3744
1,1,0,0,1,0,1,3744
0,0,1,0,1,0,1,3745
1,1,1,0,2,0,2,3745
2,2,1,0,3,0,3,3745
3,3,2,0,5,0,5,3745
4,4,0,0,5,0,5,3745
0,0,1,0,1,0,1,3746
1,1,0,0,1,0,1,3746
0,0,1,0,1,0,1,3747
1,1,3,2,4,2,6,3747
2,2,3,1,7,3,10,3747
3,3,3,0,10,3,13,3747
4,4,2,1,12,4,16,3747
5,5,0,1,12,5,17,3747
6,6,0,1,12,6,18,3747
7,7,0,1,12,7,19,3747
8,8,0,2,12,9,21,3747
9,9,0,1,12,10,22,3747
10,10,0,0,12,10,22,3747
0,0,1,0,1,0,1,3748
1,1,0,0,1,0,1,3748
0,0,1,0,1,0,1,3749
1,1,1,0,2,0,2,3749
2,2,1,0,3,0,3,3749
3,3,1,1,4,1,5,3749
4,4,2,0,6,1,7,3749
5,5,4,0,10,1,11,3749
6,6,2,1,12,2,14,3749
7,7,2,0,14,2,16,3749
8,8,3,0,17,2,19,3749
9,9,0,1,17,3,20,3749
10,10,0,0,17,3,20,3749
0,0,1,0,1,0,1,3750
1,1,0,0,1,0,1,3750
0,0,1,0,1,0,1,3751
1,1,0,0,1,0,1,3751
0,0,1,0,1,0,1,3752
1,1,1,1,2,1,3,3752
2,2,1,0,3,1,4,3752
3,3,1,0,4,1,5,3752
4,4,0,0,4,1,5,3752
0,0,1,0,1,0,1,3753
1,1,1,0,2,0,2,3753
2,2,0,0,2,0,2,3753
0,0,1,0,1,0,1,3754
1,1,0,0,1,0,1,3754
0,0,1,0,1,0,1,3755
1,1,3,1,4,1,5,3755
2,2,2,1,6,2,8,3755
3,3,4,0,10,2,12,3755
4,4,2,0,12,2,14,3755
5,5,2,1,14,3,17,3755
6,6,1,1,15,4,19,3755
7,7,1,0,16,4,20,3755
8,8,2,0,18,4,22,3755
9,9,2,0,20,4,24,3755
10,10,0,0,20,4,24,3755
0,0,1,0,1,0,1,3756
1,1,0,0,1,0,1,3756
0,0,1,0,1,0,1,3757
1,1,0,0,1,0,1,3757
0,0,1,0,1,0,1,3758
1,1,1,0,2,0,2,3758
2,2,1,0,3,0,3,3758
3,3,0,0,3,0,3,3758
0,0,1,0,1,0,1,3759
1,1,1,1,2,1,3,3759
2,2,0,3,2,4,6,3759
3,3,0,0,2,4,6,3759
0,0,1,0,1,0,1,3760
1,1,1,1,2,1,3,3760
2,2,1,0,3,1,4,3760
3,3,0,0,3,1,4,3760
0,0,1,0,1,0,1,3761
1,1,0,0,1,0,1,3761
0,0,1,0,1,0,1,3762
1,1,3,0,4,0,4,3762
2,2,3,2,7,2,9,3762
3,3,2,3,9,5,14,3762
4,4,3,4,12,9,21,3762
5,5,1,3,13,12,25,3762
6,6,1,1,14,13,27,3762
7,7,1,0,15,13,28,3762
8,8,1,1,16,14,30,3762
9,9,2,1,18,15,33,3762
10,10,2,1,20,16,36,3762
11,11,1,0,21,16,37,3762
12,12,0,0,21,16,37,3762
0,0,1,0,1,0,1,3763
1,1,0,0,1,0,1,3763
0,0,1,0,1,0,1,3764
1,1,0,0,1,0,1,3764
0,0,1,0,1,0,1,3765
1,1,1,0,2,0,2,3765
2,2,2,0,4,0,4,3765
3,3,1,0,5,0,5,3765
4,4,1,0,6,0,6,3765
5,5,0,0,6,0,6,3765
0,0,1,0,1,0,1,3766
1,1,0,0,1,0,1,3766
0,0,1,0,1,0,1,3767
1,1,3,0,4,0,4,3767
2,2,1,2,5,2,7,3767
3,3,0,1,5,3,8,3767
4,4,0,1,5,4,9,3767
5,5,0,0,5,4,9,3767
0,0,1,0,1,0,1,3768
1,1,1,0,2,0,2,3768
2,2,1,0,3,0,3,3768
3,3,2,0,5,0,5,3768
4,4,0,0,5,0,5,3768
0,0,1,0,1,0,1,3769
1,1,0,0,1,0,1,3769
0,0,1,0,1,0,1,3770
1,1,0,0,1,0,1,3770
0,0,1,0,1,0,1,3771
1,1,0,0,1,0,1,3771
0,0,1,0,1,0,1,3772
1,1,1,0,2,0,2,3772
2,2,0,0,2,0,2,3772
0,0,1,0,1,0,1,3773
1,1,0,0,1,0,1,3773
0,0,1,0,1,0,1,3774
1,1,2,0,3,0,3,3774
2,2,1,0,4,0,4,3774
3,3,0,0,4,0,4,3774
0,0,1,0,1,0,1,3775
1,1,0,0,1,0,1,3775
0,0,1,0,1,0,1,3776
1,1,1,0,2,0,2,3776
2,2,3,0,5,0,5,3776
3,3,3,0,8,0,8,3776
4,4,4,1,12,1,13,3776
5,5,4,1,16,2,18,3776
6,6,4,2,20,4,24,3776
7,7,7,3,27,7,34,3776
8,8,6,3,33,10,43,3776
9,9,2,3,35,13,48,3776
10,10,2,2,37,15,52,3776
11,11,2,0,39,15,54,3776
12,12,1,1,40,16,56,3776
13,13,1,1,41,17,58,3776
14,14,0,1,41,18,59,3776
15,15,1,1,42,19,61,3776
16,16,4,0,46,19,65,3776
17,17,1,2,47,21,68,3776
18,18,0,1,47,22,69,3776
19,19,1,1,48,23,71,3776
20,20,1,0,49,23,72,3776
21,21,0,0,49,23,72,3776
0,0,1,0,1,0,1,3777
1,1,0,0,1,0,1,3777
0,0,1,0,1,0,1,3778
1,1,1,0,2,0,2,3778
2,2,1,0,3,0,3,3778
3,3,1,0,4,0,4,3778
4,4,2,1,6,1,7,3778
5,5,3,0,9,1,10,3778
6,6,1,1,10,2,12,3778
7,7,1,1,11,3,14,3778
8,8,2,0,13,3,16,3778
9,9,1,0,14,3,17,3778
10,10,1,0,15,3,18,3778
11,11,1,0,16,3,19,3778
12,12,3,0,19,3,22,3778
13,13,1,0,20,3,23,3778
14,14,1,1,21,4,25,3778
15,15,2,1,23,5,28,3778
16,16,2,0,25,5,30,3778
17,17,2,1,27,6,33,3778
18,18,2,1,29,7,36,3778
19,19,0,1,29,8,37,3778
20,20,0,0,29,8,37,3778
0,0,1,0,1,0,1,3779
1,1,1,0,2,0,2,3779
2,2,1,0,3,0,3,3779
3,3,0,0,3,0,3,3779
0,0,1,0,1,0,1,3780
1,1,2,0,3,0,3,3780
2,2,0,0,3,0,3,3780
0,0,1,0,1,0,1,3781
1,1,2,0,3,0,3,3781
2,2,1,1,4,1,5,3781
3,3,0,0,4,1,5,3781
0,0,1,0,1,0,1,3782
1,1,3,0,4,0,4,3782
2,2,1,1,5,1,6,3782
3,3,2,1,7,2,9,3782
4,4,4,2,11,4,15,3782
5,5,3,2,14,6,20,3782
6,6,2,3,16,9,25,3782
7,7,3,2,19,11,30,3782
8,8,5,1,24,12,36,3782
9,9,2,3,26,15,41,3782
10,10,2,1,28,16,44,3782
11,11,0,0,28,16,44,3782
0,0,1,0,1,0,1,3783
1,1,0,0,1,0,1,3783
0,0,1,0,1,0,1,3784
1,1,0,1,1,1,2,3784
2,2,0,0,1,1,2,3784
0,0,1,0,1,0,1,3785
1,1,0,1,1,1,2,3785
2,2,2,1,3,2,5,3785
3,3,3,0,6,2,8,3785
4,4,2,1,8,3,11,3785
5,5,0,1,8,4,12,3785
6,6,0,0,8,4,12,3785
0,0,1,0,1,0,1,3786
1,1,1,0,2,0,2,3786
2,2,1,0,3,0,3,3786
3,3,0,1,3,1,4,3786
4,4,0,0,3,1,4,3786
0,0,1,0,1,0,1,3787
1,1,0,0,1,0,1,3787
0,0,1,0,1,0,1,3788
1,1,0,0,1,0,1,3788
0,0,1,0,1,0,1,3789
1,1,1,1,2,1,3,3789
2,2,0,1,2,2,4,3789
3,3,0,1,2,3,5,3789
4,4,1,0,3,3,6,3789
5,5,1,1,4,4,8,3789
6,6,0,1,4,5,9,3789
7,7,0,2,4,7,11,3789
8,8,0,2,4,9,13,3789
9,9,0,2,4,11,15,3789
10,10,0,2,4,13,17,3789
11,11,1,0,5,13,18,3789
12,12,1,1,6,14,20,3789
13,13,1,0,7,14,21,3789
14,14,0,0,7,14,21,3789
0,0,1,0,1,0,1,3790
1,1,1,0,2,0,2,3790
2,2,0,0,2,0,2,3790
0,0,1,0,1,0,1,3791
1,1,1,0,2,0,2,3791
2,2,0,1,2,1,3,3791
3,3,1,0,3,1,4,3791
4,4,1,0,4,1,5,3791
5,5,1,0,5,1,6,3791
6,6,1,0,6,1,7,3791
7,7,2,0,8,1,9,3791
8,8,2,1,10,2,12,3791
9,9,0,2,10,4,14,3791
10,10,1,3,11,7,18,3791
11,11,0,0,11,7,18,3791
0,0,1,0,1,0,1,3792
1,1,1,0,2,0,2,3792
2,2,4,0,6,0,6,3792
3,3,4,0,10,0,10,3792
4,4,6,0,16,0,16,3792
5,5,5,2,21,2,23,3792
6,6,6,5,27,7,34,3792
7,7,4,3,31,10,41,3792
8,8,0,2,31,12,43,3792
9,9,0,2,31,14,45,3792
10,10,0,3,31,17,48,3792
11,11,2,1,33,18,51,3792
12,12,3,2,36,20,56,3792
13,13,4,2,40,22,62,3792
14,14,5,1,45,23,68,3792
15,15,6,1,51,24,75,3792
16,16,3,2,54,26,80,3792
17,17,2,1,56,27,83,3792
18,18,0,2,56,29,85,3792
19,19,0,0,56,29,85,3792
0,0,1,0,1,0,1,3793
1,1,1,0,2,0,2,3793
2,2,1,0,3,0,3,3793
3,3,1,0,4,0,4,3793
4,4,1,0,5,0,5,3793
5,5,0,1,5,1,6,3793
6,6,1,0,6,1,7,3793
7,7,0,0,6,1,7,3793
0,0,1,0,1,0,1,3794
1,1,0,0,1,0,1,3794
0,0,1,0,1,0,1,3795
1,1,0,0,1,0,1,3795
0,0,1,0,1,0,1,3796
1,1,0,0,1,0,1,3796
0,0,1,0,1,0,1,3797
1,1,0,0,1,0,1,3797
0,0,1,0,1,0,1,3798
1,1,2,0,3,0,3,3798
2,2,2,1,5,1,6,3798
3,3,2,1,7,2,9,3798
4,4,1,0,8,2,10,3798
5,5,1,1,9,3,12,3798
6,6,0,0,9,3,12,3798
0,0,1,0,1,0,1,3799
1,1,1,1,2,1,3,3799
2,2,3,1,5,2,7,3799
3,3,3,0,8,2,10,3799
4,4,0,0,8,2,10,3799
0,0,1,0,1,0,1,3800
1,1,0,1,1,1,2,3800
2,2,0,0,1,1,2,3800
0,0,1,0,1,0,1,3801
1,1,1,0,2,0,2,3801
2,2,1,0,3,0,3,3801
3,3,1,0,4,0,4,3801
4,4,1,0,5,0,5,3801
5,5,0,0,5,0,5,3801
0,0,1,0,1,0,1,3802
1,1,2,0,3,0,3,3802
2,2,1,0,4,0,4,3802
3,3,3,0,7,0,7,3802
4,4,1,1,8,1,9,3802
5,5,2,3,10,4,14,3802
6,6,3,3,13,7,20,3802
7,7,6,1,19,8,27,3802
8,8,5,3,24,11,35,3802
9,9,2,2,26,13,39,3802
10,10,0,1,26,14,40,3802
11,11,0,0,26,14,40,3802
0,0,1,0,1,0,1,3803
1,1,1,0,2,0,2,3803
2,2,1,0,3,0,3,3803
3,3,2,0,5,0,5,3803
4,4,4,0,9,0,9,3803
5,5,3,1,12,1,13,3803
6,6,3,2,15,3,18,3803
7,7,7,3,22,6,28,3803
8,8,1,1,23,7,30,3803
9,9,0,2,23,9,32,3803
10,10,0,2,23,11,34,3803
11,11,0,3,23,14,37,3803
12,12,1,3,24,17,41,3803
13,13,0,2,24,19,43,3803
14,14,0,5,24,24,48,3803
15,15,1,3,25,27,52,3803
16,16,0,5,25,32,57,3803
17,17,1,3,26,35,61,3803
18,18,2,4,28,39,67,3803
19,19,1,3,29,42,71,3803
20,20,4,2,33,44,77,3803
21,21,2,2,35,46,81,3803
22,22,1,1,36,47,83,3803
23,23,0,1,36,48,84,3803
24,24,0,2,36,50,86,3803
25,25,0,3,36,53,89,3803
26,26,0,0,36,53,89,3803
0,0,1,0,1,0,1,3804
1,1,1,0,2,0,2,3804
2,2,0,0,2,0,2,3804
0,0,1,0,1,0,1,3805
1,1,2,0,3,0,3,3805
2,2,1,1,4,1,5,3805
3,3,2,5,6,6,12,3805
4,4,3,4,9,10,19,3805
5,5,3,4,12,14,26,3805
6,6,6,6,18,20,38,3805
7,7,4,10,22,30,52,3805
8,8,3,6,25,36,61,3805
9,9,3,5,28,41,69,3805
10,10,2,6,30,47,77,3805
11,11,1,8,31,55,86,3805
12,12,1,11,32,66,98,3805
13,13,0,10,32,76,108,3805
14,14,3,5,35,81,116,3805
15,15,3,2,38,83,121,3805
16,16,5,3,43,86,129,3805
17,17,4,3,47,89,136,3805
18,18,2,3,49,92,141,3805
19,19,6,2,55,94,149,3805
20,20,3,1,58,95,153,3805
21,21,1,3,59,98,157,3805
22,22,1,1,60,99,159,3805
23,23,0,0,60,99,159,3805
0,0,1,0,1,0,1,3806
1,1,2,0,3,0,3,3806
2,2,1,1,4,1,5,3806
3,3,1,0,5,1,6,3806
4,4,0,0,5,1,6,3806
0,0,1,0,1,0,1,3807
1,1,2,0,3,0,3,3807
2,2,1,0,4,0,4,3807
3,3,0,0,4,0,4,3807
0,0,1,0,1,0,1,3808
1,1,0,0,1,0,1,3808
0,0,1,0,1,0,1,3809
1,1,1,1,2,1,3,3809
2,2,1,1,3,2,5,3809
3,3,2,1,5,3,8,3809
4,4,2,2,7,5,12,3809
5,5,4,3,11,8,19,3809
6,6,1,0,12,8,20,3809
7,7,2,0,14,8,22,3809
8,8,2,0,16,8,24,3809
9,9,1,0,17,8,25,3809
10,10,1,0,18,8,26,3809
11,11,5,0,23,8,31,3809
12,12,3,0,26,8,34,3809
13,13,2,0,28,8,36,3809
14,14,0,0,28,8,36,3809
0,0,1,0,1,0,1,3810
1,1,1,0,2,0,2,3810
2,2,0,0,2,0,2,3810
0,0,1,0,1,0,1,3811
1,1,2,0,3,0,3,3811
2,2,3,0,6,0,6,3811
3,3,4,1,10,1,11,3811
4,4,3,2,13,3,16,3811
5,5,5,1,18,4,22,3811
6,6,6,1,24,5,29,3811
7,7,8,2,32,7,39,3811
8,8,7,2,39,9,48,3811
9,9,4,1,43,10,53,3811
10,10,2,0,45,10,55,3811
11,11,0,0,45,10,55,3811
0,0,1,0,1,0,1,3812
1,1,1,0,2,0,2,3812
2,2,1,0,3,0,3,3812
3,3,0,0,3,0,3,3812
0,0,1,0,1,0,1,3813
1,1,0,0,1,0,1,3813
0,0,1,0,1,0,1,3814
1,1,0,0,1,0,1,3814
0,0,1,0,1,0,1,3815
1,1,1,1,2,1,3,3815
2,2,1,0,3,1,4,3815
3,3,2,0,5,1,6,3815
4,4,5,0,10,1,11,3815
5,5,6,1,16,2,18,3815
6,6,9,2,25,4,29,3815
7,7,4,2,29,6,35,3815
8,8,3,2,32,8,40,3815
9,9,3,5,35,13,48,3815
10,10,1,0,36,13,49,3815
11,11,3,0,39,13,52,3815
12,12,0,0,39,13,52,3815
0,0,1,0,1,0,1,3816
1,1,0,0,1,0,1,3816
0,0,1,0,1,0,1,3817
1,1,1,0,2,0,2,3817
2,2,1,0,3,0,3,3817
3,3,0,1,3,1,4,3817
4,4,0,1,3,2,5,3817
5,5,0,0,3,2,5,3817
0,0,1,0,1,0,1,3818
1,1,1,0,2,0,2,3818
2,2,0,1,2,1,3,3818
3,3,0,0,2,1,3,3818
0,0,1,0,1,0,1,3819
1,1,0,1,1,1,2,3819
2,2,0,2,1,3,4,3819
3,3,1,1,2,4,6,3819
4,4,0,1,2,5,7,3819
5,5,0,0,2,5,7,3819
0,0,1,0,1,0,1,3820
1,1,3,0,4,0,4,3820
2,2,2,0,6,0,6,3820
3,3,2,0,8,0,8,3820
4,4,3,0,11,0,11,3820
5,5,1,3,12,3,15,3820
6,6,1,0,13,3,16,3820
7,7,1,0,14,3,17,3820
8,8,2,1,16,4,20,3820
9,9,2,0,18,4,22,3820
10,10,1,1,19,5,24,3820
11,11,1,1,20,6,26,3820
12,12,2,1,22,7,29,3820
13,13,6,1,28,8,36,3820
14,14,4,1,32,9,41,3820
15,15,4,0,36,9,45,3820
16,16,2,0,38,9,47,3820
17,17,2,0,40,9,49,3820
18,18,3,1,43,10,53,3820
19,19,4,2,47,12,59,3820
20,20,3,3,50,15,65,3820
21,21,1,3,51,18,69,3820
22,22,1,1,52,19,71,3820
23,23,0,3,52,22,74,3820
24,24,0,1,52,23,75,3820
25,25,0,0,52,23,75,3820
0,0,1,0,1,0,1,3821
1,1,2,0,3,0,3,3821
2,2,1,0,4,0,4,3821
3,3,1,0,5,0,5,3821
4,4,1,0,6,0,6,3821
5,5,0,0,6,0,6,3821
0,0,1,0,1,0,1,3822
1,1,2,0,3,0,3,3822
2,2,1,1,4,1,5,3822
3,3,1,1,5,2,7,3822
4,4,0,0,5,2,7,3822
0,0,1,0,1,0,1,3823
1,1,0,0,1,0,1,3823
0,0,1,0,1,0,1,3824
1,1,0,0,1,0,1,3824
0,0,1,0,1,0,1,3825
1,1,0,0,1,0,1,3825
0,0,1,0,1,0,1,3826
1,1,2,0,3,0,3,3826
2,2,2,0,5,0,5,3826
3,3,2,4,7,4,11,3826
4,4,3,5,10,9,19,3826
5,5,1,5,11,14,25,3826
6,6,2,6,13,20,33,3826
7,7,0,7,13,27,40,3826
8,8,1,2,14,29,43,3826
9,9,1,1,15,30,45,3826
10,10,1,0,16,30,46,3826
11,11,0,0,16,30,46,3826
0,0,1,0,1,0,1,3827
1,1,0,0,1,0,1,3827
0,0,1,0,1,0,1,3828
1,1,1,0,2,0,2,3828
2,2,1,0,3,0,3,3828
3,3,0,0,3,0,3,3828
0,0,1,0,1,0,1,3829
1,1,0,0,1,0,1,3829
0,0,1,0,1,0,1,3830
1,1,1,0,2,0,2,3830
2,2,1,0,3,0,3,3830
3,3,1,0,4,0,4,3830
4,4,0,0,4,0,4,3830
0,0,1,0,1,0,1,3831
1,1,0,0,1,0,1,3831
0,0,1,0,1,0,1,3832
1,1,3,0,4,0,4,3832
2,2,3,0,7,0,7,3832
3,3,3,2,10,2,12,3832
4,4,2,6,12,8,20,3832
5,5,0,5,12,13,25,3832
6,6,1,3,13,16,29,3832
7,7,2,3,15,19,34,3832
8,8,1,2,16,21,37,3832
9,9,1,2,17,23,40,3832
10,10,0,6,17,29,46,3832
11,11,1,5,18,34,52,3832
12,12,1,3,19,37,56,3832
13,13,4,2,23,39,62,3832
14,14,5,2,28,41,69,3832
15,15,2,4,30,45,75,3832
16,16,1,5,31,50,81,3832
17,17,1,3,32,53,85,3832
18,18,1,1,33,54,87,3832
19,19,0,1,33,55,88,3832
20,20,2,0,35,55,90,3832
21,21,2,0,37,55,92,3832
22,22,3,0,40,55,95,3832
23,23,2,0,42,55,97,3832
24,24,0,0,42,55,97,3832
0,0,1,0,1,0,1,3833
1,1,1,0,2,0,2,3833
2,2,1,0,3,0,3,3833
3,3,0,1,3,1,4,3833
4,4,0,1,3,2,5,3833
5,5,0,0,3,2,5,3833
0,0,1,0,1,0,1,3834
1,1,0,0,1,0,1,3834
0,0,1,0,1,0,1,3835
1,1,0,0,1,0,1,3835
0,0,1,0,1,0,1,3836
1,1,0,1,1,1,2,3836
2,2,0,0,1,1,2,3836
0,0,1,0,1,0,1,3837
1,1,0,0,1,0,1,3837
0,0,1,0,1,0,1,3838
1,1,0,0,1,0,1,3838
0,0,1,0,1,0,1,3839
1,1,0,1,1,1,2,3839
2,2,0,0,1,1,2,3839
0,0,1,0,1,0,1,3840
1,1,1,1,2,1,3,3840
2,2,1,0,3,1,4,3840
3,3,0,0,3,1,4,3840
0,0,1,0,1,0,1,3841
1,1,0,0,1,0,1,3841
0,0,1,0,1,0,1,3842
1,1,0,0,1,0,1,3842
0,0,1,0,1,0,1,3843
1,1,1,0,2,0,2,3843
2,2,0,0,2,0,2,3843
0,0,1,0,1,0,1,3844
1,1,0,0,1,0,1,3844
0,0,1,0,1,0,1,3845
1,1,1,0,2,0,2,3845
2,2,0,0,2,0,2,3845
0,0,1,0,1,0,1,3846
1,1,1,1,2,1,3,3846
2,2,2,1,4,2,6,3846
3,3,0,2,4,4,8,3846
4,4,0,5,4,9,13,3846
5,5,0,1,4,10,14,3846
6,6,0,0,4,10,14,3846
0,0,1,0,1,0,1,3847
1,1,0,0,1,0,1,3847
0,0,1,0,1,0,1,3848
1,1,0,0,1,0,1,3848
0,0,1,0,1,0,1,3849
1,1,1,0,2,0,2,3849
2,2,1,0,3,0,3,3849
3,3,1,0,4,0,4,3849
4,4,1,0,5,0,5,3849
5,5,3,0,8,0,8,3849
6,6,1,0,9,0,9,3849
7,7,0,0,9,0,9,3849
0,0,1,0,1,0,1,3850
1,1,0,0,1,0,1,3850
0,0,1,0,1,0,1,3851
1,1,2,0,3,0,3,3851
2,2,2,0,5,0,5,3851
3,3,3,1,8,1,9,3851
4,4,7,2,15,3,18,3851
5,5,5,0,20,3,23,3851
6,6,5,2,25,5,30,3851
7,7,4,0,29,5,34,3851
8,8,3,0,32,5,37,3851
9,9,4,0,36,5,41,3851
10,10,5,1,41,6,47,3851
11,11,4,1,45,7,52,3851
12,12,1,1,46,8,54,3851
13,13,1,1,47,9,56,3851
14,14,2,0,49,9,58,3851
15,15,1,0,50,9,59,3851
16,16,0,0,50,9,59,3851
0,0,1,0,1,0,1,3852
1,1,0,0,1,0,1,3852
0,0,1,0,1,0,1,3853
1,1,1,1,2,1,3,3853
2,2,0,0,2,1,3,3853
0,0,1,0,1,0,1,3854
1,1,0,0,1,0,1,3854
0,0,1,0,1,0,1,3855
1,1,0,0,1,0,1,3855
0,0,1,0,1,0,1,3856
1,1,0,0,1,0,1,3856
0,0,1,0,1,0,1,3857
1,1,0,0,1,0,1,3857
0,0,1,0,1,0,1,3858
1,1,1,1,2,1,3,3858
2,2,1,1,3,2,5,3858
3,3,0,0,3,2,5,3858
0,0,1,0,1,0,1,3859
1,1,1,0,2,0,2,3859
2,2,1,1,3,1,4,3859
3,3,1,2,4,3,7,3859
4,4,2,2,6,5,11,3859
5,5,1,1,7,6,13,3859
6,6,2,2,9,8,17,3859
7,7,0,2,9,10,19,3859
8,8,1,1,10,11,21,3859
9,9,1,0,11,11,22,3859
10,10,0,0,11,11,22,3859
0,0,1,0,1,0,1,3860
1,1,0,1,1,1,2,3860
2,2,0,0,1,1,2,3860
0,0,1,0,1,0,1,3861
1,1,2,0,3,0,3,3861
2,2,0,0,3,0,3,3861
0,0,1,0,1,0,1,3862
1,1,1,0,2,0,2,3862
2,2,0,1,2,1,3,3862
3,3,0,1,2,2,4,3862
4,4,0,0,2,2,4,3862
0,0,1,0,1,0,1,3863
1,1,0,0,1,0,1,3863
0,0,1,0,1,0,1,3864
1,1,0,0,1,0,1,3864
0,0,1,0,1,0,1,3865
1,1,2,0,3,0,3,3865
2,2,1,0,4,0,4,3865
3,3,0,1,4,1,5,3865
4,4,0,0,4,1,5,3865
0,0,1,0,1,0,1,3866
1,1,2,0,3,0,3,3866
2,2,2,0,5,0,5,3866
3,3,1,0,6,0,6,3866
4,4,0,0,6,0,6,3866
0,0,1,0,1,0,1,3867
1,1,0,0,1,0,1,3867
0,0,1,0,1,0,1,3868
1,1,0,1,1,1,2,3868
2,2,0,1,1,2,3,3868
3,3,0,1,1,3,4,3868
4,4,1,0,2,3,5,3868
5,5,0,0,2,3,5,3868
0,0,1,0,1,0,1,3869
1,1,1,0,2,0,2,3869
2,2,1,0,3,0,3,3869
3,3,0,0,3,0,3,3869
0,0,1,0,1,0,1,3870
1,1,0,0,1,0,1,3870
0,0,1,0,1,0,1,3871
1,1,0,0,1,0,1,3871
0,0,1,0,1,0,1,3872
1,1,2,0,3,0,3,3872
2,2,0,0,3,0,3,3872
0,0,1,0,1,0,1,3873
1,1,0,2,1,2,3,3873
2,2,0,0,1,2,3,3873
0,0,1,0,1,0,1,3874
1,1,0,0,1,0,1,3874
0,0,1,0,1,0,1,3875
1,1,0,0,1,0,1,3875
0,0,1,0,1,0,1,3876
1,1,1,0,2,0,2,3876
2,2,0,0,2,0,2,3876
0,0,1,0,1,0,1,3877
1,1,1,0,2,0,2,3877
2,2,1,0,3,0,3,3877
3,3,1,0,4,0,4,3877
4,4,0,0,4,0,4,3877
0,0,1,0,1,0,1,3878
1,1,1,0,2,0,2,3878
2,2,2,0,4,0,4,3878
3,3,2,0,6,0,6,3878
4,4,1,0,7,0,7,3878
5,5,1,0,8,0,8,3878
6,6,0,0,8,0,8,3878
0,0,1,0,1,0,1,3879
1,1,0,0,1,0,1,3879
0,0,1,0,1,0,1,3880
1,1,1,0,2,0,2,3880
2,2,2,0,4,0,4,3880
3,3,1,0,5,0,5,3880
4,4,1,1,6,1,7,3880
5,5,3,2,9,3,12,3880
6,6,3,1,12,4,16,3880
7,7,2,2,14,6,20,3880
8,8,3,2,17,8,25,3880
9,9,4,0,21,8,29,3880
10,10,4,0,25,8,33,3880
11,11,2,0,27,8,35,3880
12,12,2,0,29,8,37,3880
13,13,0,0,29,8,37,3880
0,0,1,0,1,0,1,3881
1,1,0,1,1,1,2,3881
2,2,0,1,1,2,3,3881
3,3,1,2,2,4,6,3881
4,4,2,4,4,8,12,3881
5,5,2,1,6,9,15,3881
6,6,3,2,9,11,20,3881
7,7,4,5,13,16,29,3881
8,8,3,1,16,17,33,3881
9,9,3,0,19,17,36,3881
10,10,1,0,20,17,37,3881
11,11,1,0,21,17,38,3881
12,12,3,0,24,17,41,3881
13,13,1,0,25,17,42,3881
14,14,0,1,25,18,43,3881
15,15,0,1,25,19,44,3881
16,16,0,2,25,21,46,3881
17,17,1,2,26,23,49,3881
18,18,1,4,27,27,54,3881
19,19,2,1,29,28,57,3881
20,20,2,2,31,30,61,3881
21,21,4,2,35,32,67,3881
22,22,3,4,38,36,74,3881
23,23,5,2,43,38,81,3881
24,24,6,3,49,41,90,3881
25,25,8,5,57,46,103,3881
26,26,9,6,66,52,118,3881
27,27,11,6,77,58,135,3881
28,28,12,9,89,67,156,3881
29,29,11,3,100,70,170,3881
30,30,8,2,108,72,180,3881
31,31,4,1,112,73,185,3881
32,32,2,2,114,75,189,3881
33,33,0,3,114,78,192,3881
34,34,0,1,114,79,193,3881
35,35,0,2,114,81,195,3881
36,36,0,0,114,81,195,3881
0,0,1,0,1,0,1,3882
1,1,0,1,1,1,2,3882
2,2,0,0,1,1,2,3882
0,0,1,0,1,0,1,3883
1,1,0,0,1,0,1,3883
0,0,1,0,1,0,1,3884
1,1,3,0,4,0,4,3884
2,2,1,0,5,0,5,3884
3,3,0,0,5,0,5,3884
0,0,1,0,1,0,1,3885
1,1,0,0,1,0,1,3885
0,0,1,0,1,0,1,3886
1,1,0,0,1,0,1,3886
0,0,1,0,1,0,1,3887
1,1,1,0,2,0,2,3887
2,2,3,0,5,0,5,3887
3,3,4,0,9,0,9,3887
4,4,2,1,11,1,12,3887
5,5,4,1,15,2,17,3887
6,6,6,0,21,2,23,3887
7,7,5,2,26,4,30,3887
8,8,7,2,33,6,39,3887
9,9,4,4,37,10,47,3887
10,10,5,1,42,11,53,3887
11,11,5,2,47,13,60,3887
12,12,7,5,54,18,72,3887
13,13,5,8,59,26,85,3887
14,14,8,8,67,34,101,3887
15,15,12,8,79,42,121,3887
16,16,3,10,82,52,134,3887
17,17,5,4,87,56,143,3887
18,18,3,4,90,60,150,3887
19,19,2,2,92,62,154,3887
20,20,1,1,93,63,156,3887
21,21,1,1,94,64,158,3887
22,22,3,1,97,65,162,3887
23,23,4,2,101,67,168,3887
24,24,6,2,107,69,176,3887
25,25,2,2,109,71,180,3887
26,26,1,2,110,73,183,3887
27,27,0,2,110,75,185,3887
28,28,0,1,110,76,186,3887
29,29,1,0,111,76,187,3887
30,30,0,0,111,76,187,3887
0,0,1,0,1,0,1,3888
1,1,0,0,1,0,1,3888
0,0,1,0,1,0,1,3889
1,1,2,0,3,0,3,3889
2,2,0,0,3,0,3,3889
0,0,1,0,1,0,1,3890
1,1,0,0,1,0,1,3890
0,0,1,0,1,0,1,3891
1,1,0,0,1,0,1,3891
0,0,1,0,1,0,1,3892
1,1,3,0,4,0,4,3892
2,2,2,0,6,0,6,3892
3,3,1,0,7,0,7,3892
4,4,0,0,7,0,7,3892
0,0,1,0,1,0,1,3893
1,1,1,0,2,0,2,3893
2,2,1,1,3,1,4,3893
3,3,1,1,4,2,6,3893
4,4,4,0,8,2,10,3893
5,5,3,3,11,5,16,3893
6,6,3,6,14,11,25,3893
7,7,6,4,20,15,35,3893
8,8,5,3,25,18,43,3893
9,9,4,4,29,22,51,3893
10,10,7,0,36,22,58,3893
11,11,10,2,46,24,70,3893
12,12,9,4,55,28,83,3893
13,13,8,3,63,31,94,3893
14,14,5,4,68,35,103,3893
15,15,5,2,73,37,110,3893
16,16,7,6,80,43,123,3893
17,17,3,5,83,48,131,3893
18,18,1,3,84,51,135,3893
19,19,0,2,84,53,137,3893
20,20,0,3,84,56,140,3893
21,21,1,2,85,58,143,3893
22,22,1,0,86,58,144,3893
23,23,0,0,86,58,144,3893
0,0,1,0,1,0,1,3894
1,1,2,0,3,0,3,3894
2,2,2,0,5,0,5,3894
3,3,2,0,7,0,7,3894
4,4,1,0,8,0,8,3894
5,5,1,0,9,0,9,3894
6,6,1,0,10,0,10,3894
7,7,3,0,13,0,13,3894
8,8,2,0,15,0,15,3894
9,9,0,0,15,0,15,3894
0,0,1,0,1,0,1,3895
1,1,1,0,2,0,2,3895
2,2,1,0,3,0,3,3895
3,3,0,1,3,1,4,3895
4,4,0,0,3,1,4,3895
0,0,1,0,1,0,1,3896
1,1,0,0,1,0,1,3896
0,0,1,0,1,0,1,3897
1,1,0,0,1,0,1,3897
0,0,1,0,1,0,1,3898
1,1,0,1,1,1,2,3898
2,2,1,1,2,2,4,3898
3,3,0,2,2,4,6,3898
4,4,0,0,2,4,6,3898
0,0,1,0,1,0,1,3899
1,1,0,1,1,1,2,3899
2,2,0,1,1,2,3,3899
3,3,0,1,1,3,4,3899
4,4,0,1,1,4,5,3899
5,5,1,0,2,4,6,3899
6,6,0,1,2,5,7,3899
7,7,0,1,2,6,8,3899
8,8,0,1,2,7,9,3899
9,9,0,0,2,7,9,3899
0,0,1,0,1,0,1,3900
1,1,0,0,1,0,1,3900
0,0,1,0,1,0,1,3901
1,1,2,0,3,0,3,3901
2,2,3,1,6,1,7,3901
3,3,1,0,7,1,8,3901
4,4,0,0,7,1,8,3901
0,0,1,0,1,0,1,3902
1,1,1,0,2,0,2,3902
2,2,2,0,4,0,4,3902
3,3,2,0,6,0,6,3902
4,4,1,0,7,0,7,3902
5,5,0,2,7,2,9,3902
6,6,0,0,7,2,9,3902
0,0,1,0,1,0,1,3903
1,1,0,0,1,0,1,3903
0,0,1,0,1,0,1,3904
1,1,2,0,3,0,3,3904
2,2,3,0,6,0,6,3904
3,3,3,1,9,1,10,3904
4,4,2,0,11,1,12,3904
5,5,1,0,12,1,13,3904
6,6,0,0,12,1,13,3904
0,0,1,0,1,0,1,3905
1,1,0,0,1,0,1,3905
0,0,1,0,1,0,1,3906
1,1,0,1,1,1,2,3906
2,2,1,0,2,1,3,3906
3,3,0,0,2,1,3,3906
0,0,1,0,1,0,1,3907
1,1,0,0,1,0,1,3907
0,0,1,0,1,0,1,3908
1,1,1,0,2,0,2,3908
2,2,1,0,3,0,3,3908
3,3,0,0,3,0,3,3908
0,0,1,0,1,0,1,3909
1,1,0,0,1,0,1,3909
0,0,1,0,1,0,1,3910
1,1,3,0,4,0,4,3910
2,2,3,0,7,0,7,3910
3,3,1,2,8,2,10,3910
4,4,0,1,8,3,11,3910
5,5,0,0,8,3,11,3910
0,0,1,0,1,0,1,3911
1,1,0,0,1,0,1,3911
0,0,1,0,1,0,1,3912
1,1,2,0,3,0,3,3912
2,2,0,0,3,0,3,3912
0,0,1,0,1,0,1,3913
1,1,1,0,2,0,2,3913
2,2,0,1,2,1,3,3913
3,3,0,0,2,1,3,3913
0,0,1,0,1,0,1,3914
1,1,2,1,3,1,4,3914
2,2,0,3,3,4,7,3914
3,3,0,2,3,6,9,3914
4,4,1,3,4,9,13,3914
5,5,1,3,5,12,17,3914
6,6,2,5,7,17,24,3914
7,7,1,7,8,24,32,3914
8,8,1,3,9,27,36,3914
9,9,0,3,9,30,39,3914
10,10,2,4,11,34,45,3914
11,11,1,2,12,36,48,3914
12,12,2,1,14,37,51,3914
13,13,2,0,16,37,53,3914
14,14,2,1,18,38,56,3914
15,15,3,2,21,40,61,3914
16,16,3,1,24,41,65,3914
17,17,5,1,29,42,71,3914
18,18,3,2,32,44,76,3914
19,19,3,1,35,45,80,3914
20,20,4,4,39,49,88,3914
21,21,6,4,45,53,98,3914
22,22,4,2,49,55,104,3914
23,23,4,5,53,60,113,3914
24,24,1,3,54,63,117,3914
25,25,2,3,56,66,122,3914
26,26,1,4,57,70,127,3914
27,27,4,4,61,74,135,3914
28,28,4,2,65,76,141,3914
29,29,4,0,69,76,145,3914
30,30,3,0,72,76,148,3914
31,31,1,0,73,76,149,3914
32,32,1,0,74,76,150,3914
33,33,1,0,75,76,151,3914
34,34,1,0,76,76,152,3914
35,35,1,0,77,76,153,3914
36,36,1,0,78,76,154,3914
37,37,0,0,78,76,154,3914
0,0,1,0,1,0,1,3915
1,1,2,0,3,0,3,3915
2,2,3,0,6,0,6,3915
3,3,1,0,7,0,7,3915
4,4,1,0,8,0,8,3915
5,5,1,0,9,0,9,3915
6,6,1,0,10,0,10,3915
7,7,0,0,10,0,10,3915
0,0,1,0,1,0,1,3916
1,1,0,0,1,0,1,3916
0,0,1,0,1,0,1,3917
1,1,0,0,1,0,1,3917
0,0,1,0,1,0,1,3918
1,1,0,0,1,0,1,3918
0,0,1,0,1,0,1,3919
1,1,1,0,2,0,2,3919
2,2,1,0,3,0,3,3919
3,3,1,0,4,0,4,3919
4,4,1,0,5,0,5,3919
5,5,0,2,5,2,7,3919
6,6,0,2,5,4,9,3919
7,7,1,1,6,5,11,3919
8,8,1,1,7,6,13,3919
9,9,1,1,8,7,15,3919
10,10,1,1,9,8,17,3919
11,11,0,0,9,8,17,3919
0,0,1,0,1,0,1,3920
1,1,0,0,1,0,1,3920
0,0,1,0,1,0,1,3921
1,1,0,0,1,0,1,3921
0,0,1,0,1,0,1,3922
1,1,2,0,3,0,3,3922
2,2,2,1,5,1,6,3922
3,3,2,1,7,2,9,3922
4,4,0,2,7,4,11,3922
5,5,0,0,7,4,11,3922
0,0,1,0,1,0,1,3923
1,1,0,0,1,0,1,3923
0,0,1,0,1,0,1,3924
1,1,0,0,1,0,1,3924
0,0,1,0,1,0,1,3925
1,1,1,0,2,0,2,3925
2,2,2,0,4,0,4,3925
3,3,1,0,5,0,5,3925
4,4,1,1,6,1,7,3925
5,5,0,0,6,1,7,3925
0,0,1,0,1,0,1,3926
1,1,0,0,1,0,1,3926
0,0,1,0,1,0,1,3927
1,1,0,0,1,0,1,3927
0,0,1,0,1,0,1,3928
1,1,0,0,1,0,1,3928
0,0,1,0,1,0,1,3929
1,1,1,0,2,0,2,3929
2,2,1,1,3,1,4,3929
3,3,1,0,4,1,5,3929
4,4,1,0,5,1,6,3929
5,5,1,0,6,1,7,3929
6,6,0,0,6,1,7,3929
0,0,1,0,1,0,1,3930
1,1,0,0,1,0,1,3930
0,0,1,0,1,0,1,3931
1,1,1,0,2,0,2,3931
2,2,2,0,4,0,4,3931
3,3,1,0,5,0,5,3931
4,4,1,0,6,0,6,3931
5,5,2,0,8,0,8,3931
6,6,0,0,8,0,8,3931
0,0,1,0,1,0,1,3932
1,1,1,1,2,1,3,3932
2,2,1,2,3,3,6,3932
3,3,0,4,3,7,10,3932
4,4,0,5,3,12,15,3932
5,5,1,2,4,14,18,3932
6,6,1,1,5,15,20,3932
7,7,1,0,6,15,21,3932
8,8,0,0,6,15,21,3932
0,0,1,0,1,0,1,3933
1,1,1,0,2,0,2,3933
2,2,1,1,3,1,4,3933
3,3,0,1,3,2,5,3933
4,4,0,1,3,3,6,3933
5,5,0,0,3,3,6,3933
0,0,1,0,1,0,1,3934
1,1,0,0,1,0,1,3934
0,0,1,0,1,0,1,3935
1,1,0,0,1,0,1,3935
0,0,1,0,1,0,1,3936
1,1,0,0,1,0,1,3936
0,0,1,0,1,0,1,3937
1,1,0,0,1,0,1,3937
0,0,1,0,1,0,1,3938
1,1,2,0,3,0,3,3938
2,2,1,0,4,0,4,3938
3,3,1,0,5,0,5,3938
4,4,1,0,6,0,6,3938
5,5,0,0,6,0,6,3938
0,0,1,0,1,0,1,3939
1,1,1,0,2,0,2,3939
2,2,3,1,5,1,6,3939
3,3,7,1,12,2,14,3939
4,4,3,1,15,3,18,3939
5,5,3,1,18,4,22,3939
6,6,0,0,18,4,22,3939
0,0,1,0,1,0,1,3940
1,1,1,1,2,1,3,3940
2,2,0,1,2,2,4,3940
3,3,0,1,2,3,5,3940
4,4,0,1,2,4,6,3940
5,5,1,0,3,4,7,3940
6,6,1,0,4,4,8,3940
7,7,0,0,4,4,8,3940
0,0,1,0,1,0,1,3941
1,1,1,0,2,0,2,3941
2,2,2,0,4,0,4,3941
3,3,0,0,4,0,4,3941
0,0,1,0,1,0,1,3942
1,1,0,0,1,0,1,3942
0,0,1,0,1,0,1,3943
1,1,2,2,3,2,5,3943
2,2,2,2,5,4,9,3943
3,3,1,1,6,5,11,3943
4,4,0,1,6,6,12,3943
5,5,0,0,6,6,12,3943
0,0,1,0,1,0,1,3944
1,1,0,0,1,0,1,3944
0,0,1,0,1,0,1,3945
1,1,0,0,1,0,1,3945
0,0,1,0,1,0,1,3946
1,1,1,0,2,0,2,3946
2,2,0,1,2,1,3,3946
3,3,0,1,2,2,4,3946
4,4,1,0,3,2,5,3946
5,5,0,0,3,2,5,3946
0,0,1,0,1,0,1,3947
1,1,2,0,3,0,3,3947
2,2,0,0,3,0,3,3947
0,0,1,0,1,0,1,3948
1,1,0,1,1,1,2,3948
2,2,0,0,1,1,2,3948
0,0,1,0,1,0,1,3949
1,1,0,0,1,0,1,3949
0,0,1,0,1,0,1,3950
1,1,0,0,1,0,1,3950
0,0,1,0,1,0,1,3951
1,1,0,3,1,3,4,3951
2,2,1,2,2,5,7,3951
3,3,3,3,5,8,13,3951
4,4,1,4,6,12,18,3951
5,5,4,1,10,13,23,3951
6,6,7,1,17,14,31,3951
7,7,4,5,21,19,40,3951
8,8,5,7,26,26,52,3951
9,9,5,8,31,34,65,3951
10,10,10,13,41,47,88,3951
11,11,10,9,51,56,107,3951
12,12,4,8,55,64,119,3951
13,13,8,7,63,71,134,3951
14,14,5,11,68,82,150,3951
15,15,13,12,81,94,175,3951
16,16,15,14,96,108,204,3951
17,17,13,15,109,123,232,3951
18,18,12,12,121,135,256,3951
19,19,14,12,135,147,282,3951
20,20,11,9,146,156,302,3951
21,21,7,13,153,169,322,3951
22,22,2,11,155,180,335,3951
23,23,6,5,161,185,346,3951
24,24,4,3,165,188,353,3951
25,25,5,4,170,192,362,3951
26,26,4,3,174,195,369,3951
27,27,8,3,182,198,380,3951
28,28,7,1,189,199,388,3951
29,29,5,0,194,199,393,3951
30,30,4,2,198,201,399,3951
31,31,1,3,199,204,403,3951
32,32,0,1,199,205,404,3951
33,33,0,0,199,205,404,3951
0,0,1,0,1,0,1,3952
1,1,1,0,2,0,2,3952
2,2,1,0,3,0,3,3952
3,3,1,0,4,0,4,3952
4,4,0,1,4,1,5,3952
5,5,0,0,4,1,5,3952
0,0,1,0,1,0,1,3953
1,1,2,0,3,0,3,3953
2,2,1,1,4,1,5,3953
3,3,3,1,7,2,9,3953
4,4,3,2,10,4,14,3953
5,5,2,1,12,5,17,3953
6,6,1,0,13,5,18,3953
7,7,0,1,13,6,19,3953
8,8,0,0,13,6,19,3953
0,0,1,0,1,0,1,3954
1,1,2,0,3,0,3,3954
2,2,2,1,5,1,6,3954
3,3,1,1,6,2,8,3954
4,4,2,0,8,2,10,3954
5,5,0,0,8,2,10,3954
0,0,1,0,1,0,1,3955
1,1,1,0,2,0,2,3955
2,2,1,0,3,0,3,3955
3,3,1,2,4,2,6,3955
4,4,3,2,7,4,11,3955
5,5,4,3,11,7,18,3955
6,6,6,4,17,11,28,3955
7,7,4,2,21,13,34,3955
8,8,2,2,23,15,38,3955
9,9,2,1,25,16,41,3955
10,10,3,0,28,16,44,3955
11,11,3,0,31,16,47,3955
12,12,0,0,31,16,47,3955
0,0,1,0,1,0,1,3956
1,1,2,0,3,0,3,3956
2,2,3,0,6,0,6,3956
3,3,1,1,7,1,8,3956
4,4,1,1,8,2,10,3956
5,5,1,1,9,3,12,3956
6,6,0,1,9,4,13,3956
7,7,1,0,10,4,14,3956
8,8,0,1,10,5,15,3956
9,9,1,1,11,6,17,3956
10,10,1,1,12,7,19,3956
11,11,4,0,16,7,23,3956
12,12,4,0,20,7,27,3956
13,13,2,0,22,7,29,3956
14,14,1,1,23,8,31,3956
15,15,0,1,23,9,32,3956
16,16,0,2,23,11,34,3956
17,17,0,1,23,12,35,3956
18,18,0,1,23,13,36,3956
19,19,0,0,23,13,36,3956
0,0,1,0,1,0,1,3957
1,1,1,0,2,0,2,3957
2,2,0,0,2,0,2,3957
0,0,1,0,1,0,1,3958
1,1,1,0,2,0,2,3958
2,2,0,0,2,0,2,3958
0,0,1,0,1,0,1,3959
1,1,2,0,3,0,3,3959
2,2,1,0,4,0,4,3959
3,3,0,1,4,1,5,3959
4,4,0,1,4,2,6,3959
5,5,0,1,4,3,7,3959
6,6,0,1,4,4,8,3959
7,7,1,0,5,4,9,3959
8,8,0,0,5,4,9,3959
0,0,1,0,1,0,1,3960
1,1,1,1,2,1,3,3960
2,2,1,1,3,2,5,3960
3,3,0,0,3,2,5,3960
0,0,1,0,1,0,1,3961
1,1,2,0,3,0,3,3961
2,2,1,0,4,0,4,3961
3,3,1,1,5,1,6,3961
4,4,1,0,6,1,7,3961
5,5,1,0,7,1,8,3961
6,6,0,0,7,1,8,3961
0,0,1,0,1,0,1,3962
1,1,2,0,3,0,3,3962
2,2,2,0,5,0,5,3962
3,3,2,0,7,0,7,3962
4,4,2,0,9,0,9,3962
5,5,0,0,9,0,9,3962
0,0,1,0,1,0,1,3963
1,1,0,0,1,0,1,3963
0,0,1,0,1,0,1,3964
1,1,0,0,1,0,1,3964
0,0,1,0,1,0,1,3965
1,1,0,0,1,0,1,3965
0,0,1,0,1,0,1,3966
1,1,0,0,1,0,1,3966
0,0,1,0,1,0,1,3967
1,1,0,0,1,0,1,3967
0,0,1,0,1,0,1,3968
1,1,1,0,2,0,2,3968
2,2,1,0,3,0,3,3968
3,3,1,0,4,0,4,3968
4,4,2,0,6,0,6,3968
5,5,1,0,7,0,7,3968
6,6,2,1,9,1,10,3968
7,7,1,3,10,4,14,3968
8,8,2,4,12,8,20,3968
9,9,1,2,13,10,23,3968
10,10,2,4,15,14,29,3968
11,11,3,6,18,20,38,3968
12,12,0,5,18,25,43,3968
13,13,1,2,19,27,46,3968
14,14,0,0,19,27,46,3968
0,0,1,0,1,0,1,3969
1,1,0,0,1,0,1,3969
0,0,1,0,1,0,1,3970
1,1,0,0,1,0,1,3970
0,0,1,0,1,0,1,3971
1,1,0,0,1,0,1,3971
0,0,1,0,1,0,1,3972
1,1,0,0,1,0,1,3972
0,0,1,0,1,0,1,3973
1,1,1,0,2,0,2,3973
2,2,2,0,4,0,4,3973
3,3,2,2,6,2,8,3973
4,4,1,1,7,3,10,3973
5,5,0,1,7,4,11,3973
6,6,0,1,7,5,12,3973
7,7,1,0,8,5,13,3973
8,8,0,0,8,5,13,3973
0,0,1,0,1,0,1,3974
1,1,0,0,1,0,1,3974
0,0,1,0,1,0,1,3975
1,1,2,0,3,0,3,3975
2,2,3,2,6,2,8,3975
3,3,0,2,6,4,10,3975
4,4,1,2,7,6,13,3975
5,5,0,1,7,7,14,3975
6,6,0,1,7,8,15,3975
7,7,0,2,7,10,17,3975
8,8,0,2,7,12,19,3975
9,9,0,4,7,16,23,3975
10,10,1,4,8,20,28,3975
11,11,1,3,9,23,32,3975
12,12,1,1,10,24,34,3975
13,13,0,1,10,25,35,3975
14,14,0,2,10,27,37,3975
15,15,1,0,11,27,38,3975
16,16,1,0,12,27,39,3975
17,17,2,0,14,27,41,3975
18,18,2,0,16,27,43,3975
19,19,0,0,16,27,43,3975
0,0,1,0,1,0,1,3976
1,1,1,0,2,0,2,3976
2,2,0,0,2,0,2,3976
0,0,1,0,1,0,1,3977
1,1,1,1,2,1,3,3977
2,2,0,2,2,3,5,3977
3,3,0,1,2,4,6,3977
4,4,0,2,2,6,8,3977
5,5,2,2,4,8,12,3977
6,6,4,2,8,10,18,3977
7,7,3,2,11,12,23,3977
8,8,2,3,13,15,28,3977
9,9,4,3,17,18,35,3977
10,10,1,4,18,22,40,3977
11,11,1,8,19,30,49,3977
12,12,2,7,21,37,58,3977
13,13,4,4,25,41,66,3977
14,14,5,2,30,43,73,3977
15,15,3,3,33,46,79,3977
16,16,2,1,35,47,82,3977
17,17,2,0,37,47,84,3977
18,18,1,0,38,47,85,3977
19,19,0,0,38,47,85,3977
0,0,1,0,1,0,1,3978
1,1,0,1,1,1,2,3978
2,2,0,1,1,2,3,3978
3,3,0,0,1,2,3,3978
0,0,1,0,1,0,1,3979
1,1,2,0,3,0,3,3979
2,2,1,0,4,0,4,3979
3,3,2,0,6,0,6,3979
4,4,0,0,6,0,6,3979
0,0,1,0,1,0,1,3980
1,1,1,0,2,0,2,3980
2,2,3,0,5,0,5,3980
3,3,1,0,6,0,6,3980
4,4,1,0,7,0,7,3980
5,5,0,0,7,0,7,3980
0,0,1,0,1,0,1,3981
1,1,0,0,1,0,1,3981
0,0,1,0,1,0,1,3982
1,1,1,0,2,0,2,3982
2,2,0,0,2,0,2,3982
0,0,1,0,1,0,1,3983
1,1,1,1,2,1,3,3983
2,2,1,1,3,2,5,3983
3,3,0,3,3,5,8,3983
4,4,0,3,3,8,11,3983
5,5,1,1,4,9,13,3983
6,6,1,2,5,11,16,3983
7,7,0,1,5,12,17,3983
8,8,0,0,5,12,17,3983
0,0,1,0,1,0,1,3984
1,1,0,0,1,0,1,3984
0,0,1,0,1,0,1,3985
1,1,1,0,2,0,2,3985
2,2,1,0,3,0,3,3985
3,3,0,0,3,0,3,3985
0,0,1,0,1,0,1,3986
1,1,1,0,2,0,2,3986
2,2,0,0,2,0,2,3986
0,0,1,0,1,0,1,3987
1,1,0,0,1,0,1,3987
0,0,1,0,1,0,1,3988
1,1,2,0,3,0,3,3988
2,2,1,0,4,0,4,3988
3,3,0,0,4,0,4,3988
0,0,1,0,1,0,1,3989
1,1,0,0,1,0,1,3989
0,0,1,0,1,0,1,3990
1,1,0,0,1,0,1,3990
0,0,1,0,1,0,1,3991
1,1,1,1,2,1,3,3991
2,2,1,1,3,2,5,3991
3,3,0,0,3,2,5,3991
0,0,1,0,1,0,1,3992
1,1,2,0,3,0,3,3992
2,2,1,1,4,1,5,3992
3,3,2,2,6,3,9,3992
4,4,0,0,6,3,9,3992
0,0,1,0,1,0,1,3993
1,1,1,0,2,0,2,3993
2,2,1,0,3,0,3,3993
3,3,0,0,3,0,3,3993
0,0,1,0,1,0,1,3994
1,1,0,0,1,0,1,3994
0,0,1,0,1,0,1,3995
1,1,0,0,1,0,1,3995
0,0,1,0,1,0,1,3996
1,1,0,0,1,0,1,3996
0,0,1,0,1,0,1,3997
1,1,0,0,1,0,1,3997
0,0,1,0,1,0,1,3998
1,1,0,0,1,0,1,3998
0,0,1,0,1,0,1,3999
1,1,0,0,1,0,1,3999
0,0,1,0,1,0,1,4000
1,1,0,0,1,0,1,4000
0,0,1,0,1,0,1,4001
1,1,2,0,3,0,3,4001
2,2,2,0,5,0,5,4001
3,3,1,0,6,0,6,4001
4,4,0,0,6,0,6,4001
0,0,1,0,1,0,1,4002
1,1,0,0,1,0,1,4002
0,0,1,0,1,0,1,4003
1,1,0,0,1,0,1,4003
0,0,1,0,1,0,1,4004
1,1,2,0,3,0,3,4004
2,2,2,1,5,1,6,4004
3,3,2,1,7,2,9,4004
4,4,1,1,8,3,11,4004
5,5,1,0,9,3,12,4004
6,6,2,0,11,3,14,4004
7,7,0,0,11,3,14,4004
0,0,1,0,1,0,1,4005
1,1,0,1,1,1,2,4005
2,2,0,0,1,1,2,4005
0,0,1,0,1,0,1,4006
1,1,0,0,1,0,1,4006
0,0,1,0,1,0,1,4007
1,1,0,0,1,0,1,4007
0,0,1,0,1,0,1,4008
1,1,1,2,2,2,4,4008
2,2,0,1,2,3,5,4008
3,3,0,0,2,3,5,4008
0,0,1,0,1,0,1,4009
1,1,2,0,3,0,3,4009
2,2,5,0,8,0,8,4009
3,3,5,1,13,1,14,4009
4,4,3,2,16,3,19,4009
5,5,1,4,17,7,24,4009
6,6,2,0,19,7,26,4009
7,7,1,0,20,7,27,4009
8,8,2,0,22,7,29,4009
9,9,1,1,23,8,31,4009
10,10,2,0,25,8,33,4009
11,11,3,0,28,8,36,4009
12,12,3,0,31,8,39,4009
13,13,2,0,33,8,41,4009
14,14,1,1,34,9,43,4009
15,15,1,0,35,9,44,4009
16,16,1,0,36,9,45,4009
17,17,0,0,36,9,45,4009
0,0,1,0,1,0,1,4010
1,1,0,1,1,1,2,4010
2,2,0,0,1,1,2,4010
0,0,1,0,1,0,1,4011
1,1,1,0,2,0,2,4011
2,2,1,0,3,0,3,4011
3,3,0,0,3,0,3,4011
0,0,1,0,1,0,1,4012
1,1,1,0,2,0,2,4012
2,2,1,0,3,0,3,4012
3,3,3,0,6,0,6,4012
4,4,5,1,11,1,12,4012
5,5,6,4,17,5,22,4012
6,6,5,4,22,9,31,4012
7,7,5,7,27,16,43,4012
8,8,2,3,29,19,48,4012
9,9,2,0,31,19,50,4012
10,10,3,0,34,19,53,4012
11,11,2,1,36,20,56,4012
12,12,2,0,38,20,58,4012
13,13,0,1,38,21,59,4012
14,14,0,1,38,22,60,4012
15,15,0,0,38,22,60,4012
0,0,1,0,1,0,1,4013
1,1,3,0,4,0,4,4013
2,2,1,1,5,1,6,4013
3,3,0,0,5,1,6,4013
0,0,1,0,1,0,1,4014
1,1,0,0,1,0,1,4014
0,0,1,0,1,0,1,4015
1,1,1,1,2,1,3,4015
2,2,0,1,2,2,4,4015
3,3,1,0,3,2,5,4015
4,4,0,0,3,2,5,4015
0,0,1,0,1,0,1,4016
1,1,0,0,1,0,1,4016
0,0,1,0,1,0,1,4017
1,1,0,1,1,1,2,4017
2,2,0,1,1,2,3,4017
3,3,0,1,1,3,4,4017
4,4,0,0,1,3,4,4017
0,0,1,0,1,0,1,4018
1,1,1,0,2,0,2,4018
2,2,1,0,3,0,3,4018
3,3,1,0,4,0,4,4018
4,4,0,0,4,0,4,4018
0,0,1,0,1,0,1,4019
1,1,2,0,3,0,3,4019
2,2,2,0,5,0,5,4019
3,3,4,1,9,1,10,4019
4,4,2,0,11,1,12,4019
5,5,3,0,14,1,15,4019
6,6,4,0,18,1,19,4019
7,7,3,2,21,3,24,4019
8,8,2,3,23,6,29,4019
9,9,2,0,25,6,31,4019
10,10,3,2,28,8,36,4019
11,11,3,1,31,9,40,4019
12,12,2,1,33,10,43,4019
13,13,1,0,34,10,44,4019
14,14,1,0,35,10,45,4019
15,15,0,0,35,10,45,4019
0,0,1,0,1,0,1,4020
1,1,1,0,2,0,2,4020
2,2,1,0,3,0,3,4020
3,3,0,0,3,0,3,4020
0,0,1,0,1,0,1,4021
1,1,2,0,3,0,3,4021
2,2,2,0,5,0,5,4021
3,3,1,0,6,0,6,4021
4,4,3,0,9,0,9,4021
5,5,4,0,13,0,13,4021
6,6,3,0,16,0,16,4021
7,7,0,1,16,1,17,4021
8,8,0,3,16,4,20,4021
9,9,0,4,16,8,24,4021
10,10,1,1,17,9,26,4021
11,11,2,1,19,10,29,4021
12,12,2,3,21,13,34,4021
13,13,1,3,22,16,38,4021
14,14,0,6,22,22,44,4021
15,15,1,3,23,25,48,4021
16,16,1,1,24,26,50,4021
17,17,3,0,27,26,53,4021
18,18,4,1,31,27,58,4021
19,19,3,4,34,31,65,4021
20,20,0,2,34,33,67,4021
21,21,0,2,34,35,69,4021
22,22,0,0,34,35,69,4021
0,0,1,0,1,0,1,4022
1,1,2,0,3,0,3,4022
2,2,2,0,5,0,5,4022
3,3,2,0,7,0,7,4022
4,4,1,0,8,0,8,4022
5,5,0,0,8,0,8,4022
0,0,1,0,1,0,1,4023
1,1,0,0,1,0,1,4023
0,0,1,0,1,0,1,4024
1,1,2,0,3,0,3,4024
2,2,2,0,5,0,5,4024
3,3,3,0,8,0,8,4024
4,4,4,0,12,0,12,4024
5,5,2,0,14,0,14,4024
6,6,2,1,16,1,17,4024
7,7,2,0,18,1,19,4024
8,8,1,0,19,1,20,4024
9,9,0,0,19,1,20,4024
0,0,1,0,1,0,1,4025
1,1,0,0,1,0,1,4025
0,0,1,0,1,0,1,4026
1,1,1,0,2,0,2,4026
2,2,0,0,2,0,2,4026
0,0,1,0,1,0,1,4027
1,1,1,0,2,0,2,4027
2,2,0,0,2,0,2,4027
0,0,1,0,1,0,1,4028
1,1,0,0,1,0,1,4028
0,0,1,0,1,0,1,4029
1,1,1,1,2,1,3,4029
2,2,1,2,3,3,6,4029
3,3,1,4,4,7,11,4029
4,4,2,3,6,10,16,4029
5,5,0,2,6,12,18,4029
6,6,0,3,6,15,21,4029
7,7,0,3,6,18,24,4029
8,8,0,3,6,21,27,4029
9,9,1,4,7,25,32,4029
10,10,0,2,7,27,34,4029
11,11,0,1,7,28,35,4029
12,12,0,1,7,29,36,4029
13,13,0,0,7,29,36,4029
0,0,1,0,1,0,1,4030
1,1,0,0,1,0,1,4030
0,0,1,0,1,0,1,4031
1,1,0,0,1,0,1,4031
0,0,1,0,1,0,1,4032
1,1,0,0,1,0,1,4032
0,0,1,0,1,0,1,4033
1,1,1,0,2,0,2,4033
2,2,4,0,6,0,6,4033
3,3,2,2,8,2,10,4033
4,4,5,4,13,6,19,4033
5,5,2,4,15,10,25,4033
6,6,1,1,16,11,27,4033
7,7,0,0,16,11,27,4033
0,0,1,0,1,0,1,4034
1,1,0,0,1,0,1,4034
0,0,1,0,1,0,1,4035
1,1,0,0,1,0,1,4035
0,0,1,0,1,0,1,4036
1,1,2,0,3,0,3,4036
2,2,1,0,4,0,4,4036
3,3,0,0,4,0,4,4036
0,0,1,0,1,0,1,4037
1,1,1,0,2,0,2,4037
2,2,2,0,4,0,4,4037
3,3,2,0,6,0,6,4037
4,4,2,1,8,1,9,4037
5,5,1,2,9,3,12,4037
6,6,1,3,10,6,16,4037
7,7,2,3,12,9,21,4037
8,8,2,5,14,14,28,4037
9,9,2,3,16,17,33,4037
10,10,0,1,16,18,34,4037
11,11,0,1,16,19,35,4037
12,12,0,0,16,19,35,4037
0,0,1,0,1,0,1,4038
1,1,0,0,1,0,1,4038
0,0,1,0,1,0,1,4039
1,1,1,0,2,0,2,4039
2,2,0,0,2,0,2,4039
0,0,1,0,1,0,1,4040
1,1,2,0,3,0,3,4040
2,2,0,1,3,1,4,4040
3,3,0,0,3,1,4,4040
0,0,1,0,1,0,1,4041
1,1,0,0,1,0,1,4041
0,0,1,0,1,0,1,4042
1,1,2,0,3,0,3,4042
2,2,0,0,3,0,3,4042
0,0,1,0,1,0,1,4043
1,1,1,0,2,0,2,4043
2,2,2,0,4,0,4,4043
3,3,2,0,6,0,6,4043
4,4,3,1,9,1,10,4043
5,5,2,1,11,2,13,4043
6,6,2,1,13,3,16,4043
7,7,0,4,13,7,20,4043
8,8,0,4,13,11,24,4043
9,9,0,1,13,12,25,4043
10,10,0,2,13,14,27,4043
11,11,0,4,13,18,31,4043
12,12,0,3,13,21,34,4043
13,13,0,0,13,21,34,4043
0,0,1,0,1,0,1,4044
1,1,1,1,2,1,3,4044
2,2,0,1,2,2,4,4044
3,3,0,1,2,3,5,4044
4,4,0,1,2,4,6,4044
5,5,0,0,2,4,6,4044
0,0,1,0,1,0,1,4045
1,1,1,1,2,1,3,4045
2,2,0,2,2,3,5,4045
3,3,0,0,2,3,5,4045
0,0,1,0,1,0,1,4046
1,1,3,0,4,0,4,4046
2,2,6,0,10,0,10,4046
3,3,1,4,11,4,15,4046
4,4,1,1,12,5,17,4046
5,5,0,0,12,5,17,4046
0,0,1,0,1,0,1,4047
1,1,1,0,2,0,2,4047
2,2,1,2,3,2,5,4047
3,3,1,3,4,5,9,4047
4,4,1,4,5,9,14,4047
5,5,0,3,5,12,17,4047
6,6,0,0,5,12,17,4047
0,0,1,0,1,0,1,4048
1,1,1,0,2,0,2,4048
2,2,0,0,2,0,2,4048
0,0,1,0,1,0,1,4049
1,1,0,0,1,0,1,4049
0,0,1,0,1,0,1,4050
1,1,0,1,1,1,2,4050
2,2,0,0,1,1,2,4050
0,0,1,0,1,0,1,4051
1,1,1,1,2,1,3,4051
2,2,1,0,3,1,4,4051
3,3,0,0,3,1,4,4051
0,0,1,0,1,0,1,4052
1,1,3,0,4,0,4,4052
2,2,2,0,6,0,6,4052
3,3,1,1,7,1,8,4052
4,4,0,1,7,2,9,4052
5,5,0,1,7,3,10,4052
6,6,0,1,7,4,11,4052
7,7,0,1,7,5,12,4052
8,8,0,1,7,6,13,4052
9,9,0,1,7,7,14,4052
10,10,0,3,7,10,17,4052
11,11,1,1,8,11,19,4052
12,12,1,0,9,11,20,4052
13,13,0,0,9,11,20,4052
0,0,1,0,1,0,1,4053
1,1,3,0,4,0,4,4053
2,2,0,1,4,1,5,4053
3,3,1,2,5,3,8,4053
4,4,2,2,7,5,12,4053
5,5,0,2,7,7,14,4053
6,6,0,2,7,9,16,4053
7,7,0,4,7,13,20,4053
8,8,2,2,9,15,24,4053
9,9,1,3,10,18,28,4053
10,10,1,1,11,19,30,4053
11,11,2,4,13,23,36,4053
12,12,2,2,15,25,40,4053
13,13,1,1,16,26,42,4053
14,14,1,0,17,26,43,4053
15,15,0,1,17,27,44,4053
16,16,0,1,17,28,45,4053
17,17,0,1,17,29,46,4053
18,18,1,0,18,29,47,4053
19,19,0,0,18,29,47,4053
0,0,1,0,1,0,1,4054
1,1,1,0,2,0,2,4054
2,2,1,1,3,1,4,4054
3,3,0,0,3,1,4,4054
0,0,1,0,1,0,1,4055
1,1,0,0,1,0,1,4055
0,0,1,0,1,0,1,4056
1,1,1,0,2,0,2,4056
2,2,0,0,2,0,2,4056
0,0,1,0,1,0,1,4057
1,1,1,0,2,0,2,4057
2,2,0,0,2,0,2,4057
0,0,1,0,1,0,1,4058
1,1,3,0,4,0,4,4058
2,2,1,2,5,2,7,4058
3,3,1,1,6,3,9,4058
4,4,3,1,9,4,13,4058
5,5,4,0,13,4,17,4058
6,6,1,0,14,4,18,4058
7,7,0,0,14,4,18,4058
0,0,1,0,1,0,1,4059
1,1,2,0,3,0,3,4059
2,2,1,0,4,0,4,4059
3,3,0,0,4,0,4,4059
0,0,1,0,1,0,1,4060
1,1,0,0,1,0,1,4060
0,0,1,0,1,0,1,4061
1,1,0,0,1,0,1,4061
0,0,1,0,1,0,1,4062
1,1,1,0,2,0,2,4062
2,2,0,0,2,0,2,4062
0,0,1,0,1,0,1,4063
1,1,1,1,2,1,3,4063
2,2,1,1,3,2,5,4063
3,3,1,0,4,2,6,4063
4,4,1,0,5,2,7,4063
5,5,0,0,5,2,7,4063
0,0,1,0,1,0,1,4064
1,1,2,0,3,0,3,4064
2,2,0,0,3,0,3,4064
0,0,1,0,1,0,1,4065
1,1,1,0,2,0,2,4065
2,2,3,0,5,0,5,4065
3,3,1,0,6,0,6,4065
4,4,0,0,6,0,6,4065
0,0,1,0,1,0,1,4066
1,1,0,1,1,1,2,4066
2,2,0,0,1,1,2,4066
0,0,1,0,1,0,1,4067
1,1,1,0,2,0,2,4067
2,2,1,0,3,0,3,4067
3,3,1,0,4,0,4,4067
4,4,0,0,4,0,4,4067
0,0,1,0,1,0,1,4068
1,1,1,1,2,1,3,4068
2,2,2,3,4,4,8,4068
3,3,2,1,6,5,11,4068
4,4,1,0,7,5,12,4068
5,5,0,0,7,5,12,4068
0,0,1,0,1,0,1,4069
1,1,1,0,2,0,2,4069
2,2,2,0,4,0,4,4069
3,3,1,1,5,1,6,4069
4,4,0,1,5,2,7,4069
5,5,0,0,5,2,7,4069
0,0,1,0,1,0,1,4070
1,1,2,0,3,0,3,4070
2,2,1,0,4,0,4,4070
3,3,1,0,5,0,5,4070
4,4,0,0,5,0,5,4070
0,0,1,0,1,0,1,4071
1,1,0,1,1,1,2,4071
2,2,0,1,1,2,3,4071
3,3,0,1,1,3,4,4071
4,4,1,0,2,3,5,4071
5,5,1,0,3,3,6,4071
6,6,1,0,4,3,7,4071
7,7,0,0,4,3,7,4071
0,0,1,0,1,0,1,4072
1,1,1,0,2,0,2,4072
2,2,2,0,4,0,4,4072
3,3,4,1,8,1,9,4072
4,4,4,1,12,2,14,4072
5,5,5,2,17,4,21,4072
6,6,8,3,25,7,32,4072
7,7,7,5,32,12,44,4072
8,8,2,2,34,14,48,4072
9,9,1,3,35,17,52,4072
10,10,0,1,35,18,53,4072
11,11,1,0,36,18,54,4072
12,12,1,0,37,18,55,4072
13,13,0,1,37,19,56,4072
14,14,0,1,37,20,57,4072
15,15,0,0,37,20,57,4072
0,0,1,0,1,0,1,4073
1,1,0,0,1,0,1,4073
0,0,1,0,1,0,1,4074
1,1,0,0,1,0,1,4074
0,0,1,0,1,0,1,4075
1,1,4,1,5,1,6,4075
2,2,1,1,6,2,8,4075
3,3,1,1,7,3,10,4075
4,4,3,0,10,3,13,4075
5,5,4,0,14,3,17,4075
6,6,2,0,16,3,19,4075
7,7,1,0,17,3,20,4075
8,8,1,0,18,3,21,4075
9,9,1,0,19,3,22,4075
10,10,1,0,20,3,23,4075
11,11,2,0,22,3,25,4075
12,12,2,1,24,4,28,4075
13,13,3,0,27,4,31,4075
14,14,2,1,29,5,34,4075
15,15,3,1,32,6,38,4075
16,16,1,1,33,7,40,4075
17,17,1,2,34,9,43,4075
18,18,3,3,37,12,49,4075
19,19,1,2,38,14,52,4075
20,20,1,4,39,18,57,4075
21,21,0,3,39,21,60,4075
22,22,1,3,40,24,64,4075
23,23,1,3,41,27,68,4075
24,24,0,1,41,28,69,4075
25,25,1,0,42,28,70,4075
26,26,0,0,42,28,70,4075
0,0,1,0,1,0,1,4076
1,1,1,1,2,1,3,4076
2,2,1,1,3,2,5,4076
3,3,2,2,5,4,9,4076
4,4,2,2,7,6,13,4076
5,5,2,1,9,7,16,4076
6,6,1,0,10,7,17,4076
7,7,1,1,11,8,19,4076
8,8,1,3,12,11,23,4076
9,9,0,4,12,15,27,4076
10,10,0,3,12,18,30,4076
11,11,0,3,12,21,33,4076
12,12,0,0,12,21,33,4076
0,0,1,0,1,0,1,4077
1,1,0,0,1,0,1,4077
0,0,1,0,1,0,1,4078
1,1,0,0,1,0,1,4078
0,0,1,0,1,0,1,4079
1,1,1,0,2,0,2,4079
2,2,2,0,4,0,4,4079
3,3,1,0,5,0,5,4079
4,4,0,0,5,0,5,4079
0,0,1,0,1,0,1,4080
1,1,2,0,3,0,3,4080
2,2,0,0,3,0,3,4080
0,0,1,0,1,0,1,4081
1,1,0,0,1,0,1,4081
0,0,1,0,1,0,1,4082
1,1,0,0,1,0,1,4082
0,0,1,0,1,0,1,4083
1,1,1,0,2,0,2,4083
2,2,0,0,2,0,2,4083
0,0,1,0,1,0,1,4084
1,1,1,0,2,0,2,4084
2,2,0,1,2,1,3,4084
3,3,0,0,2,1,3,4084
0,0,1,0,1,0,1,4085
1,1,0,0,1,0,1,4085
0,0,1,0,1,0,1,4086
1,1,3,0,4,0,4,4086
2,2,4,0,8,0,8,4086
3,3,3,1,11,1,12,4086
4,4,2,0,13,1,14,4086
5,5,1,0,14,1,15,4086
6,6,1,0,15,1,16,4086
7,7,0,0,15,1,16,4086
0,0,1,0,1,0,1,4087
1,1,2,0,3,0,3,4087
2,2,0,0,3,0,3,4087
0,0,1,0,1,0,1,4088
1,1,1,0,2,0,2,4088
2,2,1,1,3,1,4,4088
3,3,2,1,5,2,7,4088
4,4,2,0,7,2,9,4088
5,5,0,0,7,2,9,4088
0,0,1,0,1,0,1,4089
1,1,1,0,2,0,2,4089
2,2,1,0,3,0,3,4089
3,3,0,0,3,0,3,4089
0,0,1,0,1,0,1,4090
1,1,1,0,2,0,2,4090
2,2,2,0,4,0,4,4090
3,3,1,0,5,0,5,4090
4,4,2,0,7,0,7,4090
5,5,0,0,7,0,7,4090
0,0,1,0,1,0,1,4091
1,1,0,0,1,0,1,4091
0,0,1,0,1,0,1,4092
1,1,1,0,2,0,2,4092
2,2,1,0,3,0,3,4092
3,3,2,0,5,0,5,4092
4,4,0,0,5,0,5,4092
0,0,1,0,1,0,1,4093
1,1,1,0,2,0,2,4093
2,2,0,0,2,0,2,4093
0,0,1,0,1,0,1,4094
1,1,1,0,2,0,2,4094
2,2,0,0,2,0,2,4094
0,0,1,0,1,0,1,4095
1,1,0,0,1,0,1,4095
0,0,1,0,1,0,1,4096
1,1,0,0,1,0,1,4096
0,0,1,0,1,0,1,4097
1,1,0,0,1,0,1,4097
0,0,1,0,1,0,1,4098
1,1,0,0,1,0,1,4098
0,0,1,0,1,0,1,4099
1,1,2,0,3,0,3,4099
2,2,1,1,4,1,5,4099
3,3,0,1,4,2,6,4099
4,4,1,0,5,2,7,4099
5,5,1,2,6,4,10,4099
6,6,1,2,7,6,13,4099
7,7,2,2,9,8,17,4099
8,8,2,0,11,8,19,4099
9,9,1,0,12,8,20,4099
10,10,0,0,12,8,20,4099
0,0,1,0,1,0,1,4100
1,1,2,0,3,0,3,4100
2,2,1,1,4,1,5,4100
3,3,0,1,4,2,6,4100
4,4,0,0,4,2,6,4100
0,0,1,0,1,0,1,4101
1,1,1,0,2,0,2,4101
2,2,0,1,2,1,3,4101
3,3,0,0,2,1,3,4101
0,0,1,0,1,0,1,4102
1,1,2,1,3,1,4,4102
2,2,1,5,4,6,10,4102
3,3,1,2,5,8,13,4102
4,4,3,0,8,8,16,4102
5,5,3,1,11,9,20,4102
6,6,1,1,12,10,22,4102
7,7,1,1,13,11,24,4102
8,8,1,0,14,11,25,4102
9,9,0,0,14,11,25,4102
0,0,1,0,1,0,1,4103
1,1,0,0,1,0,1,4103
0,0,1,0,1,0,1,4104
1,1,0,0,1,0,1,4104
0,0,1,0,1,0,1,4105
1,1,2,0,3,0,3,4105
2,2,2,1,5,1,6,4105
3,3,1,0,6,1,7,4105
4,4,0,0,6,1,7,4105
0,0,1,0,1,0,1,4106
1,1,1,0,2,0,2,4106
2,2,2,0,4,0,4,4106
3,3,1,0,5,0,5,4106
4,4,2,0,7,0,7,4106
5,5,0,0,7,0,7,4106
0,0,1,0,1,0,1,4107
1,1,0,0,1,0,1,4107
0,0,1,0,1,0,1,4108
1,1,1,0,2,0,2,4108
2,2,0,0,2,0,2,4108
0,0,1,0,1,0,1,4109
1,1,1,0,2,0,2,4109
2,2,1,1,3,1,4,4109
3,3,0,1,3,2,5,4109
4,4,0,0,3,2,5,4109
0,0,1,0,1,0,1,4110
1,1,0,0,1,0,1,4110
0,0,1,0,1,0,1,4111
1,1,2,0,3,0,3,4111
2,2,1,0,4,0,4,4111
3,3,0,0,4,0,4,4111
0,0,1,0,1,0,1,4112
1,1,0,0,1,0,1,4112
0,0,1,0,1,0,1,4113
1,1,2,0,3,0,3,4113
2,2,1,0,4,0,4,4113
3,3,0,0,4,0,4,4113
0,0,1,0,1,0,1,4114
1,1,0,0,1,0,1,4114
0,0,1,0,1,0,1,4115
1,1,0,0,1,0,1,4115
0,0,1,0,1,0,1,4116
1,1,0,0,1,0,1,4116
0,0,1,0,1,0,1,4117
1,1,0,0,1,0,1,4117
0,0,1,0,1,0,1,4118
1,1,0,0,1,0,1,4118
0,0,1,0,1,0,1,4119
1,1,0,0,1,0,1,4119
0,0,1,0,1,0,1,4120
1,1,2,0,3,0,3,4120
2,2,2,0,5,0,5,4120
3,3,1,0,6,0,6,4120
4,4,1,0,7,0,7,4120
5,5,1,0,8,0,8,4120
6,6,0,2,8,2,10,4120
7,7,0,0,8,2,10,4120
0,0,1,0,1,0,1,4121
1,1,0,0,1,0,1,4121
0,0,1,0,1,0,1,4122
1,1,0,1,1,1,2,4122
2,2,1,2,2,3,5,4122
3,3,1,2,3,5,8,4122
4,4,1,4,4,9,13,4122
5,5,2,1,6,10,16,4122
6,6,2,1,8,11,19,4122
7,7,3,1,11,12,23,4122
8,8,5,3,16,15,31,4122
9,9,7,2,23,17,40,4122
10,10,8,2,31,19,50,4122
11,11,6,1,37,20,57,4122
12,12,6,1,43,21,64,4122
13,13,4,4,47,25,72,4122
14,14,1,2,48,27,75,4122
15,15,0,4,48,31,79,4122
16,16,2,3,50,34,84,4122
17,17,0,5,50,39,89,4122
18,18,0,3,50,42,92,4122
19,19,1,5,51,47,98,4122
20,20,3,1,54,48,102,4122
21,21,4,0,58,48,106,4122
22,22,4,1,62,49,111,4122
23,23,5,0,67,49,116,4122
24,24,4,2,71,51,122,4122
25,25,4,0,75,51,126,4122
26,26,4,0,79,51,130,4122
27,27,5,0,84,51,135,4122
28,28,3,0,87,51,138,4122
29,29,1,2,88,53,141,4122
30,30,0,2,88,55,143,4122
31,31,0,1,88,56,144,4122
32,32,1,1,89,57,146,4122
33,33,0,0,89,57,146,4122
0,0,1,0,1,0,1,4123
1,1,1,0,2,0,2,4123
2,2,3,1,5,1,6,4123
3,3,1,2,6,3,9,4123
4,4,2,2,8,5,13,4123
5,5,3,3,11,8,19,4123
6,6,4,4,15,12,27,4123
7,7,2,5,17,17,34,4123
8,8,4,1,21,18,39,4123
9,9,0,1,21,19,40,4123
10,10,0,0,21,19,40,4123
0,0,1,0,1,0,1,4124
1,1,0,0,1,0,1,4124
0,0,1,0,1,0,1,4125
1,1,0,0,1,0,1,4125
0,0,1,0,1,0,1,4126
1,1,0,0,1,0,1,4126
0,0,1,0,1,0,1,4127
1,1,1,0,2,0,2,4127
2,2,1,0,3,0,3,4127
3,3,0,0,3,0,3,4127
0,0,1,0,1,0,1,4128
1,1,1,0,2,0,2,4128
2,2,2,0,4,0,4,4128
3,3,1,0,5,0,5,4128
4,4,0,0,5,0,5,4128
0,0,1,0,1,0,1,4129
1,1,0,0,1,0,1,4129
0,0,1,0,1,0,1,4130
1,1,1,0,2,0,2,4130
2,2,0,0,2,0,2,4130
0,0,1,0,1,0,1,4131
1,1,2,1,3,1,4,4131
2,2,4,1,7,2,9,4131
3,3,2,0,9,2,11,4131
4,4,0,0,9,2,11,4131
0,0,1,0,1,0,1,4132
1,1,2,0,3,0,3,4132
2,2,1,0,4,0,4,4132
3,3,0,0,4,0,4,4132
0,0,1,0,1,0,1,4133
1,1,0,0,1,0,1,4133
0,0,1,0,1,0,1,4134
1,1,2,0,3,0,3,4134
2,2,0,0,3,0,3,4134
0,0,1,0,1,0,1,4135
1,1,0,0,1,0,1,4135
0,0,1,0,1,0,1,4136
1,1,1,0,2,0,2,4136
2,2,1,1,3,1,4,4136
3,3,1,0,4,1,5,4136
4,4,1,0,5,1,6,4136
5,5,0,0,5,1,6,4136
0,0,1,0,1,0,1,4137
1,1,0,0,1,0,1,4137
0,0,1,0,1,0,1,4138
1,1,1,0,2,0,2,4138
2,2,1,0,3,0,3,4138
3,3,3,0,6,0,6,4138
4,4,1,0,7,0,7,4138
5,5,1,0,8,0,8,4138
6,6,1,0,9,0,9,4138
7,7,0,0,9,0,9,4138
0,0,1,0,1,0,1,4139
1,1,1,0,2,0,2,4139
2,2,3,0,5,0,5,4139
3,3,3,1,8,1,9,4139
4,4,6,1,14,2,16,4139
5,5,2,3,16,5,21,4139
6,6,1,2,17,7,24,4139
7,7,1,6,18,13,31,4139
8,8,5,6,23,19,42,4139
9,9,8,5,31,24,55,4139
10,10,2,4,33,28,61,4139
11,11,1,3,34,31,65,4139
12,12,1,4,35,35,70,4139
13,13,1,5,36,40,76,4139
14,14,1,3,37,43,80,4139
15,15,0,1,37,44,81,4139
16,16,0,1,37,45,82,4139
17,17,1,0,38,45,83,4139
18,18,1,0,39,45,84,4139
19,19,1,1,40,46,86,4139
20,20,2,0,42,46,88,4139
21,21,1,1,43,47,90,4139
22,22,1,2,44,49,93,4139
23,23,0,3,44,52,96,4139
24,24,1,0,45,52,97,4139
25,25,0,0,45,52,97,4139
0,0,1,0,1,0,1,4140
1,1,1,1,2,1,3,4140
2,2,0,2,2,3,5,4140
3,3,0,2,2,5,7,4140
4,4,0,1,2,6,8,4140
5,5,0,0,2,6,8,4140
0,0,1,0,1,0,1,4141
1,1,0,1,1,1,2,4141
2,2,1,0,2,1,3,4141
3,3,1,0,3,1,4,4141
4,4,2,0,5,1,6,4141
5,5,2,0,7,1,8,4141
6,6,2,2,9,3,12,4141
7,7,2,1,11,4,15,4141
8,8,3,3,14,7,21,4141
9,9,1,0,15,7,22,4141
10,10,1,0,16,7,23,4141
11,11,1,0,17,7,24,4141
12,12,1,0,18,7,25,4141
13,13,1,0,19,7,26,4141
14,14,1,0,20,7,27,4141
15,15,0,0,20,7,27,4141
0,0,1,0,1,0,1,4142
1,1,1,0,2,0,2,4142
2,2,0,0,2,0,2,4142
0,0,1,0,1,0,1,4143
1,1,0,0,1,0,1,4143
0,0,1,0,1,0,1,4144
1,1,3,1,4,1,5,4144
2,2,3,2,7,3,10,4144
3,3,2,4,9,7,16,4144
4,4,1,3,10,10,20,4144
5,5,0,0,10,10,20,4144
0,0,1,0,1,0,1,4145
1,1,0,0,1,0,1,4145
0,0,1,0,1,0,1,4146
1,1,3,0,4,0,4,4146
2,2,1,0,5,0,5,4146
3,3,0,0,5,0,5,4146
0,0,1,0,1,0,1,4147
1,1,1,0,2,0,2,4147
2,2,2,0,4,0,4,4147
3,3,1,0,5,0,5,4147
4,4,0,0,5,0,5,4147
0,0,1,0,1,0,1,4148
1,1,0,0,1,0,1,4148
0,0,1,0,1,0,1,4149
1,1,1,0,2,0,2,4149
2,2,1,1,3,1,4,4149
3,3,0,2,3,3,6,4149
4,4,0,1,3,4,7,4149
5,5,0,0,3,4,7,4149
0,0,1,0,1,0,1,4150
1,1,4,0,5,0,5,4150
2,2,5,1,10,1,11,4150
3,3,2,3,12,4,16,4150
4,4,0,1,12,5,17,4150
5,5,0,0,12,5,17,4150
0,0,1,0,1,0,1,4151
1,1,1,0,2,0,2,4151
2,2,1,0,3,0,3,4151
3,3,0,0,3,0,3,4151
0,0,1,0,1,0,1,4152
1,1,0,1,1,1,2,4152
2,2,0,0,1,1,2,4152
0,0,1,0,1,0,1,4153
1,1,2,0,3,0,3,4153
2,2,0,0,3,0,3,4153
0,0,1,0,1,0,1,4154
1,1,3,0,4,0,4,4154
2,2,0,0,4,0,4,4154
0,0,1,0,1,0,1,4155
1,1,2,0,3,0,3,4155
2,2,2,0,5,0,5,4155
3,3,0,1,5,1,6,4155
4,4,0,1,5,2,7,4155
5,5,0,0,5,2,7,4155
0,0,1,0,1,0,1,4156
1,1,1,0,2,0,2,4156
2,2,2,1,4,1,5,4156
3,3,1,1,5,2,7,4156
4,4,0,1,5,3,8,4156
5,5,0,0,5,3,8,4156
0,0,1,0,1,0,1,4157
1,1,2,0,3,0,3,4157
2,2,2,0,5,0,5,4157
3,3,3,1,8,1,9,4157
4,4,1,2,9,3,12,4157
5,5,3,2,12,5,17,4157
6,6,0,4,12,9,21,4157
7,7,0,0,12,9,21,4157
0,0,1,0,1,0,1,4158
1,1,1,0,2,0,2,4158
2,2,0,0,2,0,2,4158
0,0,1,0,1,0,1,4159
1,1,0,0,1,0,1,4159
0,0,1,0,1,0,1,4160
1,1,0,0,1,0,1,4160
0,0,1,0,1,0,1,4161
1,1,0,0,1,0,1,4161
0,0,1,0,1,0,1,4162
1,1,0,0,1,0,1,4162
0,0,1,0,1,0,1,4163
1,1,1,0,2,0,2,4163
2,2,0,0,2,0,2,4163
0,0,1,0,1,0,1,4164
1,1,1,0,2,0,2,4164
2,2,0,0,2,0,2,4164
0,0,1,0,1,0,1,4165
1,1,1,1,2,1,3,4165
2,2,3,2,5,3,8,4165
3,3,1,2,6,5,11,4165
4,4,3,1,9,6,15,4165
5,5,2,3,11,9,20,4165
6,6,2,1,13,10,23,4165
7,7,4,2,17,12,29,4165
8,8,4,2,21,14,35,4165
9,9,3,2,24,16,40,4165
10,10,1,3,25,19,44,4165
11,11,1,2,26,21,47,4165
12,12,1,1,27,22,49,4165
13,13,0,0,27,22,49,4165
0,0,1,0,1,0,1,4166
1,1,1,1,2,1,3,4166
2,2,0,0,2,1,3,4166
0,0,1,0,1,0,1,4167
1,1,1,0,2,0,2,4167
2,2,1,0,3,0,3,4167
3,3,0,1,3,1,4,4167
4,4,0,0,3,1,4,4167
0,0,1,0,1,0,1,4168
1,1,0,0,1,0,1,4168
0,0,1,0,1,0,1,4169
1,1,0,0,1,0,1,4169
0,0,1,0,1,0,1,4170
1,1,0,0,1,0,1,4170
0,0,1,0,1,0,1,4171
1,1,0,0,1,0,1,4171
0,0,1,0,1,0,1,4172
1,1,0,0,1,0,1,4172
0,0,1,0,1,0,1,4173
1,1,1,1,2,1,3,4173
2,2,1,1,3,2,5,4173
3,3,0,2,3,4,7,4173
4,4,0,5,3,9,12,4173
5,5,0,2,3,11,14,4173
6,6,1,1,4,12,16,4173
7,7,1,3,5,15,20,4173
8,8,0,2,5,17,22,4173
9,9,0,0,5,17,22,4173
0,0,1,0,1,0,1,4174
1,1,0,0,1,0,1,4174
0,0,1,0,1,0,1,4175
1,1,0,0,1,0,1,4175
0,0,1,0,1,0,1,4176
1,1,1,2,2,2,4,4176
2,2,1,1,3,3,6,4176
3,3,0,0,3,3,6,4176
0,0,1,0,1,0,1,4177
1,1,1,0,2,0,2,4177
2,2,0,0,2,0,2,4177
0,0,1,0,1,0,1,4178
1,1,1,0,2,0,2,4178
2,2,0,1,2,1,3,4178
3,3,0,1,2,2,4,4178
4,4,1,0,3,2,5,4178
5,5,1,0,4,2,6,4178
6,6,1,0,5,2,7,4178
7,7,1,0,6,2,8,4178
8,8,1,0,7,2,9,4178
9,9,3,0,10,2,12,4178
10,10,0,0,10,2,12,4178
0,0,1,0,1,0,1,4179
1,1,0,0,1,0,1,4179
0,0,1,0,1,0,1,4180
1,1,0,0,1,0,1,4180
0,0,1,0,1,0,1,4181
1,1,1,0,2,0,2,4181
2,2,1,0,3,0,3,4181
3,3,0,0,3,0,3,4181
0,0,1,0,1,0,1,4182
1,1,1,0,2,0,2,4182
2,2,0,1,2,1,3,4182
3,3,0,2,2,3,5,4182
4,4,2,2,4,5,9,4182
5,5,2,1,6,6,12,4182
6,6,4,3,10,9,19,4182
7,7,5,3,15,12,27,4182
8,8,6,3,21,15,36,4182
9,9,4,2,25,17,42,4182
10,10,6,0,31,17,48,4182
11,11,2,1,33,18,51,4182
12,12,1,0,34,18,52,4182
13,13,0,0,34,18,52,4182
0,0,1,0,1,0,1,4183
1,1,1,0,2,0,2,4183
2,2,0,0,2,0,2,4183
0,0,1,0,1,0,1,4184
1,1,1,0,2,0,2,4184
2,2,2,1,4,1,5,4184
3,3,0,0,4,1,5,4184
0,0,1,0,1,0,1,4185
1,1,0,0,1,0,1,4185
0,0,1,0,1,0,1,4186
1,1,0,0,1,0,1,4186
0,0,1,0,1,0,1,4187
1,1,1,0,2,0,2,4187
2,2,1,0,3,0,3,4187
3,3,0,0,3,0,3,4187
0,0,1,0,1,0,1,4188
1,1,3,0,4,0,4,4188
2,2,3,1,7,1,8,4188
3,3,0,2,7,3,10,4188
4,4,0,1,7,4,11,4188
5,5,0,2,7,6,13,4188
6,6,1,1,8,7,15,4188
7,7,0,2,8,9,17,4188
8,8,0,0,8,9,17,4188
0,0,1,0,1,0,1,4189
1,1,0,0,1,0,1,4189
0,0,1,0,1,0,1,4190
1,1,0,0,1,0,1,4190
0,0,1,0,1,0,1,4191
1,1,2,0,3,0,3,4191
2,2,1,1,4,1,5,4191
3,3,0,0,4,1,5,4191
0,0,1,0,1,0,1,4192
1,1,0,0,1,0,1,4192
0,0,1,0,1,0,1,4193
1,1,0,0,1,0,1,4193
0,0,1,0,1,0,1,4194
1,1,0,0,1,0,1,4194
0,0,1,0,1,0,1,4195
1,1,0,0,1,0,1,4195
0,0,1,0,1,0,1,4196
1,1,0,1,1,1,2,4196
2,2,0,0,1,1,2,4196
0,0,1,0,1,0,1,4197
1,1,1,0,2,0,2,4197
2,2,3,0,5,0,5,4197
3,3,5,1,10,1,11,4197
4,4,5,2,15,3,18,4197
5,5,6,1,21,4,25,4197
6,6,3,4,24,8,32,4197
7,7,2,1,26,9,35,4197
8,8,4,1,30,10,40,4197
9,9,4,2,34,12,46,4197
10,10,3,2,37,14,51,4197
11,11,1,2,38,16,54,4197
12,12,1,2,39,18,57,4197
13,13,1,2,40,20,60,4197
14,14,1,2,41,22,63,4197
15,15,0,1,41,23,64,4197
16,16,0,2,41,25,66,4197
17,17,0,2,41,27,68,4197
18,18,1,2,42,29,71,4197
19,19,1,1,43,30,73,4197
20,20,2,1,45,31,76,4197
21,21,4,1,49,32,81,4197
22,22,1,1,50,33,83,4197
23,23,0,1,50,34,84,4197
24,24,0,0,50,34,84,4197
0,0,1,0,1,0,1,4198
1,1,1,1,2,1,3,4198
2,2,1,1,3,2,5,4198
3,3,0,3,3,5,8,4198
4,4,0,1,3,6,9,4198
5,5,1,1,4,7,11,4198
6,6,0,2,4,9,13,4198
7,7,0,0,4,9,13,4198
0,0,1,0,1,0,1,4199
1,1,0,2,1,2,3,4199
2,2,0,1,1,3,4,4199
3,3,0,0,1,3,4,4199
0,0,1,0,1,0,1,4200
1,1,2,0,3,0,3,4200
2,2,1,0,4,0,4,4200
3,3,3,0,7,0,7,4200
4,4,5,1,12,1,13,4200
5,5,2,0,14,1,15,4200
6,6,3,0,17,1,18,4200
7,7,2,1,19,2,21,4200
8,8,6,0,25,2,27,4200
9,9,6,0,31,2,33,4200
10,10,5,3,36,5,41,4200
11,11,2,4,38,9,47,4200
12,12,2,5,40,14,54,4200
13,13,3,2,43,16,59,4200
14,14,5,2,48,18,66,4200
15,15,4,1,52,19,71,4200
16,16,1,0,53,19,72,4200
17,17,0,0,53,19,72,4200
0,0,1,0,1,0,1,4201
1,1,0,1,1,1,2,4201
2,2,0,1,1,2,3,4201
3,3,0,0,1,2,3,4201
0,0,1,0,1,0,1,4202
1,1,0,1,1,1,2,4202
2,2,0,0,1,1,2,4202
0,0,1,0,1,0,1,4203
1,1,3,1,4,1,5,4203
2,2,2,0,6,1,7,4203
3,3,0,0,6,1,7,4203
0,0,1,0,1,0,1,4204
1,1,1,0,2,0,2,4204
2,2,1,0,3,0,3,4204
3,3,0,0,3,0,3,4204
0,0,1,0,1,0,1,4205
1,1,1,1,2,1,3,4205
2,2,2,1,4,2,6,4205
3,3,1,0,5,2,7,4205
4,4,1,0,6,2,8,4205
5,5,0,0,6,2,8,4205
0,0,1,0,1,0,1,4206
1,1,0,0,1,0,1,4206
0,0,1,0,1,0,1,4207
1,1,0,0,1,0,1,4207
0,0,1,0,1,0,1,4208
1,1,0,0,1,0,1,4208
0,0,1,0,1,0,1,4209
1,1,0,0,1,0,1,4209
0,0,1,0,1,0,1,4210
1,1,1,0,2,0,2,4210
2,2,2,0,4,0,4,4210
3,3,1,0,5,0,5,4210
4,4,1,0,6,0,6,4210
5,5,0,0,6,0,6,4210
0,0,1,0,1,0,1,4211
1,1,0,0,1,0,1,4211
0,0,1,0,1,0,1,4212
1,1,0,0,1,0,1,4212
0,0,1,0,1,0,1,4213
1,1,0,1,1,1,2,4213
2,2,1,0,2,1,3,4213
3,3,2,0,4,1,5,4213
4,4,0,0,4,1,5,4213
0,0,1,0,1,0,1,4214
1,1,0,1,1,1,2,4214
2,2,0,0,1,1,2,4214
0,0,1,0,1,0,1,4215
1,1,1,0,2,0,2,4215
2,2,0,0,2,0,2,4215
0,0,1,0,1,0,1,4216
1,1,0,0,1,0,1,4216
0,0,1,0,1,0,1,4217
1,1,1,0,2,0,2,4217
2,2,1,0,3,0,3,4217
3,3,1,0,4,0,4,4217
4,4,0,0,4,0,4,4217
0,0,1,0,1,0,1,4218
1,1,0,0,1,0,1,4218
0,0,1,0,1,0,1,4219
1,1,0,0,1,0,1,4219
0,0,1,0,1,0,1,4220
1,1,4,1,5,1,6,4220
2,2,2,3,7,4,11,4220
3,3,2,1,9,5,14,4220
4,4,2,3,11,8,19,4220
5,5,0,1,11,9,20,4220
6,6,0,1,11,10,21,4220
7,7,1,1,12,11,23,4220
8,8,1,1,13,12,25,4220
9,9,0,1,13,13,26,4220
10,10,0,1,13,14,27,4220
11,11,0,0,13,14,27,4220
0,0,1,0,1,0,1,4221
1,1,1,1,2,1,3,4221
2,2,1,0,3,1,4,4221
3,3,2,0,5,1,6,4221
4,4,1,0,6,1,7,4221
5,5,0,0,6,1,7,4221
0,0,1,0,1,0,1,4222
1,1,1,1,2,1,3,4222
2,2,1,2,3,3,6,4222
3,3,0,1,3,4,7,4222
4,4,0,1,3,5,8,4222
5,5,0,1,3,6,9,4222
6,6,2,0,5,6,11,4222
7,7,2,0,7,6,13,4222
8,8,0,0,7,6,13,4222
0,0,1,0,1,0,1,4223
1,1,1,0,2,0,2,4223
2,2,1,1,3,1,4,4223
3,3,0,4,3,5,8,4223
4,4,3,4,6,9,15,4223
5,5,1,6,7,15,22,4223
6,6,2,3,9,18,27,4223
7,7,3,4,12,22,34,4223
8,8,3,4,15,26,41,4223
9,9,2,1,17,27,44,4223
10,10,3,1,20,28,48,4223
11,11,3,1,23,29,52,4223
12,12,4,1,27,30,57,4223
13,13,4,6,31,36,67,4223
14,14,6,4,37,40,77,4223
15,15,6,1,43,41,84,4223
16,16,10,1,53,42,95,4223
17,17,7,5,60,47,107,4223
18,18,5,0,65,47,112,4223
19,19,2,2,67,49,116,4223
20,20,5,2,72,51,123,4223
21,21,7,1,79,52,131,4223
22,22,3,2,82,54,136,4223
23,23,2,1,84,55,139,4223
24,24,3,0,87,55,142,4223
25,25,6,0,93,55,148,4223
26,26,4,2,97,57,154,4223
27,27,5,1,102,58,160,4223
28,28,3,0,105,58,163,4223
29,29,1,2,106,60,166,4223
30,30,0,2,106,62,168,4223
31,31,0,0,106,62,168,4223
0,0,1,0,1,0,1,4224
1,1,1,0,2,0,2,4224
2,2,0,0,2,0,2,4224
0,0,1,0,1,0,1,4225
1,1,0,0,1,0,1,4225
0,0,1,0,1,0,1,4226
1,1,1,0,2,0,2,4226
2,2,1,0,3,0,3,4226
3,3,2,0,5,0,5,4226
4,4,1,0,6,0,6,4226
5,5,0,0,6,0,6,4226
0,0,1,0,1,0,1,4227
1,1,1,1,2,1,3,4227
2,2,0,0,2,1,3,4227
0,0,1,0,1,0,1,4228
1,1,2,0,3,0,3,4228
2,2,0,0,3,0,3,4228
0,0,1,0,1,0,1,4229
1,1,0,0,1,0,1,4229
0,0,1,0,1,0,1,4230
1,1,0,0,1,0,1,4230
0,0,1,0,1,0,1,4231
1,1,0,0,1,0,1,4231
0,0,1,0,1,0,1,4232
1,1,2,1,3,1,4,4232
2,2,1,1,4,2,6,4232
3,3,1,0,5,2,7,4232
4,4,0,0,5,2,7,4232
0,0,1,0,1,0,1,4233
1,1,3,0,4,0,4,4233
2,2,5,2,9,2,11,4233
3,3,6,2,15,4,19,4233
4,4,4,5,19,9,28,4233
5,5,1,6,20,15,35,4233
6,6,1,2,21,17,38,4233
7,7,0,4,21,21,42,4233
8,8,0,2,21,23,44,4233
9,9,2,4,23,27,50,4233
10,10,2,5,25,32,57,4233
11,11,4,7,29,39,68,4233
12,12,7,7,36,46,82,4233
13,13,3,3,39,49,88,4233
14,14,2,0,41,49,90,4233
15,15,4,1,45,50,95,4233
16,16,10,1,55,51,106,4233
17,17,5,1,60,52,112,4233
18,18,2,1,62,53,115,4233
19,19,3,2,65,55,120,4233
20,20,5,3,70,58,128,4233
21,21,3,4,73,62,135,4233
22,22,1,8,74,70,144,4233
23,23,2,2,76,72,148,4233
24,24,1,1,77,73,150,4233
25,25,0,1,77,74,151,4233
26,26,0,0,77,74,151,4233
0,0,1,0,1,0,1,4234
1,1,1,1,2,1,3,4234
2,2,1,1,3,2,5,4234
3,3,2,2,5,4,9,4234
4,4,4,3,9,7,16,4234
5,5,1,3,10,10,20,4234
6,6,0,5,10,15,25,4234
7,7,3,3,13,18,31,4234
8,8,1,1,14,19,33,4234
9,9,2,1,16,20,36,4234
10,10,1,1,17,21,38,4234
11,11,2,2,19,23,42,4234
12,12,2,0,21,23,44,4234
13,13,1,0,22,23,45,4234
14,14,0,0,22,23,45,4234
0,0,1,0,1,0,1,4235
1,1,1,0,2,0,2,4235
2,2,0,0,2,0,2,4235
0,0,1,0,1,0,1,4236
1,1,0,0,1,0,1,4236
0,0,1,0,1,0,1,4237
1,1,0,1,1,1,2,4237
2,2,0,0,1,1,2,4237
0,0,1,0,1,0,1,4238
1,1,1,1,2,1,3,4238
2,2,0,2,2,3,5,4238
3,3,1,0,3,3,6,4238
4,4,0,0,3,3,6,4238
0,0,1,0,1,0,1,4239
1,1,2,0,3,0,3,4239
2,2,0,0,3,0,3,4239
0,0,1,0,1,0,1,4240
1,1,0,0,1,0,1,4240
0,0,1,0,1,0,1,4241
1,1,0,0,1,0,1,4241
0,0,1,0,1,0,1,4242
1,1,2,0,3,0,3,4242
2,2,2,2,5,2,7,4242
3,3,4,1,9,3,12,4242
4,4,2,1,11,4,15,4242
5,5,3,0,14,4,18,4242
6,6,0,3,14,7,21,4242
7,7,2,1,16,8,24,4242
8,8,2,0,18,8,26,4242
9,9,2,0,20,8,28,4242
10,10,1,0,21,8,29,4242
11,11,0,0,21,8,29,4242
0,0,1,0,1,0,1,4243
1,1,3,0,4,0,4,4243
2,2,0,0,4,0,4,4243
0,0,1,0,1,0,1,4244
1,1,1,0,2,0,2,4244
2,2,1,0,3,0,3,4244
3,3,1,0,4,0,4,4244
4,4,1,0,5,0,5,4244
5,5,1,0,6,0,6,4244
6,6,1,0,7,0,7,4244
7,7,1,0,8,0,8,4244
8,8,0,0,8,0,8,4244
0,0,1,0,1,0,1,4245
1,1,2,0,3,0,3,4245
2,2,0,0,3,0,3,4245
0,0,1,0,1,0,1,4246
1,1,1,0,2,0,2,4246
2,2,0,0,2,0,2,4246
0,0,1,0,1,0,1,4247
1,1,0,0,1,0,1,4247
0,0,1,0,1,0,1,4248
1,1,0,0,1,0,1,4248
0,0,1,0,1,0,1,4249
1,1,2,0,3,0,3,4249
2,2,2,0,5,0,5,4249
3,3,1,1,6,1,7,4249
4,4,1,0,7,1,8,4249
5,5,0,0,7,1,8,4249
0,0,1,0,1,0,1,4250
1,1,1,0,2,0,2,4250
2,2,1,0,3,0,3,4250
3,3,2,1,5,1,6,4250
4,4,1,2,6,3,9,4250
5,5,1,0,7,3,10,4250
6,6,0,0,7,3,10,4250
0,0,1,0,1,0,1,4251
1,1,0,0,1,0,1,4251
0,0,1,0,1,0,1,4252
1,1,1,0,2,0,2,4252
2,2,0,0,2,0,2,4252
0,0,1,0,1,0,1,4253
1,1,3,0,4,0,4,4253
2,2,7,0,11,0,11,4253
3,3,4,4,15,4,19,4253
4,4,6,6,21,10,31,4253
5,5,7,4,28,14,42,4253
6,6,7,4,35,18,53,4253
7,7,7,2,42,20,62,4253
8,8,8,1,50,21,71,4253
9,9,7,1,57,22,79,4253
10,10,1,0,58,22,80,4253
11,11,0,0,58,22,80,4253
0,0,1,0,1,0,1,4254
1,1,0,1,1,1,2,4254
2,2,0,1,1,2,3,4254
3,3,0,0,1,2,3,4254
0,0,1,0,1,0,1,4255
1,1,0,0,1,0,1,4255
0,0,1,0,1,0,1,4256
1,1,0,0,1,0,1,4256
0,0,1,0,1,0,1,4257
1,1,1,0,2,0,2,4257
2,2,0,0,2,0,2,4257
0,0,1,0,1,0,1,4258
1,1,0,0,1,0,1,4258
0,0,1,0,1,0,1,4259
1,1,0,0,1,0,1,4259
0,0,1,0,1,0,1,4260
1,1,1,0,2,0,2,4260
2,2,0,0,2,0,2,4260
0,0,1,0,1,0,1,4261
1,1,1,0,2,0,2,4261
2,2,1,0,3,0,3,4261
3,3,0,0,3,0,3,4261
0,0,1,0,1,0,1,4262
1,1,0,0,1,0,1,4262
0,0,1,0,1,0,1,4263
1,1,0,0,1,0,1,4263
0,0,1,0,1,0,1,4264
1,1,0,0,1,0,1,4264
0,0,1,0,1,0,1,4265
1,1,1,0,2,0,2,4265
2,2,0,1,2,1,3,4265
3,3,0,0,2,1,3,4265
0,0,1,0,1,0,1,4266
1,1,2,0,3,0,3,4266
2,2,2,0,5,0,5,4266
3,3,1,0,6,0,6,4266
4,4,0,0,6,0,6,4266
0,0,1,0,1,0,1,4267
1,1,2,0,3,0,3,4267
2,2,0,0,3,0,3,4267
0,0,1,0,1,0,1,4268
1,1,1,2,2,2,4,4268
2,2,2,1,4,3,7,4268
3,3,1,0,5,3,8,4268
4,4,0,0,5,3,8,4268
0,0,1,0,1,0,1,4269
1,1,1,0,2,0,2,4269
2,2,0,0,2,0,2,4269
0,0,1,0,1,0,1,4270
1,1,0,0,1,0,1,4270
0,0,1,0,1,0,1,4271
1,1,1,0,2,0,2,4271
2,2,0,0,2,0,2,4271
0,0,1,0,1,0,1,4272
1,1,2,0,3,0,3,4272
2,2,0,1,3,1,4,4272
3,3,1,1,4,2,6,4272
4,4,1,2,5,4,9,4272
5,5,0,3,5,7,12,4272
6,6,0,0,5,7,12,4272
0,0,1,0,1,0,1,4273
1,1,0,1,1,1,2,4273
2,2,0,3,1,4,5,4273
3,3,0,7,1,11,12,4273
4,4,0,7,1,18,19,4273
5,5,1,5,2,23,25,4273
6,6,1,2,3,25,28,4273
7,7,1,1,4,26,30,4273
8,8,1,3,5,29,34,4273
9,9,0,2,5,31,36,4273
10,10,1,2,6,33,39,4273
11,11,2,1,8,34,42,4273
12,12,2,0,10,34,44,4273
13,13,3,1,13,35,48,4273
14,14,3,0,16,35,51,4273
15,15,1,0,17,35,52,4273
16,16,0,1,17,36,53,4273
17,17,0,1,17,37,54,4273
18,18,0,1,17,38,55,4273
19,19,0,0,17,38,55,4273
0,0,1,0,1,0,1,4274
1,1,0,0,1,0,1,4274
0,0,1,0,1,0,1,4275
1,1,0,0,1,0,1,4275
0,0,1,0,1,0,1,4276
1,1,0,0,1,0,1,4276
0,0,1,0,1,0,1,4277
1,1,1,1,2,1,3,4277
2,2,1,3,3,4,7,4277
3,3,1,3,4,7,11,4277
4,4,1,2,5,9,14,4277
5,5,1,0,6,9,15,4277
6,6,1,0,7,9,16,4277
7,7,0,0,7,9,16,4277
0,0,1,0,1,0,1,4278
1,1,2,0,3,0,3,4278
2,2,2,1,5,1,6,4278
3,3,3,2,8,3,11,4278
4,4,3,1,11,4,15,4278
5,5,3,1,14,5,19,4278
6,6,0,0,14,5,19,4278
0,0,1,0,1,0,1,4279
1,1,0,0,1,0,1,4279
0,0,1,0,1,0,1,4280
1,1,2,0,3,0,3,4280
2,2,3,1,6,1,7,4280
3,3,1,1,7,2,9,4280
4,4,0,0,7,2,9,4280
0,0,1,0,1,0,1,4281
1,1,1,0,2,0,2,4281
2,2,0,0,2,0,2,4281
0,0,1,0,1,0,1,4282
1,1,0,0,1,0,1,4282
0,0,1,0,1,0,1,4283
1,1,2,0,3,0,3,4283
2,2,2,0,5,0,5,4283
3,3,1,0,6,0,6,4283
4,4,1,1,7,1,8,4283
5,5,0,0,7,1,8,4283
0,0,1,0,1,0,1,4284
1,1,1,0,2,0,2,4284
2,2,0,0,2,0,2,4284
0,0,1,0,1,0,1,4285
1,1,0,0,1,0,1,4285
0,0,1,0,1,0,1,4286
1,1,2,0,3,0,3,4286
2,2,1,0,4,0,4,4286
3,3,1,0,5,0,5,4286
4,4,1,2,6,2,8,4286
5,5,2,3,8,5,13,4286
6,6,2,1,10,6,16,4286
7,7,2,1,12,7,19,4286
8,8,2,1,14,8,22,4286
9,9,3,1,17,9,26,4286
10,10,3,0,20,9,29,4286
11,11,0,0,20,9,29,4286
0,0,1,0,1,0,1,4287
1,1,1,0,2,0,2,4287
2,2,1,0,3,0,3,4287
3,3,3,0,6,0,6,4287
4,4,4,1,10,1,11,4287
5,5,1,1,11,2,13,4287
6,6,2,0,13,2,15,4287
7,7,2,0,15,2,17,4287
8,8,2,0,17,2,19,4287
9,9,0,3,17,5,22,4287
10,10,1,3,18,8,26,4287
11,11,0,2,18,10,28,4287
12,12,2,1,20,11,31,4287
13,13,4,0,24,11,35,4287
14,14,1,1,25,12,37,4287
15,15,1,1,26,13,39,4287
16,16,1,0,27,13,40,4287
17,17,0,0,27,13,40,4287
0,0,1,0,1,0,1,4288
1,1,0,0,1,0,1,4288
0,0,1,0,1,0,1,4289
1,1,1,0,2,0,2,4289
2,2,1,0,3,0,3,4289
3,3,2,0,5,0,5,4289
4,4,2,0,7,0,7,4289
5,5,1,0,8,0,8,4289
6,6,2,0,10,0,10,4289
7,7,0,1,10,1,11,4289
8,8,0,1,10,2,12,4289
9,9,2,0,12,2,14,4289
10,10,1,0,13,2,15,4289
11,11,0,0,13,2,15,4289
0,0,1,0,1,0,1,4290
1,1,0,0,1,0,1,4290
0,0,1,0,1,0,1,4291
1,1,1,0,2,0,2,4291
2,2,0,0,2,0,2,4291
0,0,1,0,1,0,1,4292
1,1,2,1,3,1,4,4292
2,2,1,2,4,3,7,4292
3,3,0,1,4,4,8,4292
4,4,0,0,4,4,8,4292
0,0,1,0,1,0,1,4293
1,1,1,0,2,0,2,4293
2,2,0,0,2,0,2,4293
0,0,1,0,1,0,1,4294
1,1,1,0,2,0,2,4294
2,2,1,0,3,0,3,4294
3,3,3,0,6,0,6,4294
4,4,3,0,9,0,9,4294
5,5,2,1,11,1,12,4294
6,6,2,0,13,1,14,4294
7,7,3,0,16,1,17,4294
8,8,2,1,18,2,20,4294
9,9,0,0,18,2,20,4294
0,0,1,0,1,0,1,4295
1,1,1,0,2,0,2,4295
2,2,1,0,3,0,3,4295
3,3,1,0,4,0,4,4295
4,4,1,2,5,2,7,4295
5,5,0,1,5,3,8,4295
6,6,0,1,5,4,9,4295
7,7,0,0,5,4,9,4295
0,0,1,0,1,0,1,4296
1,1,2,0,3,0,3,4296
2,2,2,0,5,0,5,4296
3,3,2,0,7,0,7,4296
4,4,2,0,9,0,9,4296
5,5,1,0,10,0,10,4296
6,6,0,0,10,0,10,4296
0,0,1,0,1,0,1,4297
1,1,1,0,2,0,2,4297
2,2,1,0,3,0,3,4297
3,3,0,0,3,0,3,4297
0,0,1,0,1,0,1,4298
1,1,1,0,2,0,2,4298
2,2,0,0,2,0,2,4298
0,0,1,0,1,0,1,4299
1,1,0,0,1,0,1,4299
0,0,1,0,1,0,1,4300
1,1,0,0,1,0,1,4300
0,0,1,0,1,0,1,4301
1,1,0,1,1,1,2,4301
2,2,0,2,1,3,4,4301
3,3,0,5,1,8,9,4301
4,4,1,4,2,12,14,4301
5,5,1,5,3,17,20,4301
6,6,0,6,3,23,26,4301
7,7,1,2,4,25,29,4301
8,8,1,1,5,26,31,4301
9,9,1,4,6,30,36,4301
10,10,2,3,8,33,41,4301
11,11,1,2,9,35,44,4301
12,12,2,1,11,36,47,4301
13,13,0,3,11,39,50,4301
14,14,2,2,13,41,54,4301
15,15,3,2,16,43,59,4301
16,16,1,1,17,44,61,4301
17,17,2,1,19,45,64,4301
18,18,3,1,22,46,68,4301
19,19,1,2,23,48,71,4301
20,20,0,1,23,49,72,4301
21,21,1,0,24,49,73,4301
22,22,0,0,24,49,73,4301
0,0,1,0,1,0,1,4302
1,1,0,0,1,0,1,4302
0,0,1,0,1,0,1,4303
1,1,1,0,2,0,2,4303
2,2,1,2,3,2,5,4303
3,3,0,4,3,6,9,4303
4,4,0,1,3,7,10,4303
5,5,0,0,3,7,10,4303
0,0,1,0,1,0,1,4304
1,1,0,0,1,0,1,4304
0,0,1,0,1,0,1,4305
1,1,1,0,2,0,2,4305
2,2,2,1,4,1,5,4305
3,3,0,0,4,1,5,4305
0,0,1,0,1,0,1,4306
1,1,1,0,2,0,2,4306
2,2,0,0,2,0,2,4306
0,0,1,0,1,0,1,4307
1,1,0,0,1,0,1,4307
0,0,1,0,1,0,1,4308
1,1,1,0,2,0,2,4308
2,2,0,0,2,0,2,4308
0,0,1,0,1,0,1,4309
1,1,1,0,2,0,2,4309
2,2,0,0,2,0,2,4309
0,0,1,0,1,0,1,4310
1,1,1,0,2,0,2,4310
2,2,1,0,3,0,3,4310
3,3,0,0,3,0,3,4310
0,0,1,0,1,0,1,4311
1,1,0,0,1,0,1,4311
0,0,1,0,1,0,1,4312
1,1,0,0,1,0,1,4312
0,0,1,0,1,0,1,4313
1,1,1,0,2,0,2,4313
2,2,2,0,4,0,4,4313
3,3,0,1,4,1,5,4313
4,4,0,0,4,1,5,4313
0,0,1,0,1,0,1,4314
1,1,0,0,1,0,1,4314
0,0,1,0,1,0,1,4315
1,1,2,0,3,0,3,4315
2,2,0,2,3,2,5,4315
3,3,0,1,3,3,6,4315
4,4,0,2,3,5,8,4315
5,5,2,4,5,9,14,4315
6,6,5,6,10,15,25,4315
7,7,5,4,15,19,34,4315
8,8,3,5,18,24,42,4315
9,9,0,3,18,27,45,4315
10,10,0,2,18,29,47,4315
11,11,0,4,18,33,51,4315
12,12,0,4,18,37,55,4315
13,13,2,1,20,38,58,4315
14,14,1,0,21,38,59,4315
15,15,0,1,21,39,60,4315
16,16,0,1,21,40,61,4315
17,17,0,0,21,40,61,4315
0,0,1,0,1,0,1,4316
1,1,2,0,3,0,3,4316
2,2,1,1,4,1,5,4316
3,3,1,1,5,2,7,4316
4,4,2,1,7,3,10,4316
5,5,0,0,7,3,10,4316
0,0,1,0,1,0,1,4317
1,1,0,0,1,0,1,4317
0,0,1,0,1,0,1,4318
1,1,0,0,1,0,1,4318
0,0,1,0,1,0,1,4319
1,1,0,0,1,0,1,4319
0,0,1,0,1,0,1,4320
1,1,1,1,2,1,3,4320
2,2,0,1,2,2,4,4320
3,3,0,0,2,2,4,4320
0,0,1,0,1,0,1,4321
1,1,1,0,2,0,2,4321
2,2,1,0,3,0,3,4321
3,3,1,0,4,0,4,4321
4,4,0,0,4,0,4,4321
0,0,1,0,1,0,1,4322
1,1,0,0,1,0,1,4322
0,0,1,0,1,0,1,4323
1,1,2,0,3,0,3,4323
2,2,1,1,4,1,5,4323
3,3,0,0,4,1,5,4323
0,0,1,0,1,0,1,4324
1,1,1,0,2,0,2,4324
2,2,1,0,3,0,3,4324
3,3,0,0,3,0,3,4324
0,0,1,0,1,0,1,4325
1,1,0,0,1,0,1,4325
0,0,1,0,1,0,1,4326
1,1,0,0,1,0,1,4326
0,0,1,0,1,0,1,4327
1,1,1,0,2,0,2,4327
2,2,0,0,2,0,2,4327
0,0,1,0,1,0,1,4328
1,1,0,0,1,0,1,4328
0,0,1,0,1,0,1,4329
1,1,1,0,2,0,2,4329
2,2,0,0,2,0,2,4329
0,0,1,0,1,0,1,4330
1,1,0,0,1,0,1,4330
0,0,1,0,1,0,1,4331
1,1,1,1,2,1,3,4331
2,2,1,0,3,1,4,4331
3,3,0,0,3,1,4,4331
0,0,1,0,1,0,1,4332
1,1,0,0,1,0,1,4332
0,0,1,0,1,0,1,4333
1,1,1,1,2,1,3,4333
2,2,0,0,2,1,3,4333
0,0,1,0,1,0,1,4334
1,1,0,0,1,0,1,4334
0,0,1,0,1,0,1,4335
1,1,0,0,1,0,1,4335
0,0,1,0,1,0,1,4336
1,1,1,0,2,0,2,4336
2,2,2,0,4,0,4,4336
3,3,0,0,4,0,4,4336
0,0,1,0,1,0,1,4337
1,1,0,1,1,1,2,4337
2,2,1,3,2,4,6,4337
3,3,1,3,3,7,10,4337
4,4,0,1,3,8,11,4337
5,5,1,0,4,8,12,4337
6,6,1,0,5,8,13,4337
7,7,1,0,6,8,14,4337
8,8,0,0,6,8,14,4337
0,0,1,0,1,0,1,4338
1,1,0,0,1,0,1,4338
0,0,1,0,1,0,1,4339
1,1,0,0,1,0,1,4339
0,0,1,0,1,0,1,4340
1,1,1,0,2,0,2,4340
2,2,0,0,2,0,2,4340
0,0,1,0,1,0,1,4341
1,1,1,0,2,0,2,4341
2,2,0,0,2,0,2,4341
0,0,1,0,1,0,1,4342
1,1,0,0,1,0,1,4342
0,0,1,0,1,0,1,4343
1,1,0,0,1,0,1,4343
0,0,1,0,1,0,1,4344
1,1,0,0,1,0,1,4344
0,0,1,0,1,0,1,4345
1,1,0,0,1,0,1,4345
0,0,1,0,1,0,1,4346
1,1,0,1,1,1,2,4346
2,2,0,0,1,1,2,4346
0,0,1,0,1,0,1,4347
1,1,2,1,3,1,4,4347
2,2,1,3,4,4,8,4347
3,3,1,1,5,5,10,4347
4,4,1,1,6,6,12,4347
5,5,0,1,6,7,13,4347
6,6,1,0,7,7,14,4347
7,7,2,0,9,7,16,4347
8,8,1,1,10,8,18,4347
9,9,1,0,11,8,19,4347
10,10,0,0,11,8,19,4347
0,0,1,0,1,0,1,4348
1,1,1,0,2,0,2,4348
2,2,0,0,2,0,2,4348
0,0,1,0,1,0,1,4349
1,1,2,0,3,0,3,4349
2,2,1,1,4,1,5,4349
3,3,0,1,4,2,6,4349
4,4,0,2,4,4,8,4349
5,5,2,1,6,5,11,4349
6,6,0,0,6,5,11,4349
0,0,1,0,1,0,1,4350
1,1,1,0,2,0,2,4350
2,2,1,0,3,0,3,4350
3,3,1,0,4,0,4,4350
4,4,0,0,4,0,4,4350
0,0,1,0,1,0,1,4351
1,1,0,0,1,0,1,4351
0,0,1,0,1,0,1,4352
1,1,1,1,2,1,3,4352
2,2,0,2,2,3,5,4352
3,3,1,2,3,5,8,4352
4,4,0,1,3,6,9,4352
5,5,1,0,4,6,10,4352
6,6,0,0,4,6,10,4352
0,0,1,0,1,0,1,4353
1,1,0,1,1,1,2,4353
2,2,0,0,1,1,2,4353
0,0,1,0,1,0,1,4354
1,1,1,0,2,0,2,4354
2,2,0,0,2,0,2,4354
0,0,1,0,1,0,1,4355
1,1,0,0,1,0,1,4355
0,0,1,0,1,0,1,4356
1,1,2,1,3,1,4,4356
2,2,0,1,3,2,5,4356
3,3,0,0,3,2,5,4356
0,0,1,0,1,0,1,4357
1,1,0,0,1,0,1,4357
0,0,1,0,1,0,1,4358
1,1,1,0,2,0,2,4358
2,2,0,0,2,0,2,4358
0,0,1,0,1,0,1,4359
1,1,1,0,2,0,2,4359
2,2,1,0,3,0,3,4359
3,3,1,0,4,0,4,4359
4,4,1,0,5,0,5,4359
5,5,1,0,6,0,6,4359
6,6,1,1,7,1,8,4359
7,7,1,2,8,3,11,4359
8,8,0,4,8,7,15,4359
9,9,0,3,8,10,18,4359
10,10,0,1,8,11,19,4359
11,11,0,0,8,11,19,4359
0,0,1,0,1,0,1,4360
1,1,1,0,2,0,2,4360
2,2,0,0,2,0,2,4360
0,0,1,0,1,0,1,4361
1,1,1,0,2,0,2,4361
2,2,1,0,3,0,3,4361
3,3,0,0,3,0,3,4361
0,0,1,0,1,0,1,4362
1,1,0,1,1,1,2,4362
2,2,0,2,1,3,4,4362
3,3,0,1,1,4,5,4362
4,4,1,3,2,7,9,4362
5,5,3,2,5,9,14,4362
6,6,1,0,6,9,15,4362
7,7,1,0,7,9,16,4362
8,8,1,0,8,9,17,4362
9,9,0,0,8,9,17,4362
0,0,1,0,1,0,1,4363
1,1,1,0,2,0,2,4363
2,2,1,0,3,0,3,4363
3,3,0,0,3,0,3,4363
0,0,1,0,1,0,1,4364
1,1,0,0,1,0,1,4364
0,0,1,0,1,0,1,4365
1,1,0,0,1,0,1,4365
0,0,1,0,1,0,1,4366
1,1,1,0,2,0,2,4366
2,2,0,1,2,1,3,4366
3,3,0,0,2,1,3,4366
0,0,1,0,1,0,1,4367
1,1,1,0,2,0,2,4367
2,2,0,1,2,1,3,4367
3,3,0,0,2,1,3,4367
0,0,1,0,1,0,1,4368
1,1,1,0,2,0,2,4368
2,2,1,1,3,1,4,4368
3,3,0,0,3,1,4,4368
0,0,1,0,1,0,1,4369
1,1,2,0,3,0,3,4369
2,2,1,0,4,0,4,4369
3,3,0,0,4,0,4,4369
0,0,1,0,1,0,1,4370
1,1,2,0,3,0,3,4370
2,2,1,0,4,0,4,4370
3,3,1,0,5,0,5,4370
4,4,0,0,5,0,5,4370
0,0,1,0,1,0,1,4371
1,1,0,0,1,0,1,4371
0,0,1,0,1,0,1,4372
1,1,0,0,1,0,1,4372
0,0,1,0,1,0,1,4373
1,1,0,0,1,0,1,4373
0,0,1,0,1,0,1,4374
1,1,1,0,2,0,2,4374
2,2,2,1,4,1,5,4374
3,3,1,1,5,2,7,4374
4,4,2,0,7,2,9,4374
5,5,1,0,8,2,10,4374
6,6,0,2,8,4,12,4374
7,7,0,3,8,7,15,4374
8,8,1,2,9,9,18,4374
9,9,0,3,9,12,21,4374
10,10,1,3,10,15,25,4374
11,11,3,5,13,20,33,4374
12,12,2,2,15,22,37,4374
13,13,2,2,17,24,41,4374
14,14,1,1,18,25,43,4374
15,15,1,2,19,27,46,4374
16,16,0,1,19,28,47,4374
17,17,0,0,19,28,47,4374
0,0,1,0,1,0,1,4375
1,1,0,0,1,0,1,4375
0,0,1,0,1,0,1,4376
1,1,0,0,1,0,1,4376
0,0,1,0,1,0,1,4377
1,1,0,1,1,1,2,4377
2,2,0,0,1,1,2,4377
0,0,1,0,1,0,1,4378
1,1,0,1,1,1,2,4378
2,2,1,1,2,2,4,4378
3,3,1,0,3,2,5,4378
4,4,0,0,3,2,5,4378
0,0,1,0,1,0,1,4379
1,1,1,0,2,0,2,4379
2,2,0,0,2,0,2,4379
0,0,1,0,1,0,1,4380
1,1,1,0,2,0,2,4380
2,2,3,0,5,0,5,4380
3,3,2,1,7,1,8,4380
4,4,0,2,7,3,10,4380
5,5,0,2,7,5,12,4380
6,6,0,2,7,7,14,4380
7,7,0,1,7,8,15,4380
8,8,0,0,7,8,15,4380
0,0,1,0,1,0,1,4381
1,1,0,0,1,0,1,4381
0,0,1,0,1,0,1,4382
1,1,0,0,1,0,1,4382
0,0,1,0,1,0,1,4383
1,1,1,1,2,1,3,4383
2,2,0,0,2,1,3,4383
0,0,1,0,1,0,1,4384
1,1,1,0,2,0,2,4384
2,2,0,0,2,0,2,4384
0,0,1,0,1,0,1,4385
1,1,0,0,1,0,1,4385
0,0,1,0,1,0,1,4386
1,1,2,0,3,0,3,4386
2,2,1,0,4,0,4,4386
3,3,1,0,5,0,5,4386
4,4,0,0,5,0,5,4386
0,0,1,0,1,0,1,4387
1,1,0,0,1,0,1,4387
0,0,1,0,1,0,1,4388
1,1,2,1,3,1,4,4388
2,2,6,0,9,1,10,4388
3,3,6,1,15,2,17,4388
4,4,6,1,21,3,24,4388
5,5,4,2,25,5,30,4388
6,6,3,0,28,5,33,4388
7,7,3,1,31,6,37,4388
8,8,7,2,38,8,46,4388
9,9,6,2,44,10,54,4388
10,10,6,5,50,15,65,4388
11,11,4,3,54,18,72,4388
12,12,2,2,56,20,76,4388
13,13,2,2,58,22,80,4388
14,14,1,0,59,22,81,4388
15,15,1,0,60,22,82,4388
16,16,1,0,61,22,83,4388
17,17,0,0,61,22,83,4388
0,0,1,0,1,0,1,4389
1,1,0,1,1,1,2,4389
2,2,0,0,1,1,2,4389
0,0,1,0,1,0,1,4390
1,1,2,0,3,0,3,4390
2,2,1,0,4,0,4,4390
3,3,1,0,5,0,5,4390
4,4,1,0,6,0,6,4390
5,5,0,0,6,0,6,4390
0,0,1,0,1,0,1,4391
1,1,0,1,1,1,2,4391
2,2,0,1,1,2,3,4391
3,3,1,0,2,2,4,4391
4,4,0,0,2,2,4,4391
0,0,1,0,1,0,1,4392
1,1,1,0,2,0,2,4392
2,2,0,0,2,0,2,4392
0,0,1,0,1,0,1,4393
1,1,0,0,1,0,1,4393
0,0,1,0,1,0,1,4394
1,1,1,0,2,0,2,4394
2,2,0,0,2,0,2,4394
0,0,1,0,1,0,1,4395
1,1,2,0,3,0,3,4395
2,2,2,0,5,0,5,4395
3,3,1,2,6,2,8,4395
4,4,0,1,6,3,9,4395
5,5,0,0,6,3,9,4395
0,0,1,0,1,0,1,4396
1,1,0,0,1,0,1,4396
0,0,1,0,1,0,1,4397
1,1,2,0,3,0,3,4397
2,2,0,0,3,0,3,4397
0,0,1,0,1,0,1,4398
1,1,2,0,3,0,3,4398
2,2,2,0,5,0,5,4398
3,3,2,0,7,0,7,4398
4,4,5,0,12,0,12,4398
5,5,3,0,15,0,15,4398
6,6,5,0,20,0,20,4398
7,7,3,3,23,3,26,4398
8,8,4,1,27,4,31,4398
9,9,2,1,29,5,34,4398
10,10,0,0,29,5,34,4398
0,0,1,0,1,0,1,4399
1,1,0,0,1,0,1,4399
0,0,1,0,1,0,1,4400
1,1,0,0,1,0,1,4400
0,0,1,0,1,0,1,4401
1,1,1,0,2,0,2,4401
2,2,0,1,2,1,3,4401
3,3,0,0,2,1,3,4401
0,0,1,0,1,0,1,4402
1,1,0,0,1,0,1,4402
0,0,1,0,1,0,1,4403
1,1,0,0,1,0,1,4403
0,0,1,0,1,0,1,4404
1,1,1,0,2,0,2,4404
2,2,0,0,2,0,2,4404
0,0,1,0,1,0,1,4405
1,1,0,1,1,1,2,4405
2,2,0,2,1,3,4,4405
3,3,1,2,2,5,7,4405
4,4,0,1,2,6,8,4405
5,5,0,0,2,6,8,4405
0,0,1,0,1,0,1,4406
1,1,2,0,3,0,3,4406
2,2,1,0,4,0,4,4406
3,3,1,0,5,0,5,4406
4,4,0,0,5,0,5,4406
0,0,1,0,1,0,1,4407
1,1,1,0,2,0,2,4407
2,2,1,0,3,0,3,4407
3,3,0,0,3,0,3,4407
0,0,1,0,1,0,1,4408
1,1,1,0,2,0,2,4408
2,2,0,0,2,0,2,4408
0,0,1,0,1,0,1,4409
1,1,3,0,4,0,4,4409
2,2,0,0,4,0,4,4409
0,0,1,0,1,0,1,4410
1,1,1,0,2,0,2,4410
2,2,1,1,3,1,4,4410
3,3,1,0,4,1,5,4410
4,4,1,0,5,1,6,4410
5,5,0,0,5,1,6,4410
0,0,1,0,1,0,1,4411
1,1,0,0,1,0,1,4411
0,0,1,0,1,0,1,4412
1,1,1,0,2,0,2,4412
2,2,0,0,2,0,2,4412
0,0,1,0,1,0,1,4413
1,1,0,0,1,0,1,4413
0,0,1,0,1,0,1,4414
1,1,1,0,2,0,2,4414
2,2,0,0,2,0,2,4414
0,0,1,0,1,0,1,4415
1,1,0,0,1,0,1,4415
0,0,1,0,1,0,1,4416
1,1,1,1,2,1,3,4416
2,2,2,0,4,1,5,4416
3,3,1,0,5,1,6,4416
4,4,1,0,6,1,7,4416
5,5,0,0,6,1,7,4416
0,0,1,0,1,0,1,4417
1,1,1,0,2,0,2,4417
2,2,0,0,2,0,2,4417
0,0,1,0,1,0,1,4418
1,1,1,0,2,0,2,4418
2,2,1,0,3,0,3,4418
3,3,2,0,5,0,5,4418
4,4,2,0,7,0,7,4418
5,5,5,0,12,0,12,4418
6,6,2,2,14,2,16,4418
7,7,0,2,14,4,18,4418
8,8,2,1,16,5,21,4418
9,9,2,0,18,5,23,4418
10,10,0,0,18,5,23,4418
0,0,1,0,1,0,1,4419
1,1,0,0,1,0,1,4419
0,0,1,0,1,0,1,4420
1,1,0,0,1,0,1,4420
0,0,1,0,1,0,1,4421
1,1,0,0,1,0,1,4421
0,0,1,0,1,0,1,4422
1,1,0,0,1,0,1,4422
0,0,1,0,1,0,1,4423
1,1,0,0,1,0,1,4423
0,0,1,0,1,0,1,4424
1,1,1,0,2,0,2,4424
2,2,1,0,3,0,3,4424
3,3,3,1,6,1,7,4424
4,4,4,1,10,2,12,4424
5,5,2,3,12,5,17,4424
6,6,2,3,14,8,22,4424
7,7,3,2,17,10,27,4424
8,8,2,2,19,12,31,4424
9,9,2,2,21,14,35,4424
10,10,2,2,23,16,39,4424
11,11,0,3,23,19,42,4424
12,12,0,1,23,20,43,4424
13,13,0,0,23,20,43,4424
0,0,1,0,1,0,1,4425
1,1,0,0,1,0,1,4425
0,0,1,0,1,0,1,4426
1,1,0,0,1,0,1,4426
0,0,1,0,1,0,1,4427
1,1,1,0,2,0,2,4427
2,2,2,0,4,0,4,4427
3,3,2,0,6,0,6,4427
4,4,0,0,6,0,6,4427
0,0,1,0,1,0,1,4428
1,1,2,0,3,0,3,4428
2,2,3,2,6,2,8,4428
3,3,3,0,9,2,11,4428
4,4,4,0,13,2,15,4428
5,5,2,0,15,2,17,4428
6,6,1,0,16,2,18,4428
7,7,1,0,17,2,19,4428
8,8,1,0,18,2,20,4428
9,9,1,0,19,2,21,4428
10,10,0,0,19,2,21,4428
0,0,1,0,1,0,1,4429
1,1,1,0,2,0,2,4429
2,2,0,0,2,0,2,4429
0,0,1,0,1,0,1,4430
1,1,0,0,1,0,1,4430
0,0,1,0,1,0,1,4431
1,1,1,0,2,0,2,4431
2,2,0,0,2,0,2,4431
0,0,1,0,1,0,1,4432
1,1,3,0,4,0,4,4432
2,2,2,0,6,0,6,4432
3,3,1,2,7,2,9,4432
4,4,2,1,9,3,12,4432
5,5,2,1,11,4,15,4432
6,6,0,1,11,5,16,4432
7,7,0,0,11,5,16,4432
0,0,1,0,1,0,1,4433
1,1,1,0,2,0,2,4433
2,2,0,0,2,0,2,4433
0,0,1,0,1,0,1,4434
1,1,0,0,1,0,1,4434
0,0,1,0,1,0,1,4435
1,1,0,0,1,0,1,4435
0,0,1,0,1,0,1,4436
1,1,1,0,2,0,2,4436
2,2,0,0,2,0,2,4436
0,0,1,0,1,0,1,4437
1,1,1,0,2,0,2,4437
2,2,1,0,3,0,3,4437
3,3,0,0,3,0,3,4437
0,0,1,0,1,0,1,4438
1,1,1,0,2,0,2,4438
2,2,1,1,3,1,4,4438
3,3,1,0,4,1,5,4438
4,4,0,1,4,2,6,4438
5,5,0,3,4,5,9,4438
6,6,0,2,4,7,11,4438
7,7,0,5,4,12,16,4438
8,8,2,3,6,15,21,4438
9,9,4,3,10,18,28,4438
10,10,0,0,10,18,28,4438
0,0,1,0,1,0,1,4439
1,1,1,0,2,0,2,4439
2,2,1,0,3,0,3,4439
3,3,2,0,5,0,5,4439
4,4,0,0,5,0,5,4439
0,0,1,0,1,0,1,4440
1,1,1,0,2,0,2,4440
2,2,3,0,5,0,5,4440
3,3,1,0,6,0,6,4440
4,4,2,0,8,0,8,4440
5,5,1,0,9,0,9,4440
6,6,1,0,10,0,10,4440
7,7,1,0,11,0,11,4440
8,8,0,0,11,0,11,4440
0,0,1,0,1,0,1,4441
1,1,0,0,1,0,1,4441
0,0,1,0,1,0,1,4442
1,1,2,0,3,0,3,4442
2,2,3,0,6,0,6,4442
3,3,4,0,10,0,10,4442
4,4,5,1,15,1,16,4442
5,5,3,1,18,2,20,4442
6,6,2,2,20,4,24,4442
7,7,1,0,21,4,25,4442
8,8,1,0,22,4,26,4442
9,9,1,0,23,4,27,4442
10,10,0,0,23,4,27,4442
0,0,1,0,1,0,1,4443
1,1,2,0,3,0,3,4443
2,2,3,0,6,0,6,4443
3,3,2,1,8,1,9,4443
4,4,0,2,8,3,11,4443
5,5,2,0,10,3,13,4443
6,6,0,1,10,4,14,4443
7,7,0,0,10,4,14,4443
0,0,1,0,1,0,1,4444
1,1,0,0,1,0,1,4444
0,0,1,0,1,0,1,4445
1,1,2,0,3,0,3,4445
2,2,2,0,5,0,5,4445
3,3,1,0,6,0,6,4445
4,4,0,0,6,0,6,4445
0,0,1,0,1,0,1,4446
1,1,0,0,1,0,1,4446
0,0,1,0,1,0,1,4447
1,1,0,1,1,1,2,4447
2,2,1,0,2,1,3,4447
3,3,0,0,2,1,3,4447
0,0,1,0,1,0,1,4448
1,1,0,0,1,0,1,4448
0,0,1,0,1,0,1,4449
1,1,1,0,2,0,2,4449
2,2,0,1,2,1,3,4449
3,3,0,0,2,1,3,4449
0,0,1,0,1,0,1,4450
1,1,3,0,4,0,4,4450
2,2,1,1,5,1,6,4450
3,3,2,1,7,2,9,4450
4,4,0,1,7,3,10,4450
5,5,1,0,8,3,11,4450
6,6,1,0,9,3,12,4450
7,7,0,0,9,3,12,4450
0,0,1,0,1,0,1,4451
1,1,1,1,2,1,3,4451
2,2,3,1,5,2,7,4451
3,3,4,0,9,2,11,4451
4,4,1,0,10,2,12,4451
5,5,1,0,11,2,13,4451
6,6,1,0,12,2,14,4451
7,7,0,0,12,2,14,4451
0,0,1,0,1,0,1,4452
1,1,1,0,2,0,2,4452
2,2,0,0,2,0,2,4452
0,0,1,0,1,0,1,4453
1,1,1,0,2,0,2,4453
2,2,3,0,5,0,5,4453
3,3,1,0,6,0,6,4453
4,4,1,0,7,0,7,4453
5,5,2,0,9,0,9,4453
6,6,1,1,10,1,11,4453
7,7,0,2,10,3,13,4453
8,8,1,2,11,5,16,4453
9,9,2,3,13,8,21,4453
10,10,2,0,15,8,23,4453
11,11,2,1,17,9,26,4453
12,12,0,2,17,11,28,4453
13,13,0,0,17,11,28,4453
0,0,1,0,1,0,1,4454
1,1,1,2,2,2,4,4454
2,2,0,0,2,2,4,4454
0,0,1,0,1,0,1,4455
1,1,0,0,1,0,1,4455
0,0,1,0,1,0,1,4456
1,1,0,0,1,0,1,4456
0,0,1,0,1,0,1,4457
1,1,0,0,1,0,1,4457
0,0,1,0,1,0,1,4458
1,1,1,0,2,0,2,4458
2,2,0,0,2,0,2,4458
0,0,1,0,1,0,1,4459
1,1,1,0,2,0,2,4459
2,2,0,0,2,0,2,4459
0,0,1,0,1,0,1,4460
1,1,2,0,3,0,3,4460
2,2,4,1,7,1,8,4460
3,3,0,1,7,2,9,4460
4,4,1,1,8,3,11,4460
5,5,1,0,9,3,12,4460
6,6,1,0,10,3,13,4460
7,7,2,0,12,3,15,4460
8,8,0,0,12,3,15,4460
0,0,1,0,1,0,1,4461
1,1,0,0,1,0,1,4461
0,0,1,0,1,0,1,4462
1,1,0,1,1,1,2,4462
2,2,0,0,1,1,2,4462
0,0,1,0,1,0,1,4463
1,1,2,0,3,0,3,4463
2,2,3,0,6,0,6,4463
3,3,1,0,7,0,7,4463
4,4,0,0,7,0,7,4463
0,0,1,0,1,0,1,4464
1,1,1,0,2,0,2,4464
2,2,0,0,2,0,2,4464
0,0,1,0,1,0,1,4465
1,1,0,0,1,0,1,4465
0,0,1,0,1,0,1,4466
1,1,2,0,3,0,3,4466
2,2,0,0,3,0,3,4466
0,0,1,0,1,0,1,4467
1,1,0,0,1,0,1,4467
0,0,1,0,1,0,1,4468
1,1,0,0,1,0,1,4468
0,0,1,0,1,0,1,4469
1,1,1,0,2,0,2,4469
2,2,1,0,3,0,3,4469
3,3,4,0,7,0,7,4469
4,4,2,2,9,2,11,4469
5,5,1,4,10,6,16,4469
6,6,3,3,13,9,22,4469
7,7,3,6,16,15,31,4469
8,8,5,7,21,22,43,4469
9,9,3,4,24,26,50,4469
10,10,3,5,27,31,58,4469
11,11,4,1,31,32,63,4469
12,12,3,2,34,34,68,4469
13,13,5,3,39,37,76,4469
14,14,4,2,43,39,82,4469
15,15,4,3,47,42,89,4469
16,16,5,4,52,46,98,4469
17,17,4,2,56,48,104,4469
18,18,4,4,60,52,112,4469
19,19,3,2,63,54,117,4469
20,20,1,2,64,56,120,4469
21,21,2,2,66,58,124,4469
22,22,2,3,68,61,129,4469
23,23,2,4,70,65,135,4469
24,24,0,3,70,68,138,4469
25,25,1,2,71,70,141,4469
26,26,4,1,75,71,146,4469
27,27,5,0,80,71,151,4469
28,28,2,2,82,73,155,4469
29,29,0,2,82,75,157,4469
30,30,1,1,83,76,159,4469
31,31,0,0,83,76,159,4469
0,0,1,0,1,0,1,4470
1,1,1,0,2,0,2,4470
2,2,1,0,3,0,3,4470
3,3,0,0,3,0,3,4470
0,0,1,0,1,0,1,4471
1,1,0,1,1,1,2,4471
2,2,0,0,1,1,2,4471
0,0,1,0,1,0,1,4472
1,1,1,1,2,1,3,4472
2,2,1,0,3,1,4,4472
3,3,1,0,4,1,5,4472
4,4,1,0,5,1,6,4472
5,5,0,1,5,2,7,4472
6,6,0,0,5,2,7,4472
0,0,1,0,1,0,1,4473
1,1,0,0,1,0,1,4473
0,0,1,0,1,0,1,4474
1,1,1,0,2,0,2,4474
2,2,2,0,4,0,4,4474
3,3,2,2,6,2,8,4474
4,4,2,4,8,6,14,4474
5,5,3,5,11,11,22,4474
6,6,5,2,16,13,29,4474
7,7,6,3,22,16,38,4474
8,8,7,3,29,19,48,4474
9,9,5,3,34,22,56,4474
10,10,4,6,38,28,66,4474
11,11,4,3,42,31,73,4474
12,12,5,1,47,32,79,4474
13,13,5,1,52,33,85,4474
14,14,2,4,54,37,91,4474
15,15,2,2,56,39,95,4474
16,16,1,1,57,40,97,4474
17,17,3,2,60,42,102,4474
18,18,2,3,62,45,107,4474
19,19,1,2,63,47,110,4474
20,20,1,2,64,49,113,4474
21,21,1,2,65,51,116,4474
22,22,2,2,67,53,120,4474
23,23,1,3,68,56,124,4474
24,24,0,4,68,60,128,4474
25,25,3,0,71,60,131,4474
26,26,2,1,73,61,134,4474
27,27,1,0,74,61,135,4474
28,28,1,0,75,61,136,4474
29,29,1,0,76,61,137,4474
30,30,1,0,77,61,138,4474
31,31,0,0,77,61,138,4474
0,0,1,0,1,0,1,4475
1,1,1,0,2,0,2,4475
2,2,0,1,2,1,3,4475
3,3,0,0,2,1,3,4475
0,0,1,0,1,0,1,4476
1,1,0,0,1,0,1,4476
0,0,1,0,1,0,1,4477
1,1,1,0,2,0,2,4477
2,2,1,0,3,0,3,4477
3,3,0,0,3,0,3,4477
0,0,1,0,1,0,1,4478
1,1,0,0,1,0,1,4478
0,0,1,0,1,0,1,4479
1,1,1,1,2,1,3,4479
2,2,0,0,2,1,3,4479
0,0,1,0,1,0,1,4480
1,1,1,1,2,1,3,4480
2,2,0,1,2,2,4,4480
3,3,0,0,2,2,4,4480
0,0,1,0,1,0,1,4481
1,1,0,0,1,0,1,4481
0,0,1,0,1,0,1,4482
1,1,0,0,1,0,1,4482
0,0,1,0,1,0,1,4483
1,1,0,0,1,0,1,4483
0,0,1,0,1,0,1,4484
1,1,1,0,2,0,2,4484
2,2,0,0,2,0,2,4484
0,0,1,0,1,0,1,4485
1,1,2,0,3,0,3,4485
2,2,3,0,6,0,6,4485
3,3,2,1,8,1,9,4485
4,4,3,1,11,2,13,4485
5,5,3,1,14,3,17,4485
6,6,2,0,16,3,19,4485
7,7,0,0,16,3,19,4485
0,0,1,0,1,0,1,4486
1,1,0,0,1,0,1,4486
0,0,1,0,1,0,1,4487
1,1,0,0,1,0,1,4487
0,0,1,0,1,0,1,4488
1,1,0,0,1,0,1,4488
0,0,1,0,1,0,1,4489
1,1,0,0,1,0,1,4489
0,0,1,0,1,0,1,4490
1,1,0,0,1,0,1,4490
0,0,1,0,1,0,1,4491
1,1,0,1,1,1,2,4491
2,2,0,1,1,2,3,4491
3,3,0,0,1,2,3,4491
0,0,1,0,1,0,1,4492
1,1,1,1,2,1,3,4492
2,2,2,0,4,1,5,4492
3,3,2,0,6,1,7,4492
4,4,1,0,7,1,8,4492
5,5,1,1,8,2,10,4492
6,6,0,1,8,3,11,4492
7,7,0,0,8,3,11,4492
0,0,1,0,1,0,1,4493
1,1,0,0,1,0,1,4493
0,0,1,0,1,0,1,4494
1,1,0,0,1,0,1,4494
0,0,1,0,1,0,1,4495
1,1,1,0,2,0,2,4495
2,2,2,0,4,0,4,4495
3,3,3,0,7,0,7,4495
4,4,2,0,9,0,9,4495
5,5,1,1,10,1,11,4495
6,6,2,2,12,3,15,4495
7,7,2,3,14,6,20,4495
8,8,0,3,14,9,23,4495
9,9,1,7,15,16,31,4495
10,10,2,7,17,23,40,4495
11,11,2,4,19,27,46,4495
12,12,4,1,23,28,51,4495
13,13,4,1,27,29,56,4495
14,14,6,0,33,29,62,4495
15,15,5,1,38,30,68,4495
16,16,5,2,43,32,75,4495
17,17,5,3,48,35,83,4495
18,18,4,5,52,40,92,4495
19,19,2,5,54,45,99,4495
20,20,1,4,55,49,104,4495
21,21,1,2,56,51,107,4495
22,22,2,0,58,51,109,4495
23,23,0,0,58,51,109,4495
0,0,1,0,1,0,1,4496
1,1,0,2,1,2,3,4496
2,2,1,1,2,3,5,4496
3,3,1,1,3,4,7,4496
4,4,1,0,4,4,8,4496
5,5,1,0,5,4,9,4496
6,6,0,0,5,4,9,4496
0,0,1,0,1,0,1,4497
1,1,1,0,2,0,2,4497
2,2,0,0,2,0,2,4497
0,0,1,0,1,0,1,4498
1,1,0,0,1,0,1,4498
0,0,1,0,1,0,1,4499
1,1,1,0,2,0,2,4499
2,2,0,0,2,0,2,4499
0,0,1,0,1,0,1,4500
1,1,0,0,1,0,1,4500
0,0,1,0,1,0,1,4501
1,1,0,0,1,0,1,4501
0,0,1,0,1,0,1,4502
1,1,0,0,1,0,1,4502
0,0,1,0,1,0,1,4503
1,1,1,0,2,0,2,4503
2,2,0,0,2,0,2,4503
0,0,1,0,1,0,1,4504
1,1,0,0,1,0,1,4504
0,0,1,0,1,0,1,4505
1,1,1,0,2,0,2,4505
2,2,0,0,2,0,2,4505
0,0,1,0,1,0,1,4506
1,1,1,0,2,0,2,4506
2,2,0,2,2,2,4,4506
3,3,0,0,2,2,4,4506
0,0,1,0,1,0,1,4507
1,1,2,2,3,2,5,4507
2,2,4,1,7,3,10,4507
3,3,2,1,9,4,13,4507
4,4,2,2,11,6,17,4507
5,5,1,2,12,8,20,4507
6,6,2,1,14,9,23,4507
7,7,1,2,15,11,26,4507
8,8,2,4,17,15,32,4507
9,9,3,2,20,17,37,4507
10,10,2,2,22,19,41,4507
11,11,2,0,24,19,43,4507
12,12,0,0,24,19,43,4507
0,0,1,0,1,0,1,4508
1,1,0,0,1,0,1,4508
0,0,1,0,1,0,1,4509
1,1,0,0,1,0,1,4509
0,0,1,0,1,0,1,4510
1,1,1,0,2,0,2,4510
2,2,1,0,3,0,3,4510
3,3,1,0,4,0,4,4510
4,4,1,0,5,0,5,4510
5,5,1,0,6,0,6,4510
6,6,0,0,6,0,6,4510
0,0,1,0,1,0,1,4511
1,1,1,0,2,0,2,4511
2,2,0,0,2,0,2,4511
0,0,1,0,1,0,1,4512
1,1,0,0,1,0,1,4512
0,0,1,0,1,0,1,4513
1,1,1,0,2,0,2,4513
2,2,1,0,3,0,3,4513
3,3,1,0,4,0,4,4513
4,4,2,0,6,0,6,4513
5,5,1,0,7,0,7,4513
6,6,1,0,8,0,8,4513
7,7,1,0,9,0,9,4513
8,8,0,0,9,0,9,4513
0,0,1,0,1,0,1,4514
1,1,0,0,1,0,1,4514
0,0,1,0,1,0,1,4515
1,1,1,0,2,0,2,4515
2,2,0,0,2,0,2,4515
0,0,1,0,1,0,1,4516
1,1,0,0,1,0,1,4516
0,0,1,0,1,0,1,4517
1,1,1,0,2,0,2,4517
2,2,1,0,3,0,3,4517
3,3,1,0,4,0,4,4517
4,4,2,1,6,1,7,4517
5,5,3,0,9,1,10,4517
6,6,2,1,11,2,13,4517
7,7,3,0,14,2,16,4517
8,8,3,0,17,2,19,4517
9,9,2,0,19,2,21,4517
10,10,0,0,19,2,21,4517
0,0,1,0,1,0,1,4518
1,1,0,1,1,1,2,4518
2,2,0,0,1,1,2,4518
0,0,1,0,1,0,1,4519
1,1,0,0,1,0,1,4519
0,0,1,0,1,0,1,4520
1,1,1,0,2,0,2,4520
2,2,3,0,5,0,5,4520
3,3,1,0,6,0,6,4520
4,4,1,0,7,0,7,4520
5,5,0,2,7,2,9,4520
6,6,0,0,7,2,9,4520
0,0,1,0,1,0,1,4521
1,1,0,0,1,0,1,4521
0,0,1,0,1,0,1,4522
1,1,2,0,3,0,3,4522
2,2,0,0,3,0,3,4522
0,0,1,0,1,0,1,4523
1,1,1,0,2,0,2,4523
2,2,1,0,3,0,3,4523
3,3,0,1,3,1,4,4523
4,4,0,1,3,2,5,4523
5,5,1,0,4,2,6,4523
6,6,1,0,5,2,7,4523
7,7,2,0,7,2,9,4523
8,8,2,0,9,2,11,4523
9,9,1,0,10,2,12,4523
10,10,2,1,12,3,15,4523
11,11,0,1,12,4,16,4523
12,12,0,0,12,4,16,4523
0,0,1,0,1,0,1,4524
1,1,0,0,1,0,1,4524
0,0,1,0,1,0,1,4525
1,1,0,0,1,0,1,4525
0,0,1,0,1,0,1,4526
1,1,2,0,3,0,3,4526
2,2,1,0,4,0,4,4526
3,3,0,0,4,0,4,4526
0,0,1,0,1,0,1,4527
1,1,3,0,4,0,4,4527
2,2,1,2,5,2,7,4527
3,3,2,1,7,3,10,4527
4,4,3,1,10,4,14,4527
5,5,0,2,10,6,16,4527
6,6,0,3,10,9,19,4527
7,7,0,3,10,12,22,4527
8,8,0,1,10,13,23,4527
9,9,1,1,11,14,25,4527
10,10,1,0,12,14,26,4527
11,11,2,0,14,14,28,4527
12,12,3,0,17,14,31,4527
13,13,0,1,17,15,32,4527
14,14,1,1,18,16,34,4527
15,15,0,0,18,16,34,4527
0,0,1,0,1,0,1,4528
1,1,0,0,1,0,1,4528
0,0,1,0,1,0,1,4529
1,1,1,0,2,0,2,4529
2,2,0,0,2,0,2,4529
0,0,1,0,1,0,1,4530
1,1,1,0,2,0,2,4530
2,2,1,0,3,0,3,4530
3,3,1,0,4,0,4,4530
4,4,1,0,5,0,5,4530
5,5,0,0,5,0,5,4530
0,0,1,0,1,0,1,4531
1,1,0,0,1,0,1,4531
0,0,1,0,1,0,1,4532
1,1,1,0,2,0,2,4532
2,2,1,0,3,0,3,4532
3,3,1,0,4,0,4,4532
4,4,1,0,5,0,5,4532
5,5,2,0,7,0,7,4532
6,6,2,0,9,0,9,4532
7,7,3,0,12,0,12,4532
8,8,0,1,12,1,13,4532
9,9,0,1,12,2,14,4532
10,10,0,1,12,3,15,4532
11,11,0,1,12,4,16,4532
12,12,0,0,12,4,16,4532
0,0,1,0,1,0,1,4533
1,1,0,0,1,0,1,4533
0,0,1,0,1,0,1,4534
1,1,0,0,1,0,1,4534
0,0,1,0,1,0,1,4535
1,1,0,0,1,0,1,4535
0,0,1,0,1,0,1,4536
1,1,0,0,1,0,1,4536
0,0,1,0,1,0,1,4537
1,1,1,0,2,0,2,4537
2,2,0,0,2,0,2,4537
0,0,1,0,1,0,1,4538
1,1,0,0,1,0,1,4538
0,0,1,0,1,0,1,4539
1,1,1,0,2,0,2,4539
2,2,0,0,2,0,2,4539
0,0,1,0,1,0,1,4540
1,1,1,0,2,0,2,4540
2,2,0,0,2,0,2,4540
0,0,1,0,1,0,1,4541
1,1,1,0,2,0,2,4541
2,2,1,0,3,0,3,4541
3,3,0,0,3,0,3,4541
0,0,1,0,1,0,1,4542
1,1,1,1,2,1,3,4542
2,2,2,0,4,1,5,4542
3,3,1,0,5,1,6,4542
4,4,0,0,5,1,6,4542
0,0,1,0,1,0,1,4543
1,1,2,1,3,1,4,4543
2,2,0,0,3,1,4,4543
0,0,1,0,1,0,1,4544
1,1,0,0,1,0,1,4544
0,0,1,0,1,0,1,4545
1,1,1,0,2,0,2,4545
2,2,3,0,5,0,5,4545
3,3,1,1,6,1,7,4545
4,4,0,1,6,2,8,4545
5,5,0,0,6,2,8,4545
0,0,1,0,1,0,1,4546
1,1,0,0,1,0,1,4546
0,0,1,0,1,0,1,4547
1,1,2,0,3,0,3,4547
2,2,1,1,4,1,5,4547
3,3,5,0,9,1,10,4547
4,4,2,0,11,1,12,4547
5,5,4,0,15,1,16,4547
6,6,2,2,17,3,20,4547
7,7,3,1,20,4,24,4547
8,8,1,0,21,4,25,4547
9,9,0,0,21,4,25,4547
0,0,1,0,1,0,1,4548
1,1,0,1,1,1,2,4548
2,2,0,0,1,1,2,4548
0,0,1,0,1,0,1,4549
1,1,0,0,1,0,1,4549
0,0,1,0,1,0,1,4550
1,1,1,0,2,0,2,4550
2,2,1,0,3,0,3,4550
3,3,2,0,5,0,5,4550
4,4,1,1,6,1,7,4550
5,5,0,0,6,1,7,4550
0,0,1,0,1,0,1,4551
1,1,0,0,1,0,1,4551
0,0,1,0,1,0,1,4552
1,1,1,0,2,0,2,4552
2,2,1,0,3,0,3,4552
3,3,0,0,3,0,3,4552
0,0,1,0,1,0,1,4553
1,1,1,0,2,0,2,4553
2,2,0,0,2,0,2,4553
0,0,1,0,1,0,1,4554
1,1,0,1,1,1,2,4554
2,2,0,2,1,3,4,4554
3,3,0,1,1,4,5,4554
4,4,1,0,2,4,6,4554
5,5,3,0,5,4,9,4554
6,6,2,0,7,4,11,4554
7,7,3,0,10,4,14,4554
8,8,4,1,14,5,19,4554
9,9,8,1,22,6,28,4554
10,10,8,2,30,8,38,4554
11,11,7,4,37,12,49,4554
12,12,5,4,42,16,58,4554
13,13,9,4,51,20,71,4554
14,14,7,6,58,26,84,4554
15,15,6,3,64,29,93,4554
16,16,11,4,75,33,108,4554
17,17,8,4,83,37,120,4554
18,18,9,9,92,46,138,4554
19,19,9,8,101,54,155,4554
20,20,7,7,108,61,169,4554
21,21,9,4,117,65,182,4554
22,22,5,5,122,70,192,4554
23,23,8,3,130,73,203,4554
24,24,7,9,137,82,219,4554
25,25,8,5,145,87,232,4554
26,26,3,9,148,96,244,4554
27,27,4,6,152,102,254,4554
28,28,4,8,156,110,266,4554
29,29,4,8,160,118,278,4554
30,30,7,8,167,126,293,4554
31,31,3,6,170,132,302,4554
32,32,1,8,171,140,311,4554
33,33,2,9,173,149,322,4554
34,34,4,5,177,154,331,4554
35,35,2,2,179,156,335,4554
36,36,1,1,180,157,337,4554
37,37,0,0,180,157,337,4554
0,0,1,0,1,0,1,4555
1,1,0,0,1,0,1,4555
0,0,1,0,1,0,1,4556
1,1,2,0,3,0,3,4556
2,2,2,0,5,0,5,4556
3,3,1,0,6,0,6,4556
4,4,0,0,6,0,6,4556
0,0,1,0,1,0,1,4557
1,1,0,0,1,0,1,4557
0,0,1,0,1,0,1,4558
1,1,3,0,4,0,4,4558
2,2,2,1,6,1,7,4558
3,3,0,0,6,1,7,4558
0,0,1,0,1,0,1,4559
1,1,1,0,2,0,2,4559
2,2,0,0,2,0,2,4559
0,0,1,0,1,0,1,4560
1,1,0,0,1,0,1,4560
0,0,1,0,1,0,1,4561
1,1,1,0,2,0,2,4561
2,2,0,0,2,0,2,4561
0,0,1,0,1,0,1,4562
1,1,1,0,2,0,2,4562
2,2,1,2,3,2,5,4562
3,3,1,4,4,6,10,4562
4,4,1,3,5,9,14,4562
5,5,0,2,5,11,16,4562
6,6,1,0,6,11,17,4562
7,7,1,1,7,12,19,4562
8,8,1,1,8,13,21,4562
9,9,0,1,8,14,22,4562
10,10,0,0,8,14,22,4562
0,0,1,0,1,0,1,4563
1,1,1,0,2,0,2,4563
2,2,0,1,2,1,3,4563
3,3,0,1,2,2,4,4563
4,4,1,0,3,2,5,4563
5,5,0,0,3,2,5,4563
0,0,1,0,1,0,1,4564
1,1,0,0,1,0,1,4564
0,0,1,0,1,0,1,4565
1,1,1,0,2,0,2,4565
2,2,1,0,3,0,3,4565
3,3,0,0,3,0,3,4565
0,0,1,0,1,0,1,4566
1,1,1,1,2,1,3,4566
2,2,0,1,2,2,4,4566
3,3,0,0,2,2,4,4566
0,0,1,0,1,0,1,4567
1,1,1,0,2,0,2,4567
2,2,0,0,2,0,2,4567
0,0,1,0,1,0,1,4568
1,1,1,0,2,0,2,4568
2,2,1,0,3,0,3,4568
3,3,0,0,3,0,3,4568
0,0,1,0,1,0,1,4569
1,1,0,0,1,0,1,4569
0,0,1,0,1,0,1,4570
1,1,2,0,3,0,3,4570
2,2,0,0,3,0,3,4570
0,0,1,0,1,0,1,4571
1,1,1,0,2,0,2,4571
2,2,1,0,3,0,3,4571
3,3,0,0,3,0,3,4571
0,0,1,0,1,0,1,4572
1,1,1,0,2,0,2,4572
2,2,3,0,5,0,5,4572
3,3,3,0,8,0,8,4572
4,4,4,0,12,0,12,4572
5,5,3,4,15,4,19,4572
6,6,2,3,17,7,24,4572
7,7,1,2,18,9,27,4572
8,8,1,2,19,11,30,4572
9,9,2,0,21,11,32,4572
10,10,2,0,23,11,34,4572
11,11,0,0,23,11,34,4572
0,0,1,0,1,0,1,4573
1,1,0,0,1,0,1,4573
0,0,1,0,1,0,1,4574
1,1,2,0,3,0,3,4574
2,2,2,0,5,0,5,4574
3,3,2,0,7,0,7,4574
4,4,1,0,8,0,8,4574
5,5,1,0,9,0,9,4574
6,6,0,0,9,0,9,4574
0,0,1,0,1,0,1,4575
1,1,0,0,1,0,1,4575
0,0,1,0,1,0,1,4576
1,1,2,0,3,0,3,4576
2,2,1,1,4,1,5,4576
3,3,1,0,5,1,6,4576
4,4,0,0,5,1,6,4576
0,0,1,0,1,0,1,4577
1,1,0,0,1,0,1,4577
0,0,1,0,1,0,1,4578
1,1,1,0,2,0,2,4578
2,2,2,0,4,0,4,4578
3,3,1,1,5,1,6,4578
4,4,1,2,6,3,9,4578
5,5,1,0,7,3,10,4578
6,6,0,0,7,3,10,4578
0,0,1,0,1,0,1,4579
1,1,1,0,2,0,2,4579
2,2,1,0,3,0,3,4579
3,3,1,0,4,0,4,4579
4,4,0,0,4,0,4,4579
0,0,1,0,1,0,1,4580
1,1,1,1,2,1,3,4580
2,2,1,1,3,2,5,4580
3,3,1,0,4,2,6,4580
4,4,0,0,4,2,6,4580
0,0,1,0,1,0,1,4581
1,1,1,1,2,1,3,4581
2,2,0,1,2,2,4,4581
3,3,0,0,2,2,4,4581
0,0,1,0,1,0,1,4582
1,1,1,0,2,0,2,4582
2,2,0,0,2,0,2,4582
0,0,1,0,1,0,1,4583
1,1,0,0,1,0,1,4583
0,0,1,0,1,0,1,4584
1,1,1,1,2,1,3,4584
2,2,1,1,3,2,5,4584
3,3,0,1,3,3,6,4584
4,4,0,1,3,4,7,4584
5,5,0,1,3,5,8,4584
6,6,0,1,3,6,9,4584
7,7,0,1,3,7,10,4584
8,8,0,0,3,7,10,4584
0,0,1,0,1,0,1,4585
1,1,0,0,1,0,1,4585
0,0,1,0,1,0,1,4586
1,1,5,0,6,0,6,4586
2,2,5,0,11,0,11,4586
3,3,5,1,16,1,17,4586
4,4,2,1,18,2,20,4586
5,5,2,1,20,3,23,4586
6,6,3,2,23,5,28,4586
7,7,1,2,24,7,31,4586
8,8,2,3,26,10,36,4586
9,9,0,5,26,15,41,4586
10,10,0,7,26,22,48,4586
11,11,2,4,28,26,54,4586
12,12,2,2,30,28,58,4586
13,13,2,3,32,31,63,4586
14,14,1,2,33,33,66,4586
15,15,1,2,34,35,69,4586
16,16,1,2,35,37,72,4586
17,17,0,1,35,38,73,4586
18,18,0,0,35,38,73,4586
0,0,1,0,1,0,1,4587
1,1,0,0,1,0,1,4587
0,0,1,0,1,0,1,4588
1,1,1,0,2,0,2,4588
2,2,0,0,2,0,2,4588
0,0,1,0,1,0,1,4589
1,1,0,0,1,0,1,4589
0,0,1,0,1,0,1,4590
1,1,0,0,1,0,1,4590
0,0,1,0,1,0,1,4591
1,1,1,0,2,0,2,4591
2,2,1,0,3,0,3,4591
3,3,1,0,4,0,4,4591
4,4,2,0,6,0,6,4591
5,5,3,0,9,0,9,4591
6,6,0,0,9,0,9,4591
0,0,1,0,1,0,1,4592
1,1,0,1,1,1,2,4592
2,2,0,0,1,1,2,4592
0,0,1,0,1,0,1,4593
1,1,0,1,1,1,2,4593
2,2,0,1,1,2,3,4593
3,3,1,1,2,3,5,4593
4,4,1,2,3,5,8,4593
5,5,4,0,7,5,12,4593
6,6,4,0,11,5,16,4593
7,7,6,1,17,6,23,4593
8,8,2,0,19,6,25,4593
9,9,2,1,21,7,28,4593
10,10,3,3,24,10,34,4593
11,11,2,4,26,14,40,4593
12,12,2,5,28,19,47,4593
13,13,3,8,31,27,58,4593
14,14,1,7,32,34,66,4593
15,15,4,5,36,39,75,4593
16,16,3,3,39,42,81,4593
17,17,3,1,42,43,85,4593
18,18,3,0,45,43,88,4593
19,19,0,1,45,44,89,4593
20,20,0,2,45,46,91,4593
21,21,1,3,46,49,95,4593
22,22,0,3,46,52,98,4593
23,23,0,2,46,54,100,4593
24,24,1,0,47,54,101,4593
25,25,1,0,48,54,102,4593
26,26,1,0,49,54,103,4593
27,27,2,0,51,54,105,4593
28,28,1,1,52,55,107,4593
29,29,0,0,52,55,107,4593
0,0,1,0,1,0,1,4594
1,1,0,0,1,0,1,4594
0,0,1,0,1,0,1,4595
1,1,0,0,1,0,1,4595
0,0,1,0,1,0,1,4596
1,1,0,0,1,0,1,4596
0,0,1,0,1,0,1,4597
1,1,0,1,1,1,2,4597
2,2,0,0,1,1,2,4597
0,0,1,0,1,0,1,4598
1,1,0,1,1,1,2,4598
2,2,0,1,1,2,3,4598
3,3,0,1,1,3,4,4598
4,4,0,3,1,6,7,4598
5,5,1,2,2,8,10,4598
6,6,1,1,3,9,12,4598
7,7,1,1,4,10,14,4598
8,8,0,0,4,10,14,4598
0,0,1,0,1,0,1,4599
1,1,0,0,1,0,1,4599
0,0,1,0,1,0,1,4600
1,1,1,0,2,0,2,4600
2,2,2,0,4,0,4,4600
3,3,1,0,5,0,5,4600
4,4,0,0,5,0,5,4600
0,0,1,0,1,0,1,4601
1,1,1,0,2,0,2,4601
2,2,1,0,3,0,3,4601
3,3,1,1,4,1,5,4601
4,4,1,1,5,2,7,4601
5,5,0,1,5,3,8,4601
6,6,0,0,5,3,8,4601
0,0,1,0,1,0,1,4602
1,1,0,1,1,1,2,4602
2,2,1,1,2,2,4,4602
3,3,2,1,4,3,7,4602
4,4,2,0,6,3,9,4602
5,5,3,0,9,3,12,4602
6,6,1,1,10,4,14,4602
7,7,0,3,10,7,17,4602
8,8,1,2,11,9,20,4602
9,9,0,2,11,11,22,4602
10,10,1,0,12,11,23,4602
11,11,1,1,13,12,25,4602
12,12,2,1,15,13,28,4602
13,13,1,1,16,14,30,4602
14,14,0,3,16,17,33,4602
15,15,0,2,16,19,35,4602
16,16,1,1,17,20,37,4602
17,17,2,1,19,21,40,4602
18,18,1,1,20,22,42,4602
19,19,2,1,22,23,45,4602
20,20,0,2,22,25,47,4602
21,21,1,4,23,29,52,4602
22,22,0,1,23,30,53,4602
23,23,0,3,23,33,56,4602
24,24,1,0,24,33,57,4602
25,25,1,0,25,33,58,4602
26,26,0,0,25,33,58,4602
0,0,1,0,1,0,1,4603
1,1,0,0,1,0,1,4603
0,0,1,0,1,0,1,4604
1,1,2,0,3,0,3,4604
2,2,1,1,4,1,5,4604
3,3,0,2,4,3,7,4604
4,4,0,3,4,6,10,4604
5,5,0,0,4,6,10,4604
0,0,1,0,1,0,1,4605
1,1,0,0,1,0,1,4605
0,0,1,0,1,0,1,4606
1,1,1,0,2,0,2,4606
2,2,0,0,2,0,2,4606
0,0,1,0,1,0,1,4607
1,1,1,0,2,0,2,4607
2,2,0,0,2,0,2,4607
0,0,1,0,1,0,1,4608
1,1,1,0,2,0,2,4608
2,2,0,0,2,0,2,4608
0,0,1,0,1,0,1,4609
1,1,2,0,3,0,3,4609
2,2,1,1,4,1,5,4609
3,3,0,3,4,4,8,4609
4,4,1,2,5,6,11,4609
5,5,1,1,6,7,13,4609
6,6,1,2,7,9,16,4609
7,7,0,2,7,11,18,4609
8,8,0,3,7,14,21,4609
9,9,0,2,7,16,23,4609
10,10,0,1,7,17,24,4609
11,11,0,0,7,17,24,4609
0,0,1,0,1,0,1,4610
1,1,0,0,1,0,1,4610
0,0,1,0,1,0,1,4611
1,1,1,0,2,0,2,4611
2,2,1,0,3,0,3,4611
3,3,1,0,4,0,4,4611
4,4,2,0,6,0,6,4611
5,5,1,0,7,0,7,4611
6,6,1,1,8,1,9,4611
7,7,2,3,10,4,14,4611
8,8,0,2,10,6,16,4611
9,9,0,3,10,9,19,4611
10,10,0,3,10,12,22,4611
11,11,0,2,10,14,24,4611
12,12,0,1,10,15,25,4611
13,13,0,1,10,16,26,4611
14,14,0,0,10,16,26,4611
0,0,1,0,1,0,1,4612
1,1,0,0,1,0,1,4612
0,0,1,0,1,0,1,4613
1,1,0,0,1,0,1,4613
0,0,1,0,1,0,1,4614
1,1,0,0,1,0,1,4614
0,0,1,0,1,0,1,4615
1,1,2,0,3,0,3,4615
2,2,1,0,4,0,4,4615
3,3,2,0,6,0,6,4615
4,4,1,0,7,0,7,4615
5,5,0,1,7,1,8,4615
6,6,1,1,8,2,10,4615
7,7,0,1,8,3,11,4615
8,8,0,0,8,3,11,4615
0,0,1,0,1,0,1,4616
1,1,1,1,2,1,3,4616
2,2,1,2,3,3,6,4616
3,3,0,3,3,6,9,4616
4,4,0,2,3,8,11,4616
5,5,0,1,3,9,12,4616
6,6,0,2,3,11,14,4616
7,7,0,2,3,13,16,4616
8,8,1,2,4,15,19,4616
9,9,0,5,4,20,24,4616
10,10,0,6,4,26,30,4616
11,11,2,3,6,29,35,4616
12,12,2,3,8,32,40,4616
13,13,1,3,9,35,44,4616
14,14,1,3,10,38,48,4616
15,15,0,7,10,45,55,4616
16,16,3,3,13,48,61,4616
17,17,2,5,15,53,68,4616
18,18,6,5,21,58,79,4616
19,19,3,4,24,62,86,4616
20,20,1,3,25,65,90,4616
21,21,0,3,25,68,93,4616
22,22,0,1,25,69,94,4616
23,23,0,1,25,70,95,4616
24,24,0,1,25,71,96,4616
25,25,0,0,25,71,96,4616
0,0,1,0,1,0,1,4617
1,1,0,0,1,0,1,4617
0,0,1,0,1,0,1,4618
1,1,0,0,1,0,1,4618
0,0,1,0,1,0,1,4619
1,1,1,0,2,0,2,4619
2,2,1,1,3,1,4,4619
3,3,1,0,4,1,5,4619
4,4,0,0,4,1,5,4619
0,0,1,0,1,0,1,4620
1,1,0,0,1,0,1,4620
0,0,1,0,1,0,1,4621
1,1,2,0,3,0,3,4621
2,2,0,0,3,0,3,4621
0,0,1,0,1,0,1,4622
1,1,1,1,2,1,3,4622
2,2,0,2,2,3,5,4622
3,3,1,3,3,6,9,4622
4,4,1,3,4,9,13,4622
5,5,2,1,6,10,16,4622
6,6,0,1,6,11,17,4622
7,7,0,0,6,11,17,4622
0,0,1,0,1,0,1,4623
1,1,1,0,2,0,2,4623
2,2,1,0,3,0,3,4623
3,3,2,2,5,2,7,4623
4,4,1,2,6,4,10,4623
5,5,1,0,7,4,11,4623
6,6,1,0,8,4,12,4623
7,7,2,1,10,5,15,4623
8,8,3,1,13,6,19,4623
9,9,0,0,13,6,19,4623
0,0,1,0,1,0,1,4624
1,1,1,0,2,0,2,4624
2,2,1,0,3,0,3,4624
3,3,0,0,3,0,3,4624
0,0,1,0,1,0,1,4625
1,1,0,0,1,0,1,4625
0,0,1,0,1,0,1,4626
1,1,0,0,1,0,1,4626
0,0,1,0,1,0,1,4627
1,1,0,0,1,0,1,4627
0,0,1,0,1,0,1,4628
1,1,0,0,1,0,1,4628
0,0,1,0,1,0,1,4629
1,1,1,0,2,0,2,4629
2,2,1,0,3,0,3,4629
3,3,1,0,4,0,4,4629
4,4,0,0,4,0,4,4629
0,0,1,0,1,0,1,4630
1,1,0,1,1,1,2,4630
2,2,0,0,1,1,2,4630
0,0,1,0,1,0,1,4631
1,1,2,0,3,0,3,4631
2,2,1,1,4,1,5,4631
3,3,1,1,5,2,7,4631
4,4,2,0,7,2,9,4631
5,5,1,0,8,2,10,4631
6,6,0,0,8,2,10,4631
0,0,1,0,1,0,1,4632
1,1,0,2,1,2,3,4632
2,2,0,0,1,2,3,4632
0,0,1,0,1,0,1,4633
1,1,2,1,3,1,4,4633
2,2,0,0,3,1,4,4633
0,0,1,0,1,0,1,4634
1,1,0,0,1,0,1,4634
0,0,1,0,1,0,1,4635
1,1,0,0,1,0,1,4635
0,0,1,0,1,0,1,4636
1,1,0,0,1,0,1,4636
0,0,1,0,1,0,1,4637
1,1,2,1,3,1,4,4637
2,2,2,0,5,1,6,4637
3,3,0,1,5,2,7,4637
4,4,0,0,5,2,7,4637
0,0,1,0,1,0,1,4638
1,1,0,0,1,0,1,4638
0,0,1,0,1,0,1,4639
1,1,2,0,3,0,3,4639
2,2,2,0,5,0,5,4639
3,3,1,1,6,1,7,4639
4,4,0,1,6,2,8,4639
5,5,0,1,6,3,9,4639
6,6,0,1,6,4,10,4639
7,7,1,1,7,5,12,4639
8,8,2,5,9,10,19,4639
9,9,6,2,15,12,27,4639
10,10,8,3,23,15,38,4639
11,11,4,2,27,17,44,4639
12,12,3,0,30,17,47,4639
13,13,3,0,33,17,50,4639
14,14,3,1,36,18,54,4639
15,15,0,0,36,18,54,4639
0,0,1,0,1,0,1,4640
1,1,1,0,2,0,2,4640
2,2,1,0,3,0,3,4640
3,3,0,0,3,0,3,4640
0,0,1,0,1,0,1,4641
1,1,1,0,2,0,2,4641
2,2,1,1,3,1,4,4641
3,3,1,0,4,1,5,4641
4,4,0,0,4,1,5,4641
0,0,1,0,1,0,1,4642
1,1,0,1,1,1,2,4642
2,2,0,0,1,1,2,4642
0,0,1,0,1,0,1,4643
1,1,1,0,2,0,2,4643
2,2,3,0,5,0,5,4643
3,3,1,1,6,1,7,4643
4,4,3,3,9,4,13,4643
5,5,1,1,10,5,15,4643
6,6,1,1,11,6,17,4643
7,7,0,3,11,9,20,4643
8,8,0,6,11,15,26,4643
9,9,1,3,12,18,30,4643
10,10,1,3,13,21,34,4643
11,11,1,3,14,24,38,4643
12,12,2,2,16,26,42,4643
13,13,4,2,20,28,48,4643
14,14,3,1,23,29,52,4643
15,15,1,0,24,29,53,4643
16,16,0,0,24,29,53,4643
0,0,1,0,1,0,1,4644
1,1,0,0,1,0,1,4644
0,0,1,0,1,0,1,4645
1,1,0,0,1,0,1,4645
0,0,1,0,1,0,1,4646
1,1,2,0,3,0,3,4646
2,2,0,0,3,0,3,4646
0,0,1,0,1,0,1,4647
1,1,1,1,2,1,3,4647
2,2,1,0,3,1,4,4647
3,3,0,1,3,2,5,4647
4,4,0,0,3,2,5,4647
0,0,1,0,1,0,1,4648
1,1,2,0,3,0,3,4648
2,2,1,1,4,1,5,4648
3,3,1,0,5,1,6,4648
4,4,0,0,5,1,6,4648
0,0,1,0,1,0,1,4649
1,1,1,0,2,0,2,4649
2,2,0,0,2,0,2,4649
0,0,1,0,1,0,1,4650
1,1,0,0,1,0,1,4650
0,0,1,0,1,0,1,4651
1,1,0,0,1,0,1,4651
0,0,1,0,1,0,1,4652
1,1,2,0,3,0,3,4652
2,2,0,1,3,1,4,4652
3,3,0,0,3,1,4,4652
0,0,1,0,1,0,1,4653
1,1,1,0,2,0,2,4653
2,2,1,0,3,0,3,4653
3,3,1,0,4,0,4,4653
4,4,0,0,4,0,4,4653
0,0,1,0,1,0,1,4654
1,1,1,0,2,0,2,4654
2,2,0,0,2,0,2,4654
0,0,1,0,1,0,1,4655
1,1,1,1,2,1,3,4655
2,2,1,1,3,2,5,4655
3,3,0,0,3,2,5,4655
0,0,1,0,1,0,1,4656
1,1,1,0,2,0,2,4656
2,2,2,0,4,0,4,4656
3,3,3,0,7,0,7,4656
4,4,1,1,8,1,9,4656
5,5,1,0,9,1,10,4656
6,6,1,0,10,1,11,4656
7,7,1,0,11,1,12,4656
8,8,0,0,11,1,12,4656
0,0,1,0,1,0,1,4657
1,1,0,0,1,0,1,4657
0,0,1,0,1,0,1,4658
1,1,1,0,2,0,2,4658
2,2,2,0,4,0,4,4658
3,3,1,0,5,0,5,4658
4,4,1,0,6,0,6,4658
5,5,2,1,8,1,9,4658
6,6,1,2,9,3,12,4658
7,7,0,0,9,3,12,4658
0,0,1,0,1,0,1,4659
1,1,0,0,1,0,1,4659
0,0,1,0,1,0,1,4660
1,1,0,1,1,1,2,4660
2,2,0,0,1,1,2,4660
0,0,1,0,1,0,1,4661
1,1,1,0,2,0,2,4661
2,2,0,0,2,0,2,4661
0,0,1,0,1,0,1,4662
1,1,0,0,1,0,1,4662
0,0,1,0,1,0,1,4663
1,1,0,0,1,0,1,4663
0,0,1,0,1,0,1,4664
1,1,0,0,1,0,1,4664
0,0,1,0,1,0,1,4665
1,1,0,0,1,0,1,4665
0,0,1,0,1,0,1,4666
1,1,3,0,4,0,4,4666
2,2,4,0,8,0,8,4666
3,3,2,0,10,0,10,4666
4,4,4,0,14,0,14,4666
5,5,1,2,15,2,17,4666
6,6,0,2,15,4,19,4666
7,7,0,1,15,5,20,4666
8,8,0,0,15,5,20,4666
0,0,1,0,1,0,1,4667
1,1,0,1,1,1,2,4667
2,2,0,1,1,2,3,4667
3,3,0,1,1,3,4,4667
4,4,0,1,1,4,5,4667
5,5,0,1,1,5,6,4667
6,6,0,3,1,8,9,4667
7,7,0,2,1,10,11,4667
8,8,0,2,1,12,13,4667
9,9,0,5,1,17,18,4667
10,10,2,10,3,27,30,4667
11,11,4,7,7,34,41,4667
12,12,2,7,9,41,50,4667
13,13,2,7,11,48,59,4667
14,14,0,7,11,55,66,4667
15,15,0,6,11,61,72,4667
16,16,0,2,11,63,74,4667
17,17,1,1,12,64,76,4667
18,18,0,1,12,65,77,4667
19,19,0,2,12,67,79,4667
20,20,0,1,12,68,80,4667
21,21,0,1,12,69,81,4667
22,22,0,1,12,70,82,4667
23,23,0,0,12,70,82,4667
0,0,1,0,1,0,1,4668
1,1,1,0,2,0,2,4668
2,2,0,0,2,0,2,4668
0,0,1,0,1,0,1,4669
1,1,1,0,2,0,2,4669
2,2,0,0,2,0,2,4669
0,0,1,0,1,0,1,4670
1,1,1,0,2,0,2,4670
2,2,1,0,3,0,3,4670
3,3,1,0,4,0,4,4670
4,4,1,0,5,0,5,4670
5,5,1,0,6,0,6,4670
6,6,2,0,8,0,8,4670
7,7,3,1,11,1,12,4670
8,8,6,0,17,1,18,4670
9,9,6,0,23,1,24,4670
10,10,5,0,28,1,29,4670
11,11,1,2,29,3,32,4670
12,12,0,1,29,4,33,4670
13,13,0,2,29,6,35,4670
14,14,0,2,29,8,37,4670
15,15,0,1,29,9,38,4670
16,16,0,0,29,9,38,4670
0,0,1,0,1,0,1,4671
1,1,0,0,1,0,1,4671
0,0,1,0,1,0,1,4672
1,1,1,0,2,0,2,4672
2,2,0,0,2,0,2,4672
0,0,1,0,1,0,1,4673
1,1,2,0,3,0,3,4673
2,2,1,0,4,0,4,4673
3,3,2,0,6,0,6,4673
4,4,0,0,6,0,6,4673
0,0,1,0,1,0,1,4674
1,1,0,0,1,0,1,4674
0,0,1,0,1,0,1,4675
1,1,1,0,2,0,2,4675
2,2,1,0,3,0,3,4675
3,3,0,1,3,1,4,4675
4,4,0,2,3,3,6,4675
5,5,0,2,3,5,8,4675
6,6,2,0,5,5,10,4675
7,7,2,0,7,5,12,4675
8,8,1,0,8,5,13,4675
9,9,0,0,8,5,13,4675
0,0,1,0,1,0,1,4676
1,1,1,0,2,0,2,4676
2,2,0,0,2,0,2,4676
0,0,1,0,1,0,1,4677
1,1,1,0,2,0,2,4677
2,2,0,0,2,0,2,4677
0,0,1,0,1,0,1,4678
1,1,1,0,2,0,2,4678
2,2,1,0,3,0,3,4678
3,3,1,0,4,0,4,4678
4,4,0,1,4,1,5,4678
5,5,0,0,4,1,5,4678
0,0,1,0,1,0,1,4679
1,1,1,0,2,0,2,4679
2,2,2,0,4,0,4,4679
3,3,1,0,5,0,5,4679
4,4,1,0,6,0,6,4679
5,5,1,0,7,0,7,4679
6,6,2,0,9,0,9,4679
7,7,0,0,9,0,9,4679
0,0,1,0,1,0,1,4680
1,1,0,0,1,0,1,4680
0,0,1,0,1,0,1,4681
1,1,2,0,3,0,3,4681
2,2,2,0,5,0,5,4681
3,3,2,0,7,0,7,4681
4,4,1,0,8,0,8,4681
5,5,0,0,8,0,8,4681
0,0,1,0,1,0,1,4682
1,1,1,1,2,1,3,4682
2,2,3,0,5,1,6,4682
3,3,3,0,8,1,9,4682
4,4,1,1,9,2,11,4682
5,5,2,0,11,2,13,4682
6,6,2,1,13,3,16,4682
7,7,2,1,15,4,19,4682
8,8,3,1,18,5,23,4682
9,9,1,2,19,7,26,4682
10,10,0,3,19,10,29,4682
11,11,1,1,20,11,31,4682
12,12,1,0,21,11,32,4682
13,13,2,0,23,11,34,4682
14,14,3,1,26,12,38,4682
15,15,5,0,31,12,43,4682
16,16,6,1,37,13,50,4682
17,17,4,1,41,14,55,4682
18,18,5,2,46,16,62,4682
19,19,4,2,50,18,68,4682
20,20,4,1,54,19,73,4682
21,21,1,1,55,20,75,4682
22,22,0,0,55,20,75,4682
0,0,1,0,1,0,1,4683
1,1,1,0,2,0,2,4683
2,2,1,1,3,1,4,4683
3,3,2,2,5,3,8,4683
4,4,1,2,6,5,11,4683
5,5,3,1,9,6,15,4683
6,6,1,0,10,6,16,4683
7,7,2,0,12,6,18,4683
8,8,3,0,15,6,21,4683
9,9,3,0,18,6,24,4683
10,10,1,0,19,6,25,4683
11,11,1,1,20,7,27,4683
12,12,0,2,20,9,29,4683
13,13,0,0,20,9,29,4683
0,0,1,0,1,0,1,4684
1,1,0,1,1,1,2,4684
2,2,1,0,2,1,3,4684
3,3,1,0,3,1,4,4684
4,4,1,0,4,1,5,4684
5,5,0,0,4,1,5,4684
0,0,1,0,1,0,1,4685
1,1,0,1,1,1,2,4685
2,2,0,0,1,1,2,4685
0,0,1,0,1,0,1,4686
1,1,0,0,1,0,1,4686
0,0,1,0,1,0,1,4687
1,1,0,0,1,0,1,4687
0,0,1,0,1,0,1,4688
1,1,5,0,6,0,6,4688
2,2,1,3,7,3,10,4688
3,3,1,1,8,4,12,4688
4,4,0,3,8,7,15,4688
5,5,1,4,9,11,20,4688
6,6,1,1,10,12,22,4688
7,7,0,1,10,13,23,4688
8,8,0,0,10,13,23,4688
0,0,1,0,1,0,1,4689
1,1,3,0,4,0,4,4689
2,2,2,0,6,0,6,4689
3,3,1,0,7,0,7,4689
4,4,1,1,8,1,9,4689
5,5,1,2,9,3,12,4689
6,6,2,2,11,5,16,4689
7,7,0,1,11,6,17,4689
8,8,0,1,11,7,18,4689
9,9,0,0,11,7,18,4689
0,0,1,0,1,0,1,4690
1,1,1,0,2,0,2,4690
2,2,0,1,2,1,3,4690
3,3,0,2,2,3,5,4690
4,4,0,1,2,4,6,4690
5,5,0,0,2,4,6,4690
0,0,1,0,1,0,1,4691
1,1,1,0,2,0,2,4691
2,2,1,0,3,0,3,4691
3,3,1,0,4,0,4,4691
4,4,0,0,4,0,4,4691
0,0,1,0,1,0,1,4692
1,1,1,0,2,0,2,4692
2,2,1,0,3,0,3,4692
3,3,0,0,3,0,3,4692
0,0,1,0,1,0,1,4693
1,1,1,0,2,0,2,4693
2,2,0,0,2,0,2,4693
0,0,1,0,1,0,1,4694
1,1,0,0,1,0,1,4694
0,0,1,0,1,0,1,4695
1,1,1,0,2,0,2,4695
2,2,0,0,2,0,2,4695
0,0,1,0,1,0,1,4696
1,1,1,0,2,0,2,4696
2,2,1,0,3,0,3,4696
3,3,1,0,4,0,4,4696
4,4,1,0,5,0,5,4696
5,5,1,0,6,0,6,4696
6,6,0,1,6,1,7,4696
7,7,0,5,6,6,12,4696
8,8,0,4,6,10,16,4696
9,9,0,3,6,13,19,4696
10,10,2,2,8,15,23,4696
11,11,5,1,13,16,29,4696
12,12,6,2,19,18,37,4696
13,13,4,3,23,21,44,4696
14,14,1,3,24,24,48,4696
15,15,1,1,25,25,50,4696
16,16,1,0,26,25,51,4696
17,17,2,1,28,26,54,4696
18,18,1,1,29,27,56,4696
19,19,2,0,31,27,58,4696
20,20,1,0,32,27,59,4696
21,21,0,0,32,27,59,4696
0,0,1,0,1,0,1,4697
1,1,0,1,1,1,2,4697
2,2,0,1,1,2,3,4697
3,3,1,1,2,3,5,4697
4,4,0,1,2,4,6,4697
5,5,0,0,2,4,6,4697
0,0,1,0,1,0,1,4698
1,1,2,0,3,0,3,4698
2,2,6,0,9,0,9,4698
3,3,6,1,15,1,16,4698
4,4,6,2,21,3,24,4698
5,5,5,4,26,7,33,4698
6,6,2,5,28,12,40,4698
7,7,0,3,28,15,43,4698
8,8,0,4,28,19,47,4698
9,9,1,2,29,21,50,4698
10,10,2,1,31,22,53,4698
11,11,3,2,34,24,58,4698
12,12,0,3,34,27,61,4698
13,13,0,4,34,31,65,4698
14,14,0,5,34,36,70,4698
15,15,0,3,34,39,73,4698
16,16,1,4,35,43,78,4698
17,17,0,2,35,45,80,4698
18,18,0,1,35,46,81,4698
19,19,0,2,35,48,83,4698
20,20,0,2,35,50,85,4698
21,21,0,1,35,51,86,4698
22,22,1,1,36,52,88,4698
23,23,0,2,36,54,90,4698
24,24,0,0,36,54,90,4698
0,0,1,0,1,0,1,4699
1,1,2,0,3,0,3,4699
2,2,3,0,6,0,6,4699
3,3,3,1,9,1,10,4699
4,4,2,3,11,4,15,4699
5,5,0,1,11,5,16,4699
6,6,1,1,12,6,18,4699
7,7,0,0,12,6,18,4699
0,0,1,0,1,0,1,4700
1,1,0,0,1,0,1,4700
0,0,1,0,1,0,1,4701
1,1,0,0,1,0,1,4701
0,0,1,0,1,0,1,4702
1,1,2,0,3,0,3,4702
2,2,1,0,4,0,4,4702
3,3,2,0,6,0,6,4702
4,4,1,0,7,0,7,4702
5,5,0,0,7,0,7,4702
0,0,1,0,1,0,1,4703
1,1,1,0,2,0,2,4703
2,2,1,0,3,0,3,4703
3,3,2,1,5,1,6,4703
4,4,3,1,8,2,10,4703
5,5,4,1,12,3,15,4703
6,6,3,1,15,4,19,4703
7,7,3,0,18,4,22,4703
8,8,3,1,21,5,26,4703
9,9,4,1,25,6,31,4703
10,10,3,4,28,10,38,4703
11,11,5,3,33,13,46,4703
12,12,1,2,34,15,49,4703
13,13,0,1,34,16,50,4703
14,14,0,1,34,17,51,4703
15,15,0,1,34,18,52,4703
16,16,0,1,34,19,53,4703
17,17,0,0,34,19,53,4703
0,0,1,0,1,0,1,4704
1,1,1,0,2,0,2,4704
2,2,2,0,4,0,4,4704
3,3,3,2,7,2,9,4704
4,4,6,5,13,7,20,4704
5,5,5,2,18,9,27,4704
6,6,4,2,22,11,33,4704
7,7,5,0,27,11,38,4704
8,8,1,1,28,12,40,4704
9,9,2,0,30,12,42,4704
10,10,0,0,30,12,42,4704
0,0,1,0,1,0,1,4705
1,1,2,1,3,1,4,4705
2,2,1,1,4,2,6,4705
3,3,0,1,4,3,7,4705
4,4,0,2,4,5,9,4705
5,5,0,5,4,10,14,4705
6,6,1,3,5,13,18,4705
7,7,1,2,6,15,21,4705
8,8,2,0,8,15,23,4705
9,9,1,0,9,15,24,4705
10,10,0,0,9,15,24,4705
0,0,1,0,1,0,1,4706
1,1,0,1,1,1,2,4706
2,2,0,1,1,2,3,4706
3,3,0,0,1,2,3,4706
0,0,1,0,1,0,1,4707
1,1,1,0,2,0,2,4707
2,2,1,0,3,0,3,4707
3,3,0,0,3,0,3,4707
0,0,1,0,1,0,1,4708
1,1,1,0,2,0,2,4708
2,2,0,0,2,0,2,4708
0,0,1,0,1,0,1,4709
1,1,0,1,1,1,2,4709
2,2,1,1,2,2,4,4709
3,3,0,1,2,3,5,4709
4,4,0,0,2,3,5,4709
0,0,1,0,1,0,1,4710
1,1,0,1,1,1,2,4710
2,2,0,2,1,3,4,4710
3,3,0,1,1,4,5,4710
4,4,1,0,2,4,6,4710
5,5,1,0,3,4,7,4710
6,6,0,0,3,4,7,4710
0,0,1,0,1,0,1,4711
1,1,0,0,1,0,1,4711
0,0,1,0,1,0,1,4712
1,1,1,0,2,0,2,4712
2,2,0,1,2,1,3,4712
3,3,0,0,2,1,3,4712
0,0,1,0,1,0,1,4713
1,1,3,0,4,0,4,4713
2,2,0,0,4,0,4,4713
0,0,1,0,1,0,1,4714
1,1,0,0,1,0,1,4714
0,0,1,0,1,0,1,4715
1,1,1,0,2,0,2,4715
2,2,0,0,2,0,2,4715
0,0,1,0,1,0,1,4716
1,1,0,0,1,0,1,4716
0,0,1,0,1,0,1,4717
1,1,0,0,1,0,1,4717
0,0,1,0,1,0,1,4718
1,1,1,0,2,0,2,4718
2,2,0,0,2,0,2,4718
0,0,1,0,1,0,1,4719
1,1,1,0,2,0,2,4719
2,2,0,0,2,0,2,4719
0,0,1,0,1,0,1,4720
1,1,0,0,1,0,1,4720
0,0,1,0,1,0,1,4721
1,1,0,0,1,0,1,4721
0,0,1,0,1,0,1,4722
1,1,1,0,2,0,2,4722
2,2,0,0,2,0,2,4722
0,0,1,0,1,0,1,4723
1,1,0,2,1,2,3,4723
2,2,1,0,2,2,4,4723
3,3,3,1,5,3,8,4723
4,4,2,0,7,3,10,4723
5,5,2,0,9,3,12,4723
6,6,1,0,10,3,13,4723
7,7,1,0,11,3,14,4723
8,8,2,0,13,3,16,4723
9,9,2,0,15,3,18,4723
10,10,4,0,19,3,22,4723
11,11,6,1,25,4,29,4723
12,12,4,5,29,9,38,4723
13,13,8,3,37,12,49,4723
14,14,4,4,41,16,57,4723
15,15,2,2,43,18,61,4723
16,16,4,0,47,18,65,4723
17,17,6,2,53,20,73,4723
18,18,5,1,58,21,79,4723
19,19,2,3,60,24,84,4723
20,20,1,0,61,24,85,4723
21,21,1,0,62,24,86,4723
22,22,0,0,62,24,86,4723
0,0,1,0,1,0,1,4724
1,1,2,0,3,0,3,4724
2,2,1,0,4,0,4,4724
3,3,0,1,4,1,5,4724
4,4,0,3,4,4,8,4724
5,5,0,0,4,4,8,4724
0,0,1,0,1,0,1,4725
1,1,1,0,2,0,2,4725
2,2,0,2,2,2,4,4725
3,3,0,0,2,2,4,4725
0,0,1,0,1,0,1,4726
1,1,0,0,1,0,1,4726
0,0,1,0,1,0,1,4727
1,1,2,0,3,0,3,4727
2,2,1,1,4,1,5,4727
3,3,1,1,5,2,7,4727
4,4,1,2,6,4,10,4727
5,5,2,1,8,5,13,4727
6,6,2,0,10,5,15,4727
7,7,1,0,11,5,16,4727
8,8,0,0,11,5,16,4727
0,0,1,0,1,0,1,4728
1,1,0,0,1,0,1,4728
0,0,1,0,1,0,1,4729
1,1,1,0,2,0,2,4729
2,2,2,0,4,0,4,4729
3,3,1,1,5,1,6,4729
4,4,2,2,7,3,10,4729
5,5,3,2,10,5,15,4729
6,6,4,1,14,6,20,4729
7,7,3,1,17,7,24,4729
8,8,1,2,18,9,27,4729
9,9,1,0,19,9,28,4729
10,10,0,0,19,9,28,4729
0,0,1,0,1,0,1,4730
1,1,1,1,2,1,3,4730
2,2,0,1,2,2,4,4730
3,3,0,0,2,2,4,4730
0,0,1,0,1,0,1,4731
1,1,1,0,2,0,2,4731
2,2,1,0,3,0,3,4731
3,3,0,0,3,0,3,4731
0,0,1,0,1,0,1,4732
1,1,1,0,2,0,2,4732
2,2,0,0,2,0,2,4732
0,0,1,0,1,0,1,4733
1,1,1,0,2,0,2,4733
2,2,0,0,2,0,2,4733
0,0,1,0,1,0,1,4734
1,1,1,0,2,0,2,4734
2,2,0,0,2,0,2,4734
0,0,1,0,1,0,1,4735
1,1,0,0,1,0,1,4735
0,0,1,0,1,0,1,4736
1,1,0,0,1,0,1,4736
0,0,1,0,1,0,1,4737
1,1,1,0,2,0,2,4737
2,2,0,1,2,1,3,4737
3,3,0,0,2,1,3,4737
0,0,1,0,1,0,1,4738
1,1,0,0,1,0,1,4738
0,0,1,0,1,0,1,4739
1,1,1,0,2,0,2,4739
2,2,0,0,2,0,2,4739
0,0,1,0,1,0,1,4740
1,1,0,1,1,1,2,4740
2,2,0,1,1,2,3,4740
3,3,0,0,1,2,3,4740
0,0,1,0,1,0,1,4741
1,1,0,0,1,0,1,4741
0,0,1,0,1,0,1,4742
1,1,0,0,1,0,1,4742
0,0,1,0,1,0,1,4743
1,1,1,0,2,0,2,4743
2,2,1,0,3,0,3,4743
3,3,1,0,4,0,4,4743
4,4,1,0,5,0,5,4743
5,5,0,0,5,0,5,4743
0,0,1,0,1,0,1,4744
1,1,0,0,1,0,1,4744
0,0,1,0,1,0,1,4745
1,1,0,0,1,0,1,4745
0,0,1,0,1,0,1,4746
1,1,2,0,3,0,3,4746
2,2,0,0,3,0,3,4746
0,0,1,0,1,0,1,4747
1,1,1,0,2,0,2,4747
2,2,0,1,2,1,3,4747
3,3,0,1,2,2,4,4747
4,4,0,1,2,3,5,4747
5,5,0,0,2,3,5,4747
0,0,1,0,1,0,1,4748
1,1,0,0,1,0,1,4748
0,0,1,0,1,0,1,4749
1,1,0,0,1,0,1,4749
0,0,1,0,1,0,1,4750
1,1,1,0,2,0,2,4750
2,2,2,0,4,0,4,4750
3,3,1,0,5,0,5,4750
4,4,0,0,5,0,5,4750
0,0,1,0,1,0,1,4751
1,1,0,0,1,0,1,4751
0,0,1,0,1,0,1,4752
1,1,1,0,2,0,2,4752
2,2,0,0,2,0,2,4752
0,0,1,0,1,0,1,4753
1,1,1,1,2,1,3,4753
2,2,1,2,3,3,6,4753
3,3,0,2,3,5,8,4753
4,4,0,1,3,6,9,4753
5,5,0,0,3,6,9,4753
0,0,1,0,1,0,1,4754
1,1,1,0,2,0,2,4754
2,2,3,2,5,2,7,4754
3,3,1,1,6,3,9,4754
4,4,1,0,7,3,10,4754
5,5,1,0,8,3,11,4754
6,6,1,0,9,3,12,4754
7,7,0,0,9,3,12,4754
0,0,1,0,1,0,1,4755
1,1,0,0,1,0,1,4755
0,0,1,0,1,0,1,4756
1,1,1,0,2,0,2,4756
2,2,0,0,2,0,2,4756
0,0,1,0,1,0,1,4757
1,1,1,1,2,1,3,4757
2,2,0,0,2,1,3,4757
0,0,1,0,1,0,1,4758
1,1,1,0,2,0,2,4758
2,2,1,0,3,0,3,4758
3,3,0,0,3,0,3,4758
0,0,1,0,1,0,1,4759
1,1,0,0,1,0,1,4759
0,0,1,0,1,0,1,4760
1,1,3,1,4,1,5,4760
2,2,4,0,8,1,9,4760
3,3,8,2,16,3,19,4760
4,4,5,1,21,4,25,4760
5,5,6,0,27,4,31,4760
6,6,1,0,28,4,32,4760
7,7,1,1,29,5,34,4760
8,8,5,1,34,6,40,4760
9,9,2,0,36,6,42,4760
10,10,2,0,38,6,44,4760
11,11,1,0,39,6,45,4760
12,12,0,2,39,8,47,4760
13,13,0,3,39,11,50,4760
14,14,0,3,39,14,53,4760
15,15,0,0,39,14,53,4760
0,0,1,0,1,0,1,4761
1,1,1,1,2,1,3,4761
2,2,0,0,2,1,3,4761
0,0,1,0,1,0,1,4762
1,1,1,1,2,1,3,4762
2,2,1,1,3,2,5,4762
3,3,0,0,3,2,5,4762
0,0,1,0,1,0,1,4763
1,1,0,1,1,1,2,4763
2,2,0,0,1,1,2,4763
0,0,1,0,1,0,1,4764
1,1,0,1,1,1,2,4764
2,2,0,1,1,2,3,4764
3,3,0,2,1,4,5,4764
4,4,1,0,2,4,6,4764
5,5,3,0,5,4,9,4764
6,6,0,0,5,4,9,4764
0,0,1,0,1,0,1,4765
1,1,0,0,1,0,1,4765
0,0,1,0,1,0,1,4766
1,1,1,0,2,0,2,4766
2,2,3,0,5,0,5,4766
3,3,3,0,8,0,8,4766
4,4,1,2,9,2,11,4766
5,5,0,3,9,5,14,4766
6,6,0,3,9,8,17,4766
7,7,1,0,10,8,18,4766
8,8,1,0,11,8,19,4766
9,9,1,0,12,8,20,4766
10,10,0,0,12,8,20,4766
0,0,1,0,1,0,1,4767
1,1,0,0,1,0,1,4767
0,0,1,0,1,0,1,4768
1,1,2,0,3,0,3,4768
2,2,0,0,3,0,3,4768
0,0,1,0,1,0,1,4769
1,1,1,0,2,0,2,4769
2,2,0,0,2,0,2,4769
0,0,1,0,1,0,1,4770
1,1,3,0,4,0,4,4770
2,2,1,0,5,0,5,4770
3,3,1,0,6,0,6,4770
4,4,1,0,7,0,7,4770
5,5,1,0,8,0,8,4770
6,6,1,0,9,0,9,4770
7,7,2,0,11,0,11,4770
8,8,2,1,13,1,14,4770
9,9,2,1,15,2,17,4770
10,10,1,2,16,4,20,4770
11,11,1,0,17,4,21,4770
12,12,0,0,17,4,21,4770
0,0,1,0,1,0,1,4771
1,1,0,0,1,0,1,4771
0,0,1,0,1,0,1,4772
1,1,0,0,1,0,1,4772
0,0,1,0,1,0,1,4773
1,1,1,0,2,0,2,4773
2,2,1,0,3,0,3,4773
3,3,2,0,5,0,5,4773
4,4,2,0,7,0,7,4773
5,5,1,0,8,0,8,4773
6,6,2,0,10,0,10,4773
7,7,3,0,13,0,13,4773
8,8,2,0,15,0,15,4773
9,9,2,0,17,0,17,4773
10,10,1,0,18,0,18,4773
11,11,0,0,18,0,18,4773
0,0,1,0,1,0,1,4774
1,1,0,0,1,0,1,4774
0,0,1,0,1,0,1,4775
1,1,1,0,2,0,2,4775
2,2,0,0,2,0,2,4775
0,0,1,0,1,0,1,4776
1,1,1,0,2,0,2,4776
2,2,0,0,2,0,2,4776
0,0,1,0,1,0,1,4777
1,1,1,0,2,0,2,4777
2,2,0,1,2,1,3,4777
3,3,0,1,2,2,4,4777
4,4,0,1,2,3,5,4777
5,5,0,1,2,4,6,4777
6,6,1,1,3,5,8,4777
7,7,0,0,3,5,8,4777
0,0,1,0,1,0,1,4778
1,1,2,0,3,0,3,4778
2,2,1,0,4,0,4,4778
3,3,1,0,5,0,5,4778
4,4,0,0,5,0,5,4778
0,0,1,0,1,0,1,4779
1,1,0,0,1,0,1,4779
0,0,1,0,1,0,1,4780
1,1,0,0,1,0,1,4780
0,0,1,0,1,0,1,4781
1,1,1,0,2,0,2,4781
2,2,0,0,2,0,2,4781
0,0,1,0,1,0,1,4782
1,1,0,0,1,0,1,4782
0,0,1,0,1,0,1,4783
1,1,2,1,3,1,4,4783
2,2,2,0,5,1,6,4783
3,3,2,1,7,2,9,4783
4,4,0,2,7,4,11,4783
5,5,0,1,7,5,12,4783
6,6,0,0,7,5,12,4783
0,0,1,0,1,0,1,4784
1,1,1,0,2,0,2,4784
2,2,0,0,2,0,2,4784
0,0,1,0,1,0,1,4785
1,1,2,1,3,1,4,4785
2,2,2,2,5,3,8,4785
3,3,1,1,6,4,10,4785
4,4,0,1,6,5,11,4785
5,5,0,0,6,5,11,4785
0,0,1,0,1,0,1,4786
1,1,0,0,1,0,1,4786
0,0,1,0,1,0,1,4787
1,1,1,0,2,0,2,4787
2,2,2,0,4,0,4,4787
3,3,3,0,7,0,7,4787
4,4,2,0,9,0,9,4787
5,5,1,0,10,0,10,4787
6,6,1,0,11,0,11,4787
7,7,0,0,11,0,11,4787
0,0,1,0,1,0,1,4788
1,1,1,0,2,0,2,4788
2,2,1,0,3,0,3,4788
3,3,0,0,3,0,3,4788
0,0,1,0,1,0,1,4789
1,1,1,1,2,1,3,4789
2,2,0,2,2,3,5,4789
3,3,0,3,2,6,8,4789
4,4,1,3,3,9,12,4789
5,5,0,2,3,11,14,4789
6,6,1,0,4,11,15,4789
7,7,0,0,4,11,15,4789
0,0,1,0,1,0,1,4790
1,1,0,0,1,0,1,4790
0,0,1,0,1,0,1,4791
1,1,1,0,2,0,2,4791
2,2,0,0,2,0,2,4791
0,0,1,0,1,0,1,4792
1,1,0,0,1,0,1,4792
0,0,1,0,1,0,1,4793
1,1,0,1,1,1,2,4793
2,2,0,1,1,2,3,4793
3,3,0,1,1,3,4,4793
4,4,0,1,1,4,5,4793
5,5,0,1,1,5,6,4793
6,6,1,0,2,5,7,4793
7,7,0,0,2,5,7,4793
0,0,1,0,1,0,1,4794
1,1,0,1,1,1,2,4794
2,2,0,0,1,1,2,4794
0,0,1,0,1,0,1,4795
1,1,1,1,2,1,3,4795
2,2,1,2,3,3,6,4795
3,3,0,0,3,3,6,4795
0,0,1,0,1,0,1,4796
1,1,0,0,1,0,1,4796
0,0,1,0,1,0,1,4797
1,1,0,0,1,0,1,4797
0,0,1,0,1,0,1,4798
1,1,0,1,1,1,2,4798
2,2,0,0,1,1,2,4798
0,0,1,0,1,0,1,4799
1,1,0,0,1,0,1,4799
0,0,1,0,1,0,1,4800
1,1,1,0,2,0,2,4800
2,2,1,0,3,0,3,4800
3,3,0,0,3,0,3,4800
0,0,1,0,1,0,1,4801
1,1,0,0,1,0,1,4801
0,0,1,0,1,0,1,4802
1,1,0,0,1,0,1,4802
0,0,1,0,1,0,1,4803
1,1,1,1,2,1,3,4803
2,2,0,2,2,3,5,4803
3,3,1,1,3,4,7,4803
4,4,0,0,3,4,7,4803
0,0,1,0,1,0,1,4804
1,1,0,1,1,1,2,4804
2,2,1,2,2,3,5,4804
3,3,1,2,3,5,8,4804
4,4,1,2,4,7,11,4804
5,5,2,2,6,9,15,4804
6,6,0,1,6,10,16,4804
7,7,1,1,7,11,18,4804
8,8,0,0,7,11,18,4804
0,0,1,0,1,0,1,4805
1,1,0,0,1,0,1,4805
0,0,1,0,1,0,1,4806
1,1,1,0,2,0,2,4806
2,2,1,0,3,0,3,4806
3,3,3,0,6,0,6,4806
4,4,1,1,7,1,8,4806
5,5,1,1,8,2,10,4806
6,6,1,2,9,4,13,4806
7,7,1,2,10,6,16,4806
8,8,0,1,10,7,17,4806
9,9,0,2,10,9,19,4806
10,10,1,1,11,10,21,4806
11,11,2,2,13,12,25,4806
12,12,1,2,14,14,28,4806
13,13,3,0,17,14,31,4806
14,14,3,0,20,14,34,4806
15,15,2,1,22,15,37,4806
16,16,1,0,23,15,38,4806
17,17,0,1,23,16,39,4806
18,18,0,0,23,16,39,4806
0,0,1,0,1,0,1,4807
1,1,0,0,1,0,1,4807
0,0,1,0,1,0,1,4808
1,1,0,0,1,0,1,4808
0,0,1,0,1,0,1,4809
1,1,1,0,2,0,2,4809
2,2,0,1,2,1,3,4809
3,3,0,0,2,1,3,4809
0,0,1,0,1,0,1,4810
1,1,0,0,1,0,1,4810
0,0,1,0,1,0,1,4811
1,1,1,0,2,0,2,4811
2,2,0,0,2,0,2,4811
0,0,1,0,1,0,1,4812
1,1,2,1,3,1,4,4812
2,2,1,0,4,1,5,4812
3,3,0,0,4,1,5,4812
0,0,1,0,1,0,1,4813
1,1,1,1,2,1,3,4813
2,2,4,0,6,1,7,4813
3,3,2,0,8,1,9,4813
4,4,1,1,9,2,11,4813
5,5,0,1,9,3,12,4813
6,6,0,1,9,4,13,4813
7,7,0,1,9,5,14,4813
8,8,0,0,9,5,14,4813
0,0,1,0,1,0,1,4814
1,1,1,1,2,1,3,4814
2,2,1,1,3,2,5,4814
3,3,0,3,3,5,8,4814
4,4,0,1,3,6,9,4814
5,5,1,1,4,7,11,4814
6,6,0,2,4,9,13,4814
7,7,0,4,4,13,17,4814
8,8,1,2,5,15,20,4814
9,9,1,0,6,15,21,4814
10,10,1,1,7,16,23,4814
11,11,0,1,7,17,24,4814
12,12,0,1,7,18,25,4814
13,13,0,1,7,19,26,4814
14,14,0,1,7,20,27,4814
15,15,0,1,7,21,28,4814
16,16,0,2,7,23,30,4814
17,17,2,0,9,23,32,4814
18,18,0,0,9,23,32,4814
0,0,1,0,1,0,1,4815
1,1,0,1,1,1,2,4815
2,2,1,2,2,3,5,4815
3,3,2,1,4,4,8,4815
4,4,8,1,12,5,17,4815
5,5,5,1,17,6,23,4815
6,6,7,0,24,6,30,4815
7,7,2,0,26,6,32,4815
8,8,1,0,27,6,33,4815
9,9,1,0,28,6,34,4815
10,10,1,0,29,6,35,4815
11,11,1,0,30,6,36,4815
12,12,0,0,30,6,36,4815
0,0,1,0,1,0,1,4816
1,1,1,1,2,1,3,4816
2,2,0,0,2,1,3,4816
0,0,1,0,1,0,1,4817
1,1,1,0,2,0,2,4817
2,2,1,0,3,0,3,4817
3,3,5,1,8,1,9,4817
4,4,7,2,15,3,18,4817
5,5,4,4,19,7,26,4817
6,6,3,0,22,7,29,4817
7,7,1,0,23,7,30,4817
8,8,1,0,24,7,31,4817
9,9,0,0,24,7,31,4817
0,0,1,0,1,0,1,4818
1,1,1,0,2,0,2,4818
2,2,1,0,3,0,3,4818
3,3,3,0,6,0,6,4818
4,4,3,0,9,0,9,4818
5,5,1,0,10,0,10,4818
6,6,1,0,11,0,11,4818
7,7,2,0,13,0,13,4818
8,8,1,1,14,1,15,4818
9,9,0,1,14,2,16,4818
10,10,0,1,14,3,17,4818
11,11,0,1,14,4,18,4818
12,12,0,2,14,6,20,4818
13,13,0,1,14,7,21,4818
14,14,0,2,14,9,23,4818
15,15,0,1,14,10,24,4818
16,16,0,1,14,11,25,4818
17,17,0,3,14,14,28,4818
18,18,0,2,14,16,30,4818
19,19,0,1,14,17,31,4818
20,20,0,2,14,19,33,4818
21,21,0,2,14,21,35,4818
22,22,1,1,15,22,37,4818
23,23,1,2,16,24,40,4818
24,24,1,2,17,26,43,4818
25,25,2,0,19,26,45,4818
26,26,0,0,19,26,45,4818
0,0,1,0,1,0,1,4819
1,1,1,0,2,0,2,4819
2,2,1,0,3,0,3,4819
3,3,3,0,6,0,6,4819
4,4,2,1,8,1,9,4819
5,5,2,2,10,3,13,4819
6,6,4,3,14,6,20,4819
7,7,5,2,19,8,27,4819
8,8,3,2,22,10,32,4819
9,9,2,1,24,11,35,4819
10,10,2,1,26,12,38,4819
11,11,1,1,27,13,40,4819
12,12,4,1,31,14,45,4819
13,13,2,0,33,14,47,4819
14,14,1,0,34,14,48,4819
15,15,1,0,35,14,49,4819
16,16,2,0,37,14,51,4819
17,17,3,0,40,14,54,4819
18,18,3,0,43,14,57,4819
19,19,1,1,44,15,59,4819
20,20,1,0,45,15,60,4819
21,21,0,0,45,15,60,4819
0,0,1,0,1,0,1,4820
1,1,0,1,1,1,2,4820
2,2,0,0,1,1,2,4820
0,0,1,0,1,0,1,4821
1,1,1,0,2,0,2,4821
2,2,1,1,3,1,4,4821
3,3,0,2,3,3,6,4821
4,4,1,1,4,4,8,4821
5,5,2,0,6,4,10,4821
6,6,1,1,7,5,12,4821
7,7,0,3,7,8,15,4821
8,8,1,0,8,8,16,4821
9,9,1,0,9,8,17,4821
10,10,0,0,9,8,17,4821
0,0,1,0,1,0,1,4822
1,1,1,0,2,0,2,4822
2,2,2,0,4,0,4,4822
3,3,3,0,7,0,7,4822
4,4,3,0,10,0,10,4822
5,5,3,0,13,0,13,4822
6,6,1,2,14,2,16,4822
7,7,4,1,18,3,21,4822
8,8,5,3,23,6,29,4822
9,9,7,3,30,9,39,4822
10,10,4,1,34,10,44,4822
11,11,5,1,39,11,50,4822
12,12,2,3,41,14,55,4822
13,13,1,1,42,15,57,4822
14,14,0,0,42,15,57,4822
0,0,1,0,1,0,1,4823
1,1,2,0,3,0,3,4823
2,2,0,0,3,0,3,4823
0,0,1,0,1,0,1,4824
1,1,1,0,2,0,2,4824
2,2,0,0,2,0,2,4824
0,0,1,0,1,0,1,4825
1,1,1,0,2,0,2,4825
2,2,2,0,4,0,4,4825
3,3,4,0,8,0,8,4825
4,4,4,4,12,4,16,4825
5,5,2,3,14,7,21,4825
6,6,1,3,15,10,25,4825
7,7,1,0,16,10,26,4825
8,8,1,1,17,11,28,4825
9,9,0,2,17,13,30,4825
10,10,0,2,17,15,32,4825
11,11,0,0,17,15,32,4825
0,0,1,0,1,0,1,4826
1,1,0,0,1,0,1,4826
0,0,1,0,1,0,1,4827
1,1,1,0,2,0,2,4827
2,2,0,0,2,0,2,4827
0,0,1,0,1,0,1,4828
1,1,1,1,2,1,3,4828
2,2,1,0,3,1,4,4828
3,3,0,0,3,1,4,4828
0,0,1,0,1,0,1,4829
1,1,0,0,1,0,1,4829
0,0,1,0,1,0,1,4830
1,1,3,0,4,0,4,4830
2,2,2,0,6,0,6,4830
3,3,1,0,7,0,7,4830
4,4,1,0,8,0,8,4830
5,5,1,0,9,0,9,4830
6,6,2,0,11,0,11,4830
7,7,0,3,11,3,14,4830
8,8,0,1,11,4,15,4830
9,9,0,1,11,5,16,4830
10,10,0,0,11,5,16,4830
0,0,1,0,1,0,1,4831
1,1,0,0,1,0,1,4831
0,0,1,0,1,0,1,4832
1,1,0,0,1,0,1,4832
0,0,1,0,1,0,1,4833
1,1,0,0,1,0,1,4833
0,0,1,0,1,0,1,4834
1,1,1,0,2,0,2,4834
2,2,0,0,2,0,2,4834
0,0,1,0,1,0,1,4835
1,1,1,0,2,0,2,4835
2,2,0,0,2,0,2,4835
0,0,1,0,1,0,1,4836
1,1,1,0,2,0,2,4836
2,2,0,0,2,0,2,4836
0,0,1,0,1,0,1,4837
1,1,3,0,4,0,4,4837
2,2,3,0,7,0,7,4837
3,3,3,0,10,0,10,4837
4,4,2,0,12,0,12,4837
5,5,1,0,13,0,13,4837
6,6,3,0,16,0,16,4837
7,7,1,2,17,2,19,4837
8,8,0,1,17,3,20,4837
9,9,0,1,17,4,21,4837
10,10,0,0,17,4,21,4837
0,0,1,0,1,0,1,4838
1,1,1,0,2,0,2,4838
2,2,1,0,3,0,3,4838
3,3,0,0,3,0,3,4838
0,0,1,0,1,0,1,4839
1,1,0,0,1,0,1,4839
0,0,1,0,1,0,1,4840
1,1,1,0,2,0,2,4840
2,2,0,0,2,0,2,4840
0,0,1,0,1,0,1,4841
1,1,0,0,1,0,1,4841
0,0,1,0,1,0,1,4842
1,1,1,0,2,0,2,4842
2,2,0,0,2,0,2,4842
0,0,1,0,1,0,1,4843
1,1,0,0,1,0,1,4843
0,0,1,0,1,0,1,4844
1,1,2,0,3,0,3,4844
2,2,1,1,4,1,5,4844
3,3,2,1,6,2,8,4844
4,4,0,2,6,4,10,4844
5,5,1,2,7,6,13,4844
6,6,0,0,7,6,13,4844
0,0,1,0,1,0,1,4845
1,1,0,0,1,0,1,4845
0,0,1,0,1,0,1,4846
1,1,0,1,1,1,2,4846
2,2,0,1,1,2,3,4846
3,3,0,2,1,4,5,4846
4,4,0,3,1,7,8,4846
5,5,0,0,1,7,8,4846
0,0,1,0,1,0,1,4847
1,1,1,0,2,0,2,4847
2,2,1,0,3,0,3,4847
3,3,0,0,3,0,3,4847
0,0,1,0,1,0,1,4848
1,1,2,0,3,0,3,4848
2,2,3,1,6,1,7,4848
3,3,1,2,7,3,10,4848
4,4,2,4,9,7,16,4848
5,5,2,3,11,10,21,4848
6,6,2,3,13,13,26,4848
7,7,2,2,15,15,30,4848
8,8,1,2,16,17,33,4848
9,9,2,4,18,21,39,4848
10,10,4,1,22,22,44,4848
11,11,2,2,24,24,48,4848
12,12,2,1,26,25,51,4848
13,13,4,3,30,28,58,4848
14,14,4,3,34,31,65,4848
15,15,1,2,35,33,68,4848
16,16,1,1,36,34,70,4848
17,17,2,1,38,35,73,4848
18,18,1,1,39,36,75,4848
19,19,1,0,40,36,76,4848
20,20,3,0,43,36,79,4848
21,21,1,2,44,38,82,4848
22,22,0,1,44,39,83,4848
23,23,0,0,44,39,83,4848
0,0,1,0,1,0,1,4849
1,1,0,0,1,0,1,4849
0,0,1,0,1,0,1,4850
1,1,1,0,2,0,2,4850
2,2,0,0,2,0,2,4850
0,0,1,0,1,0,1,4851
1,1,0,1,1,1,2,4851
2,2,0,2,1,3,4,4851
3,3,0,0,1,3,4,4851
0,0,1,0,1,0,1,4852
1,1,2,0,3,0,3,4852
2,2,0,0,3,0,3,4852
0,0,1,0,1,0,1,4853
1,1,1,0,2,0,2,4853
2,2,1,0,3,0,3,4853
3,3,1,0,4,0,4,4853
4,4,0,0,4,0,4,4853
0,0,1,0,1,0,1,4854
1,1,1,0,2,0,2,4854
2,2,0,0,2,0,2,4854
0,0,1,0,1,0,1,4855
1,1,0,1,1,1,2,4855
2,2,0,1,1,2,3,4855
3,3,0,1,1,3,4,4855
4,4,0,1,1,4,5,4855
5,5,0,1,1,5,6,4855
6,6,0,0,1,5,6,4855
0,0,1,0,1,0,1,4856
1,1,2,0,3,0,3,4856
2,2,0,1,3,1,4,4856
3,3,0,2,3,3,6,4856
4,4,0,1,3,4,7,4856
5,5,0,0,3,4,7,4856
0,0,1,0,1,0,1,4857
1,1,0,0,1,0,1,4857
0,0,1,0,1,0,1,4858
1,1,0,1,1,1,2,4858
2,2,0,2,1,3,4,4858
3,3,0,0,1,3,4,4858
0,0,1,0,1,0,1,4859
1,1,0,0,1,0,1,4859
0,0,1,0,1,0,1,4860
1,1,1,0,2,0,2,4860
2,2,0,0,2,0,2,4860
0,0,1,0,1,0,1,4861
1,1,0,0,1,0,1,4861
0,0,1,0,1,0,1,4862
1,1,0,0,1,0,1,4862
0,0,1,0,1,0,1,4863
1,1,0,1,1,1,2,4863
2,2,0,3,1,4,5,4863
3,3,0,2,1,6,7,4863
4,4,0,0,1,6,7,4863
0,0,1,0,1,0,1,4864
1,1,1,0,2,0,2,4864
2,2,1,0,3,0,3,4864
3,3,0,0,3,0,3,4864
0,0,1,0,1,0,1,4865
1,1,2,0,3,0,3,4865
2,2,3,0,6,0,6,4865
3,3,2,0,8,0,8,4865
4,4,0,1,8,1,9,4865
5,5,0,0,8,1,9,4865
0,0,1,0,1,0,1,4866
1,1,0,1,1,1,2,4866
2,2,1,1,2,2,4,4866
3,3,2,0,4,2,6,4866
4,4,1,2,5,4,9,4866
5,5,1,0,6,4,10,4866
6,6,0,1,6,5,11,4866
7,7,0,1,6,6,12,4866
8,8,0,1,6,7,13,4866
9,9,0,0,6,7,13,4866
0,0,1,0,1,0,1,4867
1,1,0,0,1,0,1,4867
0,0,1,0,1,0,1,4868
1,1,4,0,5,0,5,4868
2,2,4,2,9,2,11,4868
3,3,6,1,15,3,18,4868
4,4,7,2,22,5,27,4868
5,5,6,1,28,6,34,4868
6,6,7,3,35,9,44,4868
7,7,1,4,36,13,49,4868
8,8,0,0,36,13,49,4868
0,0,1,0,1,0,1,4869
1,1,3,0,4,0,4,4869
2,2,2,2,6,2,8,4869
3,3,0,1,6,3,9,4869
4,4,0,0,6,3,9,4869
0,0,1,0,1,0,1,4870
1,1,0,0,1,0,1,4870
0,0,1,0,1,0,1,4871
1,1,0,0,1,0,1,4871
0,0,1,0,1,0,1,4872
1,1,0,0,1,0,1,4872
0,0,1,0,1,0,1,4873
1,1,1,0,2,0,2,4873
2,2,0,0,2,0,2,4873
0,0,1,0,1,0,1,4874
1,1,1,1,2,1,3,4874
2,2,3,0,5,1,6,4874
3,3,1,0,6,1,7,4874
4,4,1,0,7,1,8,4874
5,5,0,1,7,2,9,4874
6,6,0,1,7,3,10,4874
7,7,0,0,7,3,10,4874
0,0,1,0,1,0,1,4875
1,1,0,0,1,0,1,4875
0,0,1,0,1,0,1,4876
1,1,0,0,1,0,1,4876
0,0,1,0,1,0,1,4877
1,1,3,0,4,0,4,4877
2,2,1,0,5,0,5,4877
3,3,1,0,6,0,6,4877
4,4,0,0,6,0,6,4877
0,0,1,0,1,0,1,4878
1,1,0,0,1,0,1,4878
0,0,1,0,1,0,1,4879
1,1,1,0,2,0,2,4879
2,2,2,1,4,1,5,4879
3,3,1,0,5,1,6,4879
4,4,1,0,6,1,7,4879
5,5,2,0,8,1,9,4879
6,6,0,0,8,1,9,4879
0,0,1,0,1,0,1,4880
1,1,1,0,2,0,2,4880
2,2,2,0,4,0,4,4880
3,3,1,1,5,1,6,4880
4,4,3,0,8,1,9,4880
5,5,3,0,11,1,12,4880
6,6,1,1,12,2,14,4880
7,7,0,0,12,2,14,4880
0,0,1,0,1,0,1,4881
1,1,1,0,2,0,2,4881
2,2,0,0,2,0,2,4881
0,0,1,0,1,0,1,4882
1,1,1,0,2,0,2,4882
2,2,1,0,3,0,3,4882
3,3,0,0,3,0,3,4882
0,0,1,0,1,0,1,4883
1,1,1,0,2,0,2,4883
2,2,0,0,2,0,2,4883
0,0,1,0,1,0,1,4884
1,1,0,1,1,1,2,4884
2,2,0,0,1,1,2,4884
0,0,1,0,1,0,1,4885
1,1,0,0,1,0,1,4885
0,0,1,0,1,0,1,4886
1,1,0,0,1,0,1,4886
0,0,1,0,1,0,1,4887
1,1,2,0,3,0,3,4887
2,2,1,0,4,0,4,4887
3,3,1,0,5,0,5,4887
4,4,1,0,6,0,6,4887
5,5,1,0,7,0,7,4887
6,6,2,0,9,0,9,4887
7,7,0,1,9,1,10,4887
8,8,0,1,9,2,11,4887
9,9,0,1,9,3,12,4887
10,10,1,2,10,5,15,4887
11,11,0,1,10,6,16,4887
12,12,0,0,10,6,16,4887
0,0,1,0,1,0,1,4888
1,1,3,0,4,0,4,4888
2,2,2,0,6,0,6,4888
3,3,1,1,7,1,8,4888
4,4,1,1,8,2,10,4888
5,5,0,0,8,2,10,4888
0,0,1,0,1,0,1,4889
1,1,0,0,1,0,1,4889
0,0,1,0,1,0,1,4890
1,1,0,0,1,0,1,4890
0,0,1,0,1,0,1,4891
1,1,0,0,1,0,1,4891
0,0,1,0,1,0,1,4892
1,1,0,0,1,0,1,4892
0,0,1,0,1,0,1,4893
1,1,1,0,2,0,2,4893
2,2,0,0,2,0,2,4893
0,0,1,0,1,0,1,4894
1,1,2,0,3,0,3,4894
2,2,1,1,4,1,5,4894
3,3,1,0,5,1,6,4894
4,4,2,0,7,1,8,4894
5,5,0,0,7,1,8,4894
0,0,1,0,1,0,1,4895
1,1,0,0,1,0,1,4895
0,0,1,0,1,0,1,4896
1,1,1,0,2,0,2,4896
2,2,0,0,2,0,2,4896
0,0,1,0,1,0,1,4897
1,1,0,0,1,0,1,4897
0,0,1,0,1,0,1,4898
1,1,0,0,1,0,1,4898
0,0,1,0,1,0,1,4899
1,1,0,0,1,0,1,4899
0,0,1,0,1,0,1,4900
1,1,0,1,1,1,2,4900
2,2,0,1,1,2,3,4900
3,3,0,3,1,5,6,4900
4,4,0,2,1,7,8,4900
5,5,1,1,2,8,10,4900
6,6,0,1,2,9,11,4900
7,7,0,2,2,11,13,4900
8,8,1,3,3,14,17,4900
9,9,5,3,8,17,25,4900
10,10,4,5,12,22,34,4900
11,11,3,4,15,26,41,4900
12,12,1,4,16,30,46,4900
13,13,2,2,18,32,50,4900
14,14,1,1,19,33,52,4900
15,15,1,2,20,35,55,4900
16,16,2,1,22,36,58,4900
17,17,5,3,27,39,66,4900
18,18,2,4,29,43,72,4900
19,19,1,2,30,45,75,4900
20,20,1,0,31,45,76,4900
21,21,3,0,34,45,79,4900
22,22,1,0,35,45,80,4900
23,23,0,1,35,46,81,4900
24,24,0,0,35,46,81,4900
0,0,1,0,1,0,1,4901
1,1,0,0,1,0,1,4901
0,0,1,0,1,0,1,4902
1,1,1,1,2,1,3,4902
2,2,2,1,4,2,6,4902
3,3,0,0,4,2,6,4902
0,0,1,0,1,0,1,4903
1,1,2,0,3,0,3,4903
2,2,2,2,5,2,7,4903
3,3,1,1,6,3,9,4903
4,4,2,0,8,3,11,4903
5,5,1,0,9,3,12,4903
6,6,0,0,9,3,12,4903
0,0,1,0,1,0,1,4904
1,1,2,1,3,1,4,4904
2,2,1,2,4,3,7,4904
3,3,2,1,6,4,10,4904
4,4,4,1,10,5,15,4904
5,5,1,0,11,5,16,4904
6,6,0,0,11,5,16,4904
0,0,1,0,1,0,1,4905
1,1,1,0,2,0,2,4905
2,2,1,0,3,0,3,4905
3,3,0,1,3,1,4,4905
4,4,0,1,3,2,5,4905
5,5,0,0,3,2,5,4905
0,0,1,0,1,0,1,4906
1,1,0,0,1,0,1,4906
0,0,1,0,1,0,1,4907
1,1,1,0,2,0,2,4907
2,2,0,0,2,0,2,4907
0,0,1,0,1,0,1,4908
1,1,0,0,1,0,1,4908
0,0,1,0,1,0,1,4909
1,1,0,1,1,1,2,4909
2,2,1,1,2,2,4,4909
3,3,1,1,3,3,6,4909
4,4,2,2,5,5,10,4909
5,5,1,3,6,8,14,4909
6,6,2,6,8,14,22,4909
7,7,4,4,12,18,30,4909
8,8,2,2,14,20,34,4909
9,9,1,2,15,22,37,4909
10,10,1,2,16,24,40,4909
11,11,2,0,18,24,42,4909
12,12,0,2,18,26,44,4909
13,13,0,1,18,27,45,4909
14,14,0,1,18,28,46,4909
15,15,0,0,18,28,46,4909
0,0,1,0,1,0,1,4910
1,1,0,1,1,1,2,4910
2,2,1,1,2,2,4,4910
3,3,0,2,2,4,6,4910
4,4,1,2,3,6,9,4910
5,5,1,0,4,6,10,4910
6,6,0,0,4,6,10,4910
0,0,1,0,1,0,1,4911
1,1,1,0,2,0,2,4911
2,2,2,0,4,0,4,4911
3,3,0,0,4,0,4,4911
0,0,1,0,1,0,1,4912
1,1,1,0,2,0,2,4912
2,2,0,0,2,0,2,4912
0,0,1,0,1,0,1,4913
1,1,0,0,1,0,1,4913
0,0,1,0,1,0,1,4914
1,1,0,0,1,0,1,4914
0,0,1,0,1,0,1,4915
1,1,0,0,1,0,1,4915
0,0,1,0,1,0,1,4916
1,1,1,0,2,0,2,4916
2,2,1,0,3,0,3,4916
3,3,1,0,4,0,4,4916
4,4,0,0,4,0,4,4916
0,0,1,0,1,0,1,4917
1,1,2,0,3,0,3,4917
2,2,1,0,4,0,4,4917
3,3,0,0,4,0,4,4917
0,0,1,0,1,0,1,4918
1,1,0,0,1,0,1,4918
0,0,1,0,1,0,1,4919
1,1,0,0,1,0,1,4919
0,0,1,0,1,0,1,4920
1,1,1,0,2,0,2,4920
2,2,2,0,4,0,4,4920
3,3,0,0,4,0,4,4920
0,0,1,0,1,0,1,4921
1,1,1,0,2,0,2,4921
2,2,2,1,4,1,5,4921
3,3,2,0,6,1,7,4921
4,4,0,2,6,3,9,4921
5,5,0,3,6,6,12,4921
6,6,0,3,6,9,15,4921
7,7,0,2,6,11,17,4921
8,8,0,3,6,14,20,4921
9,9,0,2,6,16,22,4921
10,10,0,1,6,17,23,4921
11,11,0,0,6,17,23,4921
0,0,1,0,1,0,1,4922
1,1,2,0,3,0,3,4922
2,2,2,0,5,0,5,4922
3,3,3,0,8,0,8,4922
4,4,5,1,13,1,14,4922
5,5,6,2,19,3,22,4922
6,6,3,0,22,3,25,4922
7,7,3,0,25,3,28,4922
8,8,2,1,27,4,31,4922
9,9,4,1,31,5,36,4922
10,10,3,1,34,6,40,4922
11,11,0,0,34,6,40,4922
0,0,1,0,1,0,1,4923
1,1,1,0,2,0,2,4923
2,2,0,0,2,0,2,4923
0,0,1,0,1,0,1,4924
1,1,0,0,1,0,1,4924
0,0,1,0,1,0,1,4925
1,1,1,0,2,0,2,4925
2,2,1,0,3,0,3,4925
3,3,1,0,4,0,4,4925
4,4,0,0,4,0,4,4925
0,0,1,0,1,0,1,4926
1,1,1,1,2,1,3,4926
2,2,1,0,3,1,4,4926
3,3,0,0,3,1,4,4926
0,0,1,0,1,0,1,4927
1,1,0,0,1,0,1,4927
0,0,1,0,1,0,1,4928
1,1,1,0,2,0,2,4928
2,2,5,0,7,0,7,4928
3,3,2,0,9,0,9,4928
4,4,2,1,11,1,12,4928
5,5,0,1,11,2,13,4928
6,6,0,1,11,3,14,4928
7,7,1,1,12,4,16,4928
8,8,0,1,12,5,17,4928
9,9,0,0,12,5,17,4928
0,0,1,0,1,0,1,4929
1,1,0,0,1,0,1,4929
0,0,1,0,1,0,1,4930
1,1,0,0,1,0,1,4930
0,0,1,0,1,0,1,4931
1,1,0,0,1,0,1,4931
0,0,1,0,1,0,1,4932
1,1,0,0,1,0,1,4932
0,0,1,0,1,0,1,4933
1,1,0,0,1,0,1,4933
0,0,1,0,1,0,1,4934
1,1,0,0,1,0,1,4934
0,0,1,0,1,0,1,4935
1,1,0,2,1,2,3,4935
2,2,0,0,1,2,3,4935
0,0,1,0,1,0,1,4936
1,1,2,0,3,0,3,4936
2,2,3,1,6,1,7,4936
3,3,1,0,7,1,8,4936
4,4,0,0,7,1,8,4936
0,0,1,0,1,0,1,4937
1,1,1,0,2,0,2,4937
2,2,1,0,3,0,3,4937
3,3,2,1,5,1,6,4937
4,4,2,0,7,1,8,4937
5,5,1,0,8,1,9,4937
6,6,0,0,8,1,9,4937
0,0,1,0,1,0,1,4938
1,1,1,1,2,1,3,4938
2,2,1,0,3,1,4,4938
3,3,0,0,3,1,4,4938
0,0,1,0,1,0,1,4939
1,1,2,0,3,0,3,4939
2,2,3,1,6,1,7,4939
3,3,3,2,9,3,12,4939
4,4,6,1,15,4,19,4939
5,5,2,2,17,6,23,4939
6,6,1,0,18,6,24,4939
7,7,0,0,18,6,24,4939
0,0,1,0,1,0,1,4940
1,1,1,0,2,0,2,4940
2,2,1,1,3,1,4,4940
3,3,2,1,5,2,7,4940
4,4,0,3,5,5,10,4940
5,5,0,1,5,6,11,4940
6,6,0,0,5,6,11,4940
0,0,1,0,1,0,1,4941
1,1,1,0,2,0,2,4941
2,2,0,0,2,0,2,4941
0,0,1,0,1,0,1,4942
1,1,4,0,5,0,5,4942
2,2,3,0,8,0,8,4942
3,3,2,1,10,1,11,4942
4,4,2,0,12,1,13,4942
5,5,2,1,14,2,16,4942
6,6,2,0,16,2,18,4942
7,7,0,0,16,2,18,4942
0,0,1,0,1,0,1,4943
1,1,2,0,3,0,3,4943
2,2,1,0,4,0,4,4943
3,3,0,1,4,1,5,4943
4,4,0,1,4,2,6,4943
5,5,0,0,4,2,6,4943
0,0,1,0,1,0,1,4944
1,1,0,0,1,0,1,4944
0,0,1,0,1,0,1,4945
1,1,2,0,3,0,3,4945
2,2,0,0,3,0,3,4945
0,0,1,0,1,0,1,4946
1,1,0,0,1,0,1,4946
0,0,1,0,1,0,1,4947
1,1,0,0,1,0,1,4947
0,0,1,0,1,0,1,4948
1,1,1,1,2,1,3,4948
2,2,4,1,6,2,8,4948
3,3,4,3,10,5,15,4948
4,4,4,2,14,7,21,4948
5,5,3,1,17,8,25,4948
6,6,2,1,19,9,28,4948
7,7,4,0,23,9,32,4948
8,8,4,0,27,9,36,4948
9,9,2,1,29,10,39,4948
10,10,1,1,30,11,41,4948
11,11,1,2,31,13,44,4948
12,12,0,2,31,15,46,4948
13,13,0,5,31,20,51,4948
14,14,1,1,32,21,53,4948
15,15,0,0,32,21,53,4948
0,0,1,0,1,0,1,4949
1,1,0,0,1,0,1,4949
0,0,1,0,1,0,1,4950
1,1,0,0,1,0,1,4950
0,0,1,0,1,0,1,4951
1,1,0,0,1,0,1,4951
0,0,1,0,1,0,1,4952
1,1,2,0,3,0,3,4952
2,2,1,0,4,0,4,4952
3,3,1,0,5,0,5,4952
4,4,0,0,5,0,5,4952
0,0,1,0,1,0,1,4953
1,1,1,0,2,0,2,4953
2,2,1,0,3,0,3,4953
3,3,0,0,3,0,3,4953
0,0,1,0,1,0,1,4954
1,1,0,0,1,0,1,4954
0,0,1,0,1,0,1,4955
1,1,1,0,2,0,2,4955
2,2,1,0,3,0,3,4955
3,3,1,0,4,0,4,4955
4,4,1,0,5,0,5,4955
5,5,2,1,7,1,8,4955
6,6,0,1,7,2,9,4955
7,7,0,2,7,4,11,4955
8,8,1,1,8,5,13,4955
9,9,0,0,8,5,13,4955
0,0,1,0,1,0,1,4956
1,1,0,0,1,0,1,4956
0,0,1,0,1,0,1,4957
1,1,1,1,2,1,3,4957
2,2,1,0,3,1,4,4957
3,3,0,0,3,1,4,4957
0,0,1,0,1,0,1,4958
1,1,0,0,1,0,1,4958
0,0,1,0,1,0,1,4959
1,1,1,0,2,0,2,4959
2,2,1,0,3,0,3,4959
3,3,0,0,3,0,3,4959
0,0,1,0,1,0,1,4960
1,1,0,1,1,1,2,4960
2,2,0,0,1,1,2,4960
0,0,1,0,1,0,1,4961
1,1,1,0,2,0,2,4961
2,2,1,0,3,0,3,4961
3,3,1,0,4,0,4,4961
4,4,0,0,4,0,4,4961
0,0,1,0,1,0,1,4962
1,1,0,0,1,0,1,4962
0,0,1,0,1,0,1,4963
1,1,1,0,2,0,2,4963
2,2,0,1,2,1,3,4963
3,3,0,1,2,2,4,4963
4,4,0,1,2,3,5,4963
5,5,0,0,2,3,5,4963
0,0,1,0,1,0,1,4964
1,1,0,0,1,0,1,4964
0,0,1,0,1,0,1,4965
1,1,2,0,3,0,3,4965
2,2,2,1,5,1,6,4965
3,3,2,1,7,2,9,4965
4,4,2,2,9,4,13,4965
5,5,2,0,11,4,15,4965
6,6,0,0,11,4,15,4965
0,0,1,0,1,0,1,4966
1,1,1,0,2,0,2,4966
2,2,0,1,2,1,3,4966
3,3,1,1,3,2,5,4966
4,4,1,0,4,2,6,4966
5,5,1,0,5,2,7,4966
6,6,1,0,6,2,8,4966
7,7,2,0,8,2,10,4966
8,8,1,0,9,2,11,4966
9,9,2,0,11,2,13,4966
10,10,3,0,14,2,16,4966
11,11,3,1,17,3,20,4966
12,12,3,1,20,4,24,4966
13,13,2,0,22,4,26,4966
14,14,0,0,22,4,26,4966
0,0,1,0,1,0,1,4967
1,1,3,0,4,0,4,4967
2,2,1,1,5,1,6,4967
3,3,1,0,6,1,7,4967
4,4,2,0,8,1,9,4967
5,5,1,0,9,1,10,4967
6,6,2,0,11,1,12,4967
7,7,1,0,12,1,13,4967
8,8,0,0,12,1,13,4967
0,0,1,0,1,0,1,4968
1,1,1,0,2,0,2,4968
2,2,1,0,3,0,3,4968
3,3,1,0,4,0,4,4968
4,4,0,0,4,0,4,4968
0,0,1,0,1,0,1,4969
1,1,2,1,3,1,4,4969
2,2,1,3,4,4,8,4969
3,3,0,5,4,9,13,4969
4,4,1,2,5,11,16,4969
5,5,1,2,6,13,19,4969
6,6,2,3,8,16,24,4969
7,7,2,1,10,17,27,4969
8,8,1,2,11,19,30,4969
9,9,1,0,12,19,31,4969
10,10,1,0,13,19,32,4969
11,11,0,0,13,19,32,4969
0,0,1,0,1,0,1,4970
1,1,1,1,2,1,3,4970
2,2,2,1,4,2,6,4970
3,3,1,1,5,3,8,4970
4,4,1,0,6,3,9,4970
5,5,0,0,6,3,9,4970
0,0,1,0,1,0,1,4971
1,1,1,0,2,0,2,4971
2,2,1,0,3,0,3,4971
3,3,0,0,3,0,3,4971
0,0,1,0,1,0,1,4972
1,1,0,0,1,0,1,4972
0,0,1,0,1,0,1,4973
1,1,0,2,1,2,3,4973
2,2,1,2,2,4,6,4973
3,3,0,5,2,9,11,4973
4,4,0,3,2,12,14,4973
5,5,1,2,3,14,17,4973
6,6,0,1,3,15,18,4973
7,7,0,0,3,15,18,4973
0,0,1,0,1,0,1,4974
1,1,0,1,1,1,2,4974
2,2,0,1,1,2,3,4974
3,3,0,1,1,3,4,4974
4,4,1,0,2,3,5,4974
5,5,1,0,3,3,6,4974
6,6,2,0,5,3,8,4974
7,7,3,0,8,3,11,4974
8,8,2,0,10,3,13,4974
9,9,4,0,14,3,17,4974
10,10,4,2,18,5,23,4974
11,11,1,3,19,8,27,4974
12,12,0,2,19,10,29,4974
13,13,0,0,19,10,29,4974
0,0,1,0,1,0,1,4975
1,1,1,2,2,2,4,4975
2,2,1,0,3,2,5,4975
3,3,2,0,5,2,7,4975
4,4,0,1,5,3,8,4975
5,5,0,1,5,4,9,4975
6,6,0,1,5,5,10,4975
7,7,0,0,5,5,10,4975
0,0,1,0,1,0,1,4976
1,1,0,0,1,0,1,4976
0,0,1,0,1,0,1,4977
1,1,0,0,1,0,1,4977
0,0,1,0,1,0,1,4978
1,1,1,0,2,0,2,4978
2,2,1,0,3,0,3,4978
3,3,1,0,4,0,4,4978
4,4,1,0,5,0,5,4978
5,5,1,1,6,1,7,4978
6,6,0,0,6,1,7,4978
0,0,1,0,1,0,1,4979
1,1,1,0,2,0,2,4979
2,2,0,0,2,0,2,4979
0,0,1,0,1,0,1,4980
1,1,0,0,1,0,1,4980
0,0,1,0,1,0,1,4981
1,1,2,0,3,0,3,4981
2,2,1,0,4,0,4,4981
3,3,0,0,4,0,4,4981
0,0,1,0,1,0,1,4982
1,1,2,1,3,1,4,4982
2,2,2,1,5,2,7,4982
3,3,3,1,8,3,11,4982
4,4,2,2,10,5,15,4982
5,5,2,2,12,7,19,4982
6,6,1,1,13,8,21,4982
7,7,0,1,13,9,22,4982
8,8,0,2,13,11,24,4982
9,9,0,1,13,12,25,4982
10,10,0,0,13,12,25,4982
0,0,1,0,1,0,1,4983
1,1,0,0,1,0,1,4983
0,0,1,0,1,0,1,4984
1,1,1,0,2,0,2,4984
2,2,1,0,3,0,3,4984
3,3,1,0,4,0,4,4984
4,4,0,0,4,0,4,4984
0,0,1,0,1,0,1,4985
1,1,0,0,1,0,1,4985
0,0,1,0,1,0,1,4986
1,1,0,0,1,0,1,4986
0,0,1,0,1,0,1,4987
1,1,1,0,2,0,2,4987
2,2,2,0,4,0,4,4987
3,3,0,0,4,0,4,4987
0,0,1,0,1,0,1,4988
1,1,0,0,1,0,1,4988
0,0,1,0,1,0,1,4989
1,1,0,0,1,0,1,4989
0,0,1,0,1,0,1,4990
1,1,1,1,2,1,3,4990
2,2,1,1,3,2,5,4990
3,3,1,1,4,3,7,4990
4,4,1,1,5,4,9,4990
5,5,0,1,5,5,10,4990
6,6,0,0,5,5,10,4990
0,0,1,0,1,0,1,4991
1,1,1,0,2,0,2,4991
2,2,0,1,2,1,3,4991
3,3,0,0,2,1,3,4991
0,0,1,0,1,0,1,4992
1,1,2,0,3,0,3,4992
2,2,0,0,3,0,3,4992
0,0,1,0,1,0,1,4993
1,1,1,1,2,1,3,4993
2,2,2,1,4,2,6,4993
3,3,2,3,6,5,11,4993
4,4,1,2,7,7,14,4993
5,5,2,2,9,9,18,4993
6,6,1,2,10,11,21,4993
7,7,1,2,11,13,24,4993
8,8,1,1,12,14,26,4993
9,9,0,0,12,14,26,4993
0,0,1,0,1,0,1,4994
1,1,1,0,2,0,2,4994
2,2,0,0,2,0,2,4994
0,0,1,0,1,0,1,4995
1,1,0,1,1,1,2,4995
2,2,0,2,1,3,4,4995
3,3,1,3,2,6,8,4995
4,4,2,5,4,11,15,4995
5,5,3,2,7,13,20,4995
6,6,2,2,9,15,24,4995
7,7,1,1,10,16,26,4995
8,8,1,4,11,20,31,4995
9,9,1,3,12,23,35,4995
10,10,0,2,12,25,37,4995
11,11,0,0,12,25,37,4995
0,0,1,0,1,0,1,4996
1,1,1,0,2,0,2,4996
2,2,0,0,2,0,2,4996
0,0,1,0,1,0,1,4997
1,1,2,0,3,0,3,4997
2,2,2,1,5,1,6,4997
3,3,2,2,7,3,10,4997
4,4,1,2,8,5,13,4997
5,5,1,0,9,5,14,4997
6,6,1,0,10,5,15,4997
7,7,1,1,11,6,17,4997
8,8,0,3,11,9,20,4997
9,9,0,5,11,14,25,4997
10,10,0,5,11,19,30,4997
11,11,0,3,11,22,33,4997
12,12,0,0,11,22,33,4997
0,0,1,0,1,0,1,4998
1,1,2,0,3,0,3,4998
2,2,2,0,5,0,5,4998
3,3,2,0,7,0,7,4998
4,4,1,0,8,0,8,4998
5,5,2,0,10,0,10,4998
6,6,0,0,10,0,10,4998
0,0,1,0,1,0,1,4999
1,1,1,1,2,1,3,4999
2,2,2,1,4,2,6,4999
3,3,3,0,7,2,9,4999
4,4,2,1,9,3,12,4999
5,5,0,0,9,3,12,4999
0,0,1,0,1,0,1,5000
1,1,1,0,2,0,2,5000
2,2,0,0,2,0,2,5000
0,0,1,0,1,0,1,5001
1,1,0,0,1,0,1,5001
0,0,1,0,1,0,1,5002
1,1,1,0,2,0,2,5002
2,2,2,1,4,1,5,5002
3,3,2,0,6,1,7,5002
4,4,1,0,7,1,8,5002
5,5,1,0,8,1,9,5002
6,6,0,0,8,1,9,5002
0,0,1,0,1,0,1,5003
1,1,1,1,2,1,3,5003
2,2,1,0,3,1,4,5003
3,3,1,0,4,1,5,5003
4,4,1,1,5,2,7,5003
5,5,0,2,5,4,9,5003
6,6,0,2,5,6,11,5003
7,7,0,1,5,7,12,5003
8,8,0,1,5,8,13,5003
9,9,0,1,5,9,14,5003
10,10,0,1,5,10,15,5003
11,11,0,0,5,10,15,5003
0,0,1,0,1,0,1,5004
1,1,0,0,1,0,1,5004
0,0,1,0,1,0,1,5005
1,1,0,0,1,0,1,5005
0,0,1,0,1,0,1,5006
1,1,1,0,2,0,2,5006
2,2,2,0,4,0,4,5006
3,3,2,1,6,1,7,5006
4,4,1,0,7,1,8,5006
5,5,0,1,7,2,9,5006
6,6,0,0,7,2,9,5006
0,0,1,0,1,0,1,5007
1,1,1,0,2,0,2,5007
2,2,1,0,3,0,3,5007
3,3,1,0,4,0,4,5007
4,4,1,0,5,0,5,5007
5,5,0,0,5,0,5,5007
0,0,1,0,1,0,1,5008
1,1,0,0,1,0,1,5008
0,0,1,0,1,0,1,5009
1,1,0,0,1,0,1,5009
0,0,1,0,1,0,1,5010
1,1,0,0,1,0,1,5010
0,0,1,0,1,0,1,5011
1,1,1,0,2,0,2,5011
2,2,0,0,2,0,2,5011
0,0,1,0,1,0,1,5012
1,1,0,0,1,0,1,5012
0,0,1,0,1,0,1,5013
1,1,0,0,1,0,1,5013
0,0,1,0,1,0,1,5014
1,1,2,0,3,0,3,5014
2,2,3,0,6,0,6,5014
3,3,4,1,10,1,11,5014
4,4,3,2,13,3,16,5014
5,5,2,2,15,5,20,5014
6,6,1,2,16,7,23,5014
7,7,1,3,17,10,27,5014
8,8,1,2,18,12,30,5014
9,9,0,1,18,13,31,5014
10,10,0,1,18,14,32,5014
11,11,1,0,19,14,33,5014
12,12,1,0,20,14,34,5014
13,13,0,0,20,14,34,5014
0,0,1,0,1,0,1,5015
1,1,1,1,2,1,3,5015
2,2,1,0,3,1,4,5015
3,3,3,0,6,1,7,5015
4,4,1,0,7,1,8,5015
5,5,2,0,9,1,10,5015
6,6,1,0,10,1,11,5015
7,7,0,0,10,1,11,5015
0,0,1,0,1,0,1,5016
1,1,1,0,2,0,2,5016
2,2,0,0,2,0,2,5016
0,0,1,0,1,0,1,5017
1,1,1,1,2,1,3,5017
2,2,1,0,3,1,4,5017
3,3,1,0,4,1,5,5017
4,4,0,1,4,2,6,5017
5,5,0,2,4,4,8,5017
6,6,0,2,4,6,10,5017
7,7,1,0,5,6,11,5017
8,8,1,0,6,6,12,5017
9,9,0,0,6,6,12,5017
0,0,1,0,1,0,1,5018
1,1,0,0,1,0,1,5018
0,0,1,0,1,0,1,5019
1,1,0,0,1,0,1,5019
0,0,1,0,1,0,1,5020
1,1,1,0,2,0,2,5020
2,2,0,0,2,0,2,5020
0,0,1,0,1,0,1,5021
1,1,0,0,1,0,1,5021
0,0,1,0,1,0,1,5022
1,1,2,0,3,0,3,5022
2,2,1,0,4,0,4,5022
3,3,1,0,5,0,5,5022
4,4,2,0,7,0,7,5022
5,5,4,0,11,0,11,5022
6,6,6,0,17,0,17,5022
7,7,6,1,23,1,24,5022
8,8,5,2,28,3,31,5022
9,9,4,4,32,7,39,5022
10,10,6,3,38,10,48,5022
11,11,5,7,43,17,60,5022
12,12,5,4,48,21,69,5022
13,13,4,2,52,23,75,5022
14,14,2,3,54,26,80,5022
15,15,2,3,56,29,85,5022
16,16,0,0,56,29,85,5022
0,0,1,0,1,0,1,5023
1,1,0,0,1,0,1,5023
0,0,1,0,1,0,1,5024
1,1,2,0,3,0,3,5024
2,2,0,1,3,1,4,5024
3,3,0,1,3,2,5,5024
4,4,0,1,3,3,6,5024
5,5,0,1,3,4,7,5024
6,6,0,1,3,5,8,5024
7,7,0,1,3,6,9,5024
8,8,0,0,3,6,9,5024
0,0,1,0,1,0,1,5025
1,1,0,0,1,0,1,5025
0,0,1,0,1,0,1,5026
1,1,1,0,2,0,2,5026
2,2,0,0,2,0,2,5026
0,0,1,0,1,0,1,5027
1,1,1,0,2,0,2,5027
2,2,2,0,4,0,4,5027
3,3,0,0,4,0,4,5027
0,0,1,0,1,0,1,5028
1,1,0,0,1,0,1,5028
0,0,1,0,1,0,1,5029
1,1,0,2,1,2,3,5029
2,2,1,1,2,3,5,5029
3,3,1,0,3,3,6,5029
4,4,0,0,3,3,6,5029
0,0,1,0,1,0,1,5030
1,1,0,0,1,0,1,5030
0,0,1,0,1,0,1,5031
1,1,0,1,1,1,2,5031
2,2,0,0,1,1,2,5031
0,0,1,0,1,0,1,5032
1,1,0,0,1,0,1,5032
0,0,1,0,1,0,1,5033
1,1,0,0,1,0,1,5033
0,0,1,0,1,0,1,5034
1,1,1,0,2,0,2,5034
2,2,2,1,4,1,5,5034
3,3,3,0,7,1,8,5034
4,4,1,1,8,2,10,5034
5,5,1,0,9,2,11,5034
6,6,0,0,9,2,11,5034
0,0,1,0,1,0,1,5035
1,1,1,1,2,1,3,5035
2,2,3,1,5,2,7,5035
3,3,3,3,8,5,13,5035
4,4,1,2,9,7,16,5035
5,5,2,1,11,8,19,5035
6,6,1,0,12,8,20,5035
7,7,1,0,13,8,21,5035
8,8,1,0,14,8,22,5035
9,9,0,2,14,10,24,5035
10,10,0,1,14,11,25,5035
11,11,0,0,14,11,25,5035
0,0,1,0,1,0,1,5036
1,1,1,0,2,0,2,5036
2,2,0,0,2,0,2,5036
0,0,1,0,1,0,1,5037
1,1,0,1,1,1,2,5037
2,2,0,0,1,1,2,5037
0,0,1,0,1,0,1,5038
1,1,0,0,1,0,1,5038
0,0,1,0,1,0,1,5039
1,1,1,1,2,1,3,5039
2,2,0,1,2,2,4,5039
3,3,0,1,2,3,5,5039
4,4,0,0,2,3,5,5039
0,0,1,0,1,0,1,5040
1,1,1,0,2,0,2,5040
2,2,0,0,2,0,2,5040
0,0,1,0,1,0,1,5041
1,1,0,1,1,1,2,5041
2,2,0,0,1,1,2,5041
0,0,1,0,1,0,1,5042
1,1,0,0,1,0,1,5042
0,0,1,0,1,0,1,5043
1,1,0,0,1,0,1,5043
0,0,1,0,1,0,1,5044
1,1,2,0,3,0,3,5044
2,2,0,1,3,1,4,5044
3,3,1,1,4,2,6,5044
4,4,1,1,5,3,8,5044
5,5,1,1,6,4,10,5044
6,6,0,0,6,4,10,5044
0,0,1,0,1,0,1,5045
1,1,2,0,3,0,3,5045
2,2,1,0,4,0,4,5045
3,3,1,0,5,0,5,5045
4,4,0,0,5,0,5,5045
0,0,1,0,1,0,1,5046
1,1,1,0,2,0,2,5046
2,2,2,0,4,0,4,5046
3,3,1,1,5,1,6,5046
4,4,0,0,5,1,6,5046
0,0,1,0,1,0,1,5047
1,1,1,0,2,0,2,5047
2,2,0,0,2,0,2,5047
0,0,1,0,1,0,1,5048
1,1,1,0,2,0,2,5048
2,2,1,0,3,0,3,5048
3,3,0,0,3,0,3,5048
0,0,1,0,1,0,1,5049
1,1,1,0,2,0,2,5049
2,2,4,0,6,0,6,5049
3,3,5,1,11,1,12,5049
4,4,4,1,15,2,17,5049
5,5,0,2,15,4,19,5049
6,6,1,1,16,5,21,5049
7,7,1,0,17,5,22,5049
8,8,0,0,17,5,22,5049
0,0,1,0,1,0,1,5050
1,1,1,0,2,0,2,5050
2,2,0,1,2,1,3,5050
3,3,0,2,2,3,5,5050
4,4,0,3,2,6,8,5050
5,5,0,0,2,6,8,5050
0,0,1,0,1,0,1,5051
1,1,0,0,1,0,1,5051
0,0,1,0,1,0,1,5052
1,1,0,0,1,0,1,5052
0,0,1,0,1,0,1,5053
1,1,0,1,1,1,2,5053
2,2,0,0,1,1,2,5053
0,0,1,0,1,0,1,5054
1,1,0,1,1,1,2,5054
2,2,0,0,1,1,2,5054
0,0,1,0,1,0,1,5055
1,1,0,0,1,0,1,5055
0,0,1,0,1,0,1,5056
1,1,0,0,1,0,1,5056
0,0,1,0,1,0,1,5057
1,1,2,0,3,0,3,5057
2,2,1,1,4,1,5,5057
3,3,1,0,5,1,6,5057
4,4,3,0,8,1,9,5057
5,5,2,0,10,1,11,5057
6,6,1,1,11,2,13,5057
7,7,1,1,12,3,15,5057
8,8,0,0,12,3,15,5057
0,0,1,0,1,0,1,5058
1,1,1,0,2,0,2,5058
2,2,2,0,4,0,4,5058
3,3,2,0,6,0,6,5058
4,4,3,0,9,0,9,5058
5,5,3,1,12,1,13,5058
6,6,3,0,15,1,16,5058
7,7,2,0,17,1,18,5058
8,8,2,0,19,1,20,5058
9,9,2,0,21,1,22,5058
10,10,4,0,25,1,26,5058
11,11,3,1,28,2,30,5058
12,12,5,0,33,2,35,5058
13,13,1,0,34,2,36,5058
14,14,2,0,36,2,38,5058
15,15,1,1,37,3,40,5058
16,16,0,0,37,3,40,5058
0,0,1,0,1,0,1,5059
1,1,1,0,2,0,2,5059
2,2,1,0,3,0,3,5059
3,3,0,0,3,0,3,5059
0,0,1,0,1,0,1,5060
1,1,0,0,1,0,1,5060
0,0,1,0,1,0,1,5061
1,1,2,0,3,0,3,5061
2,2,3,0,6,0,6,5061
3,3,5,0,11,0,11,5061
4,4,3,0,14,0,14,5061
5,5,4,1,18,1,19,5061
6,6,2,1,20,2,22,5061
7,7,0,0,20,2,22,5061
0,0,1,0,1,0,1,5062
1,1,0,0,1,0,1,5062
0,0,1,0,1,0,1,5063
1,1,0,0,1,0,1,5063
0,0,1,0,1,0,1,5064
1,1,1,0,2,0,2,5064
2,2,0,0,2,0,2,5064
0,0,1,0,1,0,1,5065
1,1,2,0,3,0,3,5065
2,2,1,0,4,0,4,5065
3,3,1,0,5,0,5,5065
4,4,0,0,5,0,5,5065
0,0,1,0,1,0,1,5066
1,1,0,1,1,1,2,5066
2,2,0,0,1,1,2,5066
0,0,1,0,1,0,1,5067
1,1,0,0,1,0,1,5067
0,0,1,0,1,0,1,5068
1,1,0,1,1,1,2,5068
2,2,0,3,1,4,5,5068
3,3,1,5,2,9,11,5068
4,4,2,6,4,15,19,5068
5,5,2,1,6,16,22,5068
6,6,0,0,6,16,22,5068
0,0,1,0,1,0,1,5069
1,1,0,0,1,0,1,5069
0,0,1,0,1,0,1,5070
1,1,1,1,2,1,3,5070
2,2,0,0,2,1,3,5070
0,0,1,0,1,0,1,5071
1,1,1,0,2,0,2,5071
2,2,3,0,5,0,5,5071
3,3,3,0,8,0,8,5071
4,4,4,1,12,1,13,5071
5,5,5,2,17,3,20,5071
6,6,6,1,23,4,27,5071
7,7,5,0,28,4,32,5071
8,8,5,1,33,5,38,5071
9,9,3,1,36,6,42,5071
10,10,1,1,37,7,44,5071
11,11,1,0,38,7,45,5071
12,12,0,0,38,7,45,5071
0,0,1,0,1,0,1,5072
1,1,2,0,3,0,3,5072
2,2,2,0,5,0,5,5072
3,3,1,1,6,1,7,5072
4,4,1,1,7,2,9,5072
5,5,0,1,7,3,10,5072
6,6,1,0,8,3,11,5072
7,7,2,0,10,3,13,5072
8,8,1,3,11,6,17,5072
9,9,1,3,12,9,21,5072
10,10,0,3,12,12,24,5072
11,11,1,2,13,14,27,5072
12,12,2,0,15,14,29,5072
13,13,3,0,18,14,32,5072
14,14,4,1,22,15,37,5072
15,15,4,1,26,16,42,5072
16,16,1,2,27,18,45,5072
17,17,2,2,29,20,49,5072
18,18,0,2,29,22,51,5072
19,19,1,1,30,23,53,5072
20,20,1,0,31,23,54,5072
21,21,2,1,33,24,57,5072
22,22,5,0,38,24,62,5072
23,23,3,4,41,28,69,5072
24,24,4,2,45,30,75,5072
25,25,4,3,49,33,82,5072
26,26,4,4,53,37,90,5072
27,27,1,2,54,39,93,5072
28,28,3,2,57,41,98,5072
29,29,5,3,62,44,106,5072
30,30,5,3,67,47,114,5072
31,31,9,1,76,48,124,5072
32,32,6,1,82,49,131,5072
33,33,7,0,89,49,138,5072
34,34,5,1,94,50,144,5072
35,35,4,2,98,52,150,5072
36,36,3,2,101,54,155,5072
37,37,1,3,102,57,159,5072
38,38,0,2,102,59,161,5072
39,39,1,2,103,61,164,5072
40,40,0,5,103,66,169,5072
41,41,1,4,104,70,174,5072
42,42,2,3,106,73,179,5072
43,43,1,2,107,75,182,5072
44,44,1,3,108,78,186,5072
45,45,2,2,110,80,190,5072
46,46,2,1,112,81,193,5072
47,47,0,1,112,82,194,5072
48,48,0,2,112,84,196,5072
49,49,0,1,112,85,197,5072
50,50,0,0,112,85,197,5072
0,0,1,0,1,0,1,5073
1,1,1,0,2,0,2,5073
2,2,0,0,2,0,2,5073
0,0,1,0,1,0,1,5074
1,1,0,0,1,0,1,5074
0,0,1,0,1,0,1,5075
1,1,1,1,2,1,3,5075
2,2,0,0,2,1,3,5075
0,0,1,0,1,0,1,5076
1,1,0,0,1,0,1,5076
0,0,1,0,1,0,1,5077
1,1,0,0,1,0,1,5077
0,0,1,0,1,0,1,5078
1,1,1,0,2,0,2,5078
2,2,1,0,3,0,3,5078
3,3,1,0,4,0,4,5078
4,4,1,0,5,0,5,5078
5,5,3,1,8,1,9,5078
6,6,2,1,10,2,12,5078
7,7,0,0,10,2,12,5078
0,0,1,0,1,0,1,5079
1,1,1,0,2,0,2,5079
2,2,1,0,3,0,3,5079
3,3,0,0,3,0,3,5079
0,0,1,0,1,0,1,5080
1,1,1,0,2,0,2,5080
2,2,0,0,2,0,2,5080
0,0,1,0,1,0,1,5081
1,1,0,0,1,0,1,5081
0,0,1,0,1,0,1,5082
1,1,2,0,3,0,3,5082
2,2,0,1,3,1,4,5082
3,3,0,0,3,1,4,5082
0,0,1,0,1,0,1,5083
1,1,0,0,1,0,1,5083
0,0,1,0,1,0,1,5084
1,1,1,0,2,0,2,5084
2,2,1,0,3,0,3,5084
3,3,3,0,6,0,6,5084
4,4,3,1,9,1,10,5084
5,5,4,0,13,1,14,5084
6,6,0,1,13,2,15,5084
7,7,1,2,14,4,18,5084
8,8,3,4,17,8,25,5084
9,9,1,4,18,12,30,5084
10,10,1,3,19,15,34,5084
11,11,2,5,21,20,41,5084
12,12,6,4,27,24,51,5084
13,13,3,6,30,30,60,5084
14,14,1,5,31,35,66,5084
15,15,2,1,33,36,69,5084
16,16,1,0,34,36,70,5084
17,17,1,0,35,36,71,5084
18,18,0,0,35,36,71,5084
0,0,1,0,1,0,1,5085
1,1,1,0,2,0,2,5085
2,2,0,1,2,1,3,5085
3,3,0,0,2,1,3,5085
0,0,1,0,1,0,1,5086
1,1,0,0,1,0,1,5086
0,0,1,0,1,0,1,5087
1,1,1,0,2,0,2,5087
2,2,1,0,3,0,3,5087
3,3,0,0,3,0,3,5087
0,0,1,0,1,0,1,5088
1,1,1,0,2,0,2,5088
2,2,0,1,2,1,3,5088
3,3,0,0,2,1,3,5088
0,0,1,0,1,0,1,5089
1,1,1,0,2,0,2,5089
2,2,0,0,2,0,2,5089
0,0,1,0,1,0,1,5090
1,1,0,1,1,1,2,5090
2,2,0,0,1,1,2,5090
0,0,1,0,1,0,1,5091
1,1,0,2,1,2,3,5091
2,2,0,0,1,2,3,5091
0,0,1,0,1,0,1,5092
1,1,2,0,3,0,3,5092
2,2,0,0,3,0,3,5092
0,0,1,0,1,0,1,5093
1,1,0,0,1,0,1,5093
0,0,1,0,1,0,1,5094
1,1,1,0,2,0,2,5094
2,2,2,1,4,1,5,5094
3,3,1,0,5,1,6,5094
4,4,1,0,6,1,7,5094
5,5,1,0,7,1,8,5094
6,6,0,0,7,1,8,5094
0,0,1,0,1,0,1,5095
1,1,0,0,1,0,1,5095
0,0,1,0,1,0,1,5096
1,1,2,0,3,0,3,5096
2,2,4,0,7,0,7,5096
3,3,2,1,9,1,10,5096
4,4,1,2,10,3,13,5096
5,5,0,2,10,5,15,5096
6,6,1,1,11,6,17,5096
7,7,2,0,13,6,19,5096
8,8,1,1,14,7,21,5096
9,9,1,2,15,9,24,5096
10,10,1,3,16,12,28,5096
11,11,1,3,17,15,32,5096
12,12,0,0,17,15,32,5096
0,0,1,0,1,0,1,5097
1,1,2,0,3,0,3,5097
2,2,2,0,5,0,5,5097
3,3,1,0,6,0,6,5097
4,4,1,0,7,0,7,5097
5,5,0,0,7,0,7,5097
0,0,1,0,1,0,1,5098
1,1,0,1,1,1,2,5098
2,2,0,1,1,2,3,5098
3,3,0,0,1,2,3,5098
0,0,1,0,1,0,1,5099
1,1,1,0,2,0,2,5099
2,2,0,1,2,1,3,5099
3,3,0,2,2,3,5,5099
4,4,0,1,2,4,6,5099
5,5,1,1,3,5,8,5099
6,6,0,0,3,5,8,5099
0,0,1,0,1,0,1,5100
1,1,0,0,1,0,1,5100
0,0,1,0,1,0,1,5101
1,1,3,0,4,0,4,5101
2,2,2,1,6,1,7,5101
3,3,0,2,6,3,9,5101
4,4,0,1,6,4,10,5101
5,5,0,1,6,5,11,5101
6,6,0,1,6,6,12,5101
7,7,0,0,6,6,12,5101
0,0,1,0,1,0,1,5102
1,1,0,0,1,0,1,5102
0,0,1,0,1,0,1,5103
1,1,0,1,1,1,2,5103
2,2,0,0,1,1,2,5103
0,0,1,0,1,0,1,5104
1,1,0,1,1,1,2,5104
2,2,0,0,1,1,2,5104
0,0,1,0,1,0,1,5105
1,1,0,1,1,1,2,5105
2,2,0,2,1,3,4,5105
3,3,1,1,2,4,6,5105
4,4,2,2,4,6,10,5105
5,5,1,3,5,9,14,5105
6,6,0,0,5,9,14,5105
0,0,1,0,1,0,1,5106
1,1,1,0,2,0,2,5106
2,2,0,0,2,0,2,5106
0,0,1,0,1,0,1,5107
1,1,1,0,2,0,2,5107
2,2,0,0,2,0,2,5107
0,0,1,0,1,0,1,5108
1,1,1,0,2,0,2,5108
2,2,0,1,2,1,3,5108
3,3,1,0,3,1,4,5108
4,4,0,0,3,1,4,5108
0,0,1,0,1,0,1,5109
1,1,0,0,1,0,1,5109
0,0,1,0,1,0,1,5110
1,1,0,1,1,1,2,5110
2,2,0,2,1,3,4,5110
3,3,1,3,2,6,8,5110
4,4,1,2,3,8,11,5110
5,5,1,3,4,11,15,5110
6,6,3,1,7,12,19,5110
7,7,0,1,7,13,20,5110
8,8,0,0,7,13,20,5110
0,0,1,0,1,0,1,5111
1,1,1,0,2,0,2,5111
2,2,0,0,2,0,2,5111
0,0,1,0,1,0,1,5112
1,1,2,0,3,0,3,5112
2,2,2,0,5,0,5,5112
3,3,1,0,6,0,6,5112
4,4,0,0,6,0,6,5112
0,0,1,0,1,0,1,5113
1,1,0,0,1,0,1,5113
0,0,1,0,1,0,1,5114
1,1,1,0,2,0,2,5114
2,2,0,0,2,0,2,5114
0,0,1,0,1,0,1,5115
1,1,1,0,2,0,2,5115
2,2,1,0,3,0,3,5115
3,3,2,0,5,0,5,5115
4,4,3,1,8,1,9,5115
5,5,2,2,10,3,13,5115
6,6,0,3,10,6,16,5115
7,7,0,3,10,9,19,5115
8,8,1,1,11,10,21,5115
9,9,0,1,11,11,22,5115
10,10,0,0,11,11,22,5115
0,0,1,0,1,0,1,5116
1,1,0,2,1,2,3,5116
2,2,0,2,1,4,5,5116
3,3,0,2,1,6,7,5116
4,4,1,3,2,9,11,5116
5,5,2,3,4,12,16,5116
6,6,1,0,5,12,17,5116
7,7,2,0,7,12,19,5116
8,8,4,1,11,13,24,5116
9,9,3,1,14,14,28,5116
10,10,2,0,16,14,30,5116
11,11,0,0,16,14,30,5116
0,0,1,0,1,0,1,5117
1,1,0,0,1,0,1,5117
0,0,1,0,1,0,1,5118
1,1,3,0,4,0,4,5118
2,2,2,3,6,3,9,5118
3,3,4,2,10,5,15,5118
4,4,7,6,17,11,28,5118
5,5,2,7,19,18,37,5118
6,6,2,5,21,23,44,5118
7,7,4,6,25,29,54,5118
8,8,5,7,30,36,66,5118
9,9,2,6,32,42,74,5118
10,10,2,4,34,46,80,5118
11,11,2,8,36,54,90,5118
12,12,5,6,41,60,101,5118
13,13,3,8,44,68,112,5118
14,14,3,3,47,71,118,5118
15,15,1,1,48,72,120,5118
16,16,1,0,49,72,121,5118
17,17,1,1,50,73,123,5118
18,18,1,0,51,73,124,5118
19,19,0,0,51,73,124,5118
0,0,1,0,1,0,1,5119
1,1,1,1,2,1,3,5119
2,2,2,0,4,1,5,5119
3,3,1,0,5,1,6,5119
4,4,1,0,6,1,7,5119
5,5,0,0,6,1,7,5119
0,0,1,0,1,0,1,5120
1,1,0,0,1,0,1,5120
0,0,1,0,1,0,1,5121
1,1,1,0,2,0,2,5121
2,2,0,0,2,0,2,5121
0,0,1,0,1,0,1,5122
1,1,1,0,2,0,2,5122
2,2,0,0,2,0,2,5122
0,0,1,0,1,0,1,5123
1,1,1,0,2,0,2,5123
2,2,1,0,3,0,3,5123
3,3,0,0,3,0,3,5123
0,0,1,0,1,0,1,5124
1,1,0,0,1,0,1,5124
0,0,1,0,1,0,1,5125
1,1,0,0,1,0,1,5125
0,0,1,0,1,0,1,5126
1,1,3,0,4,0,4,5126
2,2,1,0,5,0,5,5126
3,3,1,0,6,0,6,5126
4,4,0,0,6,0,6,5126
0,0,1,0,1,0,1,5127
1,1,0,0,1,0,1,5127
0,0,1,0,1,0,1,5128
1,1,1,0,2,0,2,5128
2,2,0,0,2,0,2,5128
0,0,1,0,1,0,1,5129
1,1,0,0,1,0,1,5129
0,0,1,0,1,0,1,5130
1,1,3,0,4,0,4,5130
2,2,1,0,5,0,5,5130
3,3,0,0,5,0,5,5130
0,0,1,0,1,0,1,5131
1,1,1,0,2,0,2,5131
2,2,0,0,2,0,2,5131
0,0,1,0,1,0,1,5132
1,1,1,1,2,1,3,5132
2,2,2,1,4,2,6,5132
3,3,2,2,6,4,10,5132
4,4,1,1,7,5,12,5132
5,5,1,0,8,5,13,5132
6,6,0,0,8,5,13,5132
0,0,1,0,1,0,1,5133
1,1,1,0,2,0,2,5133
2,2,0,0,2,0,2,5133
0,0,1,0,1,0,1,5134
1,1,0,0,1,0,1,5134
0,0,1,0,1,0,1,5135
1,1,0,0,1,0,1,5135
0,0,1,0,1,0,1,5136
1,1,0,0,1,0,1,5136
0,0,1,0,1,0,1,5137
1,1,0,0,1,0,1,5137
0,0,1,0,1,0,1,5138
1,1,1,0,2,0,2,5138
2,2,0,0,2,0,2,5138
0,0,1,0,1,0,1,5139
1,1,0,0,1,0,1,5139
0,0,1,0,1,0,1,5140
1,1,0,0,1,0,1,5140
0,0,1,0,1,0,1,5141
1,1,2,0,3,0,3,5141
2,2,2,1,5,1,6,5141
3,3,5,2,10,3,13,5141
4,4,6,3,16,6,22,5141
5,5,4,2,20,8,28,5141
6,6,2,2,22,10,32,5141
7,7,0,5,22,15,37,5141
8,8,0,3,22,18,40,5141
9,9,2,2,24,20,44,5141
10,10,0,2,24,22,46,5141
11,11,1,2,25,24,49,5141
12,12,0,0,25,24,49,5141
0,0,1,0,1,0,1,5142
1,1,1,0,2,0,2,5142
2,2,0,1,2,1,3,5142
3,3,0,1,2,2,4,5142
4,4,1,1,3,3,6,5142
5,5,0,1,3,4,7,5142
6,6,0,0,3,4,7,5142
0,0,1,0,1,0,1,5143
1,1,0,0,1,0,1,5143
0,0,1,0,1,0,1,5144
1,1,0,1,1,1,2,5144
2,2,1,0,2,1,3,5144
3,3,1,0,3,1,4,5144
4,4,0,0,3,1,4,5144
0,0,1,0,1,0,1,5145
1,1,0,1,1,1,2,5145
2,2,0,3,1,4,5,5145
3,3,0,4,1,8,9,5145
4,4,0,3,1,11,12,5145
5,5,0,3,1,14,15,5145
6,6,0,3,1,17,18,5145
7,7,0,2,1,19,20,5145
8,8,0,4,1,23,24,5145
9,9,0,5,1,28,29,5145
10,10,1,1,2,29,31,5145
11,11,1,1,3,30,33,5145
12,12,1,1,4,31,35,5145
13,13,1,2,5,33,38,5145
14,14,3,2,8,35,43,5145
15,15,3,4,11,39,50,5145
16,16,4,1,15,40,55,5145
17,17,7,1,22,41,63,5145
18,18,2,2,24,43,67,5145
19,19,2,4,26,47,73,5145
20,20,0,1,26,48,74,5145
21,21,0,0,26,48,74,5145
0,0,1,0,1,0,1,5146
1,1,2,0,3,0,3,5146
2,2,1,1,4,1,5,5146
3,3,1,0,5,1,6,5146
4,4,0,0,5,1,6,5146
0,0,1,0,1,0,1,5147
1,1,1,0,2,0,2,5147
2,2,0,1,2,1,3,5147
3,3,1,0,3,1,4,5147
4,4,0,0,3,1,4,5147
0,0,1,0,1,0,1,5148
1,1,1,0,2,0,2,5148
2,2,0,1,2,1,3,5148
3,3,0,0,2,1,3,5148
0,0,1,0,1,0,1,5149
1,1,0,0,1,0,1,5149
0,0,1,0,1,0,1,5150
1,1,0,1,1,1,2,5150
2,2,0,1,1,2,3,5150
3,3,0,0,1,2,3,5150
0,0,1,0,1,0,1,5151
1,1,0,0,1,0,1,5151
0,0,1,0,1,0,1,5152
1,1,0,0,1,0,1,5152
0,0,1,0,1,0,1,5153
1,1,1,0,2,0,2,5153
2,2,2,1,4,1,5,5153
3,3,1,0,5,1,6,5153
4,4,0,0,5,1,6,5153
0,0,1,0,1,0,1,5154
1,1,1,0,2,0,2,5154
2,2,1,0,3,0,3,5154
3,3,2,0,5,0,5,5154
4,4,1,0,6,0,6,5154
5,5,2,1,8,1,9,5154
6,6,2,3,10,4,14,5154
7,7,3,2,13,6,19,5154
8,8,2,2,15,8,23,5154
9,9,3,2,18,10,28,5154
10,10,1,3,19,13,32,5154
11,11,1,2,20,15,35,5154
12,12,0,1,20,16,36,5154
13,13,0,0,20,16,36,5154
0,0,1,0,1,0,1,5155
1,1,1,0,2,0,2,5155
2,2,0,0,2,0,2,5155
0,0,1,0,1,0,1,5156
1,1,0,0,1,0,1,5156
0,0,1,0,1,0,1,5157
1,1,0,0,1,0,1,5157
0,0,1,0,1,0,1,5158
1,1,0,1,1,1,2,5158
2,2,0,2,1,3,4,5158
3,3,0,3,1,6,7,5158
4,4,0,5,1,11,12,5158
5,5,0,1,1,12,13,5158
6,6,0,1,1,13,14,5158
7,7,0,0,1,13,14,5158
0,0,1,0,1,0,1,5159
1,1,2,1,3,1,4,5159
2,2,0,4,3,5,8,5159
3,3,0,4,3,9,12,5159
4,4,0,0,3,9,12,5159
0,0,1,0,1,0,1,5160
1,1,1,0,2,0,2,5160
2,2,1,0,3,0,3,5160
3,3,1,0,4,0,4,5160
4,4,1,1,5,1,6,5160
5,5,0,0,5,1,6,5160
0,0,1,0,1,0,1,5161
1,1,2,0,3,0,3,5161
2,2,2,0,5,0,5,5161
3,3,2,1,7,1,8,5161
4,4,2,1,9,2,11,5161
5,5,2,1,11,3,14,5161
6,6,1,0,12,3,15,5161
7,7,1,0,13,3,16,5161
8,8,2,1,15,4,19,5161
9,9,0,2,15,6,21,5161
10,10,0,3,15,9,24,5161
11,11,0,3,15,12,27,5161
12,12,1,0,16,12,28,5161
13,13,2,0,18,12,30,5161
14,14,1,0,19,12,31,5161
15,15,0,0,19,12,31,5161
0,0,1,0,1,0,1,5162
1,1,2,0,3,0,3,5162
2,2,1,0,4,0,4,5162
3,3,0,0,4,0,4,5162
0,0,1,0,1,0,1,5163
1,1,0,0,1,0,1,5163
0,0,1,0,1,0,1,5164
1,1,2,0,3,0,3,5164
2,2,2,0,5,0,5,5164
3,3,0,2,5,2,7,5164
4,4,0,1,5,3,8,5164
5,5,2,1,7,4,11,5164
6,6,2,2,9,6,15,5164
7,7,1,0,10,6,16,5164
8,8,1,0,11,6,17,5164
9,9,0,0,11,6,17,5164
0,0,1,0,1,0,1,5165
1,1,1,1,2,1,3,5165
2,2,1,0,3,1,4,5165
3,3,0,0,3,1,4,5165
0,0,1,0,1,0,1,5166
1,1,1,0,2,0,2,5166
2,2,2,0,4,0,4,5166
3,3,0,0,4,0,4,5166
0,0,1,0,1,0,1,5167
1,1,0,0,1,0,1,5167
0,0,1,0,1,0,1,5168
1,1,1,0,2,0,2,5168
2,2,0,0,2,0,2,5168
0,0,1,0,1,0,1,5169
1,1,1,1,2,1,3,5169
2,2,2,0,4,1,5,5169
3,3,1,0,5,1,6,5169
4,4,4,0,9,1,10,5169
5,5,3,0,12,1,13,5169
6,6,5,0,17,1,18,5169
7,7,4,0,21,1,22,5169
8,8,3,1,24,2,26,5169
9,9,4,1,28,3,31,5169
10,10,3,1,31,4,35,5169
11,11,1,0,32,4,36,5169
12,12,0,0,32,4,36,5169
0,0,1,0,1,0,1,5170
1,1,0,0,1,0,1,5170
0,0,1,0,1,0,1,5171
1,1,0,0,1,0,1,5171
0,0,1,0,1,0,1,5172
1,1,1,0,2,0,2,5172
2,2,1,1,3,1,4,5172
3,3,0,2,3,3,6,5172
4,4,0,0,3,3,6,5172
0,0,1,0,1,0,1,5173
1,1,1,0,2,0,2,5173
2,2,2,0,4,0,4,5173
3,3,2,1,6,1,7,5173
4,4,3,1,9,2,11,5173
5,5,1,2,10,4,14,5173
6,6,0,2,10,6,16,5173
7,7,1,2,11,8,19,5173
8,8,0,2,11,10,21,5173
9,9,2,1,13,11,24,5173
10,10,2,0,15,11,26,5173
11,11,2,0,17,11,28,5173
12,12,1,0,18,11,29,5173
13,13,0,0,18,11,29,5173
0,0,1,0,1,0,1,5174
1,1,1,0,2,0,2,5174
2,2,1,0,3,0,3,5174
3,3,2,0,5,0,5,5174
4,4,1,0,6,0,6,5174
5,5,3,0,9,0,9,5174
6,6,2,0,11,0,11,5174
7,7,1,0,12,0,12,5174
8,8,0,0,12,0,12,5174
0,0,1,0,1,0,1,5175
1,1,1,0,2,0,2,5175
2,2,0,0,2,0,2,5175
0,0,1,0,1,0,1,5176
1,1,0,0,1,0,1,5176
0,0,1,0,1,0,1,5177
1,1,0,0,1,0,1,5177
0,0,1,0,1,0,1,5178
1,1,2,1,3,1,4,5178
2,2,1,2,4,3,7,5178
3,3,1,1,5,4,9,5178
4,4,1,0,6,4,10,5178
5,5,2,0,8,4,12,5178
6,6,2,0,10,4,14,5178
7,7,2,0,12,4,16,5178
8,8,1,0,13,4,17,5178
9,9,0,0,13,4,17,5178
0,0,1,0,1,0,1,5179
1,1,1,0,2,0,2,5179
2,2,0,1,2,1,3,5179
3,3,0,0,2,1,3,5179
0,0,1,0,1,0,1,5180
1,1,1,0,2,0,2,5180
2,2,1,0,3,0,3,5180
3,3,1,1,4,1,5,5180
4,4,3,2,7,3,10,5180
5,5,2,2,9,5,14,5180
6,6,1,0,10,5,15,5180
7,7,1,1,11,6,17,5180
8,8,2,0,13,6,19,5180
9,9,1,1,14,7,21,5180
10,10,1,1,15,8,23,5180
11,11,2,3,17,11,28,5180
12,12,0,3,17,14,31,5180
13,13,1,5,18,19,37,5180
14,14,2,8,20,27,47,5180
15,15,0,2,20,29,49,5180
16,16,0,4,20,33,53,5180
17,17,0,7,20,40,60,5180
18,18,1,1,21,41,62,5180
19,19,0,1,21,42,63,5180
20,20,0,1,21,43,64,5180
21,21,0,1,21,44,65,5180
22,22,0,2,21,46,67,5180
23,23,0,5,21,51,72,5180
24,24,2,5,23,56,79,5180
25,25,6,2,29,58,87,5180
26,26,3,1,32,59,91,5180
27,27,2,2,34,61,95,5180
28,28,4,0,38,61,99,5180
29,29,2,0,40,61,101,5180
30,30,1,1,41,62,103,5180
31,31,1,1,42,63,105,5180
32,32,2,0,44,63,107,5180
33,33,1,0,45,63,108,5180
34,34,0,0,45,63,108,5180
0,0,1,0,1,0,1,5181
1,1,2,0,3,0,3,5181
2,2,2,0,5,0,5,5181
3,3,5,0,10,0,10,5181
4,4,1,1,11,1,12,5181
5,5,2,1,13,2,15,5181
6,6,1,0,14,2,16,5181
7,7,2,0,16,2,18,5181
8,8,3,1,19,3,22,5181
9,9,1,3,20,6,26,5181
10,10,0,1,20,7,27,5181
11,11,0,1,20,8,28,5181
12,12,0,0,20,8,28,5181
0,0,1,0,1,0,1,5182
1,1,2,0,3,0,3,5182
2,2,3,1,6,1,7,5182
3,3,2,0,8,1,9,5182
4,4,2,0,10,1,11,5182
5,5,0,1,10,2,12,5182
6,6,0,0,10,2,12,5182
0,0,1,0,1,0,1,5183
1,1,0,0,1,0,1,5183
0,0,1,0,1,0,1,5184
1,1,0,0,1,0,1,5184
0,0,1,0,1,0,1,5185
1,1,0,0,1,0,1,5185
0,0,1,0,1,0,1,5186
1,1,0,0,1,0,1,5186
0,0,1,0,1,0,1,5187
1,1,0,1,1,1,2,5187
2,2,1,0,2,1,3,5187
3,3,0,0,2,1,3,5187
0,0,1,0,1,0,1,5188
1,1,1,0,2,0,2,5188
2,2,2,1,4,1,5,5188
3,3,2,0,6,1,7,5188
4,4,0,0,6,1,7,5188
0,0,1,0,1,0,1,5189
1,1,0,1,1,1,2,5189
2,2,0,0,1,1,2,5189
0,0,1,0,1,0,1,5190
1,1,0,0,1,0,1,5190
0,0,1,0,1,0,1,5191
1,1,1,0,2,0,2,5191
2,2,0,0,2,0,2,5191
0,0,1,0,1,0,1,5192
1,1,0,0,1,0,1,5192
0,0,1,0,1,0,1,5193
1,1,2,0,3,0,3,5193
2,2,0,1,3,1,4,5193
3,3,0,1,3,2,5,5193
4,4,0,2,3,4,7,5193
5,5,0,2,3,6,9,5193
6,6,0,1,3,7,10,5193
7,7,0,1,3,8,11,5193
8,8,1,1,4,9,13,5193
9,9,0,1,4,10,14,5193
10,10,0,0,4,10,14,5193
0,0,1,0,1,0,1,5194
1,1,1,1,2,1,3,5194
2,2,0,1,2,2,4,5194
3,3,0,0,2,2,4,5194
0,0,1,0,1,0,1,5195
1,1,0,1,1,1,2,5195
2,2,0,1,1,2,3,5195
3,3,0,2,1,4,5,5195
4,4,0,1,1,5,6,5195
5,5,1,0,2,5,7,5195
6,6,0,0,2,5,7,5195
0,0,1,0,1,0,1,5196
1,1,1,0,2,0,2,5196
2,2,0,1,2,1,3,5196
3,3,0,0,2,1,3,5196
0,0,1,0,1,0,1,5197
1,1,1,0,2,0,2,5197
2,2,0,0,2,0,2,5197
0,0,1,0,1,0,1,5198
1,1,0,0,1,0,1,5198
0,0,1,0,1,0,1,5199
1,1,0,0,1,0,1,5199
0,0,1,0,1,0,1,5200
1,1,0,0,1,0,1,5200
0,0,1,0,1,0,1,5201
1,1,2,1,3,1,4,5201
2,2,4,4,7,5,12,5201
3,3,1,2,8,7,15,5201
4,4,2,0,10,7,17,5201
5,5,1,0,11,7,18,5201
6,6,2,0,13,7,20,5201
7,7,1,0,14,7,21,5201
8,8,0,0,14,7,21,5201
0,0,1,0,1,0,1,5202
1,1,1,0,2,0,2,5202
2,2,1,0,3,0,3,5202
3,3,0,0,3,0,3,5202
0,0,1,0,1,0,1,5203
1,1,0,1,1,1,2,5203
2,2,0,2,1,3,4,5203
3,3,0,2,1,5,6,5203
4,4,0,1,1,6,7,5203
5,5,0,0,1,6,7,5203
0,0,1,0,1,0,1,5204
1,1,2,0,3,0,3,5204
2,2,3,1,6,1,7,5204
3,3,1,0,7,1,8,5204
4,4,0,0,7,1,8,5204
0,0,1,0,1,0,1,5205
1,1,0,0,1,0,1,5205
0,0,1,0,1,0,1,5206
1,1,1,1,2,1,3,5206
2,2,1,1,3,2,5,5206
3,3,1,1,4,3,7,5206
4,4,1,0,5,3,8,5206
5,5,1,0,6,3,9,5206
6,6,1,0,7,3,10,5206
7,7,0,0,7,3,10,5206
0,0,1,0,1,0,1,5207
1,1,1,0,2,0,2,5207
2,2,0,0,2,0,2,5207
0,0,1,0,1,0,1,5208
1,1,0,1,1,1,2,5208
2,2,1,1,2,2,4,5208
3,3,0,0,2,2,4,5208
0,0,1,0,1,0,1,5209
1,1,1,0,2,0,2,5209
2,2,1,1,3,1,4,5209
3,3,2,1,5,2,7,5209
4,4,1,1,6,3,9,5209
5,5,1,1,7,4,11,5209
6,6,1,0,8,4,12,5209
7,7,0,1,8,5,13,5209
8,8,0,2,8,7,15,5209
9,9,1,5,9,12,21,5209
10,10,3,6,12,18,30,5209
11,11,3,8,15,26,41,5209
12,12,3,4,18,30,48,5209
13,13,3,4,21,34,55,5209
14,14,5,4,26,38,64,5209
15,15,7,5,33,43,76,5209
16,16,4,8,37,51,88,5209
17,17,5,9,42,60,102,5209
18,18,6,9,48,69,117,5209
19,19,6,7,54,76,130,5209
20,20,5,3,59,79,138,5209
21,21,4,3,63,82,145,5209
22,22,4,1,67,83,150,5209
23,23,4,1,71,84,155,5209
24,24,2,3,73,87,160,5209
25,25,2,0,75,87,162,5209
26,26,1,0,76,87,163,5209
27,27,1,0,77,87,164,5209
28,28,1,1,78,88,166,5209
29,29,1,1,79,89,168,5209
30,30,0,0,79,89,168,5209
0,0,1,0,1,0,1,5210
1,1,2,0,3,0,3,5210
2,2,1,2,4,2,6,5210
3,3,2,1,6,3,9,5210
4,4,1,0,7,3,10,5210
5,5,0,0,7,3,10,5210
0,0,1,0,1,0,1,5211
1,1,0,1,1,1,2,5211
2,2,0,0,1,1,2,5211
0,0,1,0,1,0,1,5212
1,1,0,0,1,0,1,5212
0,0,1,0,1,0,1,5213
1,1,0,0,1,0,1,5213
0,0,1,0,1,0,1,5214
1,1,0,0,1,0,1,5214
0,0,1,0,1,0,1,5215
1,1,1,1,2,1,3,5215
2,2,3,0,5,1,6,5215
3,3,3,1,8,2,10,5215
4,4,2,2,10,4,14,5215
5,5,0,3,10,7,17,5215
6,6,0,0,10,7,17,5215
0,0,1,0,1,0,1,5216
1,1,0,0,1,0,1,5216
0,0,1,0,1,0,1,5217
1,1,1,0,2,0,2,5217
2,2,1,0,3,0,3,5217
3,3,1,0,4,0,4,5217
4,4,1,0,5,0,5,5217
5,5,0,0,5,0,5,5217
0,0,1,0,1,0,1,5218
1,1,1,0,2,0,2,5218
2,2,0,0,2,0,2,5218
0,0,1,0,1,0,1,5219
1,1,0,0,1,0,1,5219
0,0,1,0,1,0,1,5220
1,1,1,0,2,0,2,5220
2,2,1,0,3,0,3,5220
3,3,1,0,4,0,4,5220
4,4,2,0,6,0,6,5220
5,5,2,0,8,0,8,5220
6,6,2,2,10,2,12,5220
7,7,4,2,14,4,18,5220
8,8,6,5,20,9,29,5220
9,9,4,6,24,15,39,5220
10,10,1,4,25,19,44,5220
11,11,0,4,25,23,48,5220
12,12,2,4,27,27,54,5220
13,13,1,4,28,31,59,5220
14,14,1,3,29,34,63,5220
15,15,0,7,29,41,70,5220
16,16,1,7,30,48,78,5220
17,17,1,3,31,51,82,5220
18,18,1,3,32,54,86,5220
19,19,1,3,33,57,90,5220
20,20,3,1,36,58,94,5220
21,21,1,0,37,58,95,5220
22,22,0,0,37,58,95,5220
0,0,1,0,1,0,1,5221
1,1,0,0,1,0,1,5221
0,0,1,0,1,0,1,5222
1,1,1,0,2,0,2,5222
2,2,1,1,3,1,4,5222
3,3,0,0,3,1,4,5222
0,0,1,0,1,0,1,5223
1,1,1,1,2,1,3,5223
2,2,1,1,3,2,5,5223
3,3,0,0,3,2,5,5223
0,0,1,0,1,0,1,5224
1,1,0,0,1,0,1,5224
0,0,1,0,1,0,1,5225
1,1,0,0,1,0,1,5225
0,0,1,0,1,0,1,5226
1,1,1,0,2,0,2,5226
2,2,0,0,2,0,2,5226
0,0,1,0,1,0,1,5227
1,1,0,1,1,1,2,5227
2,2,0,1,1,2,3,5227
3,3,0,2,1,4,5,5227
4,4,0,0,1,4,5,5227
0,0,1,0,1,0,1,5228
1,1,0,0,1,0,1,5228
0,0,1,0,1,0,1,5229
1,1,1,0,2,0,2,5229
2,2,1,0,3,0,3,5229
3,3,0,0,3,0,3,5229
0,0,1,0,1,0,1,5230
1,1,0,0,1,0,1,5230
0,0,1,0,1,0,1,5231
1,1,1,0,2,0,2,5231
2,2,2,0,4,0,4,5231
3,3,2,0,6,0,6,5231
4,4,0,0,6,0,6,5231
0,0,1,0,1,0,1,5232
1,1,1,0,2,0,2,5232
2,2,1,0,3,0,3,5232
3,3,0,0,3,0,3,5232
0,0,1,0,1,0,1,5233
1,1,0,0,1,0,1,5233
0,0,1,0,1,0,1,5234
1,1,0,1,1,1,2,5234
2,2,0,2,1,3,4,5234
3,3,2,3,3,6,9,5234
4,4,3,3,6,9,15,5234
5,5,2,3,8,12,20,5234
6,6,5,5,13,17,30,5234
7,7,5,7,18,24,42,5234
8,8,4,5,22,29,51,5234
9,9,4,5,26,34,60,5234
10,10,5,5,31,39,70,5234
11,11,0,5,31,44,75,5234
12,12,1,2,32,46,78,5234
13,13,0,2,32,48,80,5234
14,14,0,1,32,49,81,5234
15,15,0,0,32,49,81,5234
0,0,1,0,1,0,1,5235
1,1,0,0,1,0,1,5235
0,0,1,0,1,0,1,5236
1,1,1,0,2,0,2,5236
2,2,3,0,5,0,5,5236
3,3,2,1,7,1,8,5236
4,4,4,1,11,2,13,5236
5,5,4,3,15,5,20,5236
6,6,3,3,18,8,26,5236
7,7,1,0,19,8,27,5236
8,8,1,1,20,9,29,5236
9,9,0,1,20,10,30,5236
10,10,0,0,20,10,30,5236
0,0,1,0,1,0,1,5237
1,1,0,1,1,1,2,5237
2,2,0,1,1,2,3,5237
3,3,0,0,1,2,3,5237
0,0,1,0,1,0,1,5238
1,1,1,0,2,0,2,5238
2,2,1,0,3,0,3,5238
3,3,1,0,4,0,4,5238
4,4,0,0,4,0,4,5238
0,0,1,0,1,0,1,5239
1,1,2,0,3,0,3,5239
2,2,3,0,6,0,6,5239
3,3,3,0,9,0,9,5239
4,4,0,0,9,0,9,5239
0,0,1,0,1,0,1,5240
1,1,0,0,1,0,1,5240
0,0,1,0,1,0,1,5241
1,1,1,0,2,0,2,5241
2,2,0,0,2,0,2,5241
0,0,1,0,1,0,1,5242
1,1,0,0,1,0,1,5242
0,0,1,0,1,0,1,5243
1,1,1,0,2,0,2,5243
2,2,1,0,3,0,3,5243
3,3,0,1,3,1,4,5243
4,4,1,0,4,1,5,5243
5,5,2,0,6,1,7,5243
6,6,2,3,8,4,12,5243
7,7,1,3,9,7,16,5243
8,8,2,3,11,10,21,5243
9,9,3,0,14,10,24,5243
10,10,2,2,16,12,28,5243
11,11,5,0,21,12,33,5243
12,12,2,2,23,14,37,5243
13,13,3,1,26,15,41,5243
14,14,2,0,28,15,43,5243
15,15,0,0,28,15,43,5243
0,0,1,0,1,0,1,5244
1,1,1,0,2,0,2,5244
2,2,2,0,4,0,4,5244
3,3,2,0,6,0,6,5244
4,4,2,1,8,1,9,5244
5,5,0,0,8,1,9,5244
0,0,1,0,1,0,1,5245
1,1,1,0,2,0,2,5245
2,2,1,0,3,0,3,5245
3,3,0,0,3,0,3,5245
0,0,1,0,1,0,1,5246
1,1,0,0,1,0,1,5246
0,0,1,0,1,0,1,5247
1,1,0,0,1,0,1,5247
0,0,1,0,1,0,1,5248
1,1,1,0,2,0,2,5248
2,2,1,2,3,2,5,5248
3,3,3,2,6,4,10,5248
4,4,4,1,10,5,15,5248
5,5,6,1,16,6,22,5248
6,6,2,2,18,8,26,5248
7,7,3,0,21,8,29,5248
8,8,2,0,23,8,31,5248
9,9,3,0,26,8,34,5248
10,10,2,1,28,9,37,5248
11,11,4,1,32,10,42,5248
12,12,2,1,34,11,45,5248
13,13,0,1,34,12,46,5248
14,14,0,1,34,13,47,5248
15,15,0,2,34,15,49,5248
16,16,0,4,34,19,53,5248
17,17,0,2,34,21,55,5248
18,18,1,0,35,21,56,5248
19,19,0,0,35,21,56,5248
0,0,1,0,1,0,1,5249
1,1,0,0,1,0,1,5249
0,0,1,0,1,0,1,5250
1,1,1,0,2,0,2,5250
2,2,0,0,2,0,2,5250
0,0,1,0,1,0,1,5251
1,1,0,0,1,0,1,5251
0,0,1,0,1,0,1,5252
1,1,1,0,2,0,2,5252
2,2,0,0,2,0,2,5252
0,0,1,0,1,0,1,5253
1,1,0,0,1,0,1,5253
0,0,1,0,1,0,1,5254
1,1,0,0,1,0,1,5254
0,0,1,0,1,0,1,5255
1,1,3,0,4,0,4,5255
2,2,0,1,4,1,5,5255
3,3,0,1,4,2,6,5255
4,4,0,0,4,2,6,5255
0,0,1,0,1,0,1,5256
1,1,1,1,2,1,3,5256
2,2,2,0,4,1,5,5256
3,3,1,2,5,3,8,5256
4,4,3,2,8,5,13,5256
5,5,3,0,11,5,16,5256
6,6,1,0,12,5,17,5256
7,7,1,1,13,6,19,5256
8,8,1,1,14,7,21,5256
9,9,1,1,15,8,23,5256
10,10,2,1,17,9,26,5256
11,11,3,0,20,9,29,5256
12,12,1,1,21,10,31,5256
13,13,1,3,22,13,35,5256
14,14,0,1,22,14,36,5256
15,15,0,2,22,16,38,5256
16,16,0,0,22,16,38,5256
0,0,1,0,1,0,1,5257
1,1,2,0,3,0,3,5257
2,2,2,0,5,0,5,5257
3,3,2,1,7,1,8,5257
4,4,0,0,7,1,8,5257
0,0,1,0,1,0,1,5258
1,1,1,0,2,0,2,5258
2,2,0,1,2,1,3,5258
3,3,1,1,3,2,5,5258
4,4,0,1,3,3,6,5258
5,5,0,1,3,4,7,5258
6,6,1,1,4,5,9,5258
7,7,0,2,4,7,11,5258
8,8,0,4,4,11,15,5258
9,9,0,4,4,15,19,5258
10,10,0,1,4,16,20,5258
11,11,1,0,5,16,21,5258
12,12,0,0,5,16,21,5258
0,0,1,0,1,0,1,5259
1,1,1,0,2,0,2,5259
2,2,0,0,2,0,2,5259
0,0,1,0,1,0,1,5260
1,1,2,0,3,0,3,5260
2,2,0,1,3,1,4,5260
3,3,0,2,3,3,6,5260
4,4,0,1,3,4,7,5260
5,5,0,0,3,4,7,5260
0,0,1,0,1,0,1,5261
1,1,1,0,2,0,2,5261
2,2,1,0,3,0,3,5261
3,3,1,0,4,0,4,5261
4,4,0,0,4,0,4,5261
0,0,1,0,1,0,1,5262
1,1,0,0,1,0,1,5262
0,0,1,0,1,0,1,5263
1,1,1,0,2,0,2,5263
2,2,0,0,2,0,2,5263
0,0,1,0,1,0,1,5264
1,1,1,0,2,0,2,5264
2,2,0,0,2,0,2,5264
0,0,1,0,1,0,1,5265
1,1,0,1,1,1,2,5265
2,2,0,1,1,2,3,5265
3,3,0,1,1,3,4,5265
4,4,0,0,1,3,4,5265
0,0,1,0,1,0,1,5266
1,1,0,0,1,0,1,5266
0,0,1,0,1,0,1,5267
1,1,2,0,3,0,3,5267
2,2,2,0,5,0,5,5267
3,3,2,0,7,0,7,5267
4,4,4,0,11,0,11,5267
5,5,3,0,14,0,14,5267
6,6,3,1,17,1,18,5267
7,7,1,3,18,4,22,5267
8,8,0,1,18,5,23,5267
9,9,0,2,18,7,25,5267
10,10,0,1,18,8,26,5267
11,11,1,1,19,9,28,5267
12,12,1,1,20,10,30,5267
13,13,1,1,21,11,32,5267
14,14,1,0,22,11,33,5267
15,15,1,0,23,11,34,5267
16,16,0,2,23,13,36,5267
17,17,1,1,24,14,38,5267
18,18,0,1,24,15,39,5267
19,19,0,0,24,15,39,5267
0,0,1,0,1,0,1,5268
1,1,0,1,1,1,2,5268
2,2,0,0,1,1,2,5268
0,0,1,0,1,0,1,5269
1,1,1,0,2,0,2,5269
2,2,1,0,3,0,3,5269
3,3,0,1,3,1,4,5269
4,4,0,1,3,2,5,5269
5,5,0,0,3,2,5,5269
0,0,1,0,1,0,1,5270
1,1,0,0,1,0,1,5270
0,0,1,0,1,0,1,5271
1,1,0,2,1,2,3,5271
2,2,0,1,1,3,4,5271
3,3,0,2,1,5,6,5271
4,4,0,2,1,7,8,5271
5,5,0,2,1,9,10,5271
6,6,0,2,1,11,12,5271
7,7,0,0,1,11,12,5271
0,0,1,0,1,0,1,5272
1,1,0,0,1,0,1,5272
0,0,1,0,1,0,1,5273
1,1,0,1,1,1,2,5273
2,2,0,1,1,2,3,5273
3,3,0,2,1,4,5,5273
4,4,0,1,1,5,6,5273
5,5,0,1,1,6,7,5273
6,6,1,0,2,6,8,5273
7,7,1,0,3,6,9,5273
8,8,2,0,5,6,11,5273
9,9,2,0,7,6,13,5273
10,10,2,0,9,6,15,5273
11,11,1,0,10,6,16,5273
12,12,0,0,10,6,16,5273
0,0,1,0,1,0,1,5274
1,1,0,0,1,0,1,5274
0,0,1,0,1,0,1,5275
1,1,0,0,1,0,1,5275
0,0,1,0,1,0,1,5276
1,1,0,0,1,0,1,5276
0,0,1,0,1,0,1,5277
1,1,0,0,1,0,1,5277
0,0,1,0,1,0,1,5278
1,1,2,0,3,0,3,5278
2,2,1,0,4,0,4,5278
3,3,0,0,4,0,4,5278
0,0,1,0,1,0,1,5279
1,1,0,0,1,0,1,5279
0,0,1,0,1,0,1,5280
1,1,0,0,1,0,1,5280
0,0,1,0,1,0,1,5281
1,1,0,0,1,0,1,5281
0,0,1,0,1,0,1,5282
1,1,1,0,2,0,2,5282
2,2,1,0,3,0,3,5282
3,3,1,0,4,0,4,5282
4,4,1,0,5,0,5,5282
5,5,0,0,5,0,5,5282
0,0,1,0,1,0,1,5283
1,1,1,0,2,0,2,5283
2,2,1,0,3,0,3,5283
3,3,2,1,5,1,6,5283
4,4,0,1,5,2,7,5283
5,5,1,1,6,3,9,5283
6,6,0,0,6,3,9,5283
0,0,1,0,1,0,1,5284
1,1,1,1,2,1,3,5284
2,2,3,0,5,1,6,5284
3,3,4,0,9,1,10,5284
4,4,2,0,11,1,12,5284
5,5,1,1,12,2,14,5284
6,6,1,0,13,2,15,5284
7,7,0,0,13,2,15,5284
0,0,1,0,1,0,1,5285
1,1,1,1,2,1,3,5285
2,2,2,1,4,2,6,5285
3,3,2,0,6,2,8,5285
4,4,1,1,7,3,10,5285
5,5,1,1,8,4,12,5285
6,6,0,1,8,5,13,5285
7,7,1,0,9,5,14,5285
8,8,1,1,10,6,16,5285
9,9,1,0,11,6,17,5285
10,10,0,0,11,6,17,5285
0,0,1,0,1,0,1,5286
1,1,0,1,1,1,2,5286
2,2,0,1,1,2,3,5286
3,3,1,1,2,3,5,5286
4,4,0,0,2,3,5,5286
0,0,1,0,1,0,1,5287
1,1,1,1,2,1,3,5287
2,2,0,0,2,1,3,5287
0,0,1,0,1,0,1,5288
1,1,0,0,1,0,1,5288
0,0,1,0,1,0,1,5289
1,1,0,0,1,0,1,5289
0,0,1,0,1,0,1,5290
1,1,1,0,2,0,2,5290
2,2,2,0,4,0,4,5290
3,3,2,0,6,0,6,5290
4,4,1,0,7,0,7,5290
5,5,1,0,8,0,8,5290
6,6,1,0,9,0,9,5290
7,7,1,0,10,0,10,5290
8,8,1,0,11,0,11,5290
9,9,1,0,12,0,12,5290
10,10,0,0,12,0,12,5290
0,0,1,0,1,0,1,5291
1,1,0,0,1,0,1,5291
0,0,1,0,1,0,1,5292
1,1,2,1,3,1,4,5292
2,2,0,0,3,1,4,5292
0,0,1,0,1,0,1,5293
1,1,0,0,1,0,1,5293
0,0,1,0,1,0,1,5294
1,1,0,0,1,0,1,5294
0,0,1,0,1,0,1,5295
1,1,0,0,1,0,1,5295
0,0,1,0,1,0,1,5296
1,1,1,0,2,0,2,5296
2,2,0,0,2,0,2,5296
0,0,1,0,1,0,1,5297
1,1,0,0,1,0,1,5297
0,0,1,0,1,0,1,5298
1,1,0,0,1,0,1,5298
0,0,1,0,1,0,1,5299
1,1,0,0,1,0,1,5299
0,0,1,0,1,0,1,5300
1,1,0,0,1,0,1,5300
0,0,1,0,1,0,1,5301
1,1,0,0,1,0,1,5301
0,0,1,0,1,0,1,5302
1,1,0,0,1,0,1,5302
0,0,1,0,1,0,1,5303
1,1,2,0,3,0,3,5303
2,2,0,0,3,0,3,5303
0,0,1,0,1,0,1,5304
1,1,1,1,2,1,3,5304
2,2,0,0,2,1,3,5304
0,0,1,0,1,0,1,5305
1,1,1,0,2,0,2,5305
2,2,1,0,3,0,3,5305
3,3,0,0,3,0,3,5305
0,0,1,0,1,0,1,5306
1,1,1,0,2,0,2,5306
2,2,0,0,2,0,2,5306
0,0,1,0,1,0,1,5307
1,1,3,0,4,0,4,5307
2,2,1,1,5,1,6,5307
3,3,0,0,5,1,6,5307
0,0,1,0,1,0,1,5308
1,1,2,0,3,0,3,5308
2,2,0,0,3,0,3,5308
0,0,1,0,1,0,1,5309
1,1,0,1,1,1,2,5309
2,2,0,1,1,2,3,5309
3,3,0,1,1,3,4,5309
4,4,0,0,1,3,4,5309
0,0,1,0,1,0,1,5310
1,1,0,1,1,1,2,5310
2,2,1,2,2,3,5,5310
3,3,0,1,2,4,6,5310
4,4,0,0,2,4,6,5310
0,0,1,0,1,0,1,5311
1,1,1,1,2,1,3,5311
2,2,2,0,4,1,5,5311
3,3,1,2,5,3,8,5311
4,4,1,4,6,7,13,5311
5,5,3,0,9,7,16,5311
6,6,3,0,12,7,19,5311
7,7,2,1,14,8,22,5311
8,8,0,4,14,12,26,5311
9,9,0,3,14,15,29,5311
10,10,0,2,14,17,31,5311
11,11,1,1,15,18,33,5311
12,12,0,1,15,19,34,5311
13,13,0,0,15,19,34,5311
0,0,1,0,1,0,1,5312
1,1,1,0,2,0,2,5312
2,2,1,0,3,0,3,5312
3,3,2,0,5,0,5,5312
4,4,2,0,7,0,7,5312
5,5,1,0,8,0,8,5312
6,6,0,0,8,0,8,5312
0,0,1,0,1,0,1,5313
1,1,1,0,2,0,2,5313
2,2,0,0,2,0,2,5313
0,0,1,0,1,0,1,5314
1,1,0,0,1,0,1,5314
0,0,1,0,1,0,1,5315
1,1,1,0,2,0,2,5315
2,2,0,0,2,0,2,5315
0,0,1,0,1,0,1,5316
1,1,0,0,1,0,1,5316
0,0,1,0,1,0,1,5317
1,1,0,0,1,0,1,5317
0,0,1,0,1,0,1,5318
1,1,0,0,1,0,1,5318
0,0,1,0,1,0,1,5319
1,1,1,1,2,1,3,5319
2,2,0,1,2,2,4,5319
3,3,0,1,2,3,5,5319
4,4,0,1,2,4,6,5319
5,5,1,0,3,4,7,5319
6,6,0,0,3,4,7,5319
0,0,1,0,1,0,1,5320
1,1,0,1,1,1,2,5320
2,2,0,0,1,1,2,5320
0,0,1,0,1,0,1,5321
1,1,0,1,1,1,2,5321
2,2,0,1,1,2,3,5321
3,3,0,2,1,4,5,5321
4,4,0,5,1,9,10,5321
5,5,1,4,2,13,15,5321
6,6,0,4,2,17,19,5321
7,7,1,1,3,18,21,5321
8,8,0,0,3,18,21,5321
0,0,1,0,1,0,1,5322
1,1,1,0,2,0,2,5322
2,2,0,0,2,0,2,5322
0,0,1,0,1,0,1,5323
1,1,0,0,1,0,1,5323
0,0,1,0,1,0,1,5324
1,1,1,0,2,0,2,5324
2,2,1,0,3,0,3,5324
3,3,0,1,3,1,4,5324
4,4,0,1,3,2,5,5324
5,5,0,1,3,3,6,5324
6,6,0,1,3,4,7,5324
7,7,0,1,3,5,8,5324
8,8,0,2,3,7,10,5324
9,9,1,3,4,10,14,5324
10,10,1,1,5,11,16,5324
11,11,0,2,5,13,18,5324
12,12,0,0,5,13,18,5324
0,0,1,0,1,0,1,5325
1,1,0,1,1,1,2,5325
2,2,1,0,2,1,3,5325
3,3,0,0,2,1,3,5325
0,0,1,0,1,0,1,5326
1,1,0,0,1,0,1,5326
0,0,1,0,1,0,1,5327
1,1,1,0,2,0,2,5327
2,2,1,0,3,0,3,5327
3,3,2,0,5,0,5,5327
4,4,1,0,6,0,6,5327
5,5,1,1,7,1,8,5327
6,6,0,0,7,1,8,5327
0,0,1,0,1,0,1,5328
1,1,0,0,1,0,1,5328
0,0,1,0,1,0,1,5329
1,1,1,1,2,1,3,5329
2,2,0,0,2,1,3,5329
0,0,1,0,1,0,1,5330
1,1,3,0,4,0,4,5330
2,2,3,0,7,0,7,5330
3,3,2,0,9,0,9,5330
4,4,1,0,10,0,10,5330
5,5,1,0,11,0,11,5330
6,6,0,1,11,1,12,5330
7,7,0,0,11,1,12,5330
0,0,1,0,1,0,1,5331
1,1,1,0,2,0,2,5331
2,2,1,0,3,0,3,5331
3,3,1,0,4,0,4,5331
4,4,1,0,5,0,5,5331
5,5,0,0,5,0,5,5331
0,0,1,0,1,0,1,5332
1,1,0,0,1,0,1,5332
0,0,1,0,1,0,1,5333
1,1,1,0,2,0,2,5333
2,2,0,0,2,0,2,5333
0,0,1,0,1,0,1,5334
1,1,0,0,1,0,1,5334
0,0,1,0,1,0,1,5335
1,1,1,0,2,0,2,5335
2,2,0,0,2,0,2,5335
0,0,1,0,1,0,1,5336
1,1,0,0,1,0,1,5336
0,0,1,0,1,0,1,5337
1,1,0,0,1,0,1,5337
0,0,1,0,1,0,1,5338
1,1,0,1,1,1,2,5338
2,2,0,0,1,1,2,5338
0,0,1,0,1,0,1,5339
1,1,0,0,1,0,1,5339
0,0,1,0,1,0,1,5340
1,1,0,0,1,0,1,5340
0,0,1,0,1,0,1,5341
1,1,1,0,2,0,2,5341
2,2,2,0,4,0,4,5341
3,3,2,1,6,1,7,5341
4,4,2,0,8,1,9,5341
5,5,2,0,10,1,11,5341
6,6,0,1,10,2,12,5341
7,7,2,0,12,2,14,5341
8,8,1,0,13,2,15,5341
9,9,0,0,13,2,15,5341
0,0,1,0,1,0,1,5342
1,1,1,0,2,0,2,5342
2,2,1,0,3,0,3,5342
3,3,1,0,4,0,4,5342
4,4,2,1,6,1,7,5342
5,5,4,1,10,2,12,5342
6,6,2,1,12,3,15,5342
7,7,3,0,15,3,18,5342
8,8,1,0,16,3,19,5342
9,9,1,1,17,4,21,5342
10,10,1,0,18,4,22,5342
11,11,1,0,19,4,23,5342
12,12,0,1,19,5,24,5342
13,13,1,0,20,5,25,5342
14,14,1,0,21,5,26,5342
15,15,2,0,23,5,28,5342
16,16,2,0,25,5,30,5342
17,17,5,0,30,5,35,5342
18,18,3,0,33,5,38,5342
19,19,5,0,38,5,43,5342
20,20,1,1,39,6,45,5342
21,21,4,1,43,7,50,5342
22,22,1,1,44,8,52,5342
23,23,0,2,44,10,54,5342
24,24,0,2,44,12,56,5342
25,25,1,1,45,13,58,5342
26,26,0,0,45,13,58,5342
0,0,1,0,1,0,1,5343
1,1,1,2,2,2,4,5343
2,2,1,0,3,2,5,5343
3,3,0,1,3,3,6,5343
4,4,0,1,3,4,7,5343
5,5,1,3,4,7,11,5343
6,6,1,1,5,8,13,5343
7,7,0,1,5,9,14,5343
8,8,0,1,5,10,15,5343
9,9,0,1,5,11,16,5343
10,10,0,0,5,11,16,5343
0,0,1,0,1,0,1,5344
1,1,0,0,1,0,1,5344
0,0,1,0,1,0,1,5345
1,1,1,0,2,0,2,5345
2,2,0,0,2,0,2,5345
0,0,1,0,1,0,1,5346
1,1,2,0,3,0,3,5346
2,2,1,0,4,0,4,5346
3,3,0,1,4,1,5,5346
4,4,0,1,4,2,6,5346
5,5,0,0,4,2,6,5346
0,0,1,0,1,0,1,5347
1,1,0,0,1,0,1,5347
0,0,1,0,1,0,1,5348
1,1,2,0,3,0,3,5348
2,2,1,1,4,1,5,5348
3,3,0,3,4,4,8,5348
4,4,0,2,4,6,10,5348
5,5,0,0,4,6,10,5348
0,0,1,0,1,0,1,5349
1,1,0,0,1,0,1,5349
0,0,1,0,1,0,1,5350
1,1,1,0,2,0,2,5350
2,2,0,1,2,1,3,5350
3,3,0,1,2,2,4,5350
4,4,0,0,2,2,4,5350
0,0,1,0,1,0,1,5351
1,1,2,0,3,0,3,5351
2,2,1,0,4,0,4,5351
3,3,0,0,4,0,4,5351
0,0,1,0,1,0,1,5352
1,1,0,0,1,0,1,5352
0,0,1,0,1,0,1,5353
1,1,0,1,1,1,2,5353
2,2,0,0,1,1,2,5353
0,0,1,0,1,0,1,5354
1,1,0,1,1,1,2,5354
2,2,0,1,1,2,3,5354
3,3,0,0,1,2,3,5354
0,0,1,0,1,0,1,5355
1,1,1,0,2,0,2,5355
2,2,1,1,3,1,4,5355
3,3,3,2,6,3,9,5355
4,4,3,5,9,8,17,5355
5,5,1,3,10,11,21,5355
6,6,0,2,10,13,23,5355
7,7,0,1,10,14,24,5355
8,8,0,0,10,14,24,5355
0,0,1,0,1,0,1,5356
1,1,1,0,2,0,2,5356
2,2,0,1,2,1,3,5356
3,3,1,0,3,1,4,5356
4,4,1,0,4,1,5,5356
5,5,0,0,4,1,5,5356
0,0,1,0,1,0,1,5357
1,1,2,0,3,0,3,5357
2,2,3,0,6,0,6,5357
3,3,4,0,10,0,10,5357
4,4,3,0,13,0,13,5357
5,5,1,0,14,0,14,5357
6,6,0,0,14,0,14,5357
0,0,1,0,1,0,1,5358
1,1,0,0,1,0,1,5358
0,0,1,0,1,0,1,5359
1,1,2,1,3,1,4,5359
2,2,1,3,4,4,8,5359
3,3,1,2,5,6,11,5359
4,4,0,3,5,9,14,5359
5,5,1,3,6,12,18,5359
6,6,0,4,6,16,22,5359
7,7,1,4,7,20,27,5359
8,8,2,4,9,24,33,5359
9,9,1,4,10,28,38,5359
10,10,0,4,10,32,42,5359
11,11,1,2,11,34,45,5359
12,12,2,2,13,36,49,5359
13,13,1,4,14,40,54,5359
14,14,0,2,14,42,56,5359
15,15,0,1,14,43,57,5359
16,16,0,1,14,44,58,5359
17,17,0,2,14,46,60,5359
18,18,0,3,14,49,63,5359
19,19,1,3,15,52,67,5359
20,20,1,2,16,54,70,5359
21,21,0,1,16,55,71,5359
22,22,0,2,16,57,73,5359
23,23,0,3,16,60,76,5359
24,24,0,1,16,61,77,5359
25,25,0,2,16,63,79,5359
26,26,0,3,16,66,82,5359
27,27,0,4,16,70,86,5359
28,28,2,2,18,72,90,5359
29,29,3,5,21,77,98,5359
30,30,4,4,25,81,106,5359
31,31,4,2,29,83,112,5359
32,32,4,3,33,86,119,5359
33,33,3,0,36,86,122,5359
34,34,2,0,38,86,124,5359
35,35,3,0,41,86,127,5359
36,36,3,0,44,86,130,5359
37,37,2,0,46,86,132,5359
38,38,1,0,47,86,133,5359
39,39,1,0,48,86,134,5359
40,40,0,0,48,86,134,5359
0,0,1,0,1,0,1,5360
1,1,3,0,4,0,4,5360
2,2,3,1,7,1,8,5360
3,3,1,0,8,1,9,5360
4,4,0,0,8,1,9,5360
0,0,1,0,1,0,1,5361
1,1,1,0,2,0,2,5361
2,2,0,0,2,0,2,5361
0,0,1,0,1,0,1,5362
1,1,0,2,1,2,3,5362
2,2,0,2,1,4,5,5362
3,3,0,0,1,4,5,5362
0,0,1,0,1,0,1,5363
1,1,0,0,1,0,1,5363
0,0,1,0,1,0,1,5364
1,1,1,0,2,0,2,5364
2,2,2,1,4,1,5,5364
3,3,0,0,4,1,5,5364
0,0,1,0,1,0,1,5365
1,1,1,1,2,1,3,5365
2,2,0,1,2,2,4,5365
3,3,0,0,2,2,4,5365
0,0,1,0,1,0,1,5366
1,1,2,0,3,0,3,5366
2,2,1,1,4,1,5,5366
3,3,2,1,6,2,8,5366
4,4,2,3,8,5,13,5366
5,5,1,3,9,8,17,5366
6,6,2,3,11,11,22,5366
7,7,0,6,11,17,28,5366
8,8,1,4,12,21,33,5366
9,9,1,4,13,25,38,5366
10,10,2,1,15,26,41,5366
11,11,2,4,17,30,47,5366
12,12,4,4,21,34,55,5366
13,13,2,6,23,40,63,5366
14,14,2,4,25,44,69,5366
15,15,4,2,29,46,75,5366
16,16,3,2,32,48,80,5366
17,17,1,0,33,48,81,5366
18,18,0,0,33,48,81,5366
0,0,1,0,1,0,1,5367
1,1,1,0,2,0,2,5367
2,2,2,0,4,0,4,5367
3,3,1,1,5,1,6,5367
4,4,0,2,5,3,8,5367
5,5,1,1,6,4,10,5367
6,6,1,4,7,8,15,5367
7,7,4,2,11,10,21,5367
8,8,6,2,17,12,29,5367
9,9,5,2,22,14,36,5367
10,10,5,1,27,15,42,5367
11,11,3,3,30,18,48,5367
12,12,0,4,30,22,52,5367
13,13,0,1,30,23,53,5367
14,14,0,1,30,24,54,5367
15,15,0,1,30,25,55,5367
16,16,0,0,30,25,55,5367
0,0,1,0,1,0,1,5368
1,1,0,0,1,0,1,5368
0,0,1,0,1,0,1,5369
1,1,0,0,1,0,1,5369
0,0,1,0,1,0,1,5370
1,1,0,0,1,0,1,5370
0,0,1,0,1,0,1,5371
1,1,1,0,2,0,2,5371
2,2,1,0,3,0,3,5371
3,3,1,0,4,0,4,5371
4,4,0,0,4,0,4,5371
0,0,1,0,1,0,1,5372
1,1,0,2,1,2,3,5372
2,2,0,3,1,5,6,5372
3,3,1,3,2,8,10,5372
4,4,2,0,4,8,12,5372
5,5,5,2,9,10,19,5372
6,6,7,2,16,12,28,5372
7,7,8,2,24,14,38,5372
8,8,4,1,28,15,43,5372
9,9,5,0,33,15,48,5372
10,10,2,0,35,15,50,5372
11,11,1,0,36,15,51,5372
12,12,0,0,36,15,51,5372
0,0,1,0,1,0,1,5373
1,1,2,0,3,0,3,5373
2,2,0,1,3,1,4,5373
3,3,0,0,3,1,4,5373
0,0,1,0,1,0,1,5374
1,1,0,0,1,0,1,5374
0,0,1,0,1,0,1,5375
1,1,1,0,2,0,2,5375
2,2,0,0,2,0,2,5375
0,0,1,0,1,0,1,5376
1,1,3,0,4,0,4,5376
2,2,0,3,4,3,7,5376
3,3,0,4,4,7,11,5376
4,4,1,2,5,9,14,5376
5,5,1,1,6,10,16,5376
6,6,2,1,8,11,19,5376
7,7,1,1,9,12,21,5376
8,8,1,1,10,13,23,5376
9,9,0,1,10,14,24,5376
10,10,0,0,10,14,24,5376
0,0,1,0,1,0,1,5377
1,1,2,0,3,0,3,5377
2,2,0,0,3,0,3,5377
0,0,1,0,1,0,1,5378
1,1,1,0,2,0,2,5378
2,2,0,1,2,1,3,5378
3,3,0,0,2,1,3,5378
0,0,1,0,1,0,1,5379
1,1,0,1,1,1,2,5379
2,2,0,1,1,2,3,5379
3,3,0,1,1,3,4,5379
4,4,0,0,1,3,4,5379
0,0,1,0,1,0,1,5380
1,1,3,0,4,0,4,5380
2,2,1,1,5,1,6,5380
3,3,0,1,5,2,7,5380
4,4,0,0,5,2,7,5380
0,0,1,0,1,0,1,5381
1,1,1,0,2,0,2,5381
2,2,0,0,2,0,2,5381
0,0,1,0,1,0,1,5382
1,1,1,1,2,1,3,5382
2,2,3,0,5,1,6,5382
3,3,0,0,5,1,6,5382
0,0,1,0,1,0,1,5383
1,1,0,0,1,0,1,5383
0,0,1,0,1,0,1,5384
1,1,1,0,2,0,2,5384
2,2,3,2,5,2,7,5384
3,3,7,2,12,4,16,5384
4,4,4,2,16,6,22,5384
5,5,1,2,17,8,25,5384
6,6,2,0,19,8,27,5384
7,7,2,0,21,8,29,5384
8,8,2,0,23,8,31,5384
9,9,1,0,24,8,32,5384
10,10,1,0,25,8,33,5384
11,11,0,1,25,9,34,5384
12,12,1,2,26,11,37,5384
13,13,0,0,26,11,37,5384
0,0,1,0,1,0,1,5385
1,1,0,0,1,0,1,5385
0,0,1,0,1,0,1,5386
1,1,2,0,3,0,3,5386
2,2,5,0,8,0,8,5386
3,3,2,0,10,0,10,5386
4,4,0,0,10,0,10,5386
0,0,1,0,1,0,1,5387
1,1,1,0,2,0,2,5387
2,2,1,0,3,0,3,5387
3,3,0,0,3,0,3,5387
0,0,1,0,1,0,1,5388
1,1,0,0,1,0,1,5388
0,0,1,0,1,0,1,5389
1,1,4,1,5,1,6,5389
2,2,2,5,7,6,13,5389
3,3,2,6,9,12,21,5389
4,4,2,2,11,14,25,5389
5,5,2,1,13,15,28,5389
6,6,0,3,13,18,31,5389
7,7,1,2,14,20,34,5389
8,8,2,0,16,20,36,5389
9,9,0,0,16,20,36,5389
0,0,1,0,1,0,1,5390
1,1,1,0,2,0,2,5390
2,2,0,0,2,0,2,5390
0,0,1,0,1,0,1,5391
1,1,2,1,3,1,4,5391
2,2,4,1,7,2,9,5391
3,3,3,0,10,2,12,5391
4,4,2,2,12,4,16,5391
5,5,1,0,13,4,17,5391
6,6,0,0,13,4,17,5391
0,0,1,0,1,0,1,5392
1,1,1,0,2,0,2,5392
2,2,0,0,2,0,2,5392
0,0,1,0,1,0,1,5393
1,1,0,0,1,0,1,5393
0,0,1,0,1,0,1,5394
1,1,0,1,1,1,2,5394
2,2,0,0,1,1,2,5394
0,0,1,0,1,0,1,5395
1,1,1,0,2,0,2,5395
2,2,2,0,4,0,4,5395
3,3,1,0,5,0,5,5395
4,4,2,0,7,0,7,5395
5,5,0,0,7,0,7,5395
0,0,1,0,1,0,1,5396
1,1,0,0,1,0,1,5396
0,0,1,0,1,0,1,5397
1,1,1,0,2,0,2,5397
2,2,1,0,3,0,3,5397
3,3,0,0,3,0,3,5397
0,0,1,0,1,0,1,5398
1,1,0,0,1,0,1,5398
0,0,1,0,1,0,1,5399
1,1,1,0,2,0,2,5399
2,2,2,1,4,1,5,5399
3,3,1,2,5,3,8,5399
4,4,3,1,8,4,12,5399
5,5,5,2,13,6,19,5399
6,6,6,1,19,7,26,5399
7,7,6,2,25,9,34,5399
8,8,6,5,31,14,45,5399
9,9,5,4,36,18,54,5399
10,10,5,2,41,20,61,5399
11,11,5,2,46,22,68,5399
12,12,3,1,49,23,72,5399
13,13,1,2,50,25,75,5399
14,14,0,2,50,27,77,5399
15,15,1,2,51,29,80,5399
16,16,0,1,51,30,81,5399
17,17,0,1,51,31,82,5399
18,18,0,0,51,31,82,5399
0,0,1,0,1,0,1,5400
1,1,0,0,1,0,1,5400
0,0,1,0,1,0,1,5401
1,1,2,1,3,1,4,5401
2,2,3,0,6,1,7,5401
3,3,3,2,9,3,12,5401
4,4,1,0,10,3,13,5401
5,5,2,2,12,5,17,5401
6,6,0,1,12,6,18,5401
7,7,0,1,12,7,19,5401
8,8,0,0,12,7,19,5401
0,0,1,0,1,0,1,5402
1,1,1,0,2,0,2,5402
2,2,2,0,4,0,4,5402
3,3,1,1,5,1,6,5402
4,4,3,0,8,1,9,5402
5,5,3,0,11,1,12,5402
6,6,2,0,13,1,14,5402
7,7,2,2,15,3,18,5402
8,8,2,1,17,4,21,5402
9,9,1,2,18,6,24,5402
10,10,1,4,19,10,29,5402
11,11,1,3,20,13,33,5402
12,12,0,3,20,16,36,5402
13,13,1,2,21,18,39,5402
14,14,0,3,21,21,42,5402
15,15,0,1,21,22,43,5402
16,16,0,3,21,25,46,5402
17,17,0,1,21,26,47,5402
18,18,0,1,21,27,48,5402
19,19,0,0,21,27,48,5402
0,0,1,0,1,0,1,5403
1,1,1,0,2,0,2,5403
2,2,1,0,3,0,3,5403
3,3,0,0,3,0,3,5403
0,0,1,0,1,0,1,5404
1,1,0,0,1,0,1,5404
0,0,1,0,1,0,1,5405
1,1,0,0,1,0,1,5405
0,0,1,0,1,0,1,5406
1,1,1,0,2,0,2,5406
2,2,1,0,3,0,3,5406
3,3,1,0,4,0,4,5406
4,4,0,0,4,0,4,5406
0,0,1,0,1,0,1,5407
1,1,1,0,2,0,2,5407
2,2,0,0,2,0,2,5407
0,0,1,0,1,0,1,5408
1,1,1,0,2,0,2,5408
2,2,1,0,3,0,3,5408
3,3,0,0,3,0,3,5408
0,0,1,0,1,0,1,5409
1,1,0,0,1,0,1,5409
0,0,1,0,1,0,1,5410
1,1,0,1,1,1,2,5410
2,2,0,1,1,2,3,5410
3,3,0,1,1,3,4,5410
4,4,0,2,1,5,6,5410
5,5,0,0,1,5,6,5410
0,0,1,0,1,0,1,5411
1,1,1,0,2,0,2,5411
2,2,2,0,4,0,4,5411
3,3,1,0,5,0,5,5411
4,4,0,0,5,0,5,5411
0,0,1,0,1,0,1,5412
1,1,0,0,1,0,1,5412
0,0,1,0,1,0,1,5413
1,1,2,1,3,1,4,5413
2,2,1,1,4,2,6,5413
3,3,1,1,5,3,8,5413
4,4,0,1,5,4,9,5413
5,5,0,0,5,4,9,5413
0,0,1,0,1,0,1,5414
1,1,0,0,1,0,1,5414
0,0,1,0,1,0,1,5415
1,1,1,0,2,0,2,5415
2,2,0,0,2,0,2,5415
0,0,1,0,1,0,1,5416
1,1,0,0,1,0,1,5416
0,0,1,0,1,0,1,5417
1,1,0,0,1,0,1,5417
0,0,1,0,1,0,1,5418
1,1,0,0,1,0,1,5418
0,0,1,0,1,0,1,5419
1,1,0,0,1,0,1,5419
0,0,1,0,1,0,1,5420
1,1,1,0,2,0,2,5420
2,2,1,0,3,0,3,5420
3,3,0,1,3,1,4,5420
4,4,0,2,3,3,6,5420
5,5,0,2,3,5,8,5420
6,6,0,0,3,5,8,5420
0,0,1,0,1,0,1,5421
1,1,0,0,1,0,1,5421
0,0,1,0,1,0,1,5422
1,1,0,2,1,2,3,5422
2,2,0,1,1,3,4,5422
3,3,0,0,1,3,4,5422
0,0,1,0,1,0,1,5423
1,1,1,0,2,0,2,5423
2,2,0,0,2,0,2,5423
0,0,1,0,1,0,1,5424
1,1,1,0,2,0,2,5424
2,2,0,0,2,0,2,5424
0,0,1,0,1,0,1,5425
1,1,2,0,3,0,3,5425
2,2,1,0,4,0,4,5425
3,3,0,0,4,0,4,5425
0,0,1,0,1,0,1,5426
1,1,0,0,1,0,1,5426
0,0,1,0,1,0,1,5427
1,1,2,0,3,0,3,5427
2,2,0,0,3,0,3,5427
0,0,1,0,1,0,1,5428
1,1,0,0,1,0,1,5428
0,0,1,0,1,0,1,5429
1,1,0,0,1,0,1,5429
0,0,1,0,1,0,1,5430
1,1,1,1,2,1,3,5430
2,2,0,3,2,4,6,5430
3,3,0,1,2,5,7,5430
4,4,0,4,2,9,11,5430
5,5,0,1,2,10,12,5430
6,6,0,1,2,11,13,5430
7,7,2,1,4,12,16,5430
8,8,1,2,5,14,19,5430
9,9,1,0,6,14,20,5430
10,10,1,0,7,14,21,5430
11,11,0,0,7,14,21,5430
0,0,1,0,1,0,1,5431
1,1,2,0,3,0,3,5431
2,2,4,0,7,0,7,5431
3,3,0,0,7,0,7,5431
0,0,1,0,1,0,1,5432
1,1,1,0,2,0,2,5432
2,2,0,0,2,0,2,5432
0,0,1,0,1,0,1,5433
1,1,3,0,4,0,4,5433
2,2,0,1,4,1,5,5433
3,3,0,0,4,1,5,5433
0,0,1,0,1,0,1,5434
1,1,1,0,2,0,2,5434
2,2,0,0,2,0,2,5434
0,0,1,0,1,0,1,5435
1,1,0,0,1,0,1,5435
0,0,1,0,1,0,1,5436
1,1,3,0,4,0,4,5436
2,2,2,0,6,0,6,5436
3,3,4,0,10,0,10,5436
4,4,3,0,13,0,13,5436
5,5,3,0,16,0,16,5436
6,6,4,1,20,1,21,5436
7,7,5,1,25,2,27,5436
8,8,3,2,28,4,32,5436
9,9,3,1,31,5,36,5436
10,10,2,4,33,9,42,5436
11,11,5,3,38,12,50,5436
12,12,8,1,46,13,59,5436
13,13,6,2,52,15,67,5436
14,14,0,0,52,15,67,5436
0,0,1,0,1,0,1,5437
1,1,1,0,2,0,2,5437
2,2,2,0,4,0,4,5437
3,3,2,1,6,1,7,5437
4,4,2,2,8,3,11,5437
5,5,3,3,11,6,17,5437
6,6,2,2,13,8,21,5437
7,7,2,5,15,13,28,5437
8,8,4,2,19,15,34,5437
9,9,5,3,24,18,42,5437
10,10,6,3,30,21,51,5437
11,11,3,3,33,24,57,5437
12,12,2,7,35,31,66,5437
13,13,1,6,36,37,73,5437
14,14,1,4,37,41,78,5437
15,15,2,1,39,42,81,5437
16,16,2,0,41,42,83,5437
17,17,4,1,45,43,88,5437
18,18,6,2,51,45,96,5437
19,19,6,2,57,47,104,5437
20,20,7,7,64,54,118,5437
21,21,9,4,73,58,131,5437
22,22,14,3,87,61,148,5437
23,23,11,4,98,65,163,5437
24,24,10,14,108,79,187,5437
25,25,17,11,125,90,215,5437
26,26,16,16,141,106,247,5437
27,27,11,18,152,124,276,5437
28,28,7,12,159,136,295,5437
29,29,9,11,168,147,315,5437
30,30,9,6,177,153,330,5437
31,31,12,5,189,158,347,5437
32,32,11,5,200,163,363,5437
33,33,12,4,212,167,379,5437
34,34,10,6,222,173,395,5437
35,35,9,5,231,178,409,5437
36,36,6,10,237,188,425,5437
37,37,6,8,243,196,439,5437
38,38,5,5,248,201,449,5437
39,39,5,5,253,206,459,5437
40,40,4,3,257,209,466,5437
41,41,3,5,260,214,474,5437
42,42,3,6,263,220,483,5437
43,43,2,9,265,229,494,5437
44,44,3,5,268,234,502,5437
45,45,4,6,272,240,512,5437
46,46,4,3,276,243,519,5437
47,47,5,2,281,245,526,5437
48,48,8,1,289,246,535,5437
49,49,1,4,290,250,540,5437
50,50,1,2,291,252,543,5437
51,51,2,1,293,253,546,5437
52,52,5,2,298,255,553,5437
53,53,3,2,301,257,558,5437
54,54,3,2,304,259,563,5437
55,55,4,2,308,261,569,5437
56,56,8,2,316,263,579,5437
57,57,8,3,324,266,590,5437
58,58,4,5,328,271,599,5437
59,59,2,6,330,277,607,5437
60,60,1,10,331,287,618,5437
61,61,1,7,332,294,626,5437
62,62,2,3,334,297,631,5437
63,63,1,1,335,298,633,5437
64,64,1,3,336,301,637,5437
65,65,2,3,338,304,642,5437
66,66,1,5,339,309,648,5437
67,67,1,1,340,310,650,5437
68,68,1,0,341,310,651,5437
69,69,0,1,341,311,652,5437
70,70,0,4,341,315,656,5437
71,71,0,6,341,321,662,5437
72,72,2,6,343,327,670,5437
73,73,1,3,344,330,674,5437
74,74,0,1,344,331,675,5437
75,75,0,0,344,331,675,5437
0,0,1,0,1,0,1,5438
1,1,0,0,1,0,1,5438
0,0,1,0,1,0,1,5439
1,1,1,0,2,0,2,5439
2,2,0,0,2,0,2,5439
0,0,1,0,1,0,1,5440
1,1,0,0,1,0,1,5440
0,0,1,0,1,0,1,5441
1,1,1,1,2,1,3,5441
2,2,0,1,2,2,4,5441
3,3,0,2,2,4,6,5441
4,4,0,0,2,4,6,5441
0,0,1,0,1,0,1,5442
1,1,1,0,2,0,2,5442
2,2,2,0,4,0,4,5442
3,3,2,1,6,1,7,5442
4,4,2,3,8,4,12,5442
5,5,0,2,8,6,14,5442
6,6,0,1,8,7,15,5442
7,7,0,0,8,7,15,5442
0,0,1,0,1,0,1,5443
1,1,0,0,1,0,1,5443
0,0,1,0,1,0,1,5444
1,1,0,0,1,0,1,5444
0,0,1,0,1,0,1,5445
1,1,1,0,2,0,2,5445
2,2,2,0,4,0,4,5445
3,3,3,0,7,0,7,5445
4,4,1,2,8,2,10,5445
5,5,2,1,10,3,13,5445
6,6,2,1,12,4,16,5445
7,7,5,1,17,5,22,5445
8,8,2,0,19,5,24,5445
9,9,0,1,19,6,25,5445
10,10,0,0,19,6,25,5445
0,0,1,0,1,0,1,5446
1,1,0,0,1,0,1,5446
0,0,1,0,1,0,1,5447
1,1,0,0,1,0,1,5447
0,0,1,0,1,0,1,5448
1,1,1,0,2,0,2,5448
2,2,0,1,2,1,3,5448
3,3,0,3,2,4,6,5448
4,4,2,0,4,4,8,5448
5,5,1,1,5,5,10,5448
6,6,0,1,5,6,11,5448
7,7,1,0,6,6,12,5448
8,8,0,0,6,6,12,5448
0,0,1,0,1,0,1,5449
1,1,1,0,2,0,2,5449
2,2,0,0,2,0,2,5449
0,0,1,0,1,0,1,5450
1,1,1,0,2,0,2,5450
2,2,2,0,4,0,4,5450
3,3,2,0,6,0,6,5450
4,4,0,0,6,0,6,5450
0,0,1,0,1,0,1,5451
1,1,1,0,2,0,2,5451
2,2,0,0,2,0,2,5451
0,0,1,0,1,0,1,5452
1,1,0,0,1,0,1,5452
0,0,1,0,1,0,1,5453
1,1,1,0,2,0,2,5453
2,2,1,0,3,0,3,5453
3,3,1,1,4,1,5,5453
4,4,0,2,4,3,7,5453
5,5,0,1,4,4,8,5453
6,6,1,0,5,4,9,5453
7,7,2,0,7,4,11,5453
8,8,2,1,9,5,14,5453
9,9,0,0,9,5,14,5453
0,0,1,0,1,0,1,5454
1,1,1,0,2,0,2,5454
2,2,1,0,3,0,3,5454
3,3,0,1,3,1,4,5454
4,4,0,2,3,3,6,5454
5,5,0,4,3,7,10,5454
6,6,2,2,5,9,14,5454
7,7,2,1,7,10,17,5454
8,8,0,1,7,11,18,5454
9,9,1,1,8,12,20,5454
10,10,0,0,8,12,20,5454
0,0,1,0,1,0,1,5455
1,1,0,1,1,1,2,5455
2,2,0,1,1,2,3,5455
3,3,0,2,1,4,5,5455
4,4,0,0,1,4,5,5455
0,0,1,0,1,0,1,5456
1,1,0,0,1,0,1,5456
0,0,1,0,1,0,1,5457
1,1,1,0,2,0,2,5457
2,2,1,0,3,0,3,5457
3,3,1,0,4,0,4,5457
4,4,1,0,5,0,5,5457
5,5,0,0,5,0,5,5457
0,0,1,0,1,0,1,5458
1,1,1,0,2,0,2,5458
2,2,1,0,3,0,3,5458
3,3,0,0,3,0,3,5458
0,0,1,0,1,0,1,5459
1,1,0,0,1,0,1,5459
0,0,1,0,1,0,1,5460
1,1,0,0,1,0,1,5460
0,0,1,0,1,0,1,5461
1,1,1,0,2,0,2,5461
2,2,0,0,2,0,2,5461
0,0,1,0,1,0,1,5462
1,1,1,0,2,0,2,5462
2,2,0,0,2,0,2,5462
0,0,1,0,1,0,1,5463
1,1,1,0,2,0,2,5463
2,2,0,1,2,1,3,5463
3,3,1,2,3,3,6,5463
4,4,1,1,4,4,8,5463
5,5,3,0,7,4,11,5463
6,6,2,0,9,4,13,5463
7,7,1,2,10,6,16,5463
8,8,1,2,11,8,19,5463
9,9,0,2,11,10,21,5463
10,10,0,0,11,10,21,5463
0,0,1,0,1,0,1,5464
1,1,0,0,1,0,1,5464
0,0,1,0,1,0,1,5465
1,1,0,0,1,0,1,5465
0,0,1,0,1,0,1,5466
1,1,3,0,4,0,4,5466
2,2,1,1,5,1,6,5466
3,3,0,2,5,3,8,5466
4,4,1,1,6,4,10,5466
5,5,1,2,7,6,13,5466
6,6,0,0,7,6,13,5466
0,0,1,0,1,0,1,5467
1,1,0,1,1,1,2,5467
2,2,0,1,1,2,3,5467
3,3,0,3,1,5,6,5467
4,4,2,1,3,6,9,5467
5,5,3,2,6,8,14,5467
6,6,2,4,8,12,20,5467
7,7,3,6,11,18,29,5467
8,8,3,1,14,19,33,5467
9,9,0,1,14,20,34,5467
10,10,2,0,16,20,36,5467
11,11,3,0,19,20,39,5467
12,12,2,0,21,20,41,5467
13,13,2,0,23,20,43,5467
14,14,1,0,24,20,44,5467
15,15,0,0,24,20,44,5467
0,0,1,0,1,0,1,5468
1,1,2,1,3,1,4,5468
2,2,2,0,5,1,6,5468
3,3,1,1,6,2,8,5468
4,4,0,2,6,4,10,5468
5,5,0,1,6,5,11,5468
6,6,0,0,6,5,11,5468
0,0,1,0,1,0,1,5469
1,1,1,0,2,0,2,5469
2,2,1,1,3,1,4,5469
3,3,1,0,4,1,5,5469
4,4,1,0,5,1,6,5469
5,5,0,0,5,1,6,5469
0,0,1,0,1,0,1,5470
1,1,2,0,3,0,3,5470
2,2,1,0,4,0,4,5470
3,3,1,0,5,0,5,5470
4,4,2,0,7,0,7,5470
5,5,2,0,9,0,9,5470
6,6,0,0,9,0,9,5470
0,0,1,0,1,0,1,5471
1,1,0,0,1,0,1,5471
0,0,1,0,1,0,1,5472
1,1,1,0,2,0,2,5472
2,2,0,0,2,0,2,5472
0,0,1,0,1,0,1,5473
1,1,1,0,2,0,2,5473
2,2,1,1,3,1,4,5473
3,3,1,1,4,2,6,5473
4,4,2,0,6,2,8,5473
5,5,3,0,9,2,11,5473
6,6,4,3,13,5,18,5473
7,7,3,1,16,6,22,5473
8,8,2,3,18,9,27,5473
9,9,0,2,18,11,29,5473
10,10,1,2,19,13,32,5473
11,11,1,2,20,15,35,5473
12,12,2,1,22,16,38,5473
13,13,1,0,23,16,39,5473
14,14,0,0,23,16,39,5473
0,0,1,0,1,0,1,5474
1,1,1,0,2,0,2,5474
2,2,1,2,3,2,5,5474
3,3,0,3,3,5,8,5474
4,4,0,2,3,7,10,5474
5,5,1,1,4,8,12,5474
6,6,2,0,6,8,14,5474
7,7,0,0,6,8,14,5474
0,0,1,0,1,0,1,5475
1,1,0,0,1,0,1,5475
0,0,1,0,1,0,1,5476
1,1,0,1,1,1,2,5476
2,2,1,1,2,2,4,5476
3,3,1,1,3,3,6,5476
4,4,1,0,4,3,7,5476
5,5,1,0,5,3,8,5476
6,6,1,0,6,3,9,5476
7,7,2,0,8,3,11,5476
8,8,1,1,9,4,13,5476
9,9,1,1,10,5,15,5476
10,10,1,1,11,6,17,5476
11,11,1,0,12,6,18,5476
12,12,1,0,13,6,19,5476
13,13,0,0,13,6,19,5476
0,0,1,0,1,0,1,5477
1,1,0,0,1,0,1,5477
0,0,1,0,1,0,1,5478
1,1,0,0,1,0,1,5478
0,0,1,0,1,0,1,5479
1,1,1,0,2,0,2,5479
2,2,0,1,2,1,3,5479
3,3,0,0,2,1,3,5479
0,0,1,0,1,0,1,5480
1,1,0,0,1,0,1,5480
0,0,1,0,1,0,1,5481
1,1,2,0,3,0,3,5481
2,2,3,1,6,1,7,5481
3,3,4,3,10,4,14,5481
4,4,7,0,17,4,21,5481
5,5,4,3,21,7,28,5481
6,6,2,4,23,11,34,5481
7,7,2,3,25,14,39,5481
8,8,4,1,29,15,44,5481
9,9,6,0,35,15,50,5481
10,10,2,0,37,15,52,5481
11,11,3,1,40,16,56,5481
12,12,3,2,43,18,61,5481
13,13,0,1,43,19,62,5481
14,14,1,2,44,21,65,5481
15,15,3,1,47,22,69,5481
16,16,2,1,49,23,72,5481
17,17,1,1,50,24,74,5481
18,18,0,2,50,26,76,5481
19,19,0,1,50,27,77,5481
20,20,1,0,51,27,78,5481
21,21,0,0,51,27,78,5481
0,0,1,0,1,0,1,5482
1,1,3,0,4,0,4,5482
2,2,2,0,6,0,6,5482
3,3,2,0,8,0,8,5482
4,4,3,1,11,1,12,5482
5,5,2,1,13,2,15,5482
6,6,1,2,14,4,18,5482
7,7,1,0,15,4,19,5482
8,8,1,0,16,4,20,5482
9,9,0,0,16,4,20,5482
0,0,1,0,1,0,1,5483
1,1,1,0,2,0,2,5483
2,2,0,0,2,0,2,5483
0,0,1,0,1,0,1,5484
1,1,1,0,2,0,2,5484
2,2,0,0,2,0,2,5484
0,0,1,0,1,0,1,5485
1,1,1,0,2,0,2,5485
2,2,1,0,3,0,3,5485
3,3,1,1,4,1,5,5485
4,4,1,1,5,2,7,5485
5,5,0,1,5,3,8,5485
6,6,0,1,5,4,9,5485
7,7,0,0,5,4,9,5485
0,0,1,0,1,0,1,5486
1,1,1,0,2,0,2,5486
2,2,0,1,2,1,3,5486
3,3,1,0,3,1,4,5486
4,4,0,0,3,1,4,5486
0,0,1,0,1,0,1,5487
1,1,1,1,2,1,3,5487
2,2,3,3,5,4,9,5487
3,3,4,3,9,7,16,5487
4,4,2,8,11,15,26,5487
5,5,3,5,14,20,34,5487
6,6,3,5,17,25,42,5487
7,7,5,6,22,31,53,5487
8,8,2,8,24,39,63,5487
9,9,5,6,29,45,74,5487
10,10,3,6,32,51,83,5487
11,11,3,8,35,59,94,5487
12,12,0,12,35,71,106,5487
13,13,2,10,37,81,118,5487
14,14,1,5,38,86,124,5487
15,15,2,3,40,89,129,5487
16,16,5,4,45,93,138,5487
17,17,7,5,52,98,150,5487
18,18,8,7,60,105,165,5487
19,19,4,3,64,108,172,5487
20,20,4,5,68,113,181,5487
21,21,2,7,70,120,190,5487
22,22,1,4,71,124,195,5487
23,23,5,3,76,127,203,5487
24,24,3,2,79,129,208,5487
25,25,1,2,80,131,211,5487
26,26,0,3,80,134,214,5487
27,27,0,2,80,136,216,5487
28,28,1,0,81,136,217,5487
29,29,0,0,81,136,217,5487
0,0,1,0,1,0,1,5488
1,1,0,0,1,0,1,5488
0,0,1,0,1,0,1,5489
1,1,0,0,1,0,1,5489
0,0,1,0,1,0,1,5490
1,1,1,0,2,0,2,5490
2,2,1,1,3,1,4,5490
3,3,1,0,4,1,5,5490
4,4,2,0,6,1,7,5490
5,5,1,0,7,1,8,5490
6,6,0,0,7,1,8,5490
0,0,1,0,1,0,1,5491
1,1,0,1,1,1,2,5491
2,2,0,0,1,1,2,5491
0,0,1,0,1,0,1,5492
1,1,0,1,1,1,2,5492
2,2,0,0,1,1,2,5492
0,0,1,0,1,0,1,5493
1,1,1,0,2,0,2,5493
2,2,0,0,2,0,2,5493
0,0,1,0,1,0,1,5494
1,1,0,0,1,0,1,5494
0,0,1,0,1,0,1,5495
1,1,1,0,2,0,2,5495
2,2,0,0,2,0,2,5495
0,0,1,0,1,0,1,5496
1,1,0,0,1,0,1,5496
0,0,1,0,1,0,1,5497
1,1,0,1,1,1,2,5497
2,2,0,1,1,2,3,5497
3,3,0,0,1,2,3,5497
0,0,1,0,1,0,1,5498
1,1,0,0,1,0,1,5498
0,0,1,0,1,0,1,5499
1,1,2,0,3,0,3,5499
2,2,2,0,5,0,5,5499
3,3,2,0,7,0,7,5499
4,4,1,0,8,0,8,5499
5,5,0,0,8,0,8,5499
0,0,1,0,1,0,1,5500
1,1,0,1,1,1,2,5500
2,2,0,2,1,3,4,5500
3,3,1,0,2,3,5,5500
4,4,1,0,3,3,6,5500
5,5,1,0,4,3,7,5500
6,6,1,0,5,3,8,5500
7,7,0,0,5,3,8,5500
0,0,1,0,1,0,1,5501
1,1,4,0,5,0,5,5501
2,2,4,1,9,1,10,5501
3,3,6,1,15,2,17,5501
4,4,1,5,16,7,23,5501
5,5,3,4,19,11,30,5501
6,6,4,4,23,15,38,5501
7,7,6,3,29,18,47,5501
8,8,3,3,32,21,53,5501
9,9,3,2,35,23,58,5501
10,10,3,1,38,24,62,5501
11,11,0,1,38,25,63,5501
12,12,0,0,38,25,63,5501
0,0,1,0,1,0,1,5502
1,1,0,0,1,0,1,5502
0,0,1,0,1,0,1,5503
1,1,0,0,1,0,1,5503
0,0,1,0,1,0,1,5504
1,1,0,0,1,0,1,5504
0,0,1,0,1,0,1,5505
1,1,1,0,2,0,2,5505
2,2,0,0,2,0,2,5505
0,0,1,0,1,0,1,5506
1,1,2,0,3,0,3,5506
2,2,0,0,3,0,3,5506
0,0,1,0,1,0,1,5507
1,1,0,0,1,0,1,5507
0,0,1,0,1,0,1,5508
1,1,1,1,2,1,3,5508
2,2,0,0,2,1,3,5508
0,0,1,0,1,0,1,5509
1,1,1,0,2,0,2,5509
2,2,0,0,2,0,2,5509
0,0,1,0,1,0,1,5510
1,1,0,0,1,0,1,5510
0,0,1,0,1,0,1,5511
1,1,0,1,1,1,2,5511
2,2,0,2,1,3,4,5511
3,3,0,1,1,4,5,5511
4,4,0,0,1,4,5,5511
0,0,1,0,1,0,1,5512
1,1,1,0,2,0,2,5512
2,2,0,0,2,0,2,5512
0,0,1,0,1,0,1,5513
1,1,0,0,1,0,1,5513
0,0,1,0,1,0,1,5514
1,1,0,0,1,0,1,5514
0,0,1,0,1,0,1,5515
1,1,0,0,1,0,1,5515
0,0,1,0,1,0,1,5516
1,1,0,0,1,0,1,5516
0,0,1,0,1,0,1,5517
1,1,0,0,1,0,1,5517
0,0,1,0,1,0,1,5518
1,1,0,0,1,0,1,5518
0,0,1,0,1,0,1,5519
1,1,0,1,1,1,2,5519
2,2,0,0,1,1,2,5519
0,0,1,0,1,0,1,5520
1,1,0,0,1,0,1,5520
0,0,1,0,1,0,1,5521
1,1,0,1,1,1,2,5521
2,2,1,0,2,1,3,5521
3,3,0,0,2,1,3,5521
0,0,1,0,1,0,1,5522
1,1,0,0,1,0,1,5522
0,0,1,0,1,0,1,5523
1,1,3,0,4,0,4,5523
2,2,3,0,7,0,7,5523
3,3,1,1,8,1,9,5523
4,4,1,2,9,3,12,5523
5,5,2,1,11,4,15,5523
6,6,1,2,12,6,18,5523
7,7,0,1,12,7,19,5523
8,8,0,0,12,7,19,5523
0,0,1,0,1,0,1,5524
1,1,0,0,1,0,1,5524
0,0,1,0,1,0,1,5525
1,1,3,0,4,0,4,5525
2,2,1,2,5,2,7,5525
3,3,2,3,7,5,12,5525
4,4,1,3,8,8,16,5525
5,5,2,2,10,10,20,5525
6,6,2,3,12,13,25,5525
7,7,1,2,13,15,28,5525
8,8,0,3,13,18,31,5525
9,9,0,1,13,19,32,5525
10,10,0,0,13,19,32,5525
0,0,1,0,1,0,1,5526
1,1,1,0,2,0,2,5526
2,2,1,0,3,0,3,5526
3,3,0,0,3,0,3,5526
0,0,1,0,1,0,1,5527
1,1,0,0,1,0,1,5527
0,0,1,0,1,0,1,5528
1,1,1,0,2,0,2,5528
2,2,0,0,2,0,2,5528
0,0,1,0,1,0,1,5529
1,1,1,0,2,0,2,5529
2,2,0,0,2,0,2,5529
0,0,1,0,1,0,1,5530
1,1,1,1,2,1,3,5530
2,2,0,2,2,3,5,5530
3,3,0,1,2,4,6,5530
4,4,0,1,2,5,7,5530
5,5,0,0,2,5,7,5530
0,0,1,0,1,0,1,5531
1,1,1,0,2,0,2,5531
2,2,1,0,3,0,3,5531
3,3,2,0,5,0,5,5531
4,4,3,0,8,0,8,5531
5,5,2,1,10,1,11,5531
6,6,1,2,11,3,14,5531
7,7,2,2,13,5,18,5531
8,8,3,1,16,6,22,5531
9,9,3,1,19,7,26,5531
10,10,4,2,23,9,32,5531
11,11,2,2,25,11,36,5531
12,12,3,2,28,13,41,5531
13,13,2,3,30,16,46,5531
14,14,0,1,30,17,47,5531
15,15,0,2,30,19,49,5531
16,16,1,3,31,22,53,5531
17,17,2,4,33,26,59,5531
18,18,2,4,35,30,65,5531
19,19,2,2,37,32,69,5531
20,20,0,2,37,34,71,5531
21,21,1,1,38,35,73,5531
22,22,0,0,38,35,73,5531
0,0,1,0,1,0,1,5532
1,1,0,0,1,0,1,5532
0,0,1,0,1,0,1,5533
1,1,3,0,4,0,4,5533
2,2,2,1,6,1,7,5533
3,3,1,1,7,2,9,5533
4,4,1,0,8,2,10,5533
5,5,0,1,8,3,11,5533
6,6,0,0,8,3,11,5533
0,0,1,0,1,0,1,5534
1,1,0,0,1,0,1,5534
0,0,1,0,1,0,1,5535
1,1,2,0,3,0,3,5535
2,2,2,1,5,1,6,5535
3,3,1,0,6,1,7,5535
4,4,2,0,8,1,9,5535
5,5,0,1,8,2,10,5535
6,6,0,0,8,2,10,5535
0,0,1,0,1,0,1,5536
1,1,1,1,2,1,3,5536
2,2,2,2,4,3,7,5536
3,3,3,2,7,5,12,5536
4,4,2,4,9,9,18,5536
5,5,0,4,9,13,22,5536
6,6,2,6,11,19,30,5536
7,7,2,1,13,20,33,5536
8,8,2,0,15,20,35,5536
9,9,5,1,20,21,41,5536
10,10,4,3,24,24,48,5536
11,11,4,5,28,29,57,5536
12,12,3,2,31,31,62,5536
13,13,4,2,35,33,68,5536
14,14,2,6,37,39,76,5536
15,15,2,4,39,43,82,5536
16,16,1,1,40,44,84,5536
17,17,1,0,41,44,85,5536
18,18,1,0,42,44,86,5536
19,19,2,1,44,45,89,5536
20,20,2,0,46,45,91,5536
21,21,2,0,48,45,93,5536
22,22,2,2,50,47,97,5536
23,23,3,5,53,52,105,5536
24,24,2,8,55,60,115,5536
25,25,4,7,59,67,126,5536
26,26,5,9,64,76,140,5536
27,27,4,3,68,79,147,5536
28,28,3,0,71,79,150,5536
29,29,1,0,72,79,151,5536
30,30,0,0,72,79,151,5536
0,0,1,0,1,0,1,5537
1,1,0,0,1,0,1,5537
0,0,1,0,1,0,1,5538
1,1,0,0,1,0,1,5538
0,0,1,0,1,0,1,5539
1,1,0,0,1,0,1,5539
0,0,1,0,1,0,1,5540
1,1,1,0,2,0,2,5540
2,2,1,0,3,0,3,5540
3,3,0,0,3,0,3,5540
0,0,1,0,1,0,1,5541
1,1,0,0,1,0,1,5541
0,0,1,0,1,0,1,5542
1,1,1,0,2,0,2,5542
2,2,1,0,3,0,3,5542
3,3,2,0,5,0,5,5542
4,4,2,2,7,2,9,5542
5,5,5,2,12,4,16,5542
6,6,5,2,17,6,23,5542
7,7,7,3,24,9,33,5542
8,8,3,9,27,18,45,5542
9,9,3,5,30,23,53,5542
10,10,3,5,33,28,61,5542
11,11,2,5,35,33,68,5542
12,12,1,4,36,37,73,5542
13,13,0,3,36,40,76,5542
14,14,0,1,36,41,77,5542
15,15,0,1,36,42,78,5542
16,16,1,1,37,43,80,5542
17,17,0,1,37,44,81,5542
18,18,0,0,37,44,81,5542
0,0,1,0,1,0,1,5543
1,1,0,0,1,0,1,5543
0,0,1,0,1,0,1,5544
1,1,1,0,2,0,2,5544
2,2,0,0,2,0,2,5544
0,0,1,0,1,0,1,5545
1,1,2,0,3,0,3,5545
2,2,2,0,5,0,5,5545
3,3,5,0,10,0,10,5545
4,4,9,1,19,1,20,5545
5,5,2,8,21,9,30,5545
6,6,4,5,25,14,39,5545
7,7,4,5,29,19,48,5545
8,8,4,5,33,24,57,5545
9,9,5,3,38,27,65,5545
10,10,3,3,41,30,71,5545
11,11,1,0,42,30,72,5545
12,12,1,0,43,30,73,5545
13,13,0,0,43,30,73,5545
0,0,1,0,1,0,1,5546
1,1,0,0,1,0,1,5546
0,0,1,0,1,0,1,5547
1,1,2,0,3,0,3,5547
2,2,4,1,7,1,8,5547
3,3,4,2,11,3,14,5547
4,4,3,0,14,3,17,5547
5,5,0,0,14,3,17,5547
0,0,1,0,1,0,1,5548
1,1,0,1,1,1,2,5548
2,2,0,0,1,1,2,5548
0,0,1,0,1,0,1,5549
1,1,0,0,1,0,1,5549
0,0,1,0,1,0,1,5550
1,1,4,1,5,1,6,5550
2,2,5,1,10,2,12,5550
3,3,0,2,10,4,14,5550
4,4,1,1,11,5,16,5550
5,5,0,2,11,7,18,5550
6,6,0,1,11,8,19,5550
7,7,1,0,12,8,20,5550
8,8,0,0,12,8,20,5550
0,0,1,0,1,0,1,5551
1,1,0,0,1,0,1,5551
0,0,1,0,1,0,1,5552
1,1,0,0,1,0,1,5552
0,0,1,0,1,0,1,5553
1,1,0,0,1,0,1,5553
0,0,1,0,1,0,1,5554
1,1,3,1,4,1,5,5554
2,2,2,0,6,1,7,5554
3,3,2,1,8,2,10,5554
4,4,2,2,10,4,14,5554
5,5,1,1,11,5,16,5554
6,6,0,2,11,7,18,5554
7,7,0,2,11,9,20,5554
8,8,0,1,11,10,21,5554
9,9,0,1,11,11,22,5554
10,10,0,2,11,13,24,5554
11,11,0,3,11,16,27,5554
12,12,0,3,11,19,30,5554
13,13,0,2,11,21,32,5554
14,14,1,2,12,23,35,5554
15,15,2,2,14,25,39,5554
16,16,3,2,17,27,44,5554
17,17,1,0,18,27,45,5554
18,18,1,0,19,27,46,5554
19,19,1,0,20,27,47,5554
20,20,1,1,21,28,49,5554
21,21,1,2,22,30,52,5554
22,22,1,0,23,30,53,5554
23,23,0,0,23,30,53,5554
0,0,1,0,1,0,1,5555
1,1,0,0,1,0,1,5555
0,0,1,0,1,0,1,5556
1,1,2,0,3,0,3,5556
2,2,2,0,5,0,5,5556
3,3,1,0,6,0,6,5556
4,4,1,0,7,0,7,5556
5,5,2,0,9,0,9,5556
6,6,2,0,11,0,11,5556
7,7,1,1,12,1,13,5556
8,8,1,1,13,2,15,5556
9,9,1,0,14,2,16,5556
10,10,0,1,14,3,17,5556
11,11,0,0,14,3,17,5556
0,0,1,0,1,0,1,5557
1,1,1,0,2,0,2,5557
2,2,0,0,2,0,2,5557
0,0,1,0,1,0,1,5558
1,1,3,0,4,0,4,5558
2,2,1,0,5,0,5,5558
3,3,1,1,6,1,7,5558
4,4,0,1,6,2,8,5558
5,5,0,0,6,2,8,5558
0,0,1,0,1,0,1,5559
1,1,1,1,2,1,3,5559
2,2,0,2,2,3,5,5559
3,3,1,1,3,4,7,5559
4,4,0,0,3,4,7,5559
0,0,1,0,1,0,1,5560
1,1,0,0,1,0,1,5560
0,0,1,0,1,0,1,5561
1,1,0,0,1,0,1,5561
0,0,1,0,1,0,1,5562
1,1,1,0,2,0,2,5562
2,2,0,1,2,1,3,5562
3,3,0,1,2,2,4,5562
4,4,0,0,2,2,4,5562
0,0,1,0,1,0,1,5563
1,1,0,0,1,0,1,5563
0,0,1,0,1,0,1,5564
1,1,0,0,1,0,1,5564
0,0,1,0,1,0,1,5565
1,1,0,0,1,0,1,5565
0,0,1,0,1,0,1,5566
1,1,0,0,1,0,1,5566
0,0,1,0,1,0,1,5567
1,1,0,0,1,0,1,5567
0,0,1,0,1,0,1,5568
1,1,0,1,1,1,2,5568
2,2,0,2,1,3,4,5568
3,3,0,3,1,6,7,5568
4,4,0,2,1,8,9,5568
5,5,0,1,1,9,10,5568
6,6,1,3,2,12,14,5568
7,7,1,2,3,14,17,5568
8,8,1,1,4,15,19,5568
9,9,1,2,5,17,22,5568
10,10,2,1,7,18,25,5568
11,11,1,2,8,20,28,5568
12,12,1,2,9,22,31,5568
13,13,2,1,11,23,34,5568
14,14,2,1,13,24,37,5568
15,15,4,2,17,26,43,5568
16,16,4,0,21,26,47,5568
17,17,4,0,25,26,51,5568
18,18,2,0,27,26,53,5568
19,19,0,0,27,26,53,5568
0,0,1,0,1,0,1,5569
1,1,1,0,2,0,2,5569
2,2,1,0,3,0,3,5569
3,3,0,0,3,0,3,5569
0,0,1,0,1,0,1,5570
1,1,0,0,1,0,1,5570
0,0,1,0,1,0,1,5571
1,1,0,0,1,0,1,5571
0,0,1,0,1,0,1,5572
1,1,3,1,4,1,5,5572
2,2,1,1,5,2,7,5572
3,3,1,1,6,3,9,5572
4,4,0,0,6,3,9,5572
0,0,1,0,1,0,1,5573
1,1,0,0,1,0,1,5573
0,0,1,0,1,0,1,5574
1,1,0,1,1,1,2,5574
2,2,0,1,1,2,3,5574
3,3,0,0,1,2,3,5574
0,0,1,0,1,0,1,5575
1,1,2,0,3,0,3,5575
2,2,1,0,4,0,4,5575
3,3,2,1,6,1,7,5575
4,4,2,0,8,1,9,5575
5,5,1,0,9,1,10,5575
6,6,0,0,9,1,10,5575
0,0,1,0,1,0,1,5576
1,1,0,0,1,0,1,5576
0,0,1,0,1,0,1,5577
1,1,0,0,1,0,1,5577
0,0,1,0,1,0,1,5578
1,1,1,0,2,0,2,5578
2,2,1,0,3,0,3,5578
3,3,1,1,4,1,5,5578
4,4,1,1,5,2,7,5578
5,5,1,2,6,4,10,5578
6,6,3,2,9,6,15,5578
7,7,1,0,10,6,16,5578
8,8,0,0,10,6,16,5578
0,0,1,0,1,0,1,5579
1,1,2,0,3,0,3,5579
2,2,3,1,6,1,7,5579
3,3,4,2,10,3,13,5579
4,4,2,2,12,5,17,5579
5,5,2,2,14,7,21,5579
6,6,1,5,15,12,27,5579
7,7,2,7,17,19,36,5579
8,8,2,4,19,23,42,5579
9,9,3,1,22,24,46,5579
10,10,1,4,23,28,51,5579
11,11,0,3,23,31,54,5579
12,12,0,5,23,36,59,5579
13,13,1,1,24,37,61,5579
14,14,0,2,24,39,63,5579
15,15,1,4,25,43,68,5579
16,16,1,5,26,48,74,5579
17,17,0,4,26,52,78,5579
18,18,0,4,26,56,82,5579
19,19,0,3,26,59,85,5579
20,20,0,1,26,60,86,5579
21,21,0,0,26,60,86,5579
0,0,1,0,1,0,1,5580
1,1,2,0,3,0,3,5580
2,2,0,2,3,2,5,5580
3,3,2,0,5,2,7,5580
4,4,0,1,5,3,8,5580
5,5,1,1,6,4,10,5580
6,6,1,0,7,4,11,5580
7,7,1,0,8,4,12,5580
8,8,2,0,10,4,14,5580
9,9,2,0,12,4,16,5580
10,10,1,0,13,4,17,5580
11,11,1,0,14,4,18,5580
12,12,0,1,14,5,19,5580
13,13,0,1,14,6,20,5580
14,14,0,0,14,6,20,5580
0,0,1,0,1,0,1,5581
1,1,0,0,1,0,1,5581
0,0,1,0,1,0,1,5582
1,1,1,1,2,1,3,5582
2,2,0,0,2,1,3,5582
0,0,1,0,1,0,1,5583
1,1,2,0,3,0,3,5583
2,2,3,1,6,1,7,5583
3,3,3,1,9,2,11,5583
4,4,1,1,10,3,13,5583
5,5,1,1,11,4,15,5583
6,6,1,0,12,4,16,5583
7,7,1,0,13,4,17,5583
8,8,2,0,15,4,19,5583
9,9,3,0,18,4,22,5583
10,10,1,1,19,5,24,5583
11,11,1,3,20,8,28,5583
12,12,1,5,21,13,34,5583
13,13,1,4,22,17,39,5583
14,14,2,4,24,21,45,5583
15,15,3,4,27,25,52,5583
16,16,3,1,30,26,56,5583
17,17,2,1,32,27,59,5583
18,18,1,1,33,28,61,5583
19,19,0,1,33,29,62,5583
20,20,0,1,33,30,63,5583
21,21,2,2,35,32,67,5583
22,22,2,2,37,34,71,5583
23,23,2,2,39,36,75,5583
24,24,1,3,40,39,79,5583
25,25,2,2,42,41,83,5583
26,26,1,0,43,41,84,5583
27,27,0,0,43,41,84,5583
0,0,1,0,1,0,1,5584
1,1,1,0,2,0,2,5584
2,2,2,0,4,0,4,5584
3,3,0,0,4,0,4,5584
0,0,1,0,1,0,1,5585
1,1,0,0,1,0,1,5585
0,0,1,0,1,0,1,5586
1,1,1,0,2,0,2,5586
2,2,0,0,2,0,2,5586
0,0,1,0,1,0,1,5587
1,1,0,0,1,0,1,5587
0,0,1,0,1,0,1,5588
1,1,4,0,5,0,5,5588
2,2,5,0,10,0,10,5588
3,3,2,0,12,0,12,5588
4,4,1,0,13,0,13,5588
5,5,1,0,14,0,14,5588
6,6,2,0,16,0,16,5588
7,7,1,1,17,1,18,5588
8,8,1,1,18,2,20,5588
9,9,1,0,19,2,21,5588
10,10,1,0,20,2,22,5588
11,11,0,0,20,2,22,5588
0,0,1,0,1,0,1,5589
1,1,1,0,2,0,2,5589
2,2,0,0,2,0,2,5589
0,0,1,0,1,0,1,5590
1,1,1,0,2,0,2,5590
2,2,0,0,2,0,2,5590
0,0,1,0,1,0,1,5591
1,1,1,1,2,1,3,5591
2,2,1,0,3,1,4,5591
3,3,2,0,5,1,6,5591
4,4,4,0,9,1,10,5591
5,5,4,0,13,1,14,5591
6,6,2,0,15,1,16,5591
7,7,0,0,15,1,16,5591
0,0,1,0,1,0,1,5592
1,1,0,0,1,0,1,5592
0,0,1,0,1,0,1,5593
1,1,2,0,3,0,3,5593
2,2,2,3,5,3,8,5593
3,3,3,5,8,8,16,5593
4,4,1,3,9,11,20,5593
5,5,1,1,10,12,22,5593
6,6,2,1,12,13,25,5593
7,7,1,2,13,15,28,5593
8,8,0,2,13,17,30,5593
9,9,0,2,13,19,32,5593
10,10,1,2,14,21,35,5593
11,11,1,1,15,22,37,5593
12,12,0,0,15,22,37,5593
0,0,1,0,1,0,1,5594
1,1,2,0,3,0,3,5594
2,2,3,0,6,0,6,5594
3,3,1,0,7,0,7,5594
4,4,0,1,7,1,8,5594
5,5,0,0,7,1,8,5594
0,0,1,0,1,0,1,5595
1,1,1,0,2,0,2,5595
2,2,1,0,3,0,3,5595
3,3,0,0,3,0,3,5595
0,0,1,0,1,0,1,5596
1,1,1,0,2,0,2,5596
2,2,0,0,2,0,2,5596
0,0,1,0,1,0,1,5597
1,1,2,0,3,0,3,5597
2,2,1,0,4,0,4,5597
3,3,0,1,4,1,5,5597
4,4,0,1,4,2,6,5597
5,5,0,0,4,2,6,5597
0,0,1,0,1,0,1,5598
1,1,0,0,1,0,1,5598
0,0,1,0,1,0,1,5599
1,1,1,0,2,0,2,5599
2,2,1,1,3,1,4,5599
3,3,0,1,3,2,5,5599
4,4,1,0,4,2,6,5599
5,5,2,0,6,2,8,5599
6,6,1,0,7,2,9,5599
7,7,0,0,7,2,9,5599
0,0,1,0,1,0,1,5600
1,1,1,0,2,0,2,5600
2,2,0,0,2,0,2,5600
0,0,1,0,1,0,1,5601
1,1,0,0,1,0,1,5601
0,0,1,0,1,0,1,5602
1,1,1,0,2,0,2,5602
2,2,0,1,2,1,3,5602
3,3,0,2,2,3,5,5602
4,4,0,0,2,3,5,5602
0,0,1,0,1,0,1,5603
1,1,0,0,1,0,1,5603
0,0,1,0,1,0,1,5604
1,1,1,0,2,0,2,5604
2,2,0,0,2,0,2,5604
0,0,1,0,1,0,1,5605
1,1,0,0,1,0,1,5605
0,0,1,0,1,0,1,5606
1,1,1,0,2,0,2,5606
2,2,1,0,3,0,3,5606
3,3,1,0,4,0,4,5606
4,4,1,0,5,0,5,5606
5,5,1,0,6,0,6,5606
6,6,0,1,6,1,7,5606
7,7,0,0,6,1,7,5606
0,0,1,0,1,0,1,5607
1,1,1,0,2,0,2,5607
2,2,0,0,2,0,2,5607
0,0,1,0,1,0,1,5608
1,1,0,1,1,1,2,5608
2,2,1,0,2,1,3,5608
3,3,0,1,2,2,4,5608
4,4,0,0,2,2,4,5608
0,0,1,0,1,0,1,5609
1,1,0,0,1,0,1,5609
0,0,1,0,1,0,1,5610
1,1,2,1,3,1,4,5610
2,2,2,1,5,2,7,5610
3,3,3,0,8,2,10,5610
4,4,1,0,9,2,11,5610
5,5,0,0,9,2,11,5610
0,0,1,0,1,0,1,5611
1,1,0,0,1,0,1,5611
0,0,1,0,1,0,1,5612
1,1,0,0,1,0,1,5612
0,0,1,0,1,0,1,5613
1,1,1,1,2,1,3,5613
2,2,1,0,3,1,4,5613
3,3,0,0,3,1,4,5613
0,0,1,0,1,0,1,5614
1,1,0,0,1,0,1,5614
0,0,1,0,1,0,1,5615
1,1,0,0,1,0,1,5615
0,0,1,0,1,0,1,5616
1,1,0,2,1,2,3,5616
2,2,1,2,2,4,6,5616
3,3,0,3,2,7,9,5616
4,4,0,4,2,11,13,5616
5,5,1,3,3,14,17,5616
6,6,1,1,4,15,19,5616
7,7,0,2,4,17,21,5616
8,8,0,0,4,17,21,5616
0,0,1,0,1,0,1,5617
1,1,1,1,2,1,3,5617
2,2,0,1,2,2,4,5617
3,3,0,1,2,3,5,5617
4,4,0,1,2,4,6,5617
5,5,0,0,2,4,6,5617
0,0,1,0,1,0,1,5618
1,1,2,1,3,1,4,5618
2,2,2,1,5,2,7,5618
3,3,0,1,5,3,8,5618
4,4,1,1,6,4,10,5618
5,5,0,0,6,4,10,5618
0,0,1,0,1,0,1,5619
1,1,2,1,3,1,4,5619
2,2,2,2,5,3,8,5619
3,3,2,2,7,5,12,5619
4,4,3,0,10,5,15,5619
5,5,3,1,13,6,19,5619
6,6,0,0,13,6,19,5619
0,0,1,0,1,0,1,5620
1,1,1,1,2,1,3,5620
2,2,0,2,2,3,5,5620
3,3,0,1,2,4,6,5620
4,4,0,0,2,4,6,5620
0,0,1,0,1,0,1,5621
1,1,1,0,2,0,2,5621
2,2,1,0,3,0,3,5621
3,3,0,0,3,0,3,5621
0,0,1,0,1,0,1,5622
1,1,1,1,2,1,3,5622
2,2,0,1,2,2,4,5622
3,3,0,0,2,2,4,5622
0,0,1,0,1,0,1,5623
1,1,0,0,1,0,1,5623
0,0,1,0,1,0,1,5624
1,1,1,1,2,1,3,5624
2,2,1,1,3,2,5,5624
3,3,0,0,3,2,5,5624
0,0,1,0,1,0,1,5625
1,1,1,0,2,0,2,5625
2,2,0,0,2,0,2,5625
0,0,1,0,1,0,1,5626
1,1,1,1,2,1,3,5626
2,2,2,0,4,1,5,5626
3,3,1,1,5,2,7,5626
4,4,1,1,6,3,9,5626
5,5,2,1,8,4,12,5626
6,6,1,1,9,5,14,5626
7,7,0,0,9,5,14,5626
0,0,1,0,1,0,1,5627
1,1,0,0,1,0,1,5627
0,0,1,0,1,0,1,5628
1,1,0,2,1,2,3,5628
2,2,1,2,2,4,6,5628
3,3,0,1,2,5,7,5628
4,4,0,2,2,7,9,5628
5,5,2,1,4,8,12,5628
6,6,0,1,4,9,13,5628
7,7,1,2,5,11,16,5628
8,8,0,2,5,13,18,5628
9,9,1,3,6,16,22,5628
10,10,1,2,7,18,25,5628
11,11,2,4,9,22,31,5628
12,12,3,1,12,23,35,5628
13,13,1,2,13,25,38,5628
14,14,2,2,15,27,42,5628
15,15,2,2,17,29,46,5628
16,16,1,3,18,32,50,5628
17,17,1,5,19,37,56,5628
18,18,2,3,21,40,61,5628
19,19,4,4,25,44,69,5628
20,20,1,6,26,50,76,5628
21,21,1,3,27,53,80,5628
22,22,1,1,28,54,82,5628
23,23,0,1,28,55,83,5628
24,24,0,0,28,55,83,5628
0,0,1,0,1,0,1,5629
1,1,0,0,1,0,1,5629
0,0,1,0,1,0,1,5630
1,1,0,1,1,1,2,5630
2,2,0,5,1,6,7,5630
3,3,0,3,1,9,10,5630
4,4,0,3,1,12,13,5630
5,5,0,2,1,14,15,5630
6,6,0,1,1,15,16,5630
7,7,0,0,1,15,16,5630
0,0,1,0,1,0,1,5631
1,1,0,0,1,0,1,5631
0,0,1,0,1,0,1,5632
1,1,2,0,3,0,3,5632
2,2,1,0,4,0,4,5632
3,3,1,1,5,1,6,5632
4,4,0,0,5,1,6,5632
0,0,1,0,1,0,1,5633
1,1,1,0,2,0,2,5633
2,2,0,0,2,0,2,5633
0,0,1,0,1,0,1,5634
1,1,1,0,2,0,2,5634
2,2,0,0,2,0,2,5634
0,0,1,0,1,0,1,5635
1,1,2,0,3,0,3,5635
2,2,1,1,4,1,5,5635
3,3,1,0,5,1,6,5635
4,4,0,0,5,1,6,5635
0,0,1,0,1,0,1,5636
1,1,1,1,2,1,3,5636
2,2,0,0,2,1,3,5636
0,0,1,0,1,0,1,5637
1,1,0,0,1,0,1,5637
0,0,1,0,1,0,1,5638
1,1,0,0,1,0,1,5638
0,0,1,0,1,0,1,5639
1,1,1,0,2,0,2,5639
2,2,0,1,2,1,3,5639
3,3,1,1,3,2,5,5639
4,4,0,2,3,4,7,5639
5,5,1,1,4,5,9,5639
6,6,0,2,4,7,11,5639
7,7,0,2,4,9,13,5639
8,8,1,1,5,10,15,5639
9,9,0,0,5,10,15,5639
0,0,1,0,1,0,1,5640
1,1,1,0,2,0,2,5640
2,2,0,1,2,1,3,5640
3,3,0,1,2,2,4,5640
4,4,1,0,3,2,5,5640
5,5,1,0,4,2,6,5640
6,6,1,0,5,2,7,5640
7,7,0,0,5,2,7,5640
0,0,1,0,1,0,1,5641
1,1,1,0,2,0,2,5641
2,2,0,0,2,0,2,5641
0,0,1,0,1,0,1,5642
1,1,0,0,1,0,1,5642
0,0,1,0,1,0,1,5643
1,1,0,1,1,1,2,5643
2,2,2,1,3,2,5,5643
3,3,0,1,3,3,6,5643
4,4,0,0,3,3,6,5643
0,0,1,0,1,0,1,5644
1,1,0,0,1,0,1,5644
0,0,1,0,1,0,1,5645
1,1,1,0,2,0,2,5645
2,2,0,0,2,0,2,5645
0,0,1,0,1,0,1,5646
1,1,0,0,1,0,1,5646
0,0,1,0,1,0,1,5647
1,1,1,0,2,0,2,5647
2,2,0,0,2,0,2,5647
0,0,1,0,1,0,1,5648
1,1,1,2,2,2,4,5648
2,2,1,2,3,4,7,5648
3,3,1,2,4,6,10,5648
4,4,1,1,5,7,12,5648
5,5,2,3,7,10,17,5648
6,6,3,5,10,15,25,5648
7,7,5,2,15,17,32,5648
8,8,9,1,24,18,42,5648
9,9,5,1,29,19,48,5648
10,10,3,3,32,22,54,5648
11,11,3,0,35,22,57,5648
12,12,4,0,39,22,61,5648
13,13,2,1,41,23,64,5648
14,14,1,2,42,25,67,5648
15,15,1,2,43,27,70,5648
16,16,3,0,46,27,73,5648
17,17,1,2,47,29,76,5648
18,18,1,2,48,31,79,5648
19,19,0,2,48,33,81,5648
20,20,0,3,48,36,84,5648
21,21,0,3,48,39,87,5648
22,22,0,1,48,40,88,5648
23,23,0,2,48,42,90,5648
24,24,0,1,48,43,91,5648
25,25,0,1,48,44,92,5648
26,26,1,2,49,46,95,5648
27,27,0,0,49,46,95,5648
0,0,1,0,1,0,1,5649
1,1,1,1,2,1,3,5649
2,2,0,0,2,1,3,5649
0,0,1,0,1,0,1,5650
1,1,1,0,2,0,2,5650
2,2,1,0,3,0,3,5650
3,3,3,0,6,0,6,5650
4,4,1,1,7,1,8,5650
5,5,0,1,7,2,9,5650
6,6,0,1,7,3,10,5650
7,7,0,0,7,3,10,5650
0,0,1,0,1,0,1,5651
1,1,1,0,2,0,2,5651
2,2,0,0,2,0,2,5651
0,0,1,0,1,0,1,5652
1,1,0,0,1,0,1,5652
0,0,1,0,1,0,1,5653
1,1,1,1,2,1,3,5653
2,2,0,2,2,3,5,5653
3,3,0,0,2,3,5,5653
0,0,1,0,1,0,1,5654
1,1,0,0,1,0,1,5654
0,0,1,0,1,0,1,5655
1,1,2,1,3,1,4,5655
2,2,0,1,3,2,5,5655
3,3,0,2,3,4,7,5655
4,4,1,1,4,5,9,5655
5,5,1,0,5,5,10,5655
6,6,0,0,5,5,10,5655
0,0,1,0,1,0,1,5656
1,1,1,0,2,0,2,5656
2,2,3,0,5,0,5,5656
3,3,2,1,7,1,8,5656
4,4,0,1,7,2,9,5656
5,5,0,1,7,3,10,5656
6,6,0,2,7,5,12,5656
7,7,0,1,7,6,13,5656
8,8,0,0,7,6,13,5656
0,0,1,0,1,0,1,5657
1,1,0,0,1,0,1,5657
0,0,1,0,1,0,1,5658
1,1,1,0,2,0,2,5658
2,2,1,1,3,1,4,5658
3,3,3,2,6,3,9,5658
4,4,0,0,6,3,9,5658
0,0,1,0,1,0,1,5659
1,1,2,0,3,0,3,5659
2,2,0,0,3,0,3,5659
0,0,1,0,1,0,1,5660
1,1,1,0,2,0,2,5660
2,2,0,0,2,0,2,5660
0,0,1,0,1,0,1,5661
1,1,1,0,2,0,2,5661
2,2,2,0,4,0,4,5661
3,3,2,0,6,0,6,5661
4,4,0,0,6,0,6,5661
0,0,1,0,1,0,1,5662
1,1,2,0,3,0,3,5662
2,2,1,0,4,0,4,5662
3,3,0,0,4,0,4,5662
0,0,1,0,1,0,1,5663
1,1,1,0,2,0,2,5663
2,2,0,0,2,0,2,5663
0,0,1,0,1,0,1,5664
1,1,1,0,2,0,2,5664
2,2,1,0,3,0,3,5664
3,3,0,0,3,0,3,5664
0,0,1,0,1,0,1,5665
1,1,2,0,3,0,3,5665
2,2,0,0,3,0,3,5665
0,0,1,0,1,0,1,5666
1,1,0,0,1,0,1,5666
0,0,1,0,1,0,1,5667
1,1,1,1,2,1,3,5667
2,2,0,3,2,4,6,5667
3,3,0,2,2,6,8,5667
4,4,1,0,3,6,9,5667
5,5,1,0,4,6,10,5667
6,6,0,0,4,6,10,5667
0,0,1,0,1,0,1,5668
1,1,1,0,2,0,2,5668
2,2,0,0,2,0,2,5668
0,0,1,0,1,0,1,5669
1,1,0,0,1,0,1,5669
0,0,1,0,1,0,1,5670
1,1,0,0,1,0,1,5670
0,0,1,0,1,0,1,5671
1,1,1,0,2,0,2,5671
2,2,2,0,4,0,4,5671
3,3,1,1,5,1,6,5671
4,4,0,1,5,2,7,5671
5,5,0,1,5,3,8,5671
6,6,0,0,5,3,8,5671
0,0,1,0,1,0,1,5672
1,1,1,1,2,1,3,5672
2,2,0,1,2,2,4,5672
3,3,0,1,2,3,5,5672
4,4,1,0,3,3,6,5672
5,5,1,0,4,3,7,5672
6,6,0,0,4,3,7,5672
0,0,1,0,1,0,1,5673
1,1,1,0,2,0,2,5673
2,2,1,0,3,0,3,5673
3,3,0,0,3,0,3,5673
0,0,1,0,1,0,1,5674
1,1,0,0,1,0,1,5674
0,0,1,0,1,0,1,5675
1,1,1,0,2,0,2,5675
2,2,0,0,2,0,2,5675
0,0,1,0,1,0,1,5676
1,1,0,0,1,0,1,5676
0,0,1,0,1,0,1,5677
1,1,0,0,1,0,1,5677
0,0,1,0,1,0,1,5678
1,1,1,0,2,0,2,5678
2,2,0,0,2,0,2,5678
0,0,1,0,1,0,1,5679
1,1,1,0,2,0,2,5679
2,2,0,0,2,0,2,5679
0,0,1,0,1,0,1,5680
1,1,0,1,1,1,2,5680
2,2,2,2,3,3,6,5680
3,3,0,0,3,3,6,5680
0,0,1,0,1,0,1,5681
1,1,3,0,4,0,4,5681
2,2,4,1,8,1,9,5681
3,3,5,3,13,4,17,5681
4,4,5,0,18,4,22,5681
5,5,2,2,20,6,26,5681
6,6,1,3,21,9,30,5681
7,7,0,2,21,11,32,5681
8,8,1,0,22,11,33,5681
9,9,0,0,22,11,33,5681
0,0,1,0,1,0,1,5682
1,1,0,0,1,0,1,5682
0,0,1,0,1,0,1,5683
1,1,1,1,2,1,3,5683
2,2,2,2,4,3,7,5683
3,3,0,3,4,6,10,5683
4,4,0,2,4,8,12,5683
5,5,0,2,4,10,14,5683
6,6,0,0,4,10,14,5683
0,0,1,0,1,0,1,5684
1,1,1,0,2,0,2,5684
2,2,2,0,4,0,4,5684
3,3,1,0,5,0,5,5684
4,4,1,1,6,1,7,5684
5,5,2,0,8,1,9,5684
6,6,3,1,11,2,13,5684
7,7,0,2,11,4,15,5684
8,8,0,2,11,6,17,5684
9,9,0,1,11,7,18,5684
10,10,0,0,11,7,18,5684
0,0,1,0,1,0,1,5685
1,1,1,0,2,0,2,5685
2,2,0,0,2,0,2,5685
0,0,1,0,1,0,1,5686
1,1,0,0,1,0,1,5686
0,0,1,0,1,0,1,5687
1,1,1,0,2,0,2,5687
2,2,1,0,3,0,3,5687
3,3,1,0,4,0,4,5687
4,4,1,0,5,0,5,5687
5,5,0,0,5,0,5,5687
0,0,1,0,1,0,1,5688
1,1,1,0,2,0,2,5688
2,2,1,0,3,0,3,5688
3,3,1,0,4,0,4,5688
4,4,1,0,5,0,5,5688
5,5,1,0,6,0,6,5688
6,6,1,0,7,0,7,5688
7,7,1,0,8,0,8,5688
8,8,1,0,9,0,9,5688
9,9,1,0,10,0,10,5688
10,10,1,1,11,1,12,5688
11,11,1,1,12,2,14,5688
12,12,2,1,14,3,17,5688
13,13,0,0,14,3,17,5688
0,0,1,0,1,0,1,5689
1,1,0,1,1,1,2,5689
2,2,0,1,1,2,3,5689
3,3,0,1,1,3,4,5689
4,4,0,1,1,4,5,5689
5,5,0,0,1,4,5,5689
0,0,1,0,1,0,1,5690
1,1,1,0,2,0,2,5690
2,2,0,0,2,0,2,5690
0,0,1,0,1,0,1,5691
1,1,3,1,4,1,5,5691
2,2,0,1,4,2,6,5691
3,3,0,0,4,2,6,5691
0,0,1,0,1,0,1,5692
1,1,1,0,2,0,2,5692
2,2,1,1,3,1,4,5692
3,3,2,2,5,3,8,5692
4,4,0,0,5,3,8,5692
0,0,1,0,1,0,1,5693
1,1,1,0,2,0,2,5693
2,2,0,0,2,0,2,5693
0,0,1,0,1,0,1,5694
1,1,0,1,1,1,2,5694
2,2,0,1,1,2,3,5694
3,3,0,0,1,2,3,5694
0,0,1,0,1,0,1,5695
1,1,1,0,2,0,2,5695
2,2,0,0,2,0,2,5695
0,0,1,0,1,0,1,5696
1,1,0,0,1,0,1,5696
0,0,1,0,1,0,1,5697
1,1,2,0,3,0,3,5697
2,2,0,0,3,0,3,5697
0,0,1,0,1,0,1,5698
1,1,0,0,1,0,1,5698
0,0,1,0,1,0,1,5699
1,1,0,0,1,0,1,5699
0,0,1,0,1,0,1,5700
1,1,1,0,2,0,2,5700
2,2,3,0,5,0,5,5700
3,3,0,0,5,0,5,5700
0,0,1,0,1,0,1,5701
1,1,1,0,2,0,2,5701
2,2,1,0,3,0,3,5701
3,3,0,0,3,0,3,5701
0,0,1,0,1,0,1,5702
1,1,1,0,2,0,2,5702
2,2,1,0,3,0,3,5702
3,3,0,0,3,0,3,5702
0,0,1,0,1,0,1,5703
1,1,0,0,1,0,1,5703
0,0,1,0,1,0,1,5704
1,1,2,0,3,0,3,5704
2,2,1,2,4,2,6,5704
3,3,0,0,4,2,6,5704
0,0,1,0,1,0,1,5705
1,1,1,0,2,0,2,5705
2,2,2,0,4,0,4,5705
3,3,0,0,4,0,4,5705
0,0,1,0,1,0,1,5706
1,1,0,0,1,0,1,5706
0,0,1,0,1,0,1,5707
1,1,0,0,1,0,1,5707
0,0,1,0,1,0,1,5708
1,1,1,1,2,1,3,5708
2,2,0,1,2,2,4,5708
3,3,0,1,2,3,5,5708
4,4,0,0,2,3,5,5708
0,0,1,0,1,0,1,5709
1,1,0,0,1,0,1,5709
0,0,1,0,1,0,1,5710
1,1,1,0,2,0,2,5710
2,2,0,0,2,0,2,5710
0,0,1,0,1,0,1,5711
1,1,0,0,1,0,1,5711
0,0,1,0,1,0,1,5712
1,1,1,0,2,0,2,5712
2,2,1,0,3,0,3,5712
3,3,1,0,4,0,4,5712
4,4,0,2,4,2,6,5712
5,5,0,1,4,3,7,5712
6,6,0,2,4,5,9,5712
7,7,0,0,4,5,9,5712
0,0,1,0,1,0,1,5713
1,1,0,0,1,0,1,5713
0,0,1,0,1,0,1,5714
1,1,0,0,1,0,1,5714
0,0,1,0,1,0,1,5715
1,1,2,0,3,0,3,5715
2,2,4,0,7,0,7,5715
3,3,6,1,13,1,14,5715
4,4,2,3,15,4,19,5715
5,5,0,1,15,5,20,5715
6,6,0,1,15,6,21,5715
7,7,0,1,15,7,22,5715
8,8,1,0,16,7,23,5715
9,9,1,1,17,8,25,5715
10,10,0,1,17,9,26,5715
11,11,0,0,17,9,26,5715
0,0,1,0,1,0,1,5716
1,1,0,1,1,1,2,5716
2,2,0,0,1,1,2,5716
0,0,1,0,1,0,1,5717
1,1,1,1,2,1,3,5717
2,2,0,0,2,1,3,5717
0,0,1,0,1,0,1,5718
1,1,0,0,1,0,1,5718
0,0,1,0,1,0,1,5719
1,1,0,0,1,0,1,5719
0,0,1,0,1,0,1,5720
1,1,1,0,2,0,2,5720
2,2,0,0,2,0,2,5720
0,0,1,0,1,0,1,5721
1,1,1,0,2,0,2,5721
2,2,1,0,3,0,3,5721
3,3,1,0,4,0,4,5721
4,4,2,0,6,0,6,5721
5,5,2,0,8,0,8,5721
6,6,0,1,8,1,9,5721
7,7,0,1,8,2,10,5721
8,8,0,0,8,2,10,5721
0,0,1,0,1,0,1,5722
1,1,0,0,1,0,1,5722
0,0,1,0,1,0,1,5723
1,1,0,0,1,0,1,5723
0,0,1,0,1,0,1,5724
1,1,0,1,1,1,2,5724
2,2,0,0,1,1,2,5724
0,0,1,0,1,0,1,5725
1,1,0,0,1,0,1,5725
0,0,1,0,1,0,1,5726
1,1,0,0,1,0,1,5726
0,0,1,0,1,0,1,5727
1,1,0,0,1,0,1,5727
0,0,1,0,1,0,1,5728
1,1,1,0,2,0,2,5728
2,2,1,0,3,0,3,5728
3,3,2,0,5,0,5,5728
4,4,0,1,5,1,6,5728
5,5,0,0,5,1,6,5728
0,0,1,0,1,0,1,5729
1,1,0,0,1,0,1,5729
0,0,1,0,1,0,1,5730
1,1,0,0,1,0,1,5730
0,0,1,0,1,0,1,5731
1,1,0,0,1,0,1,5731
0,0,1,0,1,0,1,5732
1,1,0,0,1,0,1,5732
0,0,1,0,1,0,1,5733
1,1,0,0,1,0,1,5733
0,0,1,0,1,0,1,5734
1,1,2,0,3,0,3,5734
2,2,0,0,3,0,3,5734
0,0,1,0,1,0,1,5735
1,1,1,0,2,0,2,5735
2,2,0,0,2,0,2,5735
0,0,1,0,1,0,1,5736
1,1,0,0,1,0,1,5736
0,0,1,0,1,0,1,5737
1,1,0,0,1,0,1,5737
0,0,1,0,1,0,1,5738
1,1,1,2,2,2,4,5738
2,2,1,0,3,2,5,5738
3,3,1,0,4,2,6,5738
4,4,1,0,5,2,7,5738
5,5,1,0,6,2,8,5738
6,6,1,1,7,3,10,5738
7,7,1,1,8,4,12,5738
8,8,1,1,9,5,14,5738
9,9,0,0,9,5,14,5738
0,0,1,0,1,0,1,5739
1,1,1,0,2,0,2,5739
2,2,1,0,3,0,3,5739
3,3,0,0,3,0,3,5739
0,0,1,0,1,0,1,5740
1,1,0,1,1,1,2,5740
2,2,0,2,1,3,4,5740
3,3,2,1,3,4,7,5740
4,4,3,0,6,4,10,5740
5,5,2,0,8,4,12,5740
6,6,1,1,9,5,14,5740
7,7,0,0,9,5,14,5740
0,0,1,0,1,0,1,5741
1,1,2,0,3,0,3,5741
2,2,1,0,4,0,4,5741
3,3,0,0,4,0,4,5741
0,0,1,0,1,0,1,5742
1,1,0,0,1,0,1,5742
0,0,1,0,1,0,1,5743
1,1,0,0,1,0,1,5743
0,0,1,0,1,0,1,5744
1,1,3,1,4,1,5,5744
2,2,1,1,5,2,7,5744
3,3,3,1,8,3,11,5744
4,4,2,3,10,6,16,5744
5,5,3,2,13,8,21,5744
6,6,3,1,16,9,25,5744
7,7,1,1,17,10,27,5744
8,8,0,1,17,11,28,5744
9,9,0,0,17,11,28,5744
0,0,1,0,1,0,1,5745
1,1,2,0,3,0,3,5745
2,2,2,0,5,0,5,5745
3,3,1,1,6,1,7,5745
4,4,1,0,7,1,8,5745
5,5,0,0,7,1,8,5745
0,0,1,0,1,0,1,5746
1,1,2,0,3,0,3,5746
2,2,1,2,4,2,6,5746
3,3,0,0,4,2,6,5746
0,0,1,0,1,0,1,5747
1,1,2,0,3,0,3,5747
2,2,1,0,4,0,4,5747
3,3,0,0,4,0,4,5747
0,0,1,0,1,0,1,5748
1,1,0,0,1,0,1,5748
0,0,1,0,1,0,1,5749
1,1,1,0,2,0,2,5749
2,2,0,0,2,0,2,5749
0,0,1,0,1,0,1,5750
1,1,1,0,2,0,2,5750
2,2,2,0,4,0,4,5750
3,3,1,1,5,1,6,5750
4,4,0,4,5,5,10,5750
5,5,1,3,6,8,14,5750
6,6,1,2,7,10,17,5750
7,7,3,1,10,11,21,5750
8,8,1,0,11,11,22,5750
9,9,0,0,11,11,22,5750
0,0,1,0,1,0,1,5751
1,1,0,0,1,0,1,5751
0,0,1,0,1,0,1,5752
1,1,2,0,3,0,3,5752
2,2,1,0,4,0,4,5752
3,3,0,1,4,1,5,5752
4,4,0,0,4,1,5,5752
0,0,1,0,1,0,1,5753
1,1,1,0,2,0,2,5753
2,2,3,0,5,0,5,5753
3,3,4,0,9,0,9,5753
4,4,1,0,10,0,10,5753
5,5,0,0,10,0,10,5753
0,0,1,0,1,0,1,5754
1,1,1,0,2,0,2,5754
2,2,1,0,3,0,3,5754
3,3,0,0,3,0,3,5754
0,0,1,0,1,0,1,5755
1,1,1,1,2,1,3,5755
2,2,0,0,2,1,3,5755
0,0,1,0,1,0,1,5756
1,1,1,1,2,1,3,5756
2,2,0,0,2,1,3,5756
0,0,1,0,1,0,1,5757
1,1,0,0,1,0,1,5757
0,0,1,0,1,0,1,5758
1,1,1,0,2,0,2,5758
2,2,1,0,3,0,3,5758
3,3,2,0,5,0,5,5758
4,4,0,0,5,0,5,5758
0,0,1,0,1,0,1,5759
1,1,0,0,1,0,1,5759
0,0,1,0,1,0,1,5760
1,1,0,0,1,0,1,5760
0,0,1,0,1,0,1,5761
1,1,0,0,1,0,1,5761
0,0,1,0,1,0,1,5762
1,1,0,0,1,0,1,5762
0,0,1,0,1,0,1,5763
1,1,1,0,2,0,2,5763
2,2,2,0,4,0,4,5763
3,3,2,0,6,0,6,5763
4,4,0,1,6,1,7,5763
5,5,0,0,6,1,7,5763
0,0,1,0,1,0,1,5764
1,1,1,0,2,0,2,5764
2,2,2,2,4,2,6,5764
3,3,0,2,4,4,8,5764
4,4,0,2,4,6,10,5764
5,5,0,2,4,8,12,5764
6,6,0,2,4,10,14,5764
7,7,0,3,4,13,17,5764
8,8,2,0,6,13,19,5764
9,9,0,0,6,13,19,5764
0,0,1,0,1,0,1,5765
1,1,1,0,2,0,2,5765
2,2,0,0,2,0,2,5765
0,0,1,0,1,0,1,5766
1,1,1,0,2,0,2,5766
2,2,1,0,3,0,3,5766
3,3,1,0,4,0,4,5766
4,4,1,0,5,0,5,5766
5,5,0,0,5,0,5,5766
0,0,1,0,1,0,1,5767
1,1,0,0,1,0,1,5767
0,0,1,0,1,0,1,5768
1,1,0,0,1,0,1,5768
0,0,1,0,1,0,1,5769
1,1,3,0,4,0,4,5769
2,2,3,1,7,1,8,5769
3,3,4,2,11,3,14,5769
4,4,2,3,13,6,19,5769
5,5,5,1,18,7,25,5769
6,6,3,1,21,8,29,5769
7,7,1,1,22,9,31,5769
8,8,3,1,25,10,35,5769
9,9,2,0,27,10,37,5769
10,10,1,0,28,10,38,5769
11,11,2,0,30,10,40,5769
12,12,3,0,33,10,43,5769
13,13,1,2,34,12,46,5769
14,14,1,1,35,13,48,5769
15,15,0,1,35,14,49,5769
16,16,0,1,35,15,50,5769
17,17,0,2,35,17,52,5769
18,18,1,3,36,20,56,5769
19,19,2,7,38,27,65,5769
20,20,1,7,39,34,73,5769
21,21,2,1,41,35,76,5769
22,22,2,0,43,35,78,5769
23,23,1,0,44,35,79,5769
24,24,0,1,44,36,80,5769
25,25,0,1,44,37,81,5769
26,26,0,5,44,42,86,5769
27,27,0,4,44,46,90,5769
28,28,1,1,45,47,92,5769
29,29,0,3,45,50,95,5769
30,30,1,0,46,50,96,5769
31,31,0,0,46,50,96,5769
0,0,1,0,1,0,1,5770
1,1,1,0,2,0,2,5770
2,2,1,2,3,2,5,5770
3,3,2,3,5,5,10,5770
4,4,0,2,5,7,12,5770
5,5,1,2,6,9,15,5770
6,6,1,1,7,10,17,5770
7,7,0,4,7,14,21,5770
8,8,0,3,7,17,24,5770
9,9,0,0,7,17,24,5770
0,0,1,0,1,0,1,5771
1,1,0,0,1,0,1,5771
0,0,1,0,1,0,1,5772
1,1,0,0,1,0,1,5772
0,0,1,0,1,0,1,5773
1,1,2,0,3,0,3,5773
2,2,2,1,5,1,6,5773
3,3,0,2,5,3,8,5773
4,4,0,1,5,4,9,5773
5,5,0,1,5,5,10,5773
6,6,0,0,5,5,10,5773
0,0,1,0,1,0,1,5774
1,1,0,1,1,1,2,5774
2,2,0,0,1,1,2,5774
0,0,1,0,1,0,1,5775
1,1,0,0,1,0,1,5775
0,0,1,0,1,0,1,5776
1,1,0,0,1,0,1,5776
0,0,1,0,1,0,1,5777
1,1,1,0,2,0,2,5777
2,2,0,1,2,1,3,5777
3,3,0,0,2,1,3,5777
0,0,1,0,1,0,1,5778
1,1,1,0,2,0,2,5778
2,2,2,0,4,0,4,5778
3,3,2,2,6,2,8,5778
4,4,1,1,7,3,10,5778
5,5,1,0,8,3,11,5778
6,6,0,0,8,3,11,5778
0,0,1,0,1,0,1,5779
1,1,0,0,1,0,1,5779
0,0,1,0,1,0,1,5780
1,1,0,0,1,0,1,5780
0,0,1,0,1,0,1,5781
1,1,2,1,3,1,4,5781
2,2,0,1,3,2,5,5781
3,3,0,0,3,2,5,5781
0,0,1,0,1,0,1,5782
1,1,1,0,2,0,2,5782
2,2,0,1,2,1,3,5782
3,3,0,0,2,1,3,5782
0,0,1,0,1,0,1,5783
1,1,2,0,3,0,3,5783
2,2,1,1,4,1,5,5783
3,3,0,1,4,2,6,5783
4,4,0,1,4,3,7,5783
5,5,0,1,4,4,8,5783
6,6,0,0,4,4,8,5783
0,0,1,0,1,0,1,5784
1,1,0,3,1,3,4,5784
2,2,0,2,1,5,6,5784
3,3,0,1,1,6,7,5784
4,4,0,1,1,7,8,5784
5,5,0,0,1,7,8,5784
0,0,1,0,1,0,1,5785
1,1,0,0,1,0,1,5785
0,0,1,0,1,0,1,5786
1,1,0,1,1,1,2,5786
2,2,0,0,1,1,2,5786
0,0,1,0,1,0,1,5787
1,1,1,0,2,0,2,5787
2,2,1,0,3,0,3,5787
3,3,1,0,4,0,4,5787
4,4,1,1,5,1,6,5787
5,5,2,2,7,3,10,5787
6,6,1,1,8,4,12,5787
7,7,4,0,12,4,16,5787
8,8,0,1,12,5,17,5787
9,9,1,1,13,6,19,5787
10,10,1,1,14,7,21,5787
11,11,1,0,15,7,22,5787
12,12,1,1,16,8,24,5787
13,13,0,0,16,8,24,5787
0,0,1,0,1,0,1,5788
1,1,1,0,2,0,2,5788
2,2,1,2,3,2,5,5788
3,3,3,1,6,3,9,5788
4,4,1,0,7,3,10,5788
5,5,1,0,8,3,11,5788
6,6,0,0,8,3,11,5788
0,0,1,0,1,0,1,5789
1,1,1,0,2,0,2,5789
2,2,1,0,3,0,3,5789
3,3,0,0,3,0,3,5789
0,0,1,0,1,0,1,5790
1,1,2,0,3,0,3,5790
2,2,1,1,4,1,5,5790
3,3,1,0,5,1,6,5790
4,4,0,0,5,1,6,5790
0,0,1,0,1,0,1,5791
1,1,1,0,2,0,2,5791
2,2,0,0,2,0,2,5791
0,0,1,0,1,0,1,5792
1,1,1,0,2,0,2,5792
2,2,0,0,2,0,2,5792
0,0,1,0,1,0,1,5793
1,1,1,0,2,0,2,5793
2,2,2,0,4,0,4,5793
3,3,2,1,6,1,7,5793
4,4,2,0,8,1,9,5793
5,5,0,0,8,1,9,5793
0,0,1,0,1,0,1,5794
1,1,0,0,1,0,1,5794
0,0,1,0,1,0,1,5795
1,1,0,0,1,0,1,5795
0,0,1,0,1,0,1,5796
1,1,1,0,2,0,2,5796
2,2,0,0,2,0,2,5796
0,0,1,0,1,0,1,5797
1,1,0,0,1,0,1,5797
0,0,1,0,1,0,1,5798
1,1,1,1,2,1,3,5798
2,2,0,1,2,2,4,5798
3,3,0,0,2,2,4,5798
0,0,1,0,1,0,1,5799
1,1,0,0,1,0,1,5799
0,0,1,0,1,0,1,5800
1,1,1,0,2,0,2,5800
2,2,1,0,3,0,3,5800
3,3,0,0,3,0,3,5800
0,0,1,0,1,0,1,5801
1,1,0,0,1,0,1,5801
0,0,1,0,1,0,1,5802
1,1,0,1,1,1,2,5802
2,2,0,0,1,1,2,5802
0,0,1,0,1,0,1,5803
1,1,0,0,1,0,1,5803
0,0,1,0,1,0,1,5804
1,1,0,0,1,0,1,5804
0,0,1,0,1,0,1,5805
1,1,0,0,1,0,1,5805
0,0,1,0,1,0,1,5806
1,1,0,0,1,0,1,5806
0,0,1,0,1,0,1,5807
1,1,0,0,1,0,1,5807
0,0,1,0,1,0,1,5808
1,1,1,0,2,0,2,5808
2,2,0,1,2,1,3,5808
3,3,0,3,2,4,6,5808
4,4,0,3,2,7,9,5808
5,5,0,1,2,8,10,5808
6,6,0,1,2,9,11,5808
7,7,0,0,2,9,11,5808
0,0,1,0,1,0,1,5809
1,1,0,0,1,0,1,5809
0,0,1,0,1,0,1,5810
1,1,0,0,1,0,1,5810
0,0,1,0,1,0,1,5811
1,1,0,0,1,0,1,5811
0,0,1,0,1,0,1,5812
1,1,0,1,1,1,2,5812
2,2,0,1,1,2,3,5812
3,3,0,2,1,4,5,5812
4,4,1,1,2,5,7,5812
5,5,3,1,5,6,11,5812
6,6,4,0,9,6,15,5812
7,7,5,1,14,7,21,5812
8,8,2,2,16,9,25,5812
9,9,5,2,21,11,32,5812
10,10,4,2,25,13,38,5812
11,11,4,1,29,14,43,5812
12,12,1,0,30,14,44,5812
13,13,1,1,31,15,46,5812
14,14,0,1,31,16,47,5812
15,15,0,0,31,16,47,5812
0,0,1,0,1,0,1,5813
1,1,1,0,2,0,2,5813
2,2,1,0,3,0,3,5813
3,3,2,0,5,0,5,5813
4,4,2,0,7,0,7,5813
5,5,1,1,8,1,9,5813
6,6,0,2,8,3,11,5813
7,7,1,0,9,3,12,5813
8,8,0,0,9,3,12,5813
0,0,1,0,1,0,1,5814
1,1,2,1,3,1,4,5814
2,2,1,0,4,1,5,5814
3,3,0,1,4,2,6,5814
4,4,0,2,4,4,8,5814
5,5,2,2,6,6,12,5814
6,6,1,1,7,7,14,5814
7,7,2,1,9,8,17,5814
8,8,3,2,12,10,22,5814
9,9,3,2,15,12,27,5814
10,10,4,2,19,14,33,5814
11,11,3,1,22,15,37,5814
12,12,2,1,24,16,40,5814
13,13,0,1,24,17,41,5814
14,14,0,3,24,20,44,5814
15,15,2,5,26,25,51,5814
16,16,0,3,26,28,54,5814
17,17,1,1,27,29,56,5814
18,18,0,1,27,30,57,5814
19,19,0,0,27,30,57,5814
0,0,1,0,1,0,1,5815
1,1,1,0,2,0,2,5815
2,2,3,0,5,0,5,5815
3,3,1,0,6,0,6,5815
4,4,0,0,6,0,6,5815
0,0,1,0,1,0,1,5816
1,1,2,0,3,0,3,5816
2,2,3,1,6,1,7,5816
3,3,2,0,8,1,9,5816
4,4,1,1,9,2,11,5816
5,5,1,0,10,2,12,5816
6,6,1,0,11,2,13,5816
7,7,1,1,12,3,15,5816
8,8,1,0,13,3,16,5816
9,9,1,0,14,3,17,5816
10,10,0,0,14,3,17,5816
0,0,1,0,1,0,1,5817
1,1,3,0,4,0,4,5817
2,2,2,1,6,1,7,5817
3,3,3,1,9,2,11,5817
4,4,1,1,10,3,13,5817
5,5,3,0,13,3,16,5817
6,6,5,0,18,3,21,5817
7,7,7,0,25,3,28,5817
8,8,6,1,31,4,35,5817
9,9,10,1,41,5,46,5817
10,10,6,0,47,5,52,5817
11,11,4,2,51,7,58,5817
12,12,4,1,55,8,63,5817
13,13,3,2,58,10,68,5817
14,14,0,2,58,12,70,5817
15,15,0,2,58,14,72,5817
16,16,0,1,58,15,73,5817
17,17,0,0,58,15,73,5817
0,0,1,0,1,0,1,5818
1,1,0,0,1,0,1,5818
0,0,1,0,1,0,1,5819
1,1,1,0,2,0,2,5819
2,2,1,0,3,0,3,5819
3,3,2,0,5,0,5,5819
4,4,1,0,6,0,6,5819
5,5,1,0,7,0,7,5819
6,6,2,0,9,0,9,5819
7,7,2,0,11,0,11,5819
8,8,1,0,12,0,12,5819
9,9,1,0,13,0,13,5819
10,10,1,1,14,1,15,5819
11,11,1,0,15,1,16,5819
12,12,1,0,16,1,17,5819
13,13,2,0,18,1,19,5819
14,14,2,0,20,1,21,5819
15,15,1,0,21,1,22,5819
16,16,2,0,23,1,24,5819
17,17,1,0,24,1,25,5819
18,18,0,1,24,2,26,5819
19,19,1,1,25,3,28,5819
20,20,2,1,27,4,31,5819
21,21,3,3,30,7,37,5819
22,22,4,1,34,8,42,5819
23,23,3,0,37,8,45,5819
24,24,2,0,39,8,47,5819
25,25,1,1,40,9,49,5819
26,26,0,0,40,9,49,5819
0,0,1,0,1,0,1,5820
1,1,0,0,1,0,1,5820
0,0,1,0,1,0,1,5821
1,1,1,0,2,0,2,5821
2,2,0,0,2,0,2,5821
0,0,1,0,1,0,1,5822
1,1,0,1,1,1,2,5822
2,2,0,0,1,1,2,5822
0,0,1,0,1,0,1,5823
1,1,1,0,2,0,2,5823
2,2,0,0,2,0,2,5823
0,0,1,0,1,0,1,5824
1,1,0,1,1,1,2,5824
2,2,0,1,1,2,3,5824
3,3,0,0,1,2,3,5824
0,0,1,0,1,0,1,5825
1,1,1,0,2,0,2,5825
2,2,2,0,4,0,4,5825
3,3,2,1,6,1,7,5825
4,4,1,4,7,5,12,5825
5,5,3,3,10,8,18,5825
6,6,4,4,14,12,26,5825
7,7,4,4,18,16,34,5825
8,8,6,3,24,19,43,5825
9,9,7,0,31,19,50,5825
10,10,9,4,40,23,63,5825
11,11,2,6,42,29,71,5825
12,12,5,4,47,33,80,5825
13,13,7,4,54,37,91,5825
14,14,3,2,57,39,96,5825
15,15,2,3,59,42,101,5825
16,16,3,5,62,47,109,5825
17,17,5,7,67,54,121,5825
18,18,8,7,75,61,136,5825
19,19,12,9,87,70,157,5825
20,20,12,6,99,76,175,5825
21,21,8,7,107,83,190,5825
22,22,8,8,115,91,206,5825
23,23,10,6,125,97,222,5825
24,24,8,7,133,104,237,5825
25,25,5,9,138,113,251,5825
26,26,7,6,145,119,264,5825
27,27,8,5,153,124,277,5825
28,28,8,2,161,126,287,5825
29,29,4,6,165,132,297,5825
30,30,3,6,168,138,306,5825
31,31,4,4,172,142,314,5825
32,32,6,4,178,146,324,5825
33,33,3,4,181,150,331,5825
34,34,1,7,182,157,339,5825
35,35,3,7,185,164,349,5825
36,36,6,4,191,168,359,5825
37,37,3,7,194,175,369,5825
38,38,3,6,197,181,378,5825
39,39,2,4,199,185,384,5825
40,40,3,7,202,192,394,5825
41,41,5,4,207,196,403,5825
42,42,6,1,213,197,410,5825
43,43,4,1,217,198,415,5825
44,44,4,0,221,198,419,5825
45,45,4,1,225,199,424,5825
46,46,3,2,228,201,429,5825
47,47,2,2,230,203,433,5825
48,48,1,2,231,205,436,5825
49,49,0,0,231,205,436,5825
0,0,1,0,1,0,1,5826
1,1,0,0,1,0,1,5826
0,0,1,0,1,0,1,5827
1,1,0,0,1,0,1,5827
0,0,1,0,1,0,1,5828
1,1,0,0,1,0,1,5828
0,0,1,0,1,0,1,5829
1,1,1,0,2,0,2,5829
2,2,0,0,2,0,2,5829
0,0,1,0,1,0,1,5830
1,1,0,0,1,0,1,5830
0,0,1,0,1,0,1,5831
1,1,0,2,1,2,3,5831
2,2,0,2,1,4,5,5831
3,3,1,0,2,4,6,5831
4,4,2,0,4,4,8,5831
5,5,2,0,6,4,10,5831
6,6,1,0,7,4,11,5831
7,7,0,0,7,4,11,5831
0,0,1,0,1,0,1,5832
1,1,0,1,1,1,2,5832
2,2,0,0,1,1,2,5832
0,0,1,0,1,0,1,5833
1,1,0,0,1,0,1,5833
0,0,1,0,1,0,1,5834
1,1,0,0,1,0,1,5834
0,0,1,0,1,0,1,5835
1,1,1,0,2,0,2,5835
2,2,1,0,3,0,3,5835
3,3,1,2,4,2,6,5835
4,4,1,2,5,4,9,5835
5,5,3,3,8,7,15,5835
6,6,3,1,11,8,19,5835
7,7,2,2,13,10,23,5835
8,8,3,1,16,11,27,5835
9,9,2,0,18,11,29,5835
10,10,2,0,20,11,31,5835
11,11,1,0,21,11,32,5835
12,12,1,0,22,11,33,5835
13,13,1,0,23,11,34,5835
14,14,1,0,24,11,35,5835
15,15,1,0,25,11,36,5835
16,16,2,0,27,11,38,5835
17,17,0,0,27,11,38,5835
0,0,1,0,1,0,1,5836
1,1,1,0,2,0,2,5836
2,2,1,0,3,0,3,5836
3,3,2,0,5,0,5,5836
4,4,1,0,6,0,6,5836
5,5,2,0,8,0,8,5836
6,6,0,0,8,0,8,5836
0,0,1,0,1,0,1,5837
1,1,1,0,2,0,2,5837
2,2,0,0,2,0,2,5837
0,0,1,0,1,0,1,5838
1,1,1,0,2,0,2,5838
2,2,0,0,2,0,2,5838
0,0,1,0,1,0,1,5839
1,1,0,0,1,0,1,5839
0,0,1,0,1,0,1,5840
1,1,0,0,1,0,1,5840
0,0,1,0,1,0,1,5841
1,1,1,0,2,0,2,5841
2,2,1,0,3,0,3,5841
3,3,0,0,3,0,3,5841
0,0,1,0,1,0,1,5842
1,1,2,0,3,0,3,5842
2,2,1,1,4,1,5,5842
3,3,0,1,4,2,6,5842
4,4,0,2,4,4,8,5842
5,5,0,0,4,4,8,5842
0,0,1,0,1,0,1,5843
1,1,3,0,4,0,4,5843
2,2,2,2,6,2,8,5843
3,3,2,1,8,3,11,5843
4,4,4,1,12,4,16,5843
5,5,2,1,14,5,19,5843
6,6,1,1,15,6,21,5843
7,7,1,2,16,8,24,5843
8,8,1,2,17,10,27,5843
9,9,1,0,18,10,28,5843
10,10,0,0,18,10,28,5843
0,0,1,0,1,0,1,5844
1,1,1,0,2,0,2,5844
2,2,1,0,3,0,3,5844
3,3,0,1,3,1,4,5844
4,4,0,1,3,2,5,5844
5,5,0,1,3,3,6,5844
6,6,0,0,3,3,6,5844
0,0,1,0,1,0,1,5845
1,1,1,0,2,0,2,5845
2,2,0,0,2,0,2,5845
0,0,1,0,1,0,1,5846
1,1,1,0,2,0,2,5846
2,2,2,0,4,0,4,5846
3,3,3,1,7,1,8,5846
4,4,3,0,10,1,11,5846
5,5,4,3,14,4,18,5846
6,6,5,3,19,7,26,5846
7,7,2,3,21,10,31,5846
8,8,1,2,22,12,34,5846
9,9,1,1,23,13,36,5846
10,10,1,1,24,14,38,5846
11,11,0,3,24,17,41,5846
12,12,0,2,24,19,43,5846
13,13,0,1,24,20,44,5846
14,14,0,1,24,21,45,5846
15,15,0,0,24,21,45,5846
0,0,1,0,1,0,1,5847
1,1,0,0,1,0,1,5847
0,0,1,0,1,0,1,5848
1,1,1,0,2,0,2,5848
2,2,1,0,3,0,3,5848
3,3,0,0,3,0,3,5848
0,0,1,0,1,0,1,5849
1,1,2,0,3,0,3,5849
2,2,2,0,5,0,5,5849
3,3,2,0,7,0,7,5849
4,4,3,1,10,1,11,5849
5,5,2,1,12,2,14,5849
6,6,2,0,14,2,16,5849
7,7,1,0,15,2,17,5849
8,8,2,0,17,2,19,5849
9,9,1,0,18,2,20,5849
10,10,0,0,18,2,20,5849
0,0,1,0,1,0,1,5850
1,1,0,0,1,0,1,5850
0,0,1,0,1,0,1,5851
1,1,1,0,2,0,2,5851
2,2,1,1,3,1,4,5851
3,3,0,2,3,3,6,5851
4,4,0,4,3,7,10,5851
5,5,1,4,4,11,15,5851
6,6,3,6,7,17,24,5851
7,7,4,4,11,21,32,5851
8,8,4,4,15,25,40,5851
9,9,2,3,17,28,45,5851
10,10,1,3,18,31,49,5851
11,11,2,1,20,32,52,5851
12,12,0,2,20,34,54,5851
13,13,0,1,20,35,55,5851
14,14,0,0,20,35,55,5851
0,0,1,0,1,0,1,5852
1,1,2,0,3,0,3,5852
2,2,3,1,6,1,7,5852
3,3,2,2,8,3,11,5852
4,4,2,1,10,4,14,5852
5,5,3,1,13,5,18,5852
6,6,5,0,18,5,23,5852
7,7,3,1,21,6,27,5852
8,8,3,1,24,7,31,5852
9,9,3,0,27,7,34,5852
10,10,2,0,29,7,36,5852
11,11,0,1,29,8,37,5852
12,12,0,0,29,8,37,5852
0,0,1,0,1,0,1,5853
1,1,3,1,4,1,5,5853
2,2,3,1,7,2,9,5853
3,3,3,4,10,6,16,5853
4,4,1,4,11,10,21,5853
5,5,0,3,11,13,24,5853
6,6,1,3,12,16,28,5853
7,7,3,1,15,17,32,5853
8,8,4,2,19,19,38,5853
9,9,4,1,23,20,43,5853
10,10,5,0,28,20,48,5853
11,11,6,0,34,20,54,5853
12,12,5,0,39,20,59,5853
13,13,3,1,42,21,63,5853
14,14,0,1,42,22,64,5853
15,15,0,1,42,23,65,5853
16,16,1,0,43,23,66,5853
17,17,1,0,44,23,67,5853
18,18,0,1,44,24,68,5853
19,19,1,2,45,26,71,5853
20,20,1,0,46,26,72,5853
21,21,0,0,46,26,72,5853
0,0,1,0,1,0,1,5854
1,1,0,1,1,1,2,5854
2,2,0,1,1,2,3,5854
3,3,0,1,1,3,4,5854
4,4,0,0,1,3,4,5854
0,0,1,0,1,0,1,5855
1,1,0,0,1,0,1,5855
0,0,1,0,1,0,1,5856
1,1,1,0,2,0,2,5856
2,2,1,0,3,0,3,5856
3,3,1,2,4,2,6,5856
4,4,2,2,6,4,10,5856
5,5,3,0,9,4,13,5856
6,6,2,1,11,5,16,5856
7,7,2,1,13,6,19,5856
8,8,0,1,13,7,20,5856
9,9,0,2,13,9,22,5856
10,10,0,1,13,10,23,5856
11,11,0,0,13,10,23,5856
0,0,1,0,1,0,1,5857
1,1,1,0,2,0,2,5857
2,2,0,0,2,0,2,5857
0,0,1,0,1,0,1,5858
1,1,1,0,2,0,2,5858
2,2,1,0,3,0,3,5858
3,3,1,0,4,0,4,5858
4,4,1,0,5,0,5,5858
5,5,3,0,8,0,8,5858
6,6,1,1,9,1,10,5858
7,7,1,1,10,2,12,5858
8,8,0,2,10,4,14,5858
9,9,0,0,10,4,14,5858
0,0,1,0,1,0,1,5859
1,1,0,0,1,0,1,5859
0,0,1,0,1,0,1,5860
1,1,2,1,3,1,4,5860
2,2,1,1,4,2,6,5860
3,3,0,1,4,3,7,5860
4,4,0,0,4,3,7,5860
0,0,1,0,1,0,1,5861
1,1,0,0,1,0,1,5861
0,0,1,0,1,0,1,5862
1,1,1,0,2,0,2,5862
2,2,1,0,3,0,3,5862
3,3,2,0,5,0,5,5862
4,4,2,0,7,0,7,5862
5,5,0,0,7,0,7,5862
0,0,1,0,1,0,1,5863
1,1,2,0,3,0,3,5863
2,2,2,0,5,0,5,5863
3,3,1,1,6,1,7,5863
4,4,1,1,7,2,9,5863
5,5,3,0,10,2,12,5863
6,6,5,3,15,5,20,5863
7,7,5,1,20,6,26,5863
8,8,3,2,23,8,31,5863
9,9,5,2,28,10,38,5863
10,10,2,4,30,14,44,5863
11,11,3,2,33,16,49,5863
12,12,3,2,36,18,54,5863
13,13,3,2,39,20,59,5863
14,14,1,1,40,21,61,5863
15,15,0,2,40,23,63,5863
16,16,1,2,41,25,66,5863
17,17,0,1,41,26,67,5863
18,18,0,0,41,26,67,5863
0,0,1,0,1,0,1,5864
1,1,1,0,2,0,2,5864
2,2,2,0,4,0,4,5864
3,3,1,0,5,0,5,5864
4,4,1,0,6,0,6,5864
5,5,2,0,8,0,8,5864
6,6,0,0,8,0,8,5864
0,0,1,0,1,0,1,5865
1,1,2,1,3,1,4,5865
2,2,1,1,4,2,6,5865
3,3,1,0,5,2,7,5865
4,4,0,0,5,2,7,5865
0,0,1,0,1,0,1,5866
1,1,1,1,2,1,3,5866
2,2,0,0,2,1,3,5866
0,0,1,0,1,0,1,5867
1,1,2,0,3,0,3,5867
2,2,1,0,4,0,4,5867
3,3,0,0,4,0,4,5867
0,0,1,0,1,0,1,5868
1,1,0,0,1,0,1,5868
0,0,1,0,1,0,1,5869
1,1,0,0,1,0,1,5869
0,0,1,0,1,0,1,5870
1,1,1,0,2,0,2,5870
2,2,0,0,2,0,2,5870
0,0,1,0,1,0,1,5871
1,1,0,0,1,0,1,5871
0,0,1,0,1,0,1,5872
1,1,3,0,4,0,4,5872
2,2,3,0,7,0,7,5872
3,3,0,1,7,1,8,5872
4,4,0,1,7,2,9,5872
5,5,0,0,7,2,9,5872
0,0,1,0,1,0,1,5873
1,1,2,0,3,0,3,5873
2,2,1,0,4,0,4,5873
3,3,0,0,4,0,4,5873
0,0,1,0,1,0,1,5874
1,1,0,0,1,0,1,5874
0,0,1,0,1,0,1,5875
1,1,2,0,3,0,3,5875
2,2,1,0,4,0,4,5875
3,3,1,0,5,0,5,5875
4,4,1,0,6,0,6,5875
5,5,0,0,6,0,6,5875
0,0,1,0,1,0,1,5876
1,1,0,2,1,2,3,5876
2,2,0,2,1,4,5,5876
3,3,0,1,1,5,6,5876
4,4,0,2,1,7,8,5876
5,5,0,0,1,7,8,5876
0,0,1,0,1,0,1,5877
1,1,2,0,3,0,3,5877
2,2,0,0,3,0,3,5877
0,0,1,0,1,0,1,5878
1,1,0,0,1,0,1,5878
0,0,1,0,1,0,1,5879
1,1,1,1,2,1,3,5879
2,2,2,3,4,4,8,5879
3,3,2,0,6,4,10,5879
4,4,1,0,7,4,11,5879
5,5,1,0,8,4,12,5879
6,6,1,0,9,4,13,5879
7,7,0,0,9,4,13,5879
0,0,1,0,1,0,1,5880
1,1,2,0,3,0,3,5880
2,2,0,1,3,1,4,5880
3,3,0,2,3,3,6,5880
4,4,0,2,3,5,8,5880
5,5,2,2,5,7,12,5880
6,6,3,1,8,8,16,5880
7,7,2,0,10,8,18,5880
8,8,1,0,11,8,19,5880
9,9,0,0,11,8,19,5880
0,0,1,0,1,0,1,5881
1,1,4,0,5,0,5,5881
2,2,2,1,7,1,8,5881
3,3,2,1,9,2,11,5881
4,4,2,0,11,2,13,5881
5,5,7,1,18,3,21,5881
6,6,5,0,23,3,26,5881
7,7,2,1,25,4,29,5881
8,8,2,1,27,5,32,5881
9,9,5,0,32,5,37,5881
10,10,6,1,38,6,44,5881
11,11,6,1,44,7,51,5881
12,12,6,2,50,9,59,5881
13,13,7,4,57,13,70,5881
14,14,1,4,58,17,75,5881
15,15,2,5,60,22,82,5881
16,16,0,4,60,26,86,5881
17,17,0,3,60,29,89,5881
18,18,0,1,60,30,90,5881
19,19,0,1,60,31,91,5881
20,20,1,0,61,31,92,5881
21,21,1,0,62,31,93,5881
22,22,2,2,64,33,97,5881
23,23,2,1,66,34,100,5881
24,24,0,1,66,35,101,5881
25,25,0,0,66,35,101,5881
0,0,1,0,1,0,1,5882
1,1,1,0,2,0,2,5882
2,2,1,1,3,1,4,5882
3,3,0,0,3,1,4,5882
0,0,1,0,1,0,1,5883
1,1,1,0,2,0,2,5883
2,2,0,1,2,1,3,5883
3,3,0,1,2,2,4,5883
4,4,0,1,2,3,5,5883
5,5,1,0,3,3,6,5883
6,6,1,0,4,3,7,5883
7,7,0,0,4,3,7,5883
0,0,1,0,1,0,1,5884
1,1,2,0,3,0,3,5884
2,2,5,1,8,1,9,5884
3,3,2,2,10,3,13,5884
4,4,2,4,12,7,19,5884
5,5,2,4,14,11,25,5884
6,6,2,4,16,15,31,5884
7,7,2,4,18,19,37,5884
8,8,1,3,19,22,41,5884
9,9,3,1,22,23,45,5884
10,10,1,1,23,24,47,5884
11,11,0,0,23,24,47,5884
0,0,1,0,1,0,1,5885
1,1,2,0,3,0,3,5885
2,2,0,2,3,2,5,5885
3,3,2,2,5,4,9,5885
4,4,2,1,7,5,12,5885
5,5,2,1,9,6,15,5885
6,6,4,0,13,6,19,5885
7,7,0,0,13,6,19,5885
0,0,1,0,1,0,1,5886
1,1,1,0,2,0,2,5886
2,2,0,0,2,0,2,5886
0,0,1,0,1,0,1,5887
1,1,0,0,1,0,1,5887
0,0,1,0,1,0,1,5888
1,1,1,0,2,0,2,5888
2,2,0,0,2,0,2,5888
0,0,1,0,1,0,1,5889
1,1,0,0,1,0,1,5889
0,0,1,0,1,0,1,5890
1,1,0,0,1,0,1,5890
0,0,1,0,1,0,1,5891
1,1,1,0,2,0,2,5891
2,2,1,0,3,0,3,5891
3,3,2,0,5,0,5,5891
4,4,1,0,6,0,6,5891
5,5,1,0,7,0,7,5891
6,6,0,0,7,0,7,5891
0,0,1,0,1,0,1,5892
1,1,0,0,1,0,1,5892
0,0,1,0,1,0,1,5893
1,1,0,0,1,0,1,5893
0,0,1,0,1,0,1,5894
1,1,2,0,3,0,3,5894
2,2,2,0,5,0,5,5894
3,3,1,0,6,0,6,5894
4,4,0,0,6,0,6,5894
0,0,1,0,1,0,1,5895
1,1,3,1,4,1,5,5895
2,2,4,0,8,1,9,5895
3,3,3,0,11,1,12,5895
4,4,1,1,12,2,14,5895
5,5,1,0,13,2,15,5895
6,6,0,0,13,2,15,5895
0,0,1,0,1,0,1,5896
1,1,0,0,1,0,1,5896
0,0,1,0,1,0,1,5897
1,1,0,0,1,0,1,5897
0,0,1,0,1,0,1,5898
1,1,0,0,1,0,1,5898
0,0,1,0,1,0,1,5899
1,1,2,0,3,0,3,5899
2,2,3,0,6,0,6,5899
3,3,1,1,7,1,8,5899
4,4,0,0,7,1,8,5899
0,0,1,0,1,0,1,5900
1,1,2,0,3,0,3,5900
2,2,4,0,7,0,7,5900
3,3,3,0,10,0,10,5900
4,4,2,0,12,0,12,5900
5,5,2,0,14,0,14,5900
6,6,2,0,16,0,16,5900
7,7,1,0,17,0,17,5900
8,8,0,0,17,0,17,5900
0,0,1,0,1,0,1,5901
1,1,3,0,4,0,4,5901
2,2,3,0,7,0,7,5901
3,3,3,0,10,0,10,5901
4,4,1,1,11,1,12,5901
5,5,0,1,11,2,13,5901
6,6,0,2,11,4,15,5901
7,7,0,0,11,4,15,5901
0,0,1,0,1,0,1,5902
1,1,2,0,3,0,3,5902
2,2,1,1,4,1,5,5902
3,3,1,1,5,2,7,5902
4,4,2,1,7,3,10,5902
5,5,1,1,8,4,12,5902
6,6,0,1,8,5,13,5902
7,7,0,3,8,8,16,5902
8,8,0,4,8,12,20,5902
9,9,0,4,8,16,24,5902
10,10,1,4,9,20,29,5902
11,11,2,2,11,22,33,5902
12,12,2,5,13,27,40,5902
13,13,3,5,16,32,48,5902
14,14,1,6,17,38,55,5902
15,15,3,1,20,39,59,5902
16,16,1,0,21,39,60,5902
17,17,0,0,21,39,60,5902
0,0,1,0,1,0,1,5903
1,1,2,0,3,0,3,5903
2,2,1,1,4,1,5,5903
3,3,1,1,5,2,7,5903
4,4,2,1,7,3,10,5903
5,5,4,0,11,3,14,5903
6,6,1,1,12,4,16,5903
7,7,2,2,14,6,20,5903
8,8,0,1,14,7,21,5903
9,9,0,2,14,9,23,5903
10,10,1,1,15,10,25,5903
11,11,0,0,15,10,25,5903
0,0,1,0,1,0,1,5904
1,1,1,0,2,0,2,5904
2,2,0,0,2,0,2,5904
0,0,1,0,1,0,1,5905
1,1,4,0,5,0,5,5905
2,2,2,0,7,0,7,5905
3,3,2,0,9,0,9,5905
4,4,0,0,9,0,9,5905
0,0,1,0,1,0,1,5906
1,1,1,0,2,0,2,5906
2,2,1,1,3,1,4,5906
3,3,2,0,5,1,6,5906
4,4,0,0,5,1,6,5906
0,0,1,0,1,0,1,5907
1,1,1,0,2,0,2,5907
2,2,1,0,3,0,3,5907
3,3,0,1,3,1,4,5907
4,4,0,1,3,2,5,5907
5,5,0,1,3,3,6,5907
6,6,0,0,3,3,6,5907
0,0,1,0,1,0,1,5908
1,1,0,0,1,0,1,5908
0,0,1,0,1,0,1,5909
1,1,1,0,2,0,2,5909
2,2,0,0,2,0,2,5909
0,0,1,0,1,0,1,5910
1,1,1,0,2,0,2,5910
2,2,0,0,2,0,2,5910
0,0,1,0,1,0,1,5911
1,1,0,0,1,0,1,5911
0,0,1,0,1,0,1,5912
1,1,1,0,2,0,2,5912
2,2,0,0,2,0,2,5912
0,0,1,0,1,0,1,5913
1,1,1,1,2,1,3,5913
2,2,1,3,3,4,7,5913
3,3,1,3,4,7,11,5913
4,4,0,4,4,11,15,5913
5,5,1,3,5,14,19,5913
6,6,0,2,5,16,21,5913
7,7,0,1,5,17,22,5913
8,8,0,0,5,17,22,5913
0,0,1,0,1,0,1,5914
1,1,0,0,1,0,1,5914
0,0,1,0,1,0,1,5915
1,1,1,0,2,0,2,5915
2,2,1,0,3,0,3,5915
3,3,0,0,3,0,3,5915
0,0,1,0,1,0,1,5916
1,1,0,0,1,0,1,5916
0,0,1,0,1,0,1,5917
1,1,1,0,2,0,2,5917
2,2,0,0,2,0,2,5917
0,0,1,0,1,0,1,5918
1,1,2,0,3,0,3,5918
2,2,1,0,4,0,4,5918
3,3,2,0,6,0,6,5918
4,4,3,1,9,1,10,5918
5,5,2,3,11,4,15,5918
6,6,2,7,13,11,24,5918
7,7,4,3,17,14,31,5918
8,8,3,3,20,17,37,5918
9,9,2,4,22,21,43,5918
10,10,2,3,24,24,48,5918
11,11,2,3,26,27,53,5918
12,12,3,0,29,27,56,5918
13,13,2,1,31,28,59,5918
14,14,1,2,32,30,62,5918
15,15,0,1,32,31,63,5918
16,16,0,0,32,31,63,5918
0,0,1,0,1,0,1,5919
1,1,0,0,1,0,1,5919
0,0,1,0,1,0,1,5920
1,1,0,1,1,1,2,5920
2,2,0,1,1,2,3,5920
3,3,0,0,1,2,3,5920
0,0,1,0,1,0,1,5921
1,1,0,0,1,0,1,5921
0,0,1,0,1,0,1,5922
1,1,0,0,1,0,1,5922
0,0,1,0,1,0,1,5923
1,1,0,0,1,0,1,5923
0,0,1,0,1,0,1,5924
1,1,0,0,1,0,1,5924
0,0,1,0,1,0,1,5925
1,1,1,0,2,0,2,5925
2,2,1,1,3,1,4,5925
3,3,2,1,5,2,7,5925
4,4,0,1,5,3,8,5925
5,5,0,0,5,3,8,5925
0,0,1,0,1,0,1,5926
1,1,0,0,1,0,1,5926
0,0,1,0,1,0,1,5927
1,1,0,1,1,1,2,5927
2,2,0,0,1,1,2,5927
0,0,1,0,1,0,1,5928
1,1,2,0,3,0,3,5928
2,2,0,1,3,1,4,5928
3,3,0,2,3,3,6,5928
4,4,1,2,4,5,9,5928
5,5,3,1,7,6,13,5928
6,6,3,1,10,7,17,5928
7,7,1,0,11,7,18,5928
8,8,0,0,11,7,18,5928
0,0,1,0,1,0,1,5929
1,1,1,0,2,0,2,5929
2,2,2,0,4,0,4,5929
3,3,0,0,4,0,4,5929
0,0,1,0,1,0,1,5930
1,1,0,0,1,0,1,5930
0,0,1,0,1,0,1,5931
1,1,2,0,3,0,3,5931
2,2,1,0,4,0,4,5931
3,3,1,0,5,0,5,5931
4,4,1,1,6,1,7,5931
5,5,1,0,7,1,8,5931
6,6,0,0,7,1,8,5931
0,0,1,0,1,0,1,5932
1,1,0,0,1,0,1,5932
0,0,1,0,1,0,1,5933
1,1,1,0,2,0,2,5933
2,2,0,1,2,1,3,5933
3,3,1,0,3,1,4,5933
4,4,0,0,3,1,4,5933
0,0,1,0,1,0,1,5934
1,1,0,0,1,0,1,5934
0,0,1,0,1,0,1,5935
1,1,1,1,2,1,3,5935
2,2,1,0,3,1,4,5935
3,3,0,0,3,1,4,5935
0,0,1,0,1,0,1,5936
1,1,0,0,1,0,1,5936
0,0,1,0,1,0,1,5937
1,1,0,0,1,0,1,5937
0,0,1,0,1,0,1,5938
1,1,1,0,2,0,2,5938
2,2,0,0,2,0,2,5938
0,0,1,0,1,0,1,5939
1,1,0,0,1,0,1,5939
0,0,1,0,1,0,1,5940
1,1,0,0,1,0,1,5940
0,0,1,0,1,0,1,5941
1,1,2,1,3,1,4,5941
2,2,0,1,3,2,5,5941
3,3,0,0,3,2,5,5941
0,0,1,0,1,0,1,5942
1,1,1,0,2,0,2,5942
2,2,1,0,3,0,3,5942
3,3,0,0,3,0,3,5942
0,0,1,0,1,0,1,5943
1,1,0,0,1,0,1,5943
0,0,1,0,1,0,1,5944
1,1,1,0,2,0,2,5944
2,2,1,0,3,0,3,5944
3,3,2,0,5,0,5,5944
4,4,0,0,5,0,5,5944
0,0,1,0,1,0,1,5945
1,1,2,0,3,0,3,5945
2,2,2,0,5,0,5,5945
3,3,1,0,6,0,6,5945
4,4,0,0,6,0,6,5945
0,0,1,0,1,0,1,5946
1,1,2,0,3,0,3,5946
2,2,1,0,4,0,4,5946
3,3,1,0,5,0,5,5946
4,4,0,0,5,0,5,5946
0,0,1,0,1,0,1,5947
1,1,0,0,1,0,1,5947
0,0,1,0,1,0,1,5948
1,1,1,0,2,0,2,5948
2,2,1,1,3,1,4,5948
3,3,0,0,3,1,4,5948
0,0,1,0,1,0,1,5949
1,1,0,0,1,0,1,5949
0,0,1,0,1,0,1,5950
1,1,0,0,1,0,1,5950
0,0,1,0,1,0,1,5951
1,1,1,1,2,1,3,5951
2,2,3,1,5,2,7,5951
3,3,1,2,6,4,10,5951
4,4,0,1,6,5,11,5951
5,5,0,1,6,6,12,5951
6,6,0,1,6,7,13,5951
7,7,0,1,6,8,14,5951
8,8,0,0,6,8,14,5951
0,0,1,0,1,0,1,5952
1,1,0,1,1,1,2,5952
2,2,0,1,1,2,3,5952
3,3,0,2,1,4,5,5952
4,4,0,2,1,6,7,5952
5,5,0,3,1,9,10,5952
6,6,0,5,1,14,15,5952
7,7,2,4,3,18,21,5952
8,8,3,4,6,22,28,5952
9,9,3,3,9,25,34,5952
10,10,4,1,13,26,39,5952
11,11,4,2,17,28,45,5952
12,12,3,4,20,32,52,5952
13,13,6,3,26,35,61,5952
14,14,2,4,28,39,67,5952
15,15,1,5,29,44,73,5952
16,16,3,6,32,50,82,5952
17,17,8,2,40,52,92,5952
18,18,6,2,46,54,100,5952
19,19,10,6,56,60,116,5952
20,20,4,9,60,69,129,5952
21,21,5,6,65,75,140,5952
22,22,4,5,69,80,149,5952
23,23,3,4,72,84,156,5952
24,24,0,7,72,91,163,5952
25,25,2,6,74,97,171,5952
26,26,2,6,76,103,179,5952
27,27,6,3,82,106,188,5952
28,28,8,3,90,109,199,5952
29,29,7,2,97,111,208,5952
30,30,5,6,102,117,219,5952
31,31,4,4,106,121,227,5952
32,32,2,1,108,122,230,5952
33,33,0,2,108,124,232,5952
34,34,0,5,108,129,237,5952
35,35,2,4,110,133,243,5952
36,36,3,3,113,136,249,5952
37,37,3,1,116,137,253,5952
38,38,3,2,119,139,258,5952
39,39,1,1,120,140,260,5952
40,40,0,0,120,140,260,5952
0,0,1,0,1,0,1,5953
1,1,0,1,1,1,2,5953
2,2,0,1,1,2,3,5953
3,3,0,1,1,3,4,5953
4,4,0,1,1,4,5,5953
5,5,0,0,1,4,5,5953
0,0,1,0,1,0,1,5954
1,1,1,0,2,0,2,5954
2,2,1,0,3,0,3,5954
3,3,0,0,3,0,3,5954
0,0,1,0,1,0,1,5955
1,1,0,0,1,0,1,5955
0,0,1,0,1,0,1,5956
1,1,0,1,1,1,2,5956
2,2,0,0,1,1,2,5956
0,0,1,0,1,0,1,5957
1,1,2,1,3,1,4,5957
2,2,1,1,4,2,6,5957
3,3,2,3,6,5,11,5957
4,4,2,3,8,8,16,5957
5,5,2,1,10,9,19,5957
6,6,3,2,13,11,24,5957
7,7,0,2,13,13,26,5957
8,8,0,0,13,13,26,5957
0,0,1,0,1,0,1,5958
1,1,0,1,1,1,2,5958
2,2,1,0,2,1,3,5958
3,3,1,0,3,1,4,5958
4,4,2,0,5,1,6,5958
5,5,2,1,7,2,9,5958
6,6,2,0,9,2,11,5958
7,7,3,1,12,3,15,5958
8,8,2,0,14,3,17,5958
9,9,1,0,15,3,18,5958
10,10,0,0,15,3,18,5958
0,0,1,0,1,0,1,5959
1,1,0,0,1,0,1,5959
0,0,1,0,1,0,1,5960
1,1,0,0,1,0,1,5960
0,0,1,0,1,0,1,5961
1,1,1,0,2,0,2,5961
2,2,0,0,2,0,2,5961
0,0,1,0,1,0,1,5962
1,1,2,0,3,0,3,5962
2,2,2,1,5,1,6,5962
3,3,2,1,7,2,9,5962
4,4,2,3,9,5,14,5962
5,5,2,2,11,7,18,5962
6,6,3,2,14,9,23,5962
7,7,3,4,17,13,30,5962
8,8,1,3,18,16,34,5962
9,9,1,1,19,17,36,5962
10,10,0,0,19,17,36,5962
0,0,1,0,1,0,1,5963
1,1,1,0,2,0,2,5963
2,2,1,0,3,0,3,5963
3,3,0,0,3,0,3,5963
0,0,1,0,1,0,1,5964
1,1,0,0,1,0,1,5964
0,0,1,0,1,0,1,5965
1,1,0,0,1,0,1,5965
0,0,1,0,1,0,1,5966
1,1,1,0,2,0,2,5966
2,2,1,0,3,0,3,5966
3,3,0,0,3,0,3,5966
0,0,1,0,1,0,1,5967
1,1,0,0,1,0,1,5967
0,0,1,0,1,0,1,5968
1,1,1,0,2,0,2,5968
2,2,2,0,4,0,4,5968
3,3,2,0,6,0,6,5968
4,4,1,0,7,0,7,5968
5,5,3,1,10,1,11,5968
6,6,2,1,12,2,14,5968
7,7,0,2,12,4,16,5968
8,8,0,1,12,5,17,5968
9,9,0,2,12,7,19,5968
10,10,0,3,12,10,22,5968
11,11,0,0,12,10,22,5968
0,0,1,0,1,0,1,5969
1,1,0,2,1,2,3,5969
2,2,0,1,1,3,4,5969
3,3,1,1,2,4,6,5969
4,4,1,2,3,6,9,5969
5,5,1,2,4,8,12,5969
6,6,0,4,4,12,16,5969
7,7,0,2,4,14,18,5969
8,8,0,1,4,15,19,5969
9,9,1,2,5,17,22,5969
10,10,0,1,5,18,23,5969
11,11,0,0,5,18,23,5969
0,0,1,0,1,0,1,5970
1,1,0,0,1,0,1,5970
0,0,1,0,1,0,1,5971
1,1,0,0,1,0,1,5971
0,0,1,0,1,0,1,5972
1,1,0,0,1,0,1,5972
0,0,1,0,1,0,1,5973
1,1,0,0,1,0,1,5973
0,0,1,0,1,0,1,5974
1,1,2,2,3,2,5,5974
2,2,1,3,4,5,9,5974
3,3,0,4,4,9,13,5974
4,4,4,0,8,9,17,5974
5,5,8,1,16,10,26,5974
6,6,3,4,19,14,33,5974
7,7,3,6,22,20,42,5974
8,8,6,6,28,26,54,5974
9,9,8,6,36,32,68,5974
10,10,8,7,44,39,83,5974
11,11,4,10,48,49,97,5974
12,12,6,9,54,58,112,5974
13,13,9,13,63,71,134,5974
14,14,8,10,71,81,152,5974
15,15,6,5,77,86,163,5974
16,16,3,4,80,90,170,5974
17,17,8,6,88,96,184,5974
18,18,8,4,96,100,196,5974
19,19,9,4,105,104,209,5974
20,20,12,4,117,108,225,5974
21,21,12,5,129,113,242,5974
22,22,10,9,139,122,261,5974
23,23,12,12,151,134,285,5974
24,24,14,8,165,142,307,5974
25,25,15,9,180,151,331,5974
26,26,14,6,194,157,351,5974
27,27,11,7,205,164,369,5974
28,28,5,15,210,179,389,5974
29,29,8,7,218,186,404,5974
30,30,15,6,233,192,425,5974
31,31,9,4,242,196,438,5974
32,32,12,6,254,202,456,5974
33,33,5,4,259,206,465,5974
34,34,3,6,262,212,474,5974
35,35,4,5,266,217,483,5974
36,36,4,2,270,219,489,5974
37,37,2,2,272,221,493,5974
38,38,2,1,274,222,496,5974
39,39,1,0,275,222,497,5974
40,40,0,0,275,222,497,5974
0,0,1,0,1,0,1,5975
1,1,1,0,2,0,2,5975
2,2,1,0,3,0,3,5975
3,3,0,0,3,0,3,5975
0,0,1,0,1,0,1,5976
1,1,1,0,2,0,2,5976
2,2,1,0,3,0,3,5976
3,3,3,0,6,0,6,5976
4,4,5,2,11,2,13,5976
5,5,4,3,15,5,20,5976
6,6,6,6,21,11,32,5976
7,7,4,13,25,24,49,5976
8,8,5,8,30,32,62,5976
9,9,6,7,36,39,75,5976
10,10,8,8,44,47,91,5976
11,11,12,12,56,59,115,5976
12,12,11,8,67,67,134,5976
13,13,11,6,78,73,151,5976
14,14,13,4,91,77,168,5976
15,15,10,7,101,84,185,5976
16,16,7,6,108,90,198,5976
17,17,2,3,110,93,203,5976
18,18,0,3,110,96,206,5976
19,19,0,2,110,98,208,5976
20,20,0,3,110,101,211,5976
21,21,1,0,111,101,212,5976
22,22,0,0,111,101,212,5976
0,0,1,0,1,0,1,5977
1,1,1,1,2,1,3,5977
2,2,3,2,5,3,8,5977
3,3,5,0,10,3,13,5977
4,4,7,3,17,6,23,5977
5,5,3,8,20,14,34,5977
6,6,2,4,22,18,40,5977
7,7,2,6,24,24,48,5977
8,8,0,3,24,27,51,5977
9,9,0,3,24,30,54,5977
10,10,1,5,25,35,60,5977
11,11,3,5,28,40,68,5977
12,12,2,1,30,41,71,5977
13,13,2,1,32,42,74,5977
14,14,0,1,32,43,75,5977
15,15,1,0,33,43,76,5977
16,16,0,0,33,43,76,5977
0,0,1,0,1,0,1,5978
1,1,2,0,3,0,3,5978
2,2,5,0,8,0,8,5978
3,3,5,0,13,0,13,5978
4,4,5,0,18,0,18,5978
5,5,3,0,21,0,21,5978
6,6,5,1,26,1,27,5978
7,7,3,0,29,1,30,5978
8,8,1,0,30,1,31,5978
9,9,2,0,32,1,33,5978
10,10,2,0,34,1,35,5978
11,11,1,0,35,1,36,5978
12,12,0,0,35,1,36,5978
0,0,1,0,1,0,1,5979
1,1,0,0,1,0,1,5979
0,0,1,0,1,0,1,5980
1,1,0,0,1,0,1,5980
0,0,1,0,1,0,1,5981
1,1,0,1,1,1,2,5981
2,2,0,1,1,2,3,5981
3,3,0,1,1,3,4,5981
4,4,0,0,1,3,4,5981
0,0,1,0,1,0,1,5982
1,1,1,0,2,0,2,5982
2,2,1,0,3,0,3,5982
3,3,0,0,3,0,3,5982
0,0,1,0,1,0,1,5983
1,1,2,0,3,0,3,5983
2,2,3,0,6,0,6,5983
3,3,5,0,11,0,11,5983
4,4,5,2,16,2,18,5983
5,5,2,3,18,5,23,5983
6,6,4,3,22,8,30,5983
7,7,7,2,29,10,39,5983
8,8,4,1,33,11,44,5983
9,9,2,0,35,11,46,5983
10,10,0,0,35,11,46,5983
0,0,1,0,1,0,1,5984
1,1,2,0,3,0,3,5984
2,2,0,0,3,0,3,5984
0,0,1,0,1,0,1,5985
1,1,0,1,1,1,2,5985
2,2,0,0,1,1,2,5985
0,0,1,0,1,0,1,5986
1,1,0,0,1,0,1,5986
0,0,1,0,1,0,1,5987
1,1,2,0,3,0,3,5987
2,2,1,1,4,1,5,5987
3,3,1,2,5,3,8,5987
4,4,2,4,7,7,14,5987
5,5,0,3,7,10,17,5987
6,6,0,3,7,13,20,5987
7,7,0,1,7,14,21,5987
8,8,1,0,8,14,22,5987
9,9,0,0,8,14,22,5987
0,0,1,0,1,0,1,5988
1,1,1,1,2,1,3,5988
2,2,1,2,3,3,6,5988
3,3,1,1,4,4,8,5988
4,4,0,1,4,5,9,5988
5,5,0,0,4,5,9,5988
0,0,1,0,1,0,1,5989
1,1,0,0,1,0,1,5989
0,0,1,0,1,0,1,5990
1,1,1,1,2,1,3,5990
2,2,1,2,3,3,6,5990
3,3,0,4,3,7,10,5990
4,4,1,2,4,9,13,5990
5,5,1,0,5,9,14,5990
6,6,1,0,6,9,15,5990
7,7,1,1,7,10,17,5990
8,8,1,1,8,11,19,5990
9,9,0,2,8,13,21,5990
10,10,0,3,8,16,24,5990
11,11,1,3,9,19,28,5990
12,12,0,4,9,23,32,5990
13,13,1,0,10,23,33,5990
14,14,0,0,10,23,33,5990
0,0,1,0,1,0,1,5991
1,1,0,0,1,0,1,5991
0,0,1,0,1,0,1,5992
1,1,3,0,4,0,4,5992
2,2,4,1,8,1,9,5992
3,3,2,1,10,2,12,5992
4,4,1,0,11,2,13,5992
5,5,3,0,14,2,16,5992
6,6,1,0,15,2,17,5992
7,7,1,0,16,2,18,5992
8,8,0,0,16,2,18,5992
0,0,1,0,1,0,1,5993
1,1,1,0,2,0,2,5993
2,2,0,0,2,0,2,5993
0,0,1,0,1,0,1,5994
1,1,0,0,1,0,1,5994
0,0,1,0,1,0,1,5995
1,1,0,0,1,0,1,5995
0,0,1,0,1,0,1,5996
1,1,1,0,2,0,2,5996
2,2,1,0,3,0,3,5996
3,3,0,0,3,0,3,5996
0,0,1,0,1,0,1,5997
1,1,1,0,2,0,2,5997
2,2,2,0,4,0,4,5997
3,3,0,0,4,0,4,5997
0,0,1,0,1,0,1,5998
1,1,1,0,2,0,2,5998
2,2,2,0,4,0,4,5998
3,3,1,1,5,1,6,5998
4,4,0,0,5,1,6,5998
0,0,1,0,1,0,1,5999
1,1,1,0,2,0,2,5999
2,2,3,0,5,0,5,5999
3,3,4,0,9,0,9,5999
4,4,1,0,10,0,10,5999
5,5,1,0,11,0,11,5999
6,6,0,0,11,0,11,5999
0,0,1,0,1,0,1,6000
1,1,0,0,1,0,1,6000
0,0,1,0,1,0,1,6001
1,1,1,0,2,0,2,6001
2,2,0,0,2,0,2,6001
0,0,1,0,1,0,1,6002
1,1,0,0,1,0,1,6002
0,0,1,0,1,0,1,6003
1,1,0,0,1,0,1,6003
0,0,1,0,1,0,1,6004
1,1,2,2,3,2,5,6004
2,2,2,3,5,5,10,6004
3,3,2,3,7,8,15,6004
4,4,1,1,8,9,17,6004
5,5,1,1,9,10,19,6004
6,6,1,1,10,11,21,6004
7,7,3,2,13,13,26,6004
8,8,2,1,15,14,29,6004
9,9,0,1,15,15,30,6004
10,10,0,1,15,16,31,6004
11,11,0,0,15,16,31,6004
0,0,1,0,1,0,1,6005
1,1,0,0,1,0,1,6005
0,0,1,0,1,0,1,6006
1,1,0,0,1,0,1,6006
0,0,1,0,1,0,1,6007
1,1,0,0,1,0,1,6007
0,0,1,0,1,0,1,6008
1,1,0,0,1,0,1,6008
0,0,1,0,1,0,1,6009
1,1,2,0,3,0,3,6009
2,2,1,0,4,0,4,6009
3,3,0,0,4,0,4,6009
0,0,1,0,1,0,1,6010
1,1,0,0,1,0,1,6010
0,0,1,0,1,0,1,6011
1,1,1,0,2,0,2,6011
2,2,1,0,3,0,3,6011
3,3,0,1,3,1,4,6011
4,4,0,3,3,4,7,6011
5,5,1,2,4,6,10,6011
6,6,3,1,7,7,14,6011
7,7,2,2,9,9,18,6011
8,8,3,2,12,11,23,6011
9,9,2,1,14,12,26,6011
10,10,2,1,16,13,29,6011
11,11,1,1,17,14,31,6011
12,12,1,0,18,14,32,6011
13,13,0,0,18,14,32,6011
0,0,1,0,1,0,1,6012
1,1,0,1,1,1,2,6012
2,2,0,1,1,2,3,6012
3,3,0,0,1,2,3,6012
0,0,1,0,1,0,1,6013
1,1,1,0,2,0,2,6013
2,2,1,0,3,0,3,6013
3,3,2,1,5,1,6,6013
4,4,2,1,7,2,9,6013
5,5,2,1,9,3,12,6013
6,6,3,2,12,5,17,6013
7,7,4,4,16,9,25,6013
8,8,6,3,22,12,34,6013
9,9,3,7,25,19,44,6013
10,10,1,4,26,23,49,6013
11,11,2,4,28,27,55,6013
12,12,6,0,34,27,61,6013
13,13,6,3,40,30,70,6013
14,14,4,6,44,36,80,6013
15,15,4,5,48,41,89,6013
16,16,3,4,51,45,96,6013
17,17,2,1,53,46,99,6013
18,18,0,1,53,47,100,6013
19,19,0,0,53,47,100,6013
0,0,1,0,1,0,1,6014
1,1,1,0,2,0,2,6014
2,2,0,0,2,0,2,6014
0,0,1,0,1,0,1,6015
1,1,0,0,1,0,1,6015
0,0,1,0,1,0,1,6016
1,1,0,0,1,0,1,6016
0,0,1,0,1,0,1,6017
1,1,1,0,2,0,2,6017
2,2,1,2,3,2,5,6017
3,3,0,3,3,5,8,6017
4,4,0,1,3,6,9,6017
5,5,1,2,4,8,12,6017
6,6,2,0,6,8,14,6017
7,7,0,1,6,9,15,6017
8,8,0,0,6,9,15,6017
0,0,1,0,1,0,1,6018
1,1,0,0,1,0,1,6018
0,0,1,0,1,0,1,6019
1,1,0,1,1,1,2,6019
2,2,0,2,1,3,4,6019
3,3,0,3,1,6,7,6019
4,4,1,6,2,12,14,6019
5,5,0,4,2,16,18,6019
6,6,1,3,3,19,22,6019
7,7,2,3,5,22,27,6019
8,8,4,2,9,24,33,6019
9,9,6,2,15,26,41,6019
10,10,5,2,20,28,48,6019
11,11,2,3,22,31,53,6019
12,12,1,2,23,33,56,6019
13,13,1,1,24,34,58,6019
14,14,3,0,27,34,61,6019
15,15,0,0,27,34,61,6019
0,0,1,0,1,0,1,6020
1,1,0,0,1,0,1,6020
0,0,1,0,1,0,1,6021
1,1,0,0,1,0,1,6021
0,0,1,0,1,0,1,6022
1,1,1,0,2,0,2,6022
2,2,4,0,6,0,6,6022
3,3,4,1,10,1,11,6022
4,4,1,2,11,3,14,6022
5,5,0,1,11,4,15,6022
6,6,0,0,11,4,15,6022
0,0,1,0,1,0,1,6023
1,1,1,0,2,0,2,6023
2,2,0,0,2,0,2,6023
0,0,1,0,1,0,1,6024
1,1,0,0,1,0,1,6024
0,0,1,0,1,0,1,6025
1,1,1,0,2,0,2,6025
2,2,1,0,3,0,3,6025
3,3,1,0,4,0,4,6025
4,4,2,0,6,0,6,6025
5,5,3,1,9,1,10,6025
6,6,1,1,10,2,12,6025
7,7,1,1,11,3,14,6025
8,8,0,0,11,3,14,6025
0,0,1,0,1,0,1,6026
1,1,1,1,2,1,3,6026
2,2,0,1,2,2,4,6026
3,3,0,0,2,2,4,6026
0,0,1,0,1,0,1,6027
1,1,0,1,1,1,2,6027
2,2,0,0,1,1,2,6027
0,0,1,0,1,0,1,6028
1,1,1,0,2,0,2,6028
2,2,1,0,3,0,3,6028
3,3,1,0,4,0,4,6028
4,4,0,0,4,0,4,6028
0,0,1,0,1,0,1,6029
1,1,2,0,3,0,3,6029
2,2,0,1,3,1,4,6029
3,3,1,1,4,2,6,6029
4,4,1,0,5,2,7,6029
5,5,1,0,6,2,8,6029
6,6,2,0,8,2,10,6029
7,7,3,0,11,2,13,6029
8,8,3,0,14,2,16,6029
9,9,3,0,17,2,19,6029
10,10,2,0,19,2,21,6029
11,11,0,0,19,2,21,6029
0,0,1,0,1,0,1,6030
1,1,1,0,2,0,2,6030
2,2,0,0,2,0,2,6030
0,0,1,0,1,0,1,6031
1,1,0,0,1,0,1,6031
0,0,1,0,1,0,1,6032
1,1,0,0,1,0,1,6032
0,0,1,0,1,0,1,6033
1,1,1,0,2,0,2,6033
2,2,0,2,2,2,4,6033
3,3,0,2,2,4,6,6033
4,4,0,1,2,5,7,6033
5,5,0,2,2,7,9,6033
6,6,0,1,2,8,10,6033
7,7,0,0,2,8,10,6033
0,0,1,0,1,0,1,6034
1,1,1,0,2,0,2,6034
2,2,0,0,2,0,2,6034
0,0,1,0,1,0,1,6035
1,1,0,0,1,0,1,6035
0,0,1,0,1,0,1,6036
1,1,1,0,2,0,2,6036
2,2,3,0,5,0,5,6036
3,3,5,1,10,1,11,6036
4,4,4,2,14,3,17,6036
5,5,1,3,15,6,21,6036
6,6,1,3,16,9,25,6036
7,7,2,2,18,11,29,6036
8,8,2,1,20,12,32,6036
9,9,2,1,22,13,35,6036
10,10,1,1,23,14,37,6036
11,11,0,0,23,14,37,6036
0,0,1,0,1,0,1,6037
1,1,0,0,1,0,1,6037
0,0,1,0,1,0,1,6038
1,1,0,0,1,0,1,6038
0,0,1,0,1,0,1,6039
1,1,1,0,2,0,2,6039
2,2,0,0,2,0,2,6039
0,0,1,0,1,0,1,6040
1,1,0,0,1,0,1,6040
0,0,1,0,1,0,1,6041
1,1,1,0,2,0,2,6041
2,2,1,0,3,0,3,6041
3,3,0,0,3,0,3,6041
0,0,1,0,1,0,1,6042
1,1,1,0,2,0,2,6042
2,2,0,0,2,0,2,6042
0,0,1,0,1,0,1,6043
1,1,1,0,2,0,2,6043
2,2,1,0,3,0,3,6043
3,3,0,0,3,0,3,6043
0,0,1,0,1,0,1,6044
1,1,0,0,1,0,1,6044
0,0,1,0,1,0,1,6045
1,1,0,0,1,0,1,6045
0,0,1,0,1,0,1,6046
1,1,1,0,2,0,2,6046
2,2,0,0,2,0,2,6046
0,0,1,0,1,0,1,6047
1,1,0,0,1,0,1,6047
0,0,1,0,1,0,1,6048
1,1,0,0,1,0,1,6048
0,0,1,0,1,0,1,6049
1,1,0,0,1,0,1,6049
0,0,1,0,1,0,1,6050
1,1,2,1,3,1,4,6050
2,2,2,1,5,2,7,6050
3,3,1,1,6,3,9,6050
4,4,0,4,6,7,13,6050
5,5,0,2,6,9,15,6050
6,6,0,1,6,10,16,6050
7,7,0,0,6,10,16,6050
0,0,1,0,1,0,1,6051
1,1,1,1,2,1,3,6051
2,2,0,1,2,2,4,6051
3,3,0,0,2,2,4,6051
0,0,1,0,1,0,1,6052
1,1,1,0,2,0,2,6052
2,2,1,1,3,1,4,6052
3,3,2,1,5,2,7,6052
4,4,2,0,7,2,9,6052
5,5,2,0,9,2,11,6052
6,6,1,0,10,2,12,6052
7,7,0,0,10,2,12,6052
0,0,1,0,1,0,1,6053
1,1,2,0,3,0,3,6053
2,2,1,1,4,1,5,6053
3,3,5,0,9,1,10,6053
4,4,4,0,13,1,14,6053
5,5,3,0,16,1,17,6053
6,6,1,4,17,5,22,6053
7,7,0,4,17,9,26,6053
8,8,0,6,17,15,32,6053
9,9,1,1,18,16,34,6053
10,10,0,2,18,18,36,6053
11,11,0,1,18,19,37,6053
12,12,0,2,18,21,39,6053
13,13,0,1,18,22,40,6053
14,14,0,0,18,22,40,6053
0,0,1,0,1,0,1,6054
1,1,0,0,1,0,1,6054
0,0,1,0,1,0,1,6055
1,1,0,0,1,0,1,6055
0,0,1,0,1,0,1,6056
1,1,1,0,2,0,2,6056
2,2,0,0,2,0,2,6056
0,0,1,0,1,0,1,6057
1,1,4,0,5,0,5,6057
2,2,1,0,6,0,6,6057
3,3,1,0,7,0,7,6057
4,4,1,0,8,0,8,6057
5,5,1,1,9,1,10,6057
6,6,2,4,11,5,16,6057
7,7,3,5,14,10,24,6057
8,8,4,2,18,12,30,6057
9,9,6,0,24,12,36,6057
10,10,3,0,27,12,39,6057
11,11,2,2,29,14,43,6057
12,12,0,3,29,17,46,6057
13,13,0,2,29,19,48,6057
14,14,0,0,29,19,48,6057
0,0,1,0,1,0,1,6058
1,1,2,0,3,0,3,6058
2,2,3,2,6,2,8,6058
3,3,2,1,8,3,11,6058
4,4,1,1,9,4,13,6058
5,5,0,0,9,4,13,6058
0,0,1,0,1,0,1,6059
1,1,0,0,1,0,1,6059
0,0,1,0,1,0,1,6060
1,1,1,0,2,0,2,6060
2,2,0,0,2,0,2,6060
0,0,1,0,1,0,1,6061
1,1,0,0,1,0,1,6061
0,0,1,0,1,0,1,6062
1,1,0,0,1,0,1,6062
0,0,1,0,1,0,1,6063
1,1,1,0,2,0,2,6063
2,2,1,0,3,0,3,6063
3,3,0,0,3,0,3,6063
0,0,1,0,1,0,1,6064
1,1,0,0,1,0,1,6064
0,0,1,0,1,0,1,6065
1,1,1,0,2,0,2,6065
2,2,0,0,2,0,2,6065
0,0,1,0,1,0,1,6066
1,1,1,1,2,1,3,6066
2,2,2,1,4,2,6,6066
3,3,2,0,6,2,8,6066
4,4,1,0,7,2,9,6066
5,5,0,2,7,4,11,6066
6,6,0,1,7,5,12,6066
7,7,0,0,7,5,12,6066
0,0,1,0,1,0,1,6067
1,1,2,0,3,0,3,6067
2,2,3,1,6,1,7,6067
3,3,2,1,8,2,10,6067
4,4,4,0,12,2,14,6067
5,5,2,1,14,3,17,6067
6,6,2,0,16,3,19,6067
7,7,2,1,18,4,22,6067
8,8,1,0,19,4,23,6067
9,9,0,0,19,4,23,6067
0,0,1,0,1,0,1,6068
1,1,0,0,1,0,1,6068
0,0,1,0,1,0,1,6069
1,1,2,0,3,0,3,6069
2,2,0,0,3,0,3,6069
0,0,1,0,1,0,1,6070
1,1,0,0,1,0,1,6070
0,0,1,0,1,0,1,6071
1,1,0,0,1,0,1,6071
0,0,1,0,1,0,1,6072
1,1,0,0,1,0,1,6072
0,0,1,0,1,0,1,6073
1,1,0,0,1,0,1,6073
0,0,1,0,1,0,1,6074
1,1,1,0,2,0,2,6074
2,2,1,0,3,0,3,6074
3,3,0,0,3,0,3,6074
0,0,1,0,1,0,1,6075
1,1,0,0,1,0,1,6075
0,0,1,0,1,0,1,6076
1,1,0,0,1,0,1,6076
0,0,1,0,1,0,1,6077
1,1,1,1,2,1,3,6077
2,2,0,1,2,2,4,6077
3,3,0,3,2,5,7,6077
4,4,0,2,2,7,9,6077
5,5,0,2,2,9,11,6077
6,6,1,2,3,11,14,6077
7,7,1,4,4,15,19,6077
8,8,4,3,8,18,26,6077
9,9,4,2,12,20,32,6077
10,10,4,3,16,23,39,6077
11,11,2,2,18,25,43,6077
12,12,3,0,21,25,46,6077
13,13,5,1,26,26,52,6077
14,14,1,0,27,26,53,6077
15,15,2,1,29,27,56,6077
16,16,0,2,29,29,58,6077
17,17,0,1,29,30,59,6077
18,18,0,1,29,31,60,6077
19,19,0,1,29,32,61,6077
20,20,0,1,29,33,62,6077
21,21,0,0,29,33,62,6077
0,0,1,0,1,0,1,6078
1,1,0,0,1,0,1,6078
0,0,1,0,1,0,1,6079
1,1,1,0,2,0,2,6079
2,2,0,1,2,1,3,6079
3,3,0,0,2,1,3,6079
0,0,1,0,1,0,1,6080
1,1,1,0,2,0,2,6080
2,2,0,1,2,1,3,6080
3,3,0,1,2,2,4,6080
4,4,1,0,3,2,5,6080
5,5,0,0,3,2,5,6080
0,0,1,0,1,0,1,6081
1,1,0,0,1,0,1,6081
0,0,1,0,1,0,1,6082
1,1,1,0,2,0,2,6082
2,2,0,0,2,0,2,6082
0,0,1,0,1,0,1,6083
1,1,1,0,2,0,2,6083
2,2,1,0,3,0,3,6083
3,3,1,0,4,0,4,6083
4,4,1,0,5,0,5,6083
5,5,0,0,5,0,5,6083
0,0,1,0,1,0,1,6084
1,1,0,0,1,0,1,6084
0,0,1,0,1,0,1,6085
1,1,0,0,1,0,1,6085
0,0,1,0,1,0,1,6086
1,1,0,0,1,0,1,6086
0,0,1,0,1,0,1,6087
1,1,1,0,2,0,2,6087
2,2,1,0,3,0,3,6087
3,3,0,0,3,0,3,6087
0,0,1,0,1,0,1,6088
1,1,0,0,1,0,1,6088
0,0,1,0,1,0,1,6089
1,1,0,0,1,0,1,6089
0,0,1,0,1,0,1,6090
1,1,2,0,3,0,3,6090
2,2,0,0,3,0,3,6090
0,0,1,0,1,0,1,6091
1,1,0,0,1,0,1,6091
0,0,1,0,1,0,1,6092
1,1,1,0,2,0,2,6092
2,2,2,0,4,0,4,6092
3,3,1,0,5,0,5,6092
4,4,1,1,6,1,7,6092
5,5,0,0,6,1,7,6092
0,0,1,0,1,0,1,6093
1,1,0,0,1,0,1,6093
0,0,1,0,1,0,1,6094
1,1,1,0,2,0,2,6094
2,2,0,0,2,0,2,6094
0,0,1,0,1,0,1,6095
1,1,0,0,1,0,1,6095
0,0,1,0,1,0,1,6096
1,1,0,0,1,0,1,6096
0,0,1,0,1,0,1,6097
1,1,1,0,2,0,2,6097
2,2,0,0,2,0,2,6097
0,0,1,0,1,0,1,6098
1,1,0,0,1,0,1,6098
0,0,1,0,1,0,1,6099
1,1,0,0,1,0,1,6099
0,0,1,0,1,0,1,6100
1,1,0,0,1,0,1,6100
0,0,1,0,1,0,1,6101
1,1,0,2,1,2,3,6101
2,2,0,3,1,5,6,6101
3,3,1,1,2,6,8,6101
4,4,0,0,2,6,8,6101
0,0,1,0,1,0,1,6102
1,1,0,0,1,0,1,6102
0,0,1,0,1,0,1,6103
1,1,1,0,2,0,2,6103
2,2,1,0,3,0,3,6103
3,3,0,0,3,0,3,6103
0,0,1,0,1,0,1,6104
1,1,1,0,2,0,2,6104
2,2,0,0,2,0,2,6104
0,0,1,0,1,0,1,6105
1,1,2,0,3,0,3,6105
2,2,1,1,4,1,5,6105
3,3,1,0,5,1,6,6105
4,4,0,1,5,2,7,6105
5,5,0,0,5,2,7,6105
0,0,1,0,1,0,1,6106
1,1,1,0,2,0,2,6106
2,2,1,0,3,0,3,6106
3,3,0,1,3,1,4,6106
4,4,0,0,3,1,4,6106
0,0,1,0,1,0,1,6107
1,1,2,0,3,0,3,6107
2,2,1,0,4,0,4,6107
3,3,0,0,4,0,4,6107
0,0,1,0,1,0,1,6108
1,1,0,0,1,0,1,6108
0,0,1,0,1,0,1,6109
1,1,0,0,1,0,1,6109
0,0,1,0,1,0,1,6110
1,1,1,0,2,0,2,6110
2,2,0,0,2,0,2,6110
0,0,1,0,1,0,1,6111
1,1,2,0,3,0,3,6111
2,2,1,0,4,0,4,6111
3,3,0,0,4,0,4,6111
0,0,1,0,1,0,1,6112
1,1,0,0,1,0,1,6112
0,0,1,0,1,0,1,6113
1,1,0,0,1,0,1,6113
0,0,1,0,1,0,1,6114
1,1,0,0,1,0,1,6114
0,0,1,0,1,0,1,6115
1,1,1,0,2,0,2,6115
2,2,2,0,4,0,4,6115
3,3,1,1,5,1,6,6115
4,4,0,2,5,3,8,6115
5,5,0,3,5,6,11,6115
6,6,1,1,6,7,13,6115
7,7,1,1,7,8,15,6115
8,8,3,1,10,9,19,6115
9,9,1,0,11,9,20,6115
10,10,1,0,12,9,21,6115
11,11,0,0,12,9,21,6115
0,0,1,0,1,0,1,6116
1,1,2,0,3,0,3,6116
2,2,2,2,5,2,7,6116
3,3,3,0,8,2,10,6116
4,4,4,0,12,2,14,6116
5,5,4,2,16,4,20,6116
6,6,2,1,18,5,23,6116
7,7,3,1,21,6,27,6116
8,8,2,0,23,6,29,6116
9,9,4,0,27,6,33,6116
10,10,3,0,30,6,36,6116
11,11,3,0,33,6,39,6116
12,12,3,1,36,7,43,6116
13,13,2,0,38,7,45,6116
14,14,0,0,38,7,45,6116
0,0,1,0,1,0,1,6117
1,1,1,0,2,0,2,6117
2,2,0,0,2,0,2,6117
0,0,1,0,1,0,1,6118
1,1,0,0,1,0,1,6118
0,0,1,0,1,0,1,6119
1,1,0,0,1,0,1,6119
0,0,1,0,1,0,1,6120
1,1,1,0,2,0,2,6120
2,2,0,1,2,1,3,6120
3,3,0,0,2,1,3,6120
0,0,1,0,1,0,1,6121
1,1,1,0,2,0,2,6121
2,2,0,0,2,0,2,6121
0,0,1,0,1,0,1,6122
1,1,0,0,1,0,1,6122
0,0,1,0,1,0,1,6123
1,1,0,0,1,0,1,6123
0,0,1,0,1,0,1,6124
1,1,2,0,3,0,3,6124
2,2,0,1,3,1,4,6124
3,3,1,0,4,1,5,6124
4,4,1,2,5,3,8,6124
5,5,0,2,5,5,10,6124
6,6,0,3,5,8,13,6124
7,7,0,1,5,9,14,6124
8,8,1,0,6,9,15,6124
9,9,1,0,7,9,16,6124
10,10,0,1,7,10,17,6124
11,11,0,1,7,11,18,6124
12,12,0,1,7,12,19,6124
13,13,0,0,7,12,19,6124
0,0,1,0,1,0,1,6125
1,1,2,0,3,0,3,6125
2,2,0,1,3,1,4,6125
3,3,0,1,3,2,5,6125
4,4,0,1,3,3,6,6125
5,5,0,0,3,3,6,6125
0,0,1,0,1,0,1,6126
1,1,1,0,2,0,2,6126
2,2,1,0,3,0,3,6126
3,3,1,0,4,0,4,6126
4,4,3,1,7,1,8,6126
5,5,3,2,10,3,13,6126
6,6,5,3,15,6,21,6126
7,7,4,3,19,9,28,6126
8,8,3,1,22,10,32,6126
9,9,5,3,27,13,40,6126
10,10,2,1,29,14,43,6126
11,11,1,1,30,15,45,6126
12,12,0,0,30,15,45,6126
0,0,1,0,1,0,1,6127
1,1,1,0,2,0,2,6127
2,2,1,0,3,0,3,6127
3,3,1,0,4,0,4,6127
4,4,0,0,4,0,4,6127
0,0,1,0,1,0,1,6128
1,1,2,0,3,0,3,6128
2,2,3,0,6,0,6,6128
3,3,2,0,8,0,8,6128
4,4,1,2,9,2,11,6128
5,5,2,3,11,5,16,6128
6,6,2,2,13,7,20,6128
7,7,1,1,14,8,22,6128
8,8,2,0,16,8,24,6128
9,9,3,0,19,8,27,6128
10,10,2,1,21,9,30,6128
11,11,1,0,22,9,31,6128
12,12,0,1,22,10,32,6128
13,13,0,2,22,12,34,6128
14,14,1,0,23,12,35,6128
15,15,2,1,25,13,38,6128
16,16,2,2,27,15,42,6128
17,17,0,2,27,17,44,6128
18,18,0,2,27,19,46,6128
19,19,0,3,27,22,49,6128
20,20,0,2,27,24,51,6128
21,21,0,0,27,24,51,6128
0,0,1,0,1,0,1,6129
1,1,1,0,2,0,2,6129
2,2,0,0,2,0,2,6129
0,0,1,0,1,0,1,6130
1,1,0,1,1,1,2,6130
2,2,1,1,2,2,4,6130
3,3,0,2,2,4,6,6130
4,4,1,2,3,6,9,6130
5,5,1,4,4,10,14,6130
6,6,1,3,5,13,18,6130
7,7,2,1,7,14,21,6130
8,8,1,0,8,14,22,6130
9,9,2,1,10,15,25,6130
10,10,2,1,12,16,28,6130
11,11,2,1,14,17,31,6130
12,12,1,0,15,17,32,6130
13,13,1,0,16,17,33,6130
14,14,0,0,16,17,33,6130
0,0,1,0,1,0,1,6131
1,1,0,0,1,0,1,6131
0,0,1,0,1,0,1,6132
1,1,1,1,2,1,3,6132
2,2,0,1,2,2,4,6132
3,3,0,1,2,3,5,6132
4,4,0,0,2,3,5,6132
0,0,1,0,1,0,1,6133
1,1,2,1,3,1,4,6133
2,2,2,1,5,2,7,6133
3,3,2,0,7,2,9,6133
4,4,1,1,8,3,11,6133
5,5,0,2,8,5,13,6133
6,6,0,3,8,8,16,6133
7,7,0,2,8,10,18,6133
8,8,0,3,8,13,21,6133
9,9,0,3,8,16,24,6133
10,10,0,4,8,20,28,6133
11,11,0,6,8,26,34,6133
12,12,0,7,8,33,41,6133
13,13,1,4,9,37,46,6133
14,14,2,2,11,39,50,6133
15,15,5,1,16,40,56,6133
16,16,2,2,18,42,60,6133
17,17,0,2,18,44,62,6133
18,18,1,2,19,46,65,6133
19,19,1,3,20,49,69,6133
20,20,2,3,22,52,74,6133
21,21,0,3,22,55,77,6133
22,22,0,3,22,58,80,6133
23,23,1,4,23,62,85,6133
24,24,1,1,24,63,87,6133
25,25,3,1,27,64,91,6133
26,26,1,1,28,65,93,6133
27,27,0,2,28,67,95,6133
28,28,0,3,28,70,98,6133
29,29,1,0,29,70,99,6133
30,30,0,0,29,70,99,6133
0,0,1,0,1,0,1,6134
1,1,0,1,1,1,2,6134
2,2,1,1,2,2,4,6134
3,3,2,1,4,3,7,6134
4,4,1,0,5,3,8,6134
5,5,0,0,5,3,8,6134
0,0,1,0,1,0,1,6135
1,1,0,0,1,0,1,6135
0,0,1,0,1,0,1,6136
1,1,1,0,2,0,2,6136
2,2,1,0,3,0,3,6136
3,3,0,0,3,0,3,6136
0,0,1,0,1,0,1,6137
1,1,0,0,1,0,1,6137
0,0,1,0,1,0,1,6138
1,1,3,0,4,0,4,6138
2,2,1,0,5,0,5,6138
3,3,2,0,7,0,7,6138
4,4,5,0,12,0,12,6138
5,5,2,0,14,0,14,6138
6,6,1,1,15,1,16,6138
7,7,1,0,16,1,17,6138
8,8,0,0,16,1,17,6138
0,0,1,0,1,0,1,6139
1,1,1,0,2,0,2,6139
2,2,0,0,2,0,2,6139
0,0,1,0,1,0,1,6140
1,1,2,0,3,0,3,6140
2,2,2,2,5,2,7,6140
3,3,1,1,6,3,9,6140
4,4,0,0,6,3,9,6140
0,0,1,0,1,0,1,6141
1,1,1,0,2,0,2,6141
2,2,1,0,3,0,3,6141
3,3,1,0,4,0,4,6141
4,4,0,0,4,0,4,6141
0,0,1,0,1,0,1,6142
1,1,0,0,1,0,1,6142
0,0,1,0,1,0,1,6143
1,1,0,0,1,0,1,6143
0,0,1,0,1,0,1,6144
1,1,1,1,2,1,3,6144
2,2,1,0,3,1,4,6144
3,3,3,1,6,2,8,6144
4,4,0,0,6,2,8,6144
0,0,1,0,1,0,1,6145
1,1,1,0,2,0,2,6145
2,2,1,0,3,0,3,6145
3,3,1,0,4,0,4,6145
4,4,0,0,4,0,4,6145
0,0,1,0,1,0,1,6146
1,1,1,0,2,0,2,6146
2,2,0,1,2,1,3,6146
3,3,0,0,2,1,3,6146
0,0,1,0,1,0,1,6147
1,1,1,0,2,0,2,6147
2,2,0,0,2,0,2,6147
0,0,1,0,1,0,1,6148
1,1,0,0,1,0,1,6148
0,0,1,0,1,0,1,6149
1,1,0,0,1,0,1,6149
0,0,1,0,1,0,1,6150
1,1,0,0,1,0,1,6150
0,0,1,0,1,0,1,6151
1,1,1,0,2,0,2,6151
2,2,0,0,2,0,2,6151
0,0,1,0,1,0,1,6152
1,1,0,2,1,2,3,6152
2,2,1,1,2,3,5,6152
3,3,0,0,2,3,5,6152
0,0,1,0,1,0,1,6153
1,1,2,1,3,1,4,6153
2,2,3,2,6,3,9,6153
3,3,2,2,8,5,13,6153
4,4,2,0,10,5,15,6153
5,5,1,0,11,5,16,6153
6,6,2,0,13,5,18,6153
7,7,1,1,14,6,20,6153
8,8,2,0,16,6,22,6153
9,9,1,0,17,6,23,6153
10,10,0,0,17,6,23,6153
0,0,1,0,1,0,1,6154
1,1,1,0,2,0,2,6154
2,2,0,0,2,0,2,6154
0,0,1,0,1,0,1,6155
1,1,1,0,2,0,2,6155
2,2,0,0,2,0,2,6155
0,0,1,0,1,0,1,6156
1,1,2,1,3,1,4,6156
2,2,2,2,5,3,8,6156
3,3,2,3,7,6,13,6156
4,4,4,2,11,8,19,6156
5,5,1,2,12,10,22,6156
6,6,2,0,14,10,24,6156
7,7,1,0,15,10,25,6156
8,8,1,0,16,10,26,6156
9,9,2,0,18,10,28,6156
10,10,0,1,18,11,29,6156
11,11,0,1,18,12,30,6156
12,12,0,1,18,13,31,6156
13,13,0,0,18,13,31,6156
0,0,1,0,1,0,1,6157
1,1,2,0,3,0,3,6157
2,2,3,0,6,0,6,6157
3,3,2,0,8,0,8,6157
4,4,1,0,9,0,9,6157
5,5,0,0,9,0,9,6157
0,0,1,0,1,0,1,6158
1,1,0,0,1,0,1,6158
0,0,1,0,1,0,1,6159
1,1,0,1,1,1,2,6159
2,2,0,0,1,1,2,6159
0,0,1,0,1,0,1,6160
1,1,0,0,1,0,1,6160
0,0,1,0,1,0,1,6161
1,1,2,0,3,0,3,6161
2,2,1,0,4,0,4,6161
3,3,0,0,4,0,4,6161
0,0,1,0,1,0,1,6162
1,1,2,0,3,0,3,6162
2,2,1,1,4,1,5,6162
3,3,2,1,6,2,8,6162
4,4,0,0,6,2,8,6162
0,0,1,0,1,0,1,6163
1,1,0,0,1,0,1,6163
0,0,1,0,1,0,1,6164
1,1,0,0,1,0,1,6164
0,0,1,0,1,0,1,6165
1,1,0,0,1,0,1,6165
0,0,1,0,1,0,1,6166
1,1,0,0,1,0,1,6166
0,0,1,0,1,0,1,6167
1,1,2,0,3,0,3,6167
2,2,5,0,8,0,8,6167
3,3,3,2,11,2,13,6167
4,4,3,2,14,4,18,6167
5,5,3,1,17,5,22,6167
6,6,3,3,20,8,28,6167
7,7,3,5,23,13,36,6167
8,8,2,4,25,17,42,6167
9,9,5,3,30,20,50,6167
10,10,5,3,35,23,58,6167
11,11,5,2,40,25,65,6167
12,12,5,2,45,27,72,6167
13,13,5,2,50,29,79,6167
14,14,7,4,57,33,90,6167
15,15,4,6,61,39,100,6167
16,16,7,8,68,47,115,6167
17,17,9,5,77,52,129,6167
18,18,8,7,85,59,144,6167
19,19,13,10,98,69,167,6167
20,20,13,12,111,81,192,6167
21,21,9,15,120,96,216,6167
22,22,12,13,132,109,241,6167
23,23,14,14,146,123,269,6167
24,24,13,11,159,134,293,6167
25,25,7,14,166,148,314,6167
26,26,10,13,176,161,337,6167
27,27,5,9,181,170,351,6167
28,28,9,7,190,177,367,6167
29,29,8,12,198,189,387,6167
30,30,7,18,205,207,412,6167
31,31,8,13,213,220,433,6167
32,32,8,7,221,227,448,6167
33,33,6,10,227,237,464,6167
34,34,5,9,232,246,478,6167
35,35,10,12,242,258,500,6167
36,36,8,12,250,270,520,6167
37,37,11,8,261,278,539,6167
38,38,11,10,272,288,560,6167
39,39,17,8,289,296,585,6167
40,40,13,13,302,309,611,6167
41,41,9,12,311,321,632,6167
42,42,4,10,315,331,646,6167
43,43,7,6,322,337,659,6167
44,44,4,8,326,345,671,6167
45,45,4,4,330,349,679,6167
46,46,2,3,332,352,684,6167
47,47,0,2,332,354,686,6167
48,48,0,1,332,355,687,6167
49,49,0,1,332,356,688,6167
50,50,0,1,332,357,689,6167
51,51,0,0,332,357,689,6167
0,0,1,0,1,0,1,6168
1,1,1,0,2,0,2,6168
2,2,1,0,3,0,3,6168
3,3,0,2,3,2,5,6168
4,4,0,3,3,5,8,6168
5,5,0,1,3,6,9,6168
6,6,0,0,3,6,9,6168
0,0,1,0,1,0,1,6169
1,1,2,0,3,0,3,6169
2,2,1,5,4,5,9,6169
3,3,1,8,5,13,18,6169
4,4,2,7,7,20,27,6169
5,5,0,6,7,26,33,6169
6,6,3,4,10,30,40,6169
7,7,2,3,12,33,45,6169
8,8,0,1,12,34,46,6169
9,9,0,0,12,34,46,6169
0,0,1,0,1,0,1,6170
1,1,2,0,3,0,3,6170
2,2,3,0,6,0,6,6170
3,3,2,1,8,1,9,6170
4,4,0,1,8,2,10,6170
5,5,1,1,9,3,12,6170
6,6,2,0,11,3,14,6170
7,7,3,0,14,3,17,6170
8,8,1,1,15,4,19,6170
9,9,1,1,16,5,21,6170
10,10,0,2,16,7,23,6170
11,11,0,0,16,7,23,6170
0,0,1,0,1,0,1,6171
1,1,0,1,1,1,2,6171
2,2,0,1,1,2,3,6171
3,3,1,3,2,5,7,6171
4,4,2,0,4,5,9,6171
5,5,1,0,5,5,10,6171
6,6,0,0,5,5,10,6171
0,0,1,0,1,0,1,6172
1,1,0,0,1,0,1,6172
0,0,1,0,1,0,1,6173
1,1,2,0,3,0,3,6173
2,2,3,0,6,0,6,6173
3,3,3,0,9,0,9,6173
4,4,4,0,13,0,13,6173
5,5,1,2,14,2,16,6173
6,6,1,1,15,3,18,6173
7,7,2,1,17,4,21,6173
8,8,1,1,18,5,23,6173
9,9,1,0,19,5,24,6173
10,10,0,1,19,6,25,6173
11,11,0,1,19,7,26,6173
12,12,0,2,19,9,28,6173
13,13,0,1,19,10,29,6173
14,14,0,1,19,11,30,6173
15,15,0,0,19,11,30,6173
0,0,1,0,1,0,1,6174
1,1,0,0,1,0,1,6174
0,0,1,0,1,0,1,6175
1,1,1,0,2,0,2,6175
2,2,0,0,2,0,2,6175
0,0,1,0,1,0,1,6176
1,1,0,0,1,0,1,6176
0,0,1,0,1,0,1,6177
1,1,0,0,1,0,1,6177
0,0,1,0,1,0,1,6178
1,1,1,0,2,0,2,6178
2,2,0,2,2,2,4,6178
3,3,0,1,2,3,5,6178
4,4,0,0,2,3,5,6178
0,0,1,0,1,0,1,6179
1,1,0,0,1,0,1,6179
0,0,1,0,1,0,1,6180
1,1,1,0,2,0,2,6180
2,2,1,1,3,1,4,6180
3,3,3,1,6,2,8,6180
4,4,3,3,9,5,14,6180
5,5,4,2,13,7,20,6180
6,6,3,2,16,9,25,6180
7,7,1,1,17,10,27,6180
8,8,1,0,18,10,28,6180
9,9,1,0,19,10,29,6180
10,10,0,0,19,10,29,6180
0,0,1,0,1,0,1,6181
1,1,1,0,2,0,2,6181
2,2,1,0,3,0,3,6181
3,3,0,0,3,0,3,6181
0,0,1,0,1,0,1,6182
1,1,0,0,1,0,1,6182
0,0,1,0,1,0,1,6183
1,1,2,0,3,0,3,6183
2,2,0,0,3,0,3,6183
0,0,1,0,1,0,1,6184
1,1,0,1,1,1,2,6184
2,2,0,1,1,2,3,6184
3,3,1,1,2,3,5,6184
4,4,1,2,3,5,8,6184
5,5,2,2,5,7,12,6184
6,6,1,1,6,8,14,6184
7,7,0,1,6,9,15,6184
8,8,0,0,6,9,15,6184
0,0,1,0,1,0,1,6185
1,1,0,0,1,0,1,6185
0,0,1,0,1,0,1,6186
1,1,1,0,2,0,2,6186
2,2,0,0,2,0,2,6186
0,0,1,0,1,0,1,6187
1,1,1,0,2,0,2,6187
2,2,0,0,2,0,2,6187
0,0,1,0,1,0,1,6188
1,1,1,0,2,0,2,6188
2,2,2,0,4,0,4,6188
3,3,3,1,7,1,8,6188
4,4,3,0,10,1,11,6188
5,5,0,0,10,1,11,6188
0,0,1,0,1,0,1,6189
1,1,1,0,2,0,2,6189
2,2,1,0,3,0,3,6189
3,3,2,0,5,0,5,6189
4,4,2,0,7,0,7,6189
5,5,3,0,10,0,10,6189
6,6,2,1,12,1,13,6189
7,7,1,1,13,2,15,6189
8,8,1,0,14,2,16,6189
9,9,0,1,14,3,17,6189
10,10,0,2,14,5,19,6189
11,11,0,0,14,5,19,6189
0,0,1,0,1,0,1,6190
1,1,0,0,1,0,1,6190
0,0,1,0,1,0,1,6191
1,1,0,2,1,2,3,6191
2,2,0,2,1,4,5,6191
3,3,1,0,2,4,6,6191
4,4,1,0,3,4,7,6191
5,5,0,0,3,4,7,6191
0,0,1,0,1,0,1,6192
1,1,0,0,1,0,1,6192
0,0,1,0,1,0,1,6193
1,1,0,0,1,0,1,6193
0,0,1,0,1,0,1,6194
1,1,1,0,2,0,2,6194
2,2,0,0,2,0,2,6194
0,0,1,0,1,0,1,6195
1,1,1,0,2,0,2,6195
2,2,0,0,2,0,2,6195
0,0,1,0,1,0,1,6196
1,1,2,0,3,0,3,6196
2,2,0,2,3,2,5,6196
3,3,0,1,3,3,6,6196
4,4,0,2,3,5,8,6196
5,5,1,0,4,5,9,6196
6,6,1,0,5,5,10,6196
7,7,1,0,6,5,11,6196
8,8,0,0,6,5,11,6196
0,0,1,0,1,0,1,6197
1,1,0,0,1,0,1,6197
0,0,1,0,1,0,1,6198
1,1,0,0,1,0,1,6198
0,0,1,0,1,0,1,6199
1,1,1,0,2,0,2,6199
2,2,1,0,3,0,3,6199
3,3,0,0,3,0,3,6199
0,0,1,0,1,0,1,6200
1,1,0,0,1,0,1,6200
0,0,1,0,1,0,1,6201
1,1,0,0,1,0,1,6201
0,0,1,0,1,0,1,6202
1,1,1,0,2,0,2,6202
2,2,0,0,2,0,2,6202
0,0,1,0,1,0,1,6203
1,1,0,0,1,0,1,6203
0,0,1,0,1,0,1,6204
1,1,0,1,1,1,2,6204
2,2,0,2,1,3,4,6204
3,3,1,2,2,5,7,6204
4,4,1,1,3,6,9,6204
5,5,2,0,5,6,11,6204
6,6,1,0,6,6,12,6204
7,7,1,0,7,6,13,6204
8,8,1,0,8,6,14,6204
9,9,0,0,8,6,14,6204
0,0,1,0,1,0,1,6205
1,1,1,0,2,0,2,6205
2,2,2,0,4,0,4,6205
3,3,2,0,6,0,6,6205
4,4,0,1,6,1,7,6205
5,5,0,0,6,1,7,6205
0,0,1,0,1,0,1,6206
1,1,0,1,1,1,2,6206
2,2,0,0,1,1,2,6206
0,0,1,0,1,0,1,6207
1,1,0,0,1,0,1,6207
0,0,1,0,1,0,1,6208
1,1,1,1,2,1,3,6208
2,2,2,0,4,1,5,6208
3,3,1,0,5,1,6,6208
4,4,0,0,5,1,6,6208
0,0,1,0,1,0,1,6209
1,1,2,0,3,0,3,6209
2,2,0,0,3,0,3,6209
0,0,1,0,1,0,1,6210
1,1,1,0,2,0,2,6210
2,2,2,0,4,0,4,6210
3,3,5,1,9,1,10,6210
4,4,3,1,12,2,14,6210
5,5,4,1,16,3,19,6210
6,6,4,0,20,3,23,6210
7,7,2,1,22,4,26,6210
8,8,0,0,22,4,26,6210
0,0,1,0,1,0,1,6211
1,1,0,0,1,0,1,6211
0,0,1,0,1,0,1,6212
1,1,3,0,4,0,4,6212
2,2,3,0,7,0,7,6212
3,3,2,0,9,0,9,6212
4,4,1,0,10,0,10,6212
5,5,1,0,11,0,11,6212
6,6,0,0,11,0,11,6212
0,0,1,0,1,0,1,6213
1,1,2,0,3,0,3,6213
2,2,2,0,5,0,5,6213
3,3,3,1,8,1,9,6213
4,4,1,1,9,2,11,6213
5,5,1,1,10,3,13,6213
6,6,2,1,12,4,16,6213
7,7,2,1,14,5,19,6213
8,8,2,1,16,6,22,6213
9,9,1,0,17,6,23,6213
10,10,1,1,18,7,25,6213
11,11,0,0,18,7,25,6213
0,0,1,0,1,0,1,6214
1,1,1,0,2,0,2,6214
2,2,0,0,2,0,2,6214
0,0,1,0,1,0,1,6215
1,1,0,0,1,0,1,6215
0,0,1,0,1,0,1,6216
1,1,0,0,1,0,1,6216
0,0,1,0,1,0,1,6217
1,1,1,1,2,1,3,6217
2,2,2,1,4,2,6,6217
3,3,2,0,6,2,8,6217
4,4,1,0,7,2,9,6217
5,5,1,0,8,2,10,6217
6,6,0,1,8,3,11,6217
7,7,0,0,8,3,11,6217
0,0,1,0,1,0,1,6218
1,1,1,0,2,0,2,6218
2,2,0,0,2,0,2,6218
0,0,1,0,1,0,1,6219
1,1,1,0,2,0,2,6219
2,2,0,0,2,0,2,6219
0,0,1,0,1,0,1,6220
1,1,1,0,2,0,2,6220
2,2,0,0,2,0,2,6220
0,0,1,0,1,0,1,6221
1,1,1,0,2,0,2,6221
2,2,0,0,2,0,2,6221
0,0,1,0,1,0,1,6222
1,1,2,0,3,0,3,6222
2,2,2,0,5,0,5,6222
3,3,2,0,7,0,7,6222
4,4,1,1,8,1,9,6222
5,5,0,0,8,1,9,6222
0,0,1,0,1,0,1,6223
1,1,2,0,3,0,3,6223
2,2,0,1,3,1,4,6223
3,3,0,1,3,2,5,6223
4,4,0,0,3,2,5,6223
0,0,1,0,1,0,1,6224
1,1,1,0,2,0,2,6224
2,2,2,2,4,2,6,6224
3,3,5,2,9,4,13,6224
4,4,3,2,12,6,18,6224
5,5,2,3,14,9,23,6224
6,6,2,2,16,11,27,6224
7,7,1,2,17,13,30,6224
8,8,1,2,18,15,33,6224
9,9,2,1,20,16,36,6224
10,10,2,1,22,17,39,6224
11,11,4,1,26,18,44,6224
12,12,3,2,29,20,49,6224
13,13,0,1,29,21,50,6224
14,14,1,0,30,21,51,6224
15,15,0,1,30,22,52,6224
16,16,0,0,30,22,52,6224
0,0,1,0,1,0,1,6225
1,1,0,0,1,0,1,6225
0,0,1,0,1,0,1,6226
1,1,1,0,2,0,2,6226
2,2,1,0,3,0,3,6226
3,3,0,0,3,0,3,6226
0,0,1,0,1,0,1,6227
1,1,1,0,2,0,2,6227
2,2,1,0,3,0,3,6227
3,3,0,0,3,0,3,6227
0,0,1,0,1,0,1,6228
1,1,0,0,1,0,1,6228
0,0,1,0,1,0,1,6229
1,1,3,0,4,0,4,6229
2,2,2,2,6,2,8,6229
3,3,0,3,6,5,11,6229
4,4,1,1,7,6,13,6229
5,5,0,1,7,7,14,6229
6,6,0,3,7,10,17,6229
7,7,1,2,8,12,20,6229
8,8,4,1,12,13,25,6229
9,9,3,2,15,15,30,6229
10,10,3,3,18,18,36,6229
11,11,2,4,20,22,42,6229
12,12,4,5,24,27,51,6229
13,13,5,6,29,33,62,6229
14,14,5,6,34,39,73,6229
15,15,4,6,38,45,83,6229
16,16,2,5,40,50,90,6229
17,17,3,3,43,53,96,6229
18,18,2,3,45,56,101,6229
19,19,0,4,45,60,105,6229
20,20,0,5,45,65,110,6229
21,21,1,6,46,71,117,6229
22,22,0,2,46,73,119,6229
23,23,1,0,47,73,120,6229
24,24,0,0,47,73,120,6229
0,0,1,0,1,0,1,6230
1,1,2,0,3,0,3,6230
2,2,2,0,5,0,5,6230
3,3,1,0,6,0,6,6230
4,4,0,0,6,0,6,6230
0,0,1,0,1,0,1,6231
1,1,1,0,2,0,2,6231
2,2,1,0,3,0,3,6231
3,3,2,0,5,0,5,6231
4,4,0,0,5,0,5,6231
0,0,1,0,1,0,1,6232
1,1,2,0,3,0,3,6232
2,2,1,1,4,1,5,6232
3,3,0,1,4,2,6,6232
4,4,1,1,5,3,8,6232
5,5,0,2,5,5,10,6232
6,6,0,1,5,6,11,6232
7,7,0,1,5,7,12,6232
8,8,0,1,5,8,13,6232
9,9,1,1,6,9,15,6232
10,10,0,0,6,9,15,6232
0,0,1,0,1,0,1,6233
1,1,0,0,1,0,1,6233
0,0,1,0,1,0,1,6234
1,1,0,0,1,0,1,6234
0,0,1,0,1,0,1,6235
1,1,1,0,2,0,2,6235
2,2,1,0,3,0,3,6235
3,3,0,1,3,1,4,6235
4,4,0,0,3,1,4,6235
0,0,1,0,1,0,1,6236
1,1,1,0,2,0,2,6236
2,2,2,1,4,1,5,6236
3,3,3,1,7,2,9,6236
4,4,1,2,8,4,12,6236
5,5,1,2,9,6,15,6236
6,6,0,1,9,7,16,6236
7,7,0,0,9,7,16,6236
0,0,1,0,1,0,1,6237
1,1,1,0,2,0,2,6237
2,2,2,0,4,0,4,6237
3,3,0,1,4,1,5,6237
4,4,1,0,5,1,6,6237
5,5,0,0,5,1,6,6237
0,0,1,0,1,0,1,6238
1,1,0,0,1,0,1,6238
0,0,1,0,1,0,1,6239
1,1,0,0,1,0,1,6239
0,0,1,0,1,0,1,6240
1,1,0,0,1,0,1,6240
0,0,1,0,1,0,1,6241
1,1,1,0,2,0,2,6241
2,2,1,0,3,0,3,6241
3,3,0,0,3,0,3,6241
0,0,1,0,1,0,1,6242
1,1,0,0,1,0,1,6242
0,0,1,0,1,0,1,6243
1,1,1,1,2,1,3,6243
2,2,0,0,2,1,3,6243
0,0,1,0,1,0,1,6244
1,1,1,0,2,0,2,6244
2,2,3,0,5,0,5,6244
3,3,4,0,9,0,9,6244
4,4,4,1,13,1,14,6244
5,5,0,2,13,3,16,6244
6,6,0,1,13,4,17,6244
7,7,0,0,13,4,17,6244
0,0,1,0,1,0,1,6245
1,1,1,0,2,0,2,6245
2,2,1,1,3,1,4,6245
3,3,0,1,3,2,5,6245
4,4,0,1,3,3,6,6245
5,5,0,1,3,4,7,6245
6,6,0,0,3,4,7,6245
0,0,1,0,1,0,1,6246
1,1,1,0,2,0,2,6246
2,2,3,0,5,0,5,6246
3,3,2,1,7,1,8,6246
4,4,1,1,8,2,10,6246
5,5,1,1,9,3,12,6246
6,6,0,1,9,4,13,6246
7,7,0,1,9,5,14,6246
8,8,0,0,9,5,14,6246
0,0,1,0,1,0,1,6247
1,1,0,0,1,0,1,6247
0,0,1,0,1,0,1,6248
1,1,0,0,1,0,1,6248
0,0,1,0,1,0,1,6249
1,1,1,0,2,0,2,6249
2,2,0,0,2,0,2,6249
0,0,1,0,1,0,1,6250
1,1,1,1,2,1,3,6250
2,2,1,0,3,1,4,6250
3,3,0,1,3,2,5,6250
4,4,0,2,3,4,7,6250
5,5,0,1,3,5,8,6250
6,6,0,0,3,5,8,6250
0,0,1,0,1,0,1,6251
1,1,0,0,1,0,1,6251
0,0,1,0,1,0,1,6252
1,1,0,0,1,0,1,6252
0,0,1,0,1,0,1,6253
1,1,1,0,2,0,2,6253
2,2,1,0,3,0,3,6253
3,3,1,0,4,0,4,6253
4,4,0,0,4,0,4,6253
0,0,1,0,1,0,1,6254
1,1,0,1,1,1,2,6254
2,2,0,0,1,1,2,6254
0,0,1,0,1,0,1,6255
1,1,0,0,1,0,1,6255
0,0,1,0,1,0,1,6256
1,1,0,0,1,0,1,6256
0,0,1,0,1,0,1,6257
1,1,1,0,2,0,2,6257
2,2,1,1,3,1,4,6257
3,3,0,1,3,2,5,6257
4,4,0,0,3,2,5,6257
0,0,1,0,1,0,1,6258
1,1,0,0,1,0,1,6258
0,0,1,0,1,0,1,6259
1,1,0,0,1,0,1,6259
0,0,1,0,1,0,1,6260
1,1,0,0,1,0,1,6260
0,0,1,0,1,0,1,6261
1,1,1,0,2,0,2,6261
2,2,1,0,3,0,3,6261
3,3,0,0,3,0,3,6261
0,0,1,0,1,0,1,6262
1,1,0,0,1,0,1,6262
0,0,1,0,1,0,1,6263
1,1,0,0,1,0,1,6263
0,0,1,0,1,0,1,6264
1,1,1,0,2,0,2,6264
2,2,2,0,4,0,4,6264
3,3,0,0,4,0,4,6264
0,0,1,0,1,0,1,6265
1,1,0,0,1,0,1,6265
0,0,1,0,1,0,1,6266
1,1,0,0,1,0,1,6266
0,0,1,0,1,0,1,6267
1,1,0,0,1,0,1,6267
0,0,1,0,1,0,1,6268
1,1,0,0,1,0,1,6268
0,0,1,0,1,0,1,6269
1,1,0,0,1,0,1,6269
0,0,1,0,1,0,1,6270
1,1,2,0,3,0,3,6270
2,2,0,0,3,0,3,6270
0,0,1,0,1,0,1,6271
1,1,1,0,2,0,2,6271
2,2,1,0,3,0,3,6271
3,3,1,0,4,0,4,6271
4,4,1,1,5,1,6,6271
5,5,1,1,6,2,8,6271
6,6,1,1,7,3,10,6271
7,7,2,1,9,4,13,6271
8,8,3,0,12,4,16,6271
9,9,3,0,15,4,19,6271
10,10,3,1,18,5,23,6271
11,11,0,0,18,5,23,6271
0,0,1,0,1,0,1,6272
1,1,1,0,2,0,2,6272
2,2,0,1,2,1,3,6272
3,3,1,0,3,1,4,6272
4,4,0,0,3,1,4,6272
0,0,1,0,1,0,1,6273
1,1,1,0,2,0,2,6273
2,2,1,0,3,0,3,6273
3,3,0,0,3,0,3,6273
0,0,1,0,1,0,1,6274
1,1,0,0,1,0,1,6274
0,0,1,0,1,0,1,6275
1,1,1,0,2,0,2,6275
2,2,1,0,3,0,3,6275
3,3,0,0,3,0,3,6275
0,0,1,0,1,0,1,6276
1,1,1,0,2,0,2,6276
2,2,0,0,2,0,2,6276
0,0,1,0,1,0,1,6277
1,1,2,0,3,0,3,6277
2,2,1,0,4,0,4,6277
3,3,0,0,4,0,4,6277
0,0,1,0,1,0,1,6278
1,1,0,0,1,0,1,6278
0,0,1,0,1,0,1,6279
1,1,0,0,1,0,1,6279
0,0,1,0,1,0,1,6280
1,1,0,0,1,0,1,6280
0,0,1,0,1,0,1,6281
1,1,0,1,1,1,2,6281
2,2,0,0,1,1,2,6281
0,0,1,0,1,0,1,6282
1,1,0,0,1,0,1,6282
0,0,1,0,1,0,1,6283
1,1,1,0,2,0,2,6283
2,2,1,0,3,0,3,6283
3,3,0,0,3,0,3,6283
0,0,1,0,1,0,1,6284
1,1,0,0,1,0,1,6284
0,0,1,0,1,0,1,6285
1,1,0,0,1,0,1,6285
0,0,1,0,1,0,1,6286
1,1,0,0,1,0,1,6286
0,0,1,0,1,0,1,6287
1,1,1,0,2,0,2,6287
2,2,0,0,2,0,2,6287
0,0,1,0,1,0,1,6288
1,1,1,1,2,1,3,6288
2,2,0,1,2,2,4,6288
3,3,0,2,2,4,6,6288
4,4,2,0,4,4,8,6288
5,5,2,0,6,4,10,6288
6,6,0,0,6,4,10,6288
0,0,1,0,1,0,1,6289
1,1,1,1,2,1,3,6289
2,2,1,2,3,3,6,6289
3,3,2,3,5,6,11,6289
4,4,3,4,8,10,18,6289
5,5,3,2,11,12,23,6289
6,6,4,4,15,16,31,6289
7,7,2,5,17,21,38,6289
8,8,3,4,20,25,45,6289
9,9,4,2,24,27,51,6289
10,10,2,4,26,31,57,6289
11,11,2,1,28,32,60,6289
12,12,4,1,32,33,65,6289
13,13,5,3,37,36,73,6289
14,14,5,2,42,38,80,6289
15,15,2,6,44,44,88,6289
16,16,1,5,45,49,94,6289
17,17,2,4,47,53,100,6289
18,18,1,0,48,53,101,6289
19,19,0,1,48,54,102,6289
20,20,0,0,48,54,102,6289
0,0,1,0,1,0,1,6290
1,1,1,1,2,1,3,6290
2,2,1,2,3,3,6,6290
3,3,2,3,5,6,11,6290
4,4,1,1,6,7,13,6290
5,5,0,2,6,9,15,6290
6,6,0,3,6,12,18,6290
7,7,1,2,7,14,21,6290
8,8,2,1,9,15,24,6290
9,9,0,1,9,16,25,6290
10,10,1,0,10,16,26,6290
11,11,0,0,10,16,26,6290
0,0,1,0,1,0,1,6291
1,1,1,0,2,0,2,6291
2,2,0,0,2,0,2,6291
0,0,1,0,1,0,1,6292
1,1,0,0,1,0,1,6292
0,0,1,0,1,0,1,6293
1,1,0,1,1,1,2,6293
2,2,1,0,2,1,3,6293
3,3,0,0,2,1,3,6293
0,0,1,0,1,0,1,6294
1,1,0,0,1,0,1,6294
0,0,1,0,1,0,1,6295
1,1,0,0,1,0,1,6295
0,0,1,0,1,0,1,6296
1,1,1,1,2,1,3,6296
2,2,0,2,2,3,5,6296
3,3,1,2,3,5,8,6296
4,4,1,0,4,5,9,6296
5,5,1,0,5,5,10,6296
6,6,0,1,5,6,11,6296
7,7,1,0,6,6,12,6296
8,8,1,1,7,7,14,6296
9,9,0,3,7,10,17,6296
10,10,1,0,8,10,18,6296
11,11,1,0,9,10,19,6296
12,12,1,1,10,11,21,6296
13,13,1,2,11,13,24,6296
14,14,5,1,16,14,30,6296
15,15,5,2,21,16,37,6296
16,16,1,2,22,18,40,6296
17,17,3,2,25,20,45,6296
18,18,2,2,27,22,49,6296
19,19,3,3,30,25,55,6296
20,20,2,0,32,25,57,6296
21,21,2,0,34,25,59,6296
22,22,7,2,41,27,68,6296
23,23,4,5,45,32,77,6296
24,24,3,1,48,33,81,6296
25,25,3,0,51,33,84,6296
26,26,2,0,53,33,86,6296
27,27,2,0,55,33,88,6296
28,28,0,0,55,33,88,6296
0,0,1,0,1,0,1,6297
1,1,2,1,3,1,4,6297
2,2,3,2,6,3,9,6297
3,3,1,2,7,5,12,6297
4,4,0,2,7,7,14,6297
5,5,0,1,7,8,15,6297
6,6,0,1,7,9,16,6297
7,7,0,0,7,9,16,6297
0,0,1,0,1,0,1,6298
1,1,1,0,2,0,2,6298
2,2,2,0,4,0,4,6298
3,3,0,1,4,1,5,6298
4,4,0,0,4,1,5,6298
0,0,1,0,1,0,1,6299
1,1,0,0,1,0,1,6299
0,0,1,0,1,0,1,6300
1,1,4,0,5,0,5,6300
2,2,3,0,8,0,8,6300
3,3,3,1,11,1,12,6300
4,4,1,0,12,1,13,6300
5,5,2,0,14,1,15,6300
6,6,2,2,16,3,19,6300
7,7,1,3,17,6,23,6300
8,8,2,5,19,11,30,6300
9,9,1,5,20,16,36,6300
10,10,0,5,20,21,41,6300
11,11,0,2,20,23,43,6300
12,12,1,1,21,24,45,6300
13,13,2,0,23,24,47,6300
14,14,1,0,24,24,48,6300
15,15,0,0,24,24,48,6300
0,0,1,0,1,0,1,6301
1,1,0,1,1,1,2,6301
2,2,0,1,1,2,3,6301
3,3,1,1,2,3,5,6301
4,4,0,0,2,3,5,6301
0,0,1,0,1,0,1,6302
1,1,1,0,2,0,2,6302
2,2,0,0,2,0,2,6302
0,0,1,0,1,0,1,6303
1,1,0,0,1,0,1,6303
0,0,1,0,1,0,1,6304
1,1,0,0,1,0,1,6304
0,0,1,0,1,0,1,6305
1,1,0,0,1,0,1,6305
0,0,1,0,1,0,1,6306
1,1,0,0,1,0,1,6306
0,0,1,0,1,0,1,6307
1,1,0,0,1,0,1,6307
0,0,1,0,1,0,1,6308
1,1,0,0,1,0,1,6308
0,0,1,0,1,0,1,6309
1,1,3,0,4,0,4,6309
2,2,1,1,5,1,6,6309
3,3,1,2,6,3,9,6309
4,4,1,3,7,6,13,6309
5,5,0,2,7,8,15,6309
6,6,0,0,7,8,15,6309
0,0,1,0,1,0,1,6310
1,1,1,1,2,1,3,6310
2,2,1,1,3,2,5,6310
3,3,0,1,3,3,6,6310
4,4,0,0,3,3,6,6310
0,0,1,0,1,0,1,6311
1,1,2,0,3,0,3,6311
2,2,1,0,4,0,4,6311
3,3,1,0,5,0,5,6311
4,4,0,0,5,0,5,6311
0,0,1,0,1,0,1,6312
1,1,2,1,3,1,4,6312
2,2,2,1,5,2,7,6312
3,3,2,3,7,5,12,6312
4,4,2,3,9,8,17,6312
5,5,3,4,12,12,24,6312
6,6,3,1,15,13,28,6312
7,7,1,0,16,13,29,6312
8,8,0,0,16,13,29,6312
0,0,1,0,1,0,1,6313
1,1,0,0,1,0,1,6313
0,0,1,0,1,0,1,6314
1,1,0,0,1,0,1,6314
0,0,1,0,1,0,1,6315
1,1,2,1,3,1,4,6315
2,2,2,0,5,1,6,6315
3,3,4,0,9,1,10,6315
4,4,5,0,14,1,15,6315
5,5,4,0,18,1,19,6315
6,6,5,1,23,2,25,6315
7,7,4,2,27,4,31,6315
8,8,5,0,32,4,36,6315
9,9,4,0,36,4,40,6315
10,10,1,1,37,5,42,6315
11,11,0,1,37,6,43,6315
12,12,0,1,37,7,44,6315
13,13,0,0,37,7,44,6315
0,0,1,0,1,0,1,6316
1,1,1,0,2,0,2,6316
2,2,1,0,3,0,3,6316
3,3,0,0,3,0,3,6316
0,0,1,0,1,0,1,6317
1,1,1,0,2,0,2,6317
2,2,0,1,2,1,3,6317
3,3,0,0,2,1,3,6317
0,0,1,0,1,0,1,6318
1,1,0,0,1,0,1,6318
0,0,1,0,1,0,1,6319
1,1,0,0,1,0,1,6319
0,0,1,0,1,0,1,6320
1,1,2,1,3,1,4,6320
2,2,2,0,5,1,6,6320
3,3,3,0,8,1,9,6320
4,4,1,0,9,1,10,6320
5,5,0,0,9,1,10,6320
0,0,1,0,1,0,1,6321
1,1,1,0,2,0,2,6321
2,2,1,0,3,0,3,6321
3,3,0,1,3,1,4,6321
4,4,0,0,3,1,4,6321
0,0,1,0,1,0,1,6322
1,1,2,0,3,0,3,6322
2,2,0,1,3,1,4,6322
3,3,0,0,3,1,4,6322
0,0,1,0,1,0,1,6323
1,1,2,0,3,0,3,6323
2,2,3,0,6,0,6,6323
3,3,4,0,10,0,10,6323
4,4,2,0,12,0,12,6323
5,5,1,0,13,0,13,6323
6,6,1,1,14,1,15,6323
7,7,2,1,16,2,18,6323
8,8,4,0,20,2,22,6323
9,9,2,0,22,2,24,6323
10,10,2,0,24,2,26,6323
11,11,2,0,26,2,28,6323
12,12,0,0,26,2,28,6323
0,0,1,0,1,0,1,6324
1,1,1,0,2,0,2,6324
2,2,0,0,2,0,2,6324
0,0,1,0,1,0,1,6325
1,1,2,0,3,0,3,6325
2,2,1,0,4,0,4,6325
3,3,4,0,8,0,8,6325
4,4,5,1,13,1,14,6325
5,5,1,1,14,2,16,6325
6,6,1,0,15,2,17,6325
7,7,1,1,16,3,19,6325
8,8,0,1,16,4,20,6325
9,9,0,0,16,4,20,6325
0,0,1,0,1,0,1,6326
1,1,0,1,1,1,2,6326
2,2,0,0,1,1,2,6326
0,0,1,0,1,0,1,6327
1,1,0,1,1,1,2,6327
2,2,1,3,2,4,6,6327
3,3,0,3,2,7,9,6327
4,4,0,2,2,9,11,6327
5,5,0,1,2,10,12,6327
6,6,0,2,2,12,14,6327
7,7,0,3,2,15,17,6327
8,8,1,2,3,17,20,6327
9,9,0,0,3,17,20,6327
0,0,1,0,1,0,1,6328
1,1,0,0,1,0,1,6328
0,0,1,0,1,0,1,6329
1,1,0,0,1,0,1,6329
0,0,1,0,1,0,1,6330
1,1,1,0,2,0,2,6330
2,2,0,0,2,0,2,6330
0,0,1,0,1,0,1,6331
1,1,0,1,1,1,2,6331
2,2,1,0,2,1,3,6331
3,3,2,0,4,1,5,6331
4,4,2,1,6,2,8,6331
5,5,1,0,7,2,9,6331
6,6,0,0,7,2,9,6331
0,0,1,0,1,0,1,6332
1,1,1,0,2,0,2,6332
2,2,1,0,3,0,3,6332
3,3,0,0,3,0,3,6332
0,0,1,0,1,0,1,6333
1,1,1,0,2,0,2,6333
2,2,2,0,4,0,4,6333
3,3,1,1,5,1,6,6333
4,4,0,1,5,2,7,6333
5,5,1,0,6,2,8,6333
6,6,2,0,8,2,10,6333
7,7,1,0,9,2,11,6333
8,8,0,0,9,2,11,6333
0,0,1,0,1,0,1,6334
1,1,1,1,2,1,3,6334
2,2,1,0,3,1,4,6334
3,3,1,0,4,1,5,6334
4,4,1,0,5,1,6,6334
5,5,1,0,6,1,7,6334
6,6,0,1,6,2,8,6334
7,7,0,0,6,2,8,6334
0,0,1,0,1,0,1,6335
1,1,1,0,2,0,2,6335
2,2,1,1,3,1,4,6335
3,3,0,1,3,2,5,6335
4,4,0,1,3,3,6,6335
5,5,0,1,3,4,7,6335
6,6,0,0,3,4,7,6335
0,0,1,0,1,0,1,6336
1,1,0,0,1,0,1,6336
0,0,1,0,1,0,1,6337
1,1,0,0,1,0,1,6337
0,0,1,0,1,0,1,6338
1,1,1,0,2,0,2,6338
2,2,0,0,2,0,2,6338
0,0,1,0,1,0,1,6339
1,1,0,0,1,0,1,6339
0,0,1,0,1,0,1,6340
1,1,0,0,1,0,1,6340
0,0,1,0,1,0,1,6341
1,1,0,0,1,0,1,6341
0,0,1,0,1,0,1,6342
1,1,0,1,1,1,2,6342
2,2,1,1,2,2,4,6342
3,3,1,0,3,2,5,6342
4,4,1,0,4,2,6,6342
5,5,0,0,4,2,6,6342
0,0,1,0,1,0,1,6343
1,1,0,0,1,0,1,6343
0,0,1,0,1,0,1,6344
1,1,0,0,1,0,1,6344
0,0,1,0,1,0,1,6345
1,1,2,0,3,0,3,6345
2,2,3,0,6,0,6,6345
3,3,2,0,8,0,8,6345
4,4,2,0,10,0,10,6345
5,5,1,0,11,0,11,6345
6,6,1,0,12,0,12,6345
7,7,0,2,12,2,14,6345
8,8,0,2,12,4,16,6345
9,9,0,1,12,5,17,6345
10,10,0,1,12,6,18,6345
11,11,0,2,12,8,20,6345
12,12,0,3,12,11,23,6345
13,13,1,2,13,13,26,6345
14,14,0,1,13,14,27,6345
15,15,0,1,13,15,28,6345
16,16,0,1,13,16,29,6345
17,17,0,1,13,17,30,6345
18,18,0,1,13,18,31,6345
19,19,1,5,14,23,37,6345
20,20,3,3,17,26,43,6345
21,21,5,3,22,29,51,6345
22,22,3,4,25,33,58,6345
23,23,3,3,28,36,64,6345
24,24,2,6,30,42,72,6345
25,25,3,3,33,45,78,6345
26,26,1,3,34,48,82,6345
27,27,3,1,37,49,86,6345
28,28,2,2,39,51,90,6345
29,29,3,4,42,55,97,6345
30,30,6,4,48,59,107,6345
31,31,5,6,53,65,118,6345
32,32,6,8,59,73,132,6345
33,33,2,12,61,85,146,6345
34,34,3,6,64,91,155,6345
35,35,3,4,67,95,162,6345
36,36,5,5,72,100,172,6345
37,37,5,6,77,106,183,6345
38,38,5,4,82,110,192,6345
39,39,5,4,87,114,201,6345
40,40,8,1,95,115,210,6345
41,41,5,1,100,116,216,6345
42,42,4,2,104,118,222,6345
43,43,5,2,109,120,229,6345
44,44,3,5,112,125,237,6345
45,45,2,6,114,131,245,6345
46,46,2,8,116,139,255,6345
47,47,1,9,117,148,265,6345
48,48,1,6,118,154,272,6345
49,49,3,8,121,162,283,6345
50,50,3,4,124,166,290,6345
51,51,2,4,126,170,296,6345
52,52,1,3,127,173,300,6345
53,53,3,2,130,175,305,6345
54,54,3,2,133,177,310,6345
55,55,3,3,136,180,316,6345
56,56,3,3,139,183,322,6345
57,57,1,2,140,185,325,6345
58,58,2,1,142,186,328,6345
59,59,5,1,147,187,334,6345
60,60,4,7,151,194,345,6345
61,61,2,5,153,199,352,6345
62,62,5,4,158,203,361,6345
63,63,0,6,158,209,367,6345
64,64,1,5,159,214,373,6345
65,65,1,2,160,216,376,6345
66,66,1,3,161,219,380,6345
67,67,0,0,161,219,380,6345
0,0,1,0,1,0,1,6346
1,1,1,0,2,0,2,6346
2,2,0,0,2,0,2,6346
0,0,1,0,1,0,1,6347
1,1,0,0,1,0,1,6347
0,0,1,0,1,0,1,6348
1,1,0,0,1,0,1,6348
0,0,1,0,1,0,1,6349
1,1,0,0,1,0,1,6349
0,0,1,0,1,0,1,6350
1,1,1,0,2,0,2,6350
2,2,0,0,2,0,2,6350
0,0,1,0,1,0,1,6351
1,1,1,0,2,0,2,6351
2,2,1,0,3,0,3,6351
3,3,1,0,4,0,4,6351
4,4,0,0,4,0,4,6351
0,0,1,0,1,0,1,6352
1,1,0,0,1,0,1,6352
0,0,1,0,1,0,1,6353
1,1,1,0,2,0,2,6353
2,2,1,0,3,0,3,6353
3,3,0,0,3,0,3,6353
0,0,1,0,1,0,1,6354
1,1,2,0,3,0,3,6354
2,2,3,0,6,0,6,6354
3,3,4,0,10,0,10,6354
4,4,7,2,17,2,19,6354
5,5,4,2,21,4,25,6354
6,6,4,2,25,6,31,6354
7,7,1,1,26,7,33,6354
8,8,0,1,26,8,34,6354
9,9,0,1,26,9,35,6354
10,10,1,0,27,9,36,6354
11,11,0,1,27,10,37,6354
12,12,0,0,27,10,37,6354
0,0,1,0,1,0,1,6355
1,1,0,0,1,0,1,6355
0,0,1,0,1,0,1,6356
1,1,0,0,1,0,1,6356
0,0,1,0,1,0,1,6357
1,1,1,0,2,0,2,6357
2,2,0,0,2,0,2,6357
0,0,1,0,1,0,1,6358
1,1,1,0,2,0,2,6358
2,2,2,0,4,0,4,6358
3,3,1,0,5,0,5,6358
4,4,3,0,8,0,8,6358
5,5,4,1,12,1,13,6358
6,6,1,1,13,2,15,6358
7,7,0,1,13,3,16,6358
8,8,0,0,13,3,16,6358
0,0,1,0,1,0,1,6359
1,1,1,0,2,0,2,6359
2,2,2,0,4,0,4,6359
3,3,1,1,5,1,6,6359
4,4,0,0,5,1,6,6359
0,0,1,0,1,0,1,6360
1,1,1,0,2,0,2,6360
2,2,0,0,2,0,2,6360
0,0,1,0,1,0,1,6361
1,1,1,0,2,0,2,6361
2,2,1,0,3,0,3,6361
3,3,2,0,5,0,5,6361
4,4,1,0,6,0,6,6361
5,5,1,0,7,0,7,6361
6,6,0,0,7,0,7,6361
0,0,1,0,1,0,1,6362
1,1,1,0,2,0,2,6362
2,2,1,0,3,0,3,6362
3,3,0,0,3,0,3,6362
0,0,1,0,1,0,1,6363
1,1,0,0,1,0,1,6363
0,0,1,0,1,0,1,6364
1,1,1,0,2,0,2,6364
2,2,2,0,4,0,4,6364
3,3,1,0,5,0,5,6364
4,4,1,0,6,0,6,6364
5,5,0,0,6,0,6,6364
0,0,1,0,1,0,1,6365
1,1,0,0,1,0,1,6365
0,0,1,0,1,0,1,6366
1,1,1,0,2,0,2,6366
2,2,0,0,2,0,2,6366
0,0,1,0,1,0,1,6367
1,1,0,1,1,1,2,6367
2,2,0,0,1,1,2,6367
0,0,1,0,1,0,1,6368
1,1,2,0,3,0,3,6368
2,2,3,0,6,0,6,6368
3,3,1,0,7,0,7,6368
4,4,1,1,8,1,9,6368
5,5,2,1,10,2,12,6368
6,6,3,0,13,2,15,6368
7,7,0,1,13,3,16,6368
8,8,0,0,13,3,16,6368
0,0,1,0,1,0,1,6369
1,1,2,0,3,0,3,6369
2,2,0,1,3,1,4,6369
3,3,0,1,3,2,5,6369
4,4,0,1,3,3,6,6369
5,5,0,4,3,7,10,6369
6,6,0,2,3,9,12,6369
7,7,0,2,3,11,14,6369
8,8,1,0,4,11,15,6369
9,9,1,0,5,11,16,6369
10,10,1,0,6,11,17,6369
11,11,0,0,6,11,17,6369
0,0,1,0,1,0,1,6370
1,1,1,0,2,0,2,6370
2,2,3,0,5,0,5,6370
3,3,4,1,9,1,10,6370
4,4,5,3,14,4,18,6370
5,5,9,4,23,8,31,6370
6,6,5,1,28,9,37,6370
7,7,9,0,37,9,46,6370
8,8,4,1,41,10,51,6370
9,9,4,0,45,10,55,6370
10,10,0,2,45,12,57,6370
11,11,1,3,46,15,61,6370
12,12,0,1,46,16,62,6370
13,13,0,0,46,16,62,6370
0,0,1,0,1,0,1,6371
1,1,2,1,3,1,4,6371
2,2,2,3,5,4,9,6371
3,3,2,4,7,8,15,6371
4,4,1,2,8,10,18,6371
5,5,0,2,8,12,20,6371
6,6,1,1,9,13,22,6371
7,7,2,0,11,13,24,6371
8,8,3,0,14,13,27,6371
9,9,1,0,15,13,28,6371
10,10,0,1,15,14,29,6371
11,11,0,0,15,14,29,6371
0,0,1,0,1,0,1,6372
1,1,1,0,2,0,2,6372
2,2,0,0,2,0,2,6372
0,0,1,0,1,0,1,6373
1,1,1,0,2,0,2,6373
2,2,0,0,2,0,2,6373
0,0,1,0,1,0,1,6374
1,1,2,0,3,0,3,6374
2,2,1,0,4,0,4,6374
3,3,0,0,4,0,4,6374
0,0,1,0,1,0,1,6375
1,1,0,0,1,0,1,6375
0,0,1,0,1,0,1,6376
1,1,1,0,2,0,2,6376
2,2,1,0,3,0,3,6376
3,3,1,0,4,0,4,6376
4,4,0,0,4,0,4,6376
0,0,1,0,1,0,1,6377
1,1,0,0,1,0,1,6377
0,0,1,0,1,0,1,6378
1,1,0,1,1,1,2,6378
2,2,0,1,1,2,3,6378
3,3,1,1,2,3,5,6378
4,4,1,0,3,3,6,6378
5,5,0,0,3,3,6,6378
0,0,1,0,1,0,1,6379
1,1,0,0,1,0,1,6379
0,0,1,0,1,0,1,6380
1,1,0,0,1,0,1,6380
0,0,1,0,1,0,1,6381
1,1,2,0,3,0,3,6381
2,2,1,0,4,0,4,6381
3,3,0,0,4,0,4,6381
0,0,1,0,1,0,1,6382
1,1,0,0,1,0,1,6382
0,0,1,0,1,0,1,6383
1,1,0,1,1,1,2,6383
2,2,0,1,1,2,3,6383
3,3,0,0,1,2,3,6383
0,0,1,0,1,0,1,6384
1,1,0,0,1,0,1,6384
0,0,1,0,1,0,1,6385
1,1,0,0,1,0,1,6385
0,0,1,0,1,0,1,6386
1,1,0,1,1,1,2,6386
2,2,0,1,1,2,3,6386
3,3,0,1,1,3,4,6386
4,4,0,0,1,3,4,6386
0,0,1,0,1,0,1,6387
1,1,0,0,1,0,1,6387
0,0,1,0,1,0,1,6388
1,1,1,0,2,0,2,6388
2,2,1,0,3,0,3,6388
3,3,0,0,3,0,3,6388
0,0,1,0,1,0,1,6389
1,1,0,0,1,0,1,6389
0,0,1,0,1,0,1,6390
1,1,4,0,5,0,5,6390
2,2,4,0,9,0,9,6390
3,3,3,1,12,1,13,6390
4,4,5,2,17,3,20,6390
5,5,6,0,23,3,26,6390
6,6,3,0,26,3,29,6390
7,7,0,2,26,5,31,6390
8,8,0,0,26,5,31,6390
0,0,1,0,1,0,1,6391
1,1,1,0,2,0,2,6391
2,2,1,1,3,1,4,6391
3,3,1,2,4,3,7,6391
4,4,2,6,6,9,15,6391
5,5,1,8,7,17,24,6391
6,6,3,10,10,27,37,6391
7,7,9,9,19,36,55,6391
8,8,10,7,29,43,72,6391
9,9,9,5,38,48,86,6391
10,10,6,2,44,50,94,6391
11,11,5,3,49,53,102,6391
12,12,1,3,50,56,106,6391
13,13,1,7,51,63,114,6391
14,14,1,4,52,67,119,6391
15,15,0,1,52,68,120,6391
16,16,1,2,53,70,123,6391
17,17,0,1,53,71,124,6391
18,18,0,0,53,71,124,6391
0,0,1,0,1,0,1,6392
1,1,0,0,1,0,1,6392
0,0,1,0,1,0,1,6393
1,1,0,0,1,0,1,6393
0,0,1,0,1,0,1,6394
1,1,1,0,2,0,2,6394
2,2,0,0,2,0,2,6394
0,0,1,0,1,0,1,6395
1,1,0,0,1,0,1,6395
0,0,1,0,1,0,1,6396
1,1,0,0,1,0,1,6396
0,0,1,0,1,0,1,6397
1,1,0,0,1,0,1,6397
0,0,1,0,1,0,1,6398
1,1,1,0,2,0,2,6398
2,2,0,0,2,0,2,6398
0,0,1,0,1,0,1,6399
1,1,1,0,2,0,2,6399
2,2,1,0,3,0,3,6399
3,3,2,1,5,1,6,6399
4,4,1,1,6,2,8,6399
5,5,0,1,6,3,9,6399
6,6,0,0,6,3,9,6399
0,0,1,0,1,0,1,6400
1,1,0,1,1,1,2,6400
2,2,0,0,1,1,2,6400
0,0,1,0,1,0,1,6401
1,1,1,0,2,0,2,6401
2,2,0,0,2,0,2,6401
0,0,1,0,1,0,1,6402
1,1,4,0,5,0,5,6402
2,2,2,0,7,0,7,6402
3,3,2,0,9,0,9,6402
4,4,0,0,9,0,9,6402
0,0,1,0,1,0,1,6403
1,1,1,0,2,0,2,6403
2,2,0,0,2,0,2,6403
0,0,1,0,1,0,1,6404
1,1,0,1,1,1,2,6404
2,2,0,2,1,3,4,6404
3,3,0,2,1,5,6,6404
4,4,0,1,1,6,7,6404
5,5,0,0,1,6,7,6404
0,0,1,0,1,0,1,6405
1,1,0,0,1,0,1,6405
0,0,1,0,1,0,1,6406
1,1,0,1,1,1,2,6406
2,2,0,0,1,1,2,6406
0,0,1,0,1,0,1,6407
1,1,1,0,2,0,2,6407
2,2,1,0,3,0,3,6407
3,3,0,0,3,0,3,6407
0,0,1,0,1,0,1,6408
1,1,0,0,1,0,1,6408
0,0,1,0,1,0,1,6409
1,1,2,1,3,1,4,6409
2,2,1,5,4,6,10,6409
3,3,0,3,4,9,13,6409
4,4,0,3,4,12,16,6409
5,5,0,3,4,15,19,6409
6,6,0,0,4,15,19,6409
0,0,1,0,1,0,1,6410
1,1,0,0,1,0,1,6410
0,0,1,0,1,0,1,6411
1,1,2,0,3,0,3,6411
2,2,0,1,3,1,4,6411
3,3,0,1,3,2,5,6411
4,4,0,0,3,2,5,6411
0,0,1,0,1,0,1,6412
1,1,1,1,2,1,3,6412
2,2,1,3,3,4,7,6412
3,3,1,1,4,5,9,6412
4,4,0,1,4,6,10,6412
5,5,0,0,4,6,10,6412
0,0,1,0,1,0,1,6413
1,1,0,0,1,0,1,6413
0,0,1,0,1,0,1,6414
1,1,0,0,1,0,1,6414
0,0,1,0,1,0,1,6415
1,1,0,0,1,0,1,6415
0,0,1,0,1,0,1,6416
1,1,1,0,2,0,2,6416
2,2,1,2,3,2,5,6416
3,3,0,0,3,2,5,6416
0,0,1,0,1,0,1,6417
1,1,0,0,1,0,1,6417
0,0,1,0,1,0,1,6418
1,1,0,0,1,0,1,6418
0,0,1,0,1,0,1,6419
1,1,2,0,3,0,3,6419
2,2,1,0,4,0,4,6419
3,3,0,0,4,0,4,6419
0,0,1,0,1,0,1,6420
1,1,0,0,1,0,1,6420
0,0,1,0,1,0,1,6421
1,1,1,0,2,0,2,6421
2,2,1,0,3,0,3,6421
3,3,1,0,4,0,4,6421
4,4,0,0,4,0,4,6421
0,0,1,0,1,0,1,6422
1,1,1,1,2,1,3,6422
2,2,1,4,3,5,8,6422
3,3,2,2,5,7,12,6422
4,4,1,1,6,8,14,6422
5,5,1,3,7,11,18,6422
6,6,1,0,8,11,19,6422
7,7,1,0,9,11,20,6422
8,8,1,1,10,12,22,6422
9,9,2,1,12,13,25,6422
10,10,2,0,14,13,27,6422
11,11,1,0,15,13,28,6422
12,12,0,0,15,13,28,6422
0,0,1,0,1,0,1,6423
1,1,0,1,1,1,2,6423
2,2,0,1,1,2,3,6423
3,3,1,1,2,3,5,6423
4,4,1,1,3,4,7,6423
5,5,0,1,3,5,8,6423
6,6,0,0,3,5,8,6423
0,0,1,0,1,0,1,6424
1,1,0,0,1,0,1,6424
0,0,1,0,1,0,1,6425
1,1,1,0,2,0,2,6425
2,2,1,0,3,0,3,6425
3,3,0,0,3,0,3,6425
0,0,1,0,1,0,1,6426
1,1,0,0,1,0,1,6426
0,0,1,0,1,0,1,6427
1,1,1,0,2,0,2,6427
2,2,1,0,3,0,3,6427
3,3,0,0,3,0,3,6427
0,0,1,0,1,0,1,6428
1,1,1,0,2,0,2,6428
2,2,1,1,3,1,4,6428
3,3,2,0,5,1,6,6428
4,4,2,0,7,1,8,6428
5,5,3,3,10,4,14,6428
6,6,5,4,15,8,23,6428
7,7,6,4,21,12,33,6428
8,8,7,6,28,18,46,6428
9,9,6,9,34,27,61,6428
10,10,3,8,37,35,72,6428
11,11,4,3,41,38,79,6428
12,12,3,1,44,39,83,6428
13,13,1,2,45,41,86,6428
14,14,1,3,46,44,90,6428
15,15,0,2,46,46,92,6428
16,16,0,3,46,49,95,6428
17,17,2,4,48,53,101,6428
18,18,5,2,53,55,108,6428
19,19,4,3,57,58,115,6428
20,20,2,3,59,61,120,6428
21,21,2,5,61,66,127,6428
22,22,1,4,62,70,132,6428
23,23,2,1,64,71,135,6428
24,24,1,2,65,73,138,6428
25,25,0,1,65,74,139,6428
26,26,0,1,65,75,140,6428
27,27,0,0,65,75,140,6428
0,0,1,0,1,0,1,6429
1,1,2,0,3,0,3,6429
2,2,4,0,7,0,7,6429
3,3,3,0,10,0,10,6429
4,4,2,1,12,1,13,6429
5,5,1,0,13,1,14,6429
6,6,0,0,13,1,14,6429
0,0,1,0,1,0,1,6430
1,1,1,0,2,0,2,6430
2,2,0,0,2,0,2,6430
0,0,1,0,1,0,1,6431
1,1,0,0,1,0,1,6431
0,0,1,0,1,0,1,6432
1,1,1,0,2,0,2,6432
2,2,1,0,3,0,3,6432
3,3,1,0,4,0,4,6432
4,4,2,0,6,0,6,6432
5,5,1,0,7,0,7,6432
6,6,3,1,10,1,11,6432
7,7,1,0,11,1,12,6432
8,8,2,0,13,1,14,6432
9,9,3,0,16,1,17,6432
10,10,3,2,19,3,22,6432
11,11,1,1,20,4,24,6432
12,12,1,2,21,6,27,6432
13,13,3,1,24,7,31,6432
14,14,3,2,27,9,36,6432
15,15,5,0,32,9,41,6432
16,16,5,0,37,9,46,6432
17,17,7,1,44,10,54,6432
18,18,3,3,47,13,60,6432
19,19,1,5,48,18,66,6432
20,20,3,2,51,20,71,6432
21,21,2,2,53,22,75,6432
22,22,2,1,55,23,78,6432
23,23,3,0,58,23,81,6432
24,24,2,2,60,25,85,6432
25,25,5,0,65,25,90,6432
26,26,10,1,75,26,101,6432
27,27,6,3,81,29,110,6432
28,28,8,4,89,33,122,6432
29,29,10,7,99,40,139,6432
30,30,10,4,109,44,153,6432
31,31,12,2,121,46,167,6432
32,32,9,3,130,49,179,6432
33,33,6,6,136,55,191,6432
34,34,7,3,143,58,201,6432
35,35,1,3,144,61,205,6432
36,36,2,1,146,62,208,6432
37,37,0,2,146,64,210,6432
38,38,0,2,146,66,212,6432
39,39,0,1,146,67,213,6432
40,40,0,0,146,67,213,6432
0,0,1,0,1,0,1,6433
1,1,0,0,1,0,1,6433
0,0,1,0,1,0,1,6434
1,1,1,1,2,1,3,6434
2,2,1,1,3,2,5,6434
3,3,1,0,4,2,6,6434
4,4,1,0,5,2,7,6434
5,5,0,0,5,2,7,6434
0,0,1,0,1,0,1,6435
1,1,0,0,1,0,1,6435
0,0,1,0,1,0,1,6436
1,1,0,1,1,1,2,6436
2,2,0,0,1,1,2,6436
0,0,1,0,1,0,1,6437
1,1,0,0,1,0,1,6437
0,0,1,0,1,0,1,6438
1,1,0,0,1,0,1,6438
0,0,1,0,1,0,1,6439
1,1,2,0,3,0,3,6439
2,2,4,4,7,4,11,6439
3,3,6,0,13,4,17,6439
4,4,8,1,21,5,26,6439
5,5,7,4,28,9,37,6439
6,6,7,3,35,12,47,6439
7,7,2,3,37,15,52,6439
8,8,1,5,38,20,58,6439
9,9,4,3,42,23,65,6439
10,10,1,0,43,23,66,6439
11,11,1,0,44,23,67,6439
12,12,0,0,44,23,67,6439
0,0,1,0,1,0,1,6440
1,1,0,0,1,0,1,6440
0,0,1,0,1,0,1,6441
1,1,2,0,3,0,3,6441
2,2,2,1,5,1,6,6441
3,3,0,0,5,1,6,6441
0,0,1,0,1,0,1,6442
1,1,0,2,1,2,3,6442
2,2,0,1,1,3,4,6442
3,3,0,0,1,3,4,6442
0,0,1,0,1,0,1,6443
1,1,0,0,1,0,1,6443
0,0,1,0,1,0,1,6444
1,1,0,0,1,0,1,6444
0,0,1,0,1,0,1,6445
1,1,1,1,2,1,3,6445
2,2,1,3,3,4,7,6445
3,3,2,1,5,5,10,6445
4,4,0,1,5,6,11,6445
5,5,0,0,5,6,11,6445
0,0,1,0,1,0,1,6446
1,1,2,1,3,1,4,6446
2,2,4,0,7,1,8,6446
3,3,3,0,10,1,11,6446
4,4,4,0,14,1,15,6446
5,5,4,0,18,1,19,6446
6,6,5,0,23,1,24,6446
7,7,5,0,28,1,29,6446
8,8,2,0,30,1,31,6446
9,9,0,1,30,2,32,6446
10,10,1,1,31,3,34,6446
11,11,0,0,31,3,34,6446
0,0,1,0,1,0,1,6447
1,1,0,0,1,0,1,6447
0,0,1,0,1,0,1,6448
1,1,1,0,2,0,2,6448
2,2,1,1,3,1,4,6448
3,3,2,0,5,1,6,6448
4,4,3,0,8,1,9,6448
5,5,2,0,10,1,11,6448
6,6,3,0,13,1,14,6448
7,7,1,1,14,2,16,6448
8,8,1,0,15,2,17,6448
9,9,1,0,16,2,18,6448
10,10,2,0,18,2,20,6448
11,11,4,1,22,3,25,6448
12,12,2,1,24,4,28,6448
13,13,0,3,24,7,31,6448
14,14,0,0,24,7,31,6448
0,0,1,0,1,0,1,6449
1,1,2,0,3,0,3,6449
2,2,1,0,4,0,4,6449
3,3,0,0,4,0,4,6449
0,0,1,0,1,0,1,6450
1,1,0,0,1,0,1,6450
0,0,1,0,1,0,1,6451
1,1,0,0,1,0,1,6451
0,0,1,0,1,0,1,6452
1,1,0,0,1,0,1,6452
0,0,1,0,1,0,1,6453
1,1,0,0,1,0,1,6453
0,0,1,0,1,0,1,6454
1,1,3,0,4,0,4,6454
2,2,1,0,5,0,5,6454
3,3,1,0,6,0,6,6454
4,4,0,0,6,0,6,6454
0,0,1,0,1,0,1,6455
1,1,1,0,2,0,2,6455
2,2,1,0,3,0,3,6455
3,3,0,0,3,0,3,6455
0,0,1,0,1,0,1,6456
1,1,1,0,2,0,2,6456
2,2,2,0,4,0,4,6456
3,3,1,0,5,0,5,6456
4,4,1,1,6,1,7,6456
5,5,0,0,6,1,7,6456
0,0,1,0,1,0,1,6457
1,1,1,0,2,0,2,6457
2,2,3,2,5,2,7,6457
3,3,3,0,8,2,10,6457
4,4,1,2,9,4,13,6457
5,5,0,3,9,7,16,6457
6,6,2,1,11,8,19,6457
7,7,2,2,13,10,23,6457
8,8,4,1,17,11,28,6457
9,9,6,3,23,14,37,6457
10,10,4,1,27,15,42,6457
11,11,2,1,29,16,45,6457
12,12,1,1,30,17,47,6457
13,13,0,3,30,20,50,6457
14,14,1,0,31,20,51,6457
15,15,4,0,35,20,55,6457
16,16,2,2,37,22,59,6457
17,17,3,2,40,24,64,6457
18,18,2,5,42,29,71,6457
19,19,2,2,44,31,75,6457
20,20,2,4,46,35,81,6457
21,21,4,2,50,37,87,6457
22,22,3,3,53,40,93,6457
23,23,3,0,56,40,96,6457
24,24,0,0,56,40,96,6457
0,0,1,0,1,0,1,6458
1,1,1,1,2,1,3,6458
2,2,1,1,3,2,5,6458
3,3,0,5,3,7,10,6458
4,4,0,3,3,10,13,6458
5,5,1,0,4,10,14,6458
6,6,1,1,5,11,16,6458
7,7,0,0,5,11,16,6458
0,0,1,0,1,0,1,6459
1,1,1,0,2,0,2,6459
2,2,0,0,2,0,2,6459
0,0,1,0,1,0,1,6460
1,1,0,0,1,0,1,6460
0,0,1,0,1,0,1,6461
1,1,0,0,1,0,1,6461
0,0,1,0,1,0,1,6462
1,1,1,0,2,0,2,6462
2,2,1,0,3,0,3,6462
3,3,0,1,3,1,4,6462
4,4,0,0,3,1,4,6462
0,0,1,0,1,0,1,6463
1,1,0,0,1,0,1,6463
0,0,1,0,1,0,1,6464
1,1,0,0,1,0,1,6464
0,0,1,0,1,0,1,6465
1,1,1,1,2,1,3,6465
2,2,0,0,2,1,3,6465
0,0,1,0,1,0,1,6466
1,1,0,0,1,0,1,6466
0,0,1,0,1,0,1,6467
1,1,1,0,2,0,2,6467
2,2,0,0,2,0,2,6467
0,0,1,0,1,0,1,6468
1,1,2,0,3,0,3,6468
2,2,2,0,5,0,5,6468
3,3,2,0,7,0,7,6468
4,4,1,1,8,1,9,6468
5,5,2,2,10,3,13,6468
6,6,2,2,12,5,17,6468
7,7,3,0,15,5,20,6468
8,8,1,0,16,5,21,6468
9,9,1,1,17,6,23,6468
10,10,1,3,18,9,27,6468
11,11,0,5,18,14,32,6468
12,12,1,2,19,16,35,6468
13,13,0,0,19,16,35,6468
0,0,1,0,1,0,1,6469
1,1,0,1,1,1,2,6469
2,2,0,0,1,1,2,6469
0,0,1,0,1,0,1,6470
1,1,0,0,1,0,1,6470
0,0,1,0,1,0,1,6471
1,1,0,0,1,0,1,6471
0,0,1,0,1,0,1,6472
1,1,2,0,3,0,3,6472
2,2,3,1,6,1,7,6472
3,3,3,1,9,2,11,6472
4,4,3,1,12,3,15,6472
5,5,2,2,14,5,19,6472
6,6,1,3,15,8,23,6472
7,7,2,3,17,11,28,6472
8,8,3,3,20,14,34,6472
9,9,6,1,26,15,41,6472
10,10,3,3,29,18,47,6472
11,11,2,1,31,19,50,6472
12,12,3,1,34,20,54,6472
13,13,0,2,34,22,56,6472
14,14,1,2,35,24,59,6472
15,15,1,0,36,24,60,6472
16,16,0,0,36,24,60,6472
0,0,1,0,1,0,1,6473
1,1,1,1,2,1,3,6473
2,2,3,2,5,3,8,6473
3,3,1,2,6,5,11,6473
4,4,0,1,6,6,12,6473
5,5,0,0,6,6,12,6473
0,0,1,0,1,0,1,6474
1,1,1,0,2,0,2,6474
2,2,0,0,2,0,2,6474
0,0,1,0,1,0,1,6475
1,1,2,1,3,1,4,6475
2,2,1,1,4,2,6,6475
3,3,0,1,4,3,7,6475
4,4,0,0,4,3,7,6475
0,0,1,0,1,0,1,6476
1,1,1,0,2,0,2,6476
2,2,1,0,3,0,3,6476
3,3,1,1,4,1,5,6476
4,4,1,1,5,2,7,6476
5,5,0,2,5,4,9,6476
6,6,1,1,6,5,11,6476
7,7,0,2,6,7,13,6476
8,8,1,3,7,10,17,6476
9,9,0,1,7,11,18,6476
10,10,0,2,7,13,20,6476
11,11,0,2,7,15,22,6476
12,12,2,3,9,18,27,6476
13,13,0,0,9,18,27,6476
0,0,1,0,1,0,1,6477
1,1,0,0,1,0,1,6477
0,0,1,0,1,0,1,6478
1,1,0,1,1,1,2,6478
2,2,0,1,1,2,3,6478
3,3,1,0,2,2,4,6478
4,4,1,1,3,3,6,6478
5,5,1,1,4,4,8,6478
6,6,1,0,5,4,9,6478
7,7,2,0,7,4,11,6478
8,8,1,1,8,5,13,6478
9,9,1,1,9,6,15,6478
10,10,0,2,9,8,17,6478
11,11,0,1,9,9,18,6478
12,12,1,0,10,9,19,6478
13,13,1,0,11,9,20,6478
14,14,1,0,12,9,21,6478
15,15,0,0,12,9,21,6478
0,0,1,0,1,0,1,6479
1,1,1,0,2,0,2,6479
2,2,1,0,3,0,3,6479
3,3,1,1,4,1,5,6479
4,4,0,1,4,2,6,6479
5,5,1,1,5,3,8,6479
6,6,1,3,6,6,12,6479
7,7,0,5,6,11,17,6479
8,8,1,4,7,15,22,6479
9,9,1,3,8,18,26,6479
10,10,1,1,9,19,28,6479
11,11,1,1,10,20,30,6479
12,12,0,0,10,20,30,6479
0,0,1,0,1,0,1,6480
1,1,1,0,2,0,2,6480
2,2,2,0,4,0,4,6480
3,3,2,0,6,0,6,6480
4,4,2,1,8,1,9,6480
5,5,1,1,9,2,11,6480
6,6,0,3,9,5,14,6480
7,7,1,2,10,7,17,6480
8,8,1,1,11,8,19,6480
9,9,2,0,13,8,21,6480
10,10,3,0,16,8,24,6480
11,11,3,0,19,8,27,6480
12,12,0,0,19,8,27,6480
0,0,1,0,1,0,1,6481
1,1,1,0,2,0,2,6481
2,2,2,0,4,0,4,6481
3,3,0,0,4,0,4,6481
0,0,1,0,1,0,1,6482
1,1,1,0,2,0,2,6482
2,2,0,0,2,0,2,6482
0,0,1,0,1,0,1,6483
1,1,0,0,1,0,1,6483
0,0,1,0,1,0,1,6484
1,1,0,0,1,0,1,6484
0,0,1,0,1,0,1,6485
1,1,0,0,1,0,1,6485
0,0,1,0,1,0,1,6486
1,1,0,1,1,1,2,6486
2,2,0,1,1,2,3,6486
3,3,0,1,1,3,4,6486
4,4,0,2,1,5,6,6486
5,5,0,1,1,6,7,6486
6,6,0,0,1,6,7,6486
0,0,1,0,1,0,1,6487
1,1,0,0,1,0,1,6487
0,0,1,0,1,0,1,6488
1,1,0,0,1,0,1,6488
0,0,1,0,1,0,1,6489
1,1,0,0,1,0,1,6489
0,0,1,0,1,0,1,6490
1,1,1,0,2,0,2,6490
2,2,1,0,3,0,3,6490
3,3,0,0,3,0,3,6490
0,0,1,0,1,0,1,6491
1,1,0,0,1,0,1,6491
0,0,1,0,1,0,1,6492
1,1,0,0,1,0,1,6492
0,0,1,0,1,0,1,6493
1,1,0,1,1,1,2,6493
2,2,0,0,1,1,2,6493
0,0,1,0,1,0,1,6494
1,1,1,1,2,1,3,6494
2,2,1,2,3,3,6,6494
3,3,1,2,4,5,9,6494
4,4,1,1,5,6,11,6494
5,5,1,2,6,8,14,6494
6,6,0,3,6,11,17,6494
7,7,0,3,6,14,20,6494
8,8,1,1,7,15,22,6494
9,9,1,1,8,16,24,6494
10,10,0,0,8,16,24,6494
0,0,1,0,1,0,1,6495
1,1,0,0,1,0,1,6495
0,0,1,0,1,0,1,6496
1,1,0,0,1,0,1,6496
0,0,1,0,1,0,1,6497
1,1,1,1,2,1,3,6497
2,2,2,0,4,1,5,6497
3,3,1,0,5,1,6,6497
4,4,1,0,6,1,7,6497
5,5,1,0,7,1,8,6497
6,6,0,1,7,2,9,6497
7,7,0,0,7,2,9,6497
0,0,1,0,1,0,1,6498
1,1,2,0,3,0,3,6498
2,2,2,1,5,1,6,6498
3,3,1,1,6,2,8,6498
4,4,1,0,7,2,9,6498
5,5,1,0,8,2,10,6498
6,6,1,0,9,2,11,6498
7,7,1,0,10,2,12,6498
8,8,2,0,12,2,14,6498
9,9,0,0,12,2,14,6498
0,0,1,0,1,0,1,6499
1,1,0,0,1,0,1,6499
0,0,1,0,1,0,1,6500
1,1,1,0,2,0,2,6500
2,2,0,0,2,0,2,6500
0,0,1,0,1,0,1,6501
1,1,1,0,2,0,2,6501
2,2,0,0,2,0,2,6501
0,0,1,0,1,0,1,6502
1,1,0,0,1,0,1,6502
0,0,1,0,1,0,1,6503
1,1,3,0,4,0,4,6503
2,2,0,2,4,2,6,6503
3,3,1,2,5,4,9,6503
4,4,0,1,5,5,10,6503
5,5,0,0,5,5,10,6503
0,0,1,0,1,0,1,6504
1,1,0,0,1,0,1,6504
0,0,1,0,1,0,1,6505
1,1,1,0,2,0,2,6505
2,2,2,0,4,0,4,6505
3,3,4,0,8,0,8,6505
4,4,5,0,13,0,13,6505
5,5,2,2,15,2,17,6505
6,6,0,1,15,3,18,6505
7,7,0,0,15,3,18,6505
0,0,1,0,1,0,1,6506
1,1,0,1,1,1,2,6506
2,2,0,1,1,2,3,6506
3,3,0,0,1,2,3,6506
0,0,1,0,1,0,1,6507
1,1,0,1,1,1,2,6507
2,2,0,0,1,1,2,6507
0,0,1,0,1,0,1,6508
1,1,0,0,1,0,1,6508
0,0,1,0,1,0,1,6509
1,1,1,1,2,1,3,6509
2,2,3,1,5,2,7,6509
3,3,1,2,6,4,10,6509
4,4,0,0,6,4,10,6509
0,0,1,0,1,0,1,6510
1,1,1,0,2,0,2,6510
2,2,0,0,2,0,2,6510
0,0,1,0,1,0,1,6511
1,1,0,0,1,0,1,6511
0,0,1,0,1,0,1,6512
1,1,0,0,1,0,1,6512
0,0,1,0,1,0,1,6513
1,1,0,0,1,0,1,6513
0,0,1,0,1,0,1,6514
1,1,0,0,1,0,1,6514
0,0,1,0,1,0,1,6515
1,1,0,0,1,0,1,6515
0,0,1,0,1,0,1,6516
1,1,0,0,1,0,1,6516
0,0,1,0,1,0,1,6517
1,1,0,0,1,0,1,6517
0,0,1,0,1,0,1,6518
1,1,1,0,2,0,2,6518
2,2,0,1,2,1,3,6518
3,3,0,2,2,3,5,6518
4,4,1,3,3,6,9,6518
5,5,1,1,4,7,11,6518
6,6,1,0,5,7,12,6518
7,7,0,0,5,7,12,6518
0,0,1,0,1,0,1,6519
1,1,0,0,1,0,1,6519
0,0,1,0,1,0,1,6520
1,1,1,0,2,0,2,6520
2,2,0,0,2,0,2,6520
0,0,1,0,1,0,1,6521
1,1,0,0,1,0,1,6521
0,0,1,0,1,0,1,6522
1,1,0,0,1,0,1,6522
0,0,1,0,1,0,1,6523
1,1,1,0,2,0,2,6523
2,2,0,0,2,0,2,6523
0,0,1,0,1,0,1,6524
1,1,1,0,2,0,2,6524
2,2,1,2,3,2,5,6524
3,3,2,1,5,3,8,6524
4,4,2,1,7,4,11,6524
5,5,1,2,8,6,14,6524
6,6,2,2,10,8,18,6524
7,7,0,2,10,10,20,6524
8,8,1,1,11,11,22,6524
9,9,0,0,11,11,22,6524
0,0,1,0,1,0,1,6525
1,1,1,0,2,0,2,6525
2,2,2,0,4,0,4,6525
3,3,0,1,4,1,5,6525
4,4,0,1,4,2,6,6525
5,5,0,1,4,3,7,6525
6,6,0,0,4,3,7,6525
0,0,1,0,1,0,1,6526
1,1,0,0,1,0,1,6526
0,0,1,0,1,0,1,6527
1,1,0,0,1,0,1,6527
0,0,1,0,1,0,1,6528
1,1,1,1,2,1,3,6528
2,2,3,2,5,3,8,6528
3,3,3,1,8,4,12,6528
4,4,3,0,11,4,15,6528
5,5,2,2,13,6,19,6528
6,6,2,2,15,8,23,6528
7,7,2,1,17,9,26,6528
8,8,1,1,18,10,28,6528
9,9,2,1,20,11,31,6528
10,10,2,2,22,13,35,6528
11,11,2,3,24,16,40,6528
12,12,2,0,26,16,42,6528
13,13,3,1,29,17,46,6528
14,14,1,0,30,17,47,6528
15,15,0,0,30,17,47,6528
0,0,1,0,1,0,1,6529
1,1,1,0,2,0,2,6529
2,2,0,0,2,0,2,6529
0,0,1,0,1,0,1,6530
1,1,0,0,1,0,1,6530
0,0,1,0,1,0,1,6531
1,1,2,0,3,0,3,6531
2,2,5,0,8,0,8,6531
3,3,5,0,13,0,13,6531
4,4,1,1,14,1,15,6531
5,5,1,1,15,2,17,6531
6,6,7,0,22,2,24,6531
7,7,3,0,25,2,27,6531
8,8,2,1,27,3,30,6531
9,9,0,1,27,4,31,6531
10,10,0,1,27,5,32,6531
11,11,1,0,28,5,33,6531
12,12,0,1,28,6,34,6531
13,13,1,0,29,6,35,6531
14,14,2,0,31,6,37,6531
15,15,2,0,33,6,39,6531
16,16,2,0,35,6,41,6531
17,17,4,1,39,7,46,6531
18,18,2,3,41,10,51,6531
19,19,2,2,43,12,55,6531
20,20,0,1,43,13,56,6531
21,21,0,1,43,14,57,6531
22,22,0,0,43,14,57,6531
0,0,1,0,1,0,1,6532
1,1,0,0,1,0,1,6532
0,0,1,0,1,0,1,6533
1,1,0,0,1,0,1,6533
0,0,1,0,1,0,1,6534
1,1,1,0,2,0,2,6534
2,2,0,0,2,0,2,6534
0,0,1,0,1,0,1,6535
1,1,0,0,1,0,1,6535
0,0,1,0,1,0,1,6536
1,1,0,0,1,0,1,6536
0,0,1,0,1,0,1,6537
1,1,0,0,1,0,1,6537
0,0,1,0,1,0,1,6538
1,1,0,1,1,1,2,6538
2,2,0,1,1,2,3,6538
3,3,0,1,1,3,4,6538
4,4,0,0,1,3,4,6538
0,0,1,0,1,0,1,6539
1,1,0,1,1,1,2,6539
2,2,1,0,2,1,3,6539
3,3,0,0,2,1,3,6539
0,0,1,0,1,0,1,6540
1,1,1,0,2,0,2,6540
2,2,0,0,2,0,2,6540
0,0,1,0,1,0,1,6541
1,1,1,0,2,0,2,6541
2,2,0,0,2,0,2,6541
0,0,1,0,1,0,1,6542
1,1,1,0,2,0,2,6542
2,2,0,0,2,0,2,6542
0,0,1,0,1,0,1,6543
1,1,0,0,1,0,1,6543
0,0,1,0,1,0,1,6544
1,1,0,0,1,0,1,6544
0,0,1,0,1,0,1,6545
1,1,2,0,3,0,3,6545
2,2,0,0,3,0,3,6545
0,0,1,0,1,0,1,6546
1,1,1,0,2,0,2,6546
2,2,2,0,4,0,4,6546
3,3,4,0,8,0,8,6546
4,4,6,0,14,0,14,6546
5,5,4,1,18,1,19,6546
6,6,1,4,19,5,24,6546
7,7,1,1,20,6,26,6546
8,8,3,0,23,6,29,6546
9,9,3,1,26,7,33,6546
10,10,0,1,26,8,34,6546
11,11,1,2,27,10,37,6546
12,12,0,3,27,13,40,6546
13,13,0,5,27,18,45,6546
14,14,0,3,27,21,48,6546
15,15,0,1,27,22,49,6546
16,16,0,2,27,24,51,6546
17,17,0,0,27,24,51,6546
0,0,1,0,1,0,1,6547
1,1,1,0,2,0,2,6547
2,2,0,1,2,1,3,6547
3,3,0,1,2,2,4,6547
4,4,0,1,2,3,5,6547
5,5,0,1,2,4,6,6547
6,6,1,0,3,4,7,6547
7,7,0,0,3,4,7,6547
0,0,1,0,1,0,1,6548
1,1,0,1,1,1,2,6548
2,2,0,2,1,3,4,6548
3,3,0,4,1,7,8,6548
4,4,1,2,2,9,11,6548
5,5,1,1,3,10,13,6548
6,6,1,0,4,10,14,6548
7,7,1,0,5,10,15,6548
8,8,0,0,5,10,15,6548
0,0,1,0,1,0,1,6549
1,1,1,1,2,1,3,6549
2,2,2,1,4,2,6,6549
3,3,3,0,7,2,9,6549
4,4,3,0,10,2,12,6549
5,5,2,0,12,2,14,6549
6,6,1,0,13,2,15,6549
7,7,0,0,13,2,15,6549
0,0,1,0,1,0,1,6550
1,1,1,0,2,0,2,6550
2,2,0,0,2,0,2,6550
0,0,1,0,1,0,1,6551
1,1,1,2,2,2,4,6551
2,2,3,1,5,3,8,6551
3,3,0,5,5,8,13,6551
4,4,0,5,5,13,18,6551
5,5,0,3,5,16,21,6551
6,6,0,0,5,16,21,6551
0,0,1,0,1,0,1,6552
1,1,2,0,3,0,3,6552
2,2,4,0,7,0,7,6552
3,3,1,1,8,1,9,6552
4,4,1,0,9,1,10,6552
5,5,0,0,9,1,10,6552
0,0,1,0,1,0,1,6553
1,1,0,1,1,1,2,6553
2,2,0,2,1,3,4,6553
3,3,0,1,1,4,5,6553
4,4,0,1,1,5,6,6553
5,5,0,0,1,5,6,6553
0,0,1,0,1,0,1,6554
1,1,2,0,3,0,3,6554
2,2,3,2,6,2,8,6554
3,3,2,2,8,4,12,6554
4,4,2,2,10,6,16,6554
5,5,3,3,13,9,22,6554
6,6,3,1,16,10,26,6554
7,7,1,1,17,11,28,6554
8,8,0,0,17,11,28,6554
0,0,1,0,1,0,1,6555
1,1,2,0,3,0,3,6555
2,2,0,0,3,0,3,6555
0,0,1,0,1,0,1,6556
1,1,0,0,1,0,1,6556
0,0,1,0,1,0,1,6557
1,1,2,0,3,0,3,6557
2,2,2,2,5,2,7,6557
3,3,5,0,10,2,12,6557
4,4,2,0,12,2,14,6557
5,5,0,0,12,2,14,6557
0,0,1,0,1,0,1,6558
1,1,2,0,3,0,3,6558
2,2,0,0,3,0,3,6558
0,0,1,0,1,0,1,6559
1,1,1,0,2,0,2,6559
2,2,2,0,4,0,4,6559
3,3,1,0,5,0,5,6559
4,4,0,0,5,0,5,6559
0,0,1,0,1,0,1,6560
1,1,0,1,1,1,2,6560
2,2,0,1,1,2,3,6560
3,3,0,1,1,3,4,6560
4,4,0,2,1,5,6,6560
5,5,0,0,1,5,6,6560
0,0,1,0,1,0,1,6561
1,1,1,0,2,0,2,6561
2,2,0,0,2,0,2,6561
0,0,1,0,1,0,1,6562
1,1,2,0,3,0,3,6562
2,2,1,0,4,0,4,6562
3,3,1,0,5,0,5,6562
4,4,3,1,8,1,9,6562
5,5,0,0,8,1,9,6562
0,0,1,0,1,0,1,6563
1,1,0,0,1,0,1,6563
0,0,1,0,1,0,1,6564
1,1,0,0,1,0,1,6564
0,0,1,0,1,0,1,6565
1,1,0,0,1,0,1,6565
0,0,1,0,1,0,1,6566
1,1,0,0,1,0,1,6566
0,0,1,0,1,0,1,6567
1,1,2,0,3,0,3,6567
2,2,2,0,5,0,5,6567
3,3,1,0,6,0,6,6567
4,4,0,0,6,0,6,6567
0,0,1,0,1,0,1,6568
1,1,0,0,1,0,1,6568
0,0,1,0,1,0,1,6569
1,1,0,0,1,0,1,6569
0,0,1,0,1,0,1,6570
1,1,0,0,1,0,1,6570
0,0,1,0,1,0,1,6571
1,1,2,0,3,0,3,6571
2,2,0,0,3,0,3,6571
0,0,1,0,1,0,1,6572
1,1,0,0,1,0,1,6572
0,0,1,0,1,0,1,6573
1,1,1,0,2,0,2,6573
2,2,2,0,4,0,4,6573
3,3,0,0,4,0,4,6573
0,0,1,0,1,0,1,6574
1,1,0,1,1,1,2,6574
2,2,0,2,1,3,4,6574
3,3,0,2,1,5,6,6574
4,4,3,1,4,6,10,6574
5,5,0,2,4,8,12,6574
6,6,0,2,4,10,14,6574
7,7,0,1,4,11,15,6574
8,8,0,1,4,12,16,6574
9,9,0,1,4,13,17,6574
10,10,1,1,5,14,19,6574
11,11,1,0,6,14,20,6574
12,12,0,2,6,16,22,6574
13,13,0,1,6,17,23,6574
14,14,0,3,6,20,26,6574
15,15,0,4,6,24,30,6574
16,16,0,2,6,26,32,6574
17,17,0,3,6,29,35,6574
18,18,1,5,7,34,41,6574
19,19,0,3,7,37,44,6574
20,20,0,1,7,38,45,6574
21,21,0,1,7,39,46,6574
22,22,0,1,7,40,47,6574
23,23,0,1,7,41,48,6574
24,24,0,0,7,41,48,6574
0,0,1,0,1,0,1,6575
1,1,1,0,2,0,2,6575
2,2,1,0,3,0,3,6575
3,3,1,1,4,1,5,6575
4,4,1,3,5,4,9,6575
5,5,1,2,6,6,12,6575
6,6,1,1,7,7,14,6575
7,7,3,0,10,7,17,6575
8,8,2,0,12,7,19,6575
9,9,1,1,13,8,21,6575
10,10,1,1,14,9,23,6575
11,11,1,0,15,9,24,6575
12,12,1,0,16,9,25,6575
13,13,2,0,18,9,27,6575
14,14,3,0,21,9,30,6575
15,15,3,2,24,11,35,6575
16,16,2,3,26,14,40,6575
17,17,1,7,27,21,48,6575
18,18,0,6,27,27,54,6575
19,19,0,4,27,31,58,6575
20,20,1,5,28,36,64,6575
21,21,2,3,30,39,69,6575
22,22,1,2,31,41,72,6575
23,23,1,4,32,45,77,6575
24,24,2,4,34,49,83,6575
25,25,1,2,35,51,86,6575
26,26,1,0,36,51,87,6575
27,27,0,1,36,52,88,6575
28,28,1,1,37,53,90,6575
29,29,1,3,38,56,94,6575
30,30,2,3,40,59,99,6575
31,31,4,2,44,61,105,6575
32,32,4,3,48,64,112,6575
33,33,6,1,54,65,119,6575
34,34,2,0,56,65,121,6575
35,35,0,1,56,66,122,6575
36,36,0,1,56,67,123,6575
37,37,0,0,56,67,123,6575
0,0,1,0,1,0,1,6576
1,1,0,0,1,0,1,6576
0,0,1,0,1,0,1,6577
1,1,2,0,3,0,3,6577
2,2,0,0,3,0,3,6577
0,0,1,0,1,0,1,6578
1,1,0,0,1,0,1,6578
0,0,1,0,1,0,1,6579
1,1,1,0,2,0,2,6579
2,2,0,0,2,0,2,6579
0,0,1,0,1,0,1,6580
1,1,1,0,2,0,2,6580
2,2,1,0,3,0,3,6580
3,3,0,0,3,0,3,6580
0,0,1,0,1,0,1,6581
1,1,0,0,1,0,1,6581
0,0,1,0,1,0,1,6582
1,1,2,0,3,0,3,6582
2,2,4,0,7,0,7,6582
3,3,3,2,10,2,12,6582
4,4,2,1,12,3,15,6582
5,5,3,0,15,3,18,6582
6,6,3,0,18,3,21,6582
7,7,3,0,21,3,24,6582
8,8,2,1,23,4,27,6582
9,9,3,0,26,4,30,6582
10,10,0,0,26,4,30,6582
0,0,1,0,1,0,1,6583
1,1,0,0,1,0,1,6583
0,0,1,0,1,0,1,6584
1,1,0,0,1,0,1,6584
0,0,1,0,1,0,1,6585
1,1,0,1,1,1,2,6585
2,2,0,0,1,1,2,6585
0,0,1,0,1,0,1,6586
1,1,0,0,1,0,1,6586
0,0,1,0,1,0,1,6587
1,1,0,0,1,0,1,6587
0,0,1,0,1,0,1,6588
1,1,1,0,2,0,2,6588
2,2,1,0,3,0,3,6588
3,3,3,0,6,0,6,6588
4,4,1,0,7,0,7,6588
5,5,2,0,9,0,9,6588
6,6,2,0,11,0,11,6588
7,7,3,0,14,0,14,6588
8,8,2,1,16,1,17,6588
9,9,3,1,19,2,21,6588
10,10,1,1,20,3,23,6588
11,11,2,0,22,3,25,6588
12,12,1,0,23,3,26,6588
13,13,0,0,23,3,26,6588
0,0,1,0,1,0,1,6589
1,1,0,1,1,1,2,6589
2,2,0,0,1,1,2,6589
0,0,1,0,1,0,1,6590
1,1,0,0,1,0,1,6590
0,0,1,0,1,0,1,6591
1,1,0,0,1,0,1,6591
0,0,1,0,1,0,1,6592
1,1,0,0,1,0,1,6592
0,0,1,0,1,0,1,6593
1,1,1,0,2,0,2,6593
2,2,0,0,2,0,2,6593
0,0,1,0,1,0,1,6594
1,1,1,0,2,0,2,6594
2,2,0,0,2,0,2,6594
0,0,1,0,1,0,1,6595
1,1,0,0,1,0,1,6595
0,0,1,0,1,0,1,6596
1,1,1,0,2,0,2,6596
2,2,3,0,5,0,5,6596
3,3,1,1,6,1,7,6596
4,4,1,0,7,1,8,6596
5,5,0,0,7,1,8,6596
0,0,1,0,1,0,1,6597
1,1,2,0,3,0,3,6597
2,2,2,1,5,1,6,6597
3,3,2,0,7,1,8,6597
4,4,3,0,10,1,11,6597
5,5,2,1,12,2,14,6597
6,6,2,0,14,2,16,6597
7,7,2,0,16,2,18,6597
8,8,3,0,19,2,21,6597
9,9,3,2,22,4,26,6597
10,10,4,3,26,7,33,6597
11,11,7,3,33,10,43,6597
12,12,8,3,41,13,54,6597
13,13,7,4,48,17,65,6597
14,14,6,6,54,23,77,6597
15,15,4,6,58,29,87,6597
16,16,2,8,60,37,97,6597
17,17,2,4,62,41,103,6597
18,18,2,1,64,42,106,6597
19,19,2,1,66,43,109,6597
20,20,2,0,68,43,111,6597
21,21,0,0,68,43,111,6597
0,0,1,0,1,0,1,6598
1,1,1,0,2,0,2,6598
2,2,0,0,2,0,2,6598
0,0,1,0,1,0,1,6599
1,1,0,0,1,0,1,6599
0,0,1,0,1,0,1,6600
1,1,1,0,2,0,2,6600
2,2,2,0,4,0,4,6600
3,3,0,1,4,1,5,6600
4,4,0,1,4,2,6,6600
5,5,0,0,4,2,6,6600
0,0,1,0,1,0,1,6601
1,1,0,0,1,0,1,6601
0,0,1,0,1,0,1,6602
1,1,0,1,1,1,2,6602
2,2,0,1,1,2,3,6602
3,3,0,0,1,2,3,6602
0,0,1,0,1,0,1,6603
1,1,3,0,4,0,4,6603
2,2,1,0,5,0,5,6603
3,3,1,0,6,0,6,6603
4,4,0,0,6,0,6,6603
0,0,1,0,1,0,1,6604
1,1,2,0,3,0,3,6604
2,2,3,0,6,0,6,6604
3,3,0,0,6,0,6,6604
0,0,1,0,1,0,1,6605
1,1,0,0,1,0,1,6605
0,0,1,0,1,0,1,6606
1,1,1,0,2,0,2,6606
2,2,0,0,2,0,2,6606
0,0,1,0,1,0,1,6607
1,1,1,0,2,0,2,6607
2,2,1,0,3,0,3,6607
3,3,0,0,3,0,3,6607
0,0,1,0,1,0,1,6608
1,1,1,0,2,0,2,6608
2,2,2,0,4,0,4,6608
3,3,1,0,5,0,5,6608
4,4,0,0,5,0,5,6608
0,0,1,0,1,0,1,6609
1,1,3,0,4,0,4,6609
2,2,1,2,5,2,7,6609
3,3,3,2,8,4,12,6609
4,4,0,1,8,5,13,6609
5,5,0,1,8,6,14,6609
6,6,0,0,8,6,14,6609
0,0,1,0,1,0,1,6610
1,1,1,0,2,0,2,6610
2,2,0,0,2,0,2,6610
0,0,1,0,1,0,1,6611
1,1,1,0,2,0,2,6611
2,2,0,0,2,0,2,6611
0,0,1,0,1,0,1,6612
1,1,1,0,2,0,2,6612
2,2,1,1,3,1,4,6612
3,3,0,1,3,2,5,6612
4,4,1,0,4,2,6,6612
5,5,0,0,4,2,6,6612
0,0,1,0,1,0,1,6613
1,1,0,0,1,0,1,6613
0,0,1,0,1,0,1,6614
1,1,1,0,2,0,2,6614
2,2,1,0,3,0,3,6614
3,3,1,0,4,0,4,6614
4,4,1,0,5,0,5,6614
5,5,0,1,5,1,6,6614
6,6,0,1,5,2,7,6614
7,7,0,0,5,2,7,6614
0,0,1,0,1,0,1,6615
1,1,0,0,1,0,1,6615
0,0,1,0,1,0,1,6616
1,1,0,0,1,0,1,6616
0,0,1,0,1,0,1,6617
1,1,0,0,1,0,1,6617
0,0,1,0,1,0,1,6618
1,1,2,0,3,0,3,6618
2,2,0,0,3,0,3,6618
0,0,1,0,1,0,1,6619
1,1,0,1,1,1,2,6619
2,2,0,0,1,1,2,6619
0,0,1,0,1,0,1,6620
1,1,0,0,1,0,1,6620
0,0,1,0,1,0,1,6621
1,1,0,0,1,0,1,6621
0,0,1,0,1,0,1,6622
1,1,0,0,1,0,1,6622
0,0,1,0,1,0,1,6623
1,1,2,1,3,1,4,6623
2,2,3,0,6,1,7,6623
3,3,1,1,7,2,9,6623
4,4,1,0,8,2,10,6623
5,5,1,0,9,2,11,6623
6,6,1,0,10,2,12,6623
7,7,0,0,10,2,12,6623
0,0,1,0,1,0,1,6624
1,1,1,0,2,0,2,6624
2,2,0,0,2,0,2,6624
0,0,1,0,1,0,1,6625
1,1,0,0,1,0,1,6625
0,0,1,0,1,0,1,6626
1,1,0,0,1,0,1,6626
0,0,1,0,1,0,1,6627
1,1,1,0,2,0,2,6627
2,2,2,0,4,0,4,6627
3,3,1,0,5,0,5,6627
4,4,0,0,5,0,5,6627
0,0,1,0,1,0,1,6628
1,1,0,1,1,1,2,6628
2,2,0,1,1,2,3,6628
3,3,0,2,1,4,5,6628
4,4,0,2,1,6,7,6628
5,5,0,1,1,7,8,6628
6,6,0,1,1,8,9,6628
7,7,0,0,1,8,9,6628
0,0,1,0,1,0,1,6629
1,1,0,0,1,0,1,6629
0,0,1,0,1,0,1,6630
1,1,0,0,1,0,1,6630
0,0,1,0,1,0,1,6631
1,1,0,0,1,0,1,6631
0,0,1,0,1,0,1,6632
1,1,1,0,2,0,2,6632
2,2,2,0,4,0,4,6632
3,3,2,0,6,0,6,6632
4,4,1,0,7,0,7,6632
5,5,1,0,8,0,8,6632
6,6,2,0,10,0,10,6632
7,7,2,1,12,1,13,6632
8,8,3,2,15,3,18,6632
9,9,2,1,17,4,21,6632
10,10,2,2,19,6,25,6632
11,11,3,6,22,12,34,6632
12,12,1,8,23,20,43,6632
13,13,1,6,24,26,50,6632
14,14,3,6,27,32,59,6632
15,15,5,4,32,36,68,6632
16,16,5,3,37,39,76,6632
17,17,2,5,39,44,83,6632
18,18,2,3,41,47,88,6632
19,19,1,2,42,49,91,6632
20,20,1,1,43,50,93,6632
21,21,0,0,43,50,93,6632
0,0,1,0,1,0,1,6633
1,1,0,0,1,0,1,6633
0,0,1,0,1,0,1,6634
1,1,0,0,1,0,1,6634
0,0,1,0,1,0,1,6635
1,1,1,0,2,0,2,6635
2,2,0,0,2,0,2,6635
0,0,1,0,1,0,1,6636
1,1,1,0,2,0,2,6636
2,2,1,0,3,0,3,6636
3,3,1,0,4,0,4,6636
4,4,0,0,4,0,4,6636
0,0,1,0,1,0,1,6637
1,1,0,0,1,0,1,6637
0,0,1,0,1,0,1,6638
1,1,0,0,1,0,1,6638
0,0,1,0,1,0,1,6639
1,1,2,0,3,0,3,6639
2,2,1,0,4,0,4,6639
3,3,0,0,4,0,4,6639
0,0,1,0,1,0,1,6640
1,1,0,0,1,0,1,6640
0,0,1,0,1,0,1,6641
1,1,1,0,2,0,2,6641
2,2,0,0,2,0,2,6641
0,0,1,0,1,0,1,6642
1,1,0,1,1,1,2,6642
2,2,0,1,1,2,3,6642
3,3,0,1,1,3,4,6642
4,4,0,2,1,5,6,6642
5,5,1,4,2,9,11,6642
6,6,1,1,3,10,13,6642
7,7,1,0,4,10,14,6642
8,8,2,0,6,10,16,6642
9,9,2,0,8,10,18,6642
10,10,3,0,11,10,21,6642
11,11,3,0,14,10,24,6642
12,12,2,1,16,11,27,6642
13,13,2,4,18,15,33,6642
14,14,0,4,18,19,37,6642
15,15,0,3,18,22,40,6642
16,16,0,2,18,24,42,6642
17,17,0,1,18,25,43,6642
18,18,0,1,18,26,44,6642
19,19,0,2,18,28,46,6642
20,20,0,2,18,30,48,6642
21,21,0,0,18,30,48,6642
0,0,1,0,1,0,1,6643
1,1,1,0,2,0,2,6643
2,2,0,0,2,0,2,6643
0,0,1,0,1,0,1,6644
1,1,1,0,2,0,2,6644
2,2,0,0,2,0,2,6644
0,0,1,0,1,0,1,6645
1,1,1,0,2,0,2,6645
2,2,1,0,3,0,3,6645
3,3,1,0,4,0,4,6645
4,4,1,0,5,0,5,6645
5,5,2,0,7,0,7,6645
6,6,0,1,7,1,8,6645
7,7,0,0,7,1,8,6645
0,0,1,0,1,0,1,6646
1,1,1,0,2,0,2,6646
2,2,0,0,2,0,2,6646
0,0,1,0,1,0,1,6647
1,1,0,0,1,0,1,6647
0,0,1,0,1,0,1,6648
1,1,0,2,1,2,3,6648
2,2,0,0,1,2,3,6648
0,0,1,0,1,0,1,6649
1,1,1,0,2,0,2,6649
2,2,2,0,4,0,4,6649
3,3,2,0,6,0,6,6649
4,4,1,0,7,0,7,6649
5,5,3,0,10,0,10,6649
6,6,2,1,12,1,13,6649
7,7,2,3,14,4,18,6649
8,8,0,4,14,8,22,6649
9,9,1,4,15,12,27,6649
10,10,1,0,16,12,28,6649
11,11,0,0,16,12,28,6649
0,0,1,0,1,0,1,6650
1,1,1,0,2,0,2,6650
2,2,1,0,3,0,3,6650
3,3,0,0,3,0,3,6650
0,0,1,0,1,0,1,6651
1,1,0,0,1,0,1,6651
0,0,1,0,1,0,1,6652
1,1,0,0,1,0,1,6652
0,0,1,0,1,0,1,6653
1,1,1,0,2,0,2,6653
2,2,1,0,3,0,3,6653
3,3,0,1,3,1,4,6653
4,4,0,2,3,3,6,6653
5,5,0,4,3,7,10,6653
6,6,1,4,4,11,15,6653
7,7,1,0,5,11,16,6653
8,8,2,0,7,11,18,6653
9,9,0,0,7,11,18,6653
0,0,1,0,1,0,1,6654
1,1,0,0,1,0,1,6654
0,0,1,0,1,0,1,6655
1,1,0,0,1,0,1,6655
0,0,1,0,1,0,1,6656
1,1,0,0,1,0,1,6656
0,0,1,0,1,0,1,6657
1,1,1,0,2,0,2,6657
2,2,0,0,2,0,2,6657
0,0,1,0,1,0,1,6658
1,1,1,0,2,0,2,6658
2,2,1,0,3,0,3,6658
3,3,0,0,3,0,3,6658
0,0,1,0,1,0,1,6659
1,1,0,0,1,0,1,6659
0,0,1,0,1,0,1,6660
1,1,1,0,2,0,2,6660
2,2,1,0,3,0,3,6660
3,3,0,0,3,0,3,6660
0,0,1,0,1,0,1,6661
1,1,1,0,2,0,2,6661
2,2,0,1,2,1,3,6661
3,3,0,3,2,4,6,6661
4,4,0,5,2,9,11,6661
5,5,1,4,3,13,16,6661
6,6,1,2,4,15,19,6661
7,7,3,0,7,15,22,6661
8,8,2,0,9,15,24,6661
9,9,1,0,10,15,25,6661
10,10,0,0,10,15,25,6661
0,0,1,0,1,0,1,6662
1,1,0,0,1,0,1,6662
0,0,1,0,1,0,1,6663
1,1,0,0,1,0,1,6663
0,0,1,0,1,0,1,6664
1,1,1,0,2,0,2,6664
2,2,1,0,3,0,3,6664
3,3,1,0,4,0,4,6664
4,4,0,0,4,0,4,6664
0,0,1,0,1,0,1,6665
1,1,0,0,1,0,1,6665
0,0,1,0,1,0,1,6666
1,1,0,0,1,0,1,6666
0,0,1,0,1,0,1,6667
1,1,3,0,4,0,4,6667
2,2,2,0,6,0,6,6667
3,3,1,0,7,0,7,6667
4,4,0,0,7,0,7,6667
0,0,1,0,1,0,1,6668
1,1,0,0,1,0,1,6668
0,0,1,0,1,0,1,6669
1,1,0,0,1,0,1,6669
0,0,1,0,1,0,1,6670
1,1,1,0,2,0,2,6670
2,2,0,0,2,0,2,6670
0,0,1,0,1,0,1,6671
1,1,1,0,2,0,2,6671
2,2,1,0,3,0,3,6671
3,3,0,2,3,2,5,6671
4,4,0,1,3,3,6,6671
5,5,0,0,3,3,6,6671
0,0,1,0,1,0,1,6672
1,1,1,1,2,1,3,6672
2,2,1,1,3,2,5,6672
3,3,0,2,3,4,7,6672
4,4,0,2,3,6,9,6672
5,5,0,1,3,7,10,6672
6,6,0,0,3,7,10,6672
0,0,1,0,1,0,1,6673
1,1,0,0,1,0,1,6673
0,0,1,0,1,0,1,6674
1,1,1,0,2,0,2,6674
2,2,0,0,2,0,2,6674
0,0,1,0,1,0,1,6675
1,1,1,0,2,0,2,6675
2,2,3,0,5,0,5,6675
3,3,0,0,5,0,5,6675
0,0,1,0,1,0,1,6676
1,1,1,0,2,0,2,6676
2,2,0,0,2,0,2,6676
0,0,1,0,1,0,1,6677
1,1,0,0,1,0,1,6677
0,0,1,0,1,0,1,6678
1,1,1,0,2,0,2,6678
2,2,1,0,3,0,3,6678
3,3,0,0,3,0,3,6678
0,0,1,0,1,0,1,6679
1,1,1,0,2,0,2,6679
2,2,2,0,4,0,4,6679
3,3,3,0,7,0,7,6679
4,4,3,1,10,1,11,6679
5,5,1,1,11,2,13,6679
6,6,2,0,13,2,15,6679
7,7,2,0,15,2,17,6679
8,8,3,1,18,3,21,6679
9,9,2,1,20,4,24,6679
10,10,1,1,21,5,26,6679
11,11,2,2,23,7,30,6679
12,12,2,2,25,9,34,6679
13,13,1,1,26,10,36,6679
14,14,0,1,26,11,37,6679
15,15,0,1,26,12,38,6679
16,16,0,0,26,12,38,6679
0,0,1,0,1,0,1,6680
1,1,0,0,1,0,1,6680
0,0,1,0,1,0,1,6681
1,1,0,0,1,0,1,6681
0,0,1,0,1,0,1,6682
1,1,0,0,1,0,1,6682
0,0,1,0,1,0,1,6683
1,1,2,0,3,0,3,6683
2,2,0,2,3,2,5,6683
3,3,0,1,3,3,6,6683
4,4,0,1,3,4,7,6683
5,5,0,0,3,4,7,6683
0,0,1,0,1,0,1,6684
1,1,1,0,2,0,2,6684
2,2,1,0,3,0,3,6684
3,3,2,1,5,1,6,6684
4,4,0,0,5,1,6,6684
0,0,1,0,1,0,1,6685
1,1,0,1,1,1,2,6685
2,2,0,2,1,3,4,6685
3,3,0,1,1,4,5,6685
4,4,0,1,1,5,6,6685
5,5,0,1,1,6,7,6685
6,6,0,0,1,6,7,6685
0,0,1,0,1,0,1,6686
1,1,0,0,1,0,1,6686
0,0,1,0,1,0,1,6687
1,1,0,0,1,0,1,6687
0,0,1,0,1,0,1,6688
1,1,0,0,1,0,1,6688
0,0,1,0,1,0,1,6689
1,1,0,0,1,0,1,6689
0,0,1,0,1,0,1,6690
1,1,1,0,2,0,2,6690
2,2,4,0,6,0,6,6690
3,3,4,1,10,1,11,6690
4,4,4,1,14,2,16,6690
5,5,2,0,16,2,18,6690
6,6,2,1,18,3,21,6690
7,7,1,2,19,5,24,6690
8,8,2,1,21,6,27,6690
9,9,1,1,22,7,29,6690
10,10,2,0,24,7,31,6690
11,11,2,0,26,7,33,6690
12,12,1,0,27,7,34,6690
13,13,2,0,29,7,36,6690
14,14,1,1,30,8,38,6690
15,15,1,1,31,9,40,6690
16,16,1,1,32,10,42,6690
17,17,2,2,34,12,46,6690
18,18,1,2,35,14,49,6690
19,19,1,1,36,15,51,6690
20,20,0,1,36,16,52,6690
21,21,0,3,36,19,55,6690
22,22,0,2,36,21,57,6690
23,23,0,1,36,22,58,6690
24,24,0,0,36,22,58,6690
0,0,1,0,1,0,1,6691
1,1,0,0,1,0,1,6691
0,0,1,0,1,0,1,6692
1,1,0,1,1,1,2,6692
2,2,1,1,2,2,4,6692
3,3,1,0,3,2,5,6692
4,4,0,0,3,2,5,6692
0,0,1,0,1,0,1,6693
1,1,0,0,1,0,1,6693
0,0,1,0,1,0,1,6694
1,1,0,1,1,1,2,6694
2,2,1,0,2,1,3,6694
3,3,1,0,3,1,4,6694
4,4,1,0,4,1,5,6694
5,5,0,0,4,1,5,6694
0,0,1,0,1,0,1,6695
1,1,0,0,1,0,1,6695
0,0,1,0,1,0,1,6696
1,1,0,0,1,0,1,6696
0,0,1,0,1,0,1,6697
1,1,0,0,1,0,1,6697
0,0,1,0,1,0,1,6698
1,1,0,0,1,0,1,6698
0,0,1,0,1,0,1,6699
1,1,1,0,2,0,2,6699
2,2,0,0,2,0,2,6699
0,0,1,0,1,0,1,6700
1,1,0,0,1,0,1,6700
0,0,1,0,1,0,1,6701
1,1,1,0,2,0,2,6701
2,2,0,0,2,0,2,6701
0,0,1,0,1,0,1,6702
1,1,1,0,2,0,2,6702
2,2,0,0,2,0,2,6702
0,0,1,0,1,0,1,6703
1,1,0,0,1,0,1,6703
0,0,1,0,1,0,1,6704
1,1,0,0,1,0,1,6704
0,0,1,0,1,0,1,6705
1,1,0,0,1,0,1,6705
0,0,1,0,1,0,1,6706
1,1,1,1,2,1,3,6706
2,2,1,0,3,1,4,6706
3,3,0,0,3,1,4,6706
0,0,1,0,1,0,1,6707
1,1,1,2,2,2,4,6707
2,2,0,3,2,5,7,6707
3,3,0,2,2,7,9,6707
4,4,1,1,3,8,11,6707
5,5,2,0,5,8,13,6707
6,6,2,0,7,8,15,6707
7,7,3,1,10,9,19,6707
8,8,1,0,11,9,20,6707
9,9,1,1,12,10,22,6707
10,10,0,0,12,10,22,6707
0,0,1,0,1,0,1,6708
1,1,2,0,3,0,3,6708
2,2,0,0,3,0,3,6708
0,0,1,0,1,0,1,6709
1,1,1,0,2,0,2,6709
2,2,0,0,2,0,2,6709
0,0,1,0,1,0,1,6710
1,1,1,0,2,0,2,6710
2,2,1,0,3,0,3,6710
3,3,0,0,3,0,3,6710
0,0,1,0,1,0,1,6711
1,1,0,0,1,0,1,6711
0,0,1,0,1,0,1,6712
1,1,1,0,2,0,2,6712
2,2,0,0,2,0,2,6712
0,0,1,0,1,0,1,6713
1,1,1,0,2,0,2,6713
2,2,0,0,2,0,2,6713
0,0,1,0,1,0,1,6714
1,1,0,0,1,0,1,6714
0,0,1,0,1,0,1,6715
1,1,3,0,4,0,4,6715
2,2,3,0,7,0,7,6715
3,3,4,0,11,0,11,6715
4,4,4,1,15,1,16,6715
5,5,1,5,16,6,22,6715
6,6,4,5,20,11,31,6715
7,7,3,3,23,14,37,6715
8,8,2,6,25,20,45,6715
9,9,2,7,27,27,54,6715
10,10,3,6,30,33,63,6715
11,11,3,2,33,35,68,6715
12,12,1,3,34,38,72,6715
13,13,0,4,34,42,76,6715
14,14,1,0,35,42,77,6715
15,15,0,0,35,42,77,6715
0,0,1,0,1,0,1,6716
1,1,1,0,2,0,2,6716
2,2,1,0,3,0,3,6716
3,3,0,0,3,0,3,6716
0,0,1,0,1,0,1,6717
1,1,0,0,1,0,1,6717
0,0,1,0,1,0,1,6718
1,1,1,0,2,0,2,6718
2,2,0,0,2,0,2,6718
0,0,1,0,1,0,1,6719
1,1,0,0,1,0,1,6719
0,0,1,0,1,0,1,6720
1,1,2,0,3,0,3,6720
2,2,0,0,3,0,3,6720
0,0,1,0,1,0,1,6721
1,1,2,0,3,0,3,6721
2,2,0,0,3,0,3,6721
0,0,1,0,1,0,1,6722
1,1,1,0,2,0,2,6722
2,2,0,0,2,0,2,6722
0,0,1,0,1,0,1,6723
1,1,0,0,1,0,1,6723
0,0,1,0,1,0,1,6724
1,1,2,0,3,0,3,6724
2,2,1,0,4,0,4,6724
3,3,0,0,4,0,4,6724
0,0,1,0,1,0,1,6725
1,1,2,0,3,0,3,6725
2,2,4,1,7,1,8,6725
3,3,5,3,12,4,16,6725
4,4,2,2,14,6,20,6725
5,5,3,0,17,6,23,6725
6,6,3,0,20,6,26,6725
7,7,1,0,21,6,27,6725
8,8,2,1,23,7,30,6725
9,9,1,1,24,8,32,6725
10,10,1,1,25,9,34,6725
11,11,0,0,25,9,34,6725
0,0,1,0,1,0,1,6726
1,1,0,0,1,0,1,6726
0,0,1,0,1,0,1,6727
1,1,1,0,2,0,2,6727
2,2,0,0,2,0,2,6727
0,0,1,0,1,0,1,6728
1,1,0,0,1,0,1,6728
0,0,1,0,1,0,1,6729
1,1,3,0,4,0,4,6729
2,2,4,1,8,1,9,6729
3,3,4,2,12,3,15,6729
4,4,5,0,17,3,20,6729
5,5,0,2,17,5,22,6729
6,6,1,1,18,6,24,6729
7,7,2,1,20,7,27,6729
8,8,0,3,20,10,30,6729
9,9,0,3,20,13,33,6729
10,10,1,3,21,16,37,6729
11,11,0,2,21,18,39,6729
12,12,0,0,21,18,39,6729
0,0,1,0,1,0,1,6730
1,1,1,0,2,0,2,6730
2,2,1,0,3,0,3,6730
3,3,0,0,3,0,3,6730
0,0,1,0,1,0,1,6731
1,1,0,0,1,0,1,6731
0,0,1,0,1,0,1,6732
1,1,0,0,1,0,1,6732
0,0,1,0,1,0,1,6733
1,1,0,0,1,0,1,6733
0,0,1,0,1,0,1,6734
1,1,1,0,2,0,2,6734
2,2,1,0,3,0,3,6734
3,3,0,0,3,0,3,6734
0,0,1,0,1,0,1,6735
1,1,0,0,1,0,1,6735
0,0,1,0,1,0,1,6736
1,1,0,0,1,0,1,6736
0,0,1,0,1,0,1,6737
1,1,0,0,1,0,1,6737
0,0,1,0,1,0,1,6738
1,1,0,0,1,0,1,6738
0,0,1,0,1,0,1,6739
1,1,0,1,1,1,2,6739
2,2,0,0,1,1,2,6739
0,0,1,0,1,0,1,6740
1,1,0,0,1,0,1,6740
0,0,1,0,1,0,1,6741
1,1,1,0,2,0,2,6741
2,2,1,0,3,0,3,6741
3,3,1,0,4,0,4,6741
4,4,0,0,4,0,4,6741
0,0,1,0,1,0,1,6742
1,1,2,0,3,0,3,6742
2,2,2,0,5,0,5,6742
3,3,5,0,10,0,10,6742
4,4,7,1,17,1,18,6742
5,5,6,1,23,2,25,6742
6,6,3,0,26,2,28,6742
7,7,3,1,29,3,32,6742
8,8,0,2,29,5,34,6742
9,9,0,1,29,6,35,6742
10,10,0,1,29,7,36,6742
11,11,0,1,29,8,37,6742
12,12,0,0,29,8,37,6742
0,0,1,0,1,0,1,6743
1,1,1,0,2,0,2,6743
2,2,1,0,3,0,3,6743
3,3,0,0,3,0,3,6743
0,0,1,0,1,0,1,6744
1,1,0,0,1,0,1,6744
0,0,1,0,1,0,1,6745
1,1,0,0,1,0,1,6745
0,0,1,0,1,0,1,6746
1,1,2,0,3,0,3,6746
2,2,2,1,5,1,6,6746
3,3,1,0,6,1,7,6746
4,4,0,0,6,1,7,6746
0,0,1,0,1,0,1,6747
1,1,1,0,2,0,2,6747
2,2,0,0,2,0,2,6747
0,0,1,0,1,0,1,6748
1,1,1,0,2,0,2,6748
2,2,1,0,3,0,3,6748
3,3,0,0,3,0,3,6748
0,0,1,0,1,0,1,6749
1,1,2,0,3,0,3,6749
2,2,0,2,3,2,5,6749
3,3,1,1,4,3,7,6749
4,4,2,1,6,4,10,6749
5,5,3,1,9,5,14,6749
6,6,3,2,12,7,19,6749
7,7,2,2,14,9,23,6749
8,8,1,1,15,10,25,6749
9,9,0,1,15,11,26,6749
10,10,0,2,15,13,28,6749
11,11,1,4,16,17,33,6749
12,12,2,4,18,21,39,6749
13,13,3,2,21,23,44,6749
14,14,5,2,26,25,51,6749
15,15,2,3,28,28,56,6749
16,16,3,5,31,33,64,6749
17,17,5,6,36,39,75,6749
18,18,2,3,38,42,80,6749
19,19,1,3,39,45,84,6749
20,20,1,3,40,48,88,6749
21,21,1,1,41,49,90,6749
22,22,3,3,44,52,96,6749
23,23,2,1,46,53,99,6749
24,24,2,1,48,54,102,6749
25,25,2,0,50,54,104,6749
26,26,1,0,51,54,105,6749
27,27,0,0,51,54,105,6749
0,0,1,0,1,0,1,6750
1,1,0,0,1,0,1,6750
0,0,1,0,1,0,1,6751
1,1,1,1,2,1,3,6751
2,2,0,0,2,1,3,6751
0,0,1,0,1,0,1,6752
1,1,1,0,2,0,2,6752
2,2,0,0,2,0,2,6752
0,0,1,0,1,0,1,6753
1,1,1,0,2,0,2,6753
2,2,3,0,5,0,5,6753
3,3,2,0,7,0,7,6753
4,4,2,0,9,0,9,6753
5,5,4,0,13,0,13,6753
6,6,2,2,15,2,17,6753
7,7,2,0,17,2,19,6753
8,8,2,1,19,3,22,6753
9,9,0,0,19,3,22,6753
0,0,1,0,1,0,1,6754
1,1,0,1,1,1,2,6754
2,2,0,2,1,3,4,6754
3,3,0,1,1,4,5,6754
4,4,0,0,1,4,5,6754
0,0,1,0,1,0,1,6755
1,1,0,0,1,0,1,6755
0,0,1,0,1,0,1,6756
1,1,1,0,2,0,2,6756
2,2,0,1,2,1,3,6756
3,3,0,1,2,2,4,6756
4,4,0,0,2,2,4,6756
0,0,1,0,1,0,1,6757
1,1,0,0,1,0,1,6757
0,0,1,0,1,0,1,6758
1,1,0,0,1,0,1,6758
0,0,1,0,1,0,1,6759
1,1,0,1,1,1,2,6759
2,2,0,1,1,2,3,6759
3,3,1,1,2,3,5,6759
4,4,1,1,3,4,7,6759
5,5,1,2,4,6,10,6759
6,6,1,0,5,6,11,6759
7,7,0,0,5,6,11,6759
0,0,1,0,1,0,1,6760
1,1,1,0,2,0,2,6760
2,2,1,1,3,1,4,6760
3,3,0,0,3,1,4,6760
0,0,1,0,1,0,1,6761
1,1,1,0,2,0,2,6761
2,2,0,0,2,0,2,6761
0,0,1,0,1,0,1,6762
1,1,1,0,2,0,2,6762
2,2,0,0,2,0,2,6762
0,0,1,0,1,0,1,6763
1,1,1,0,2,0,2,6763
2,2,2,0,4,0,4,6763
3,3,0,0,4,0,4,6763
0,0,1,0,1,0,1,6764
1,1,2,0,3,0,3,6764
2,2,0,0,3,0,3,6764
0,0,1,0,1,0,1,6765
1,1,0,0,1,0,1,6765
0,0,1,0,1,0,1,6766
1,1,1,0,2,0,2,6766
2,2,1,1,3,1,4,6766
3,3,2,0,5,1,6,6766
4,4,1,0,6,1,7,6766
5,5,1,0,7,1,8,6766
6,6,0,1,7,2,9,6766
7,7,0,1,7,3,10,6766
8,8,1,1,8,4,12,6766
9,9,0,2,8,6,14,6766
10,10,1,2,9,8,17,6766
11,11,0,2,9,10,19,6766
12,12,1,1,10,11,21,6766
13,13,2,1,12,12,24,6766
14,14,1,1,13,13,26,6766
15,15,1,1,14,14,28,6766
16,16,2,1,16,15,31,6766
17,17,2,2,18,17,35,6766
18,18,3,2,21,19,40,6766
19,19,3,3,24,22,46,6766
20,20,0,5,24,27,51,6766
21,21,0,3,24,30,54,6766
22,22,0,0,24,30,54,6766
0,0,1,0,1,0,1,6767
1,1,1,0,2,0,2,6767
2,2,1,0,3,0,3,6767
3,3,0,0,3,0,3,6767
0,0,1,0,1,0,1,6768
1,1,2,0,3,0,3,6768
2,2,1,1,4,1,5,6768
3,3,1,1,5,2,7,6768
4,4,1,0,6,2,8,6768
5,5,1,0,7,2,9,6768
6,6,0,0,7,2,9,6768
0,0,1,0,1,0,1,6769
1,1,2,0,3,0,3,6769
2,2,0,0,3,0,3,6769
0,0,1,0,1,0,1,6770
1,1,2,0,3,0,3,6770
2,2,3,0,6,0,6,6770
3,3,2,0,8,0,8,6770
4,4,1,1,9,1,10,6770
5,5,4,1,13,2,15,6770
6,6,4,2,17,4,21,6770
7,7,3,3,20,7,27,6770
8,8,4,1,24,8,32,6770
9,9,3,1,27,9,36,6770
10,10,2,1,29,10,39,6770
11,11,2,0,31,10,41,6770
12,12,1,0,32,10,42,6770
13,13,0,1,32,11,43,6770
14,14,0,0,32,11,43,6770
0,0,1,0,1,0,1,6771
1,1,0,0,1,0,1,6771
0,0,1,0,1,0,1,6772
1,1,0,1,1,1,2,6772
2,2,0,1,1,2,3,6772
3,3,0,0,1,2,3,6772
0,0,1,0,1,0,1,6773
1,1,2,1,3,1,4,6773
2,2,1,2,4,3,7,6773
3,3,3,3,7,6,13,6773
4,4,2,4,9,10,19,6773
5,5,3,2,12,12,24,6773
6,6,3,1,15,13,28,6773
7,7,3,1,18,14,32,6773
8,8,1,3,19,17,36,6773
9,9,1,3,20,20,40,6773
10,10,0,2,20,22,42,6773
11,11,1,2,21,24,45,6773
12,12,0,0,21,24,45,6773
0,0,1,0,1,0,1,6774
1,1,0,0,1,0,1,6774
0,0,1,0,1,0,1,6775
1,1,1,0,2,0,2,6775
2,2,0,0,2,0,2,6775
0,0,1,0,1,0,1,6776
1,1,1,0,2,0,2,6776
2,2,1,0,3,0,3,6776
3,3,2,0,5,0,5,6776
4,4,0,1,5,1,6,6776
5,5,1,2,6,3,9,6776
6,6,1,0,7,3,10,6776
7,7,0,1,7,4,11,6776
8,8,0,1,7,5,12,6776
9,9,1,1,8,6,14,6776
10,10,3,1,11,7,18,6776
11,11,1,2,12,9,21,6776
12,12,0,3,12,12,24,6776
13,13,0,3,12,15,27,6776
14,14,0,3,12,18,30,6776
15,15,0,2,12,20,32,6776
16,16,0,4,12,24,36,6776
17,17,1,1,13,25,38,6776
18,18,1,2,14,27,41,6776
19,19,1,4,15,31,46,6776
20,20,0,3,15,34,49,6776
21,21,0,0,15,34,49,6776
0,0,1,0,1,0,1,6777
1,1,0,1,1,1,2,6777
2,2,0,0,1,1,2,6777
0,0,1,0,1,0,1,6778
1,1,0,0,1,0,1,6778
0,0,1,0,1,0,1,6779
1,1,0,0,1,0,1,6779
0,0,1,0,1,0,1,6780
1,1,1,0,2,0,2,6780
2,2,1,0,3,0,3,6780
3,3,2,1,5,1,6,6780
4,4,1,0,6,1,7,6780
5,5,1,0,7,1,8,6780
6,6,0,0,7,1,8,6780
0,0,1,0,1,0,1,6781
1,1,1,0,2,0,2,6781
2,2,0,0,2,0,2,6781
0,0,1,0,1,0,1,6782
1,1,0,0,1,0,1,6782
0,0,1,0,1,0,1,6783
1,1,2,0,3,0,3,6783
2,2,2,0,5,0,5,6783
3,3,3,0,8,0,8,6783
4,4,6,0,14,0,14,6783
5,5,2,1,16,1,17,6783
6,6,1,1,17,2,19,6783
7,7,1,0,18,2,20,6783
8,8,0,0,18,2,20,6783
0,0,1,0,1,0,1,6784
1,1,0,0,1,0,1,6784
0,0,1,0,1,0,1,6785
1,1,2,0,3,0,3,6785
2,2,1,0,4,0,4,6785
3,3,1,0,5,0,5,6785
4,4,0,0,5,0,5,6785
0,0,1,0,1,0,1,6786
1,1,1,0,2,0,2,6786
2,2,0,0,2,0,2,6786
0,0,1,0,1,0,1,6787
1,1,0,0,1,0,1,6787
0,0,1,0,1,0,1,6788
1,1,0,0,1,0,1,6788
0,0,1,0,1,0,1,6789
1,1,3,0,4,0,4,6789
2,2,2,0,6,0,6,6789
3,3,1,0,7,0,7,6789
4,4,2,0,9,0,9,6789
5,5,1,0,10,0,10,6789
6,6,0,0,10,0,10,6789
0,0,1,0,1,0,1,6790
1,1,1,1,2,1,3,6790
2,2,0,0,2,1,3,6790
0,0,1,0,1,0,1,6791
1,1,1,0,2,0,2,6791
2,2,1,0,3,0,3,6791
3,3,0,0,3,0,3,6791
0,0,1,0,1,0,1,6792
1,1,2,0,3,0,3,6792
2,2,2,0,5,0,5,6792
3,3,1,0,6,0,6,6792
4,4,1,1,7,1,8,6792
5,5,2,0,9,1,10,6792
6,6,1,0,10,1,11,6792
7,7,0,0,10,1,11,6792
0,0,1,0,1,0,1,6793
1,1,0,1,1,1,2,6793
2,2,0,0,1,1,2,6793
0,0,1,0,1,0,1,6794
1,1,1,0,2,0,2,6794
2,2,1,0,3,0,3,6794
3,3,0,0,3,0,3,6794
0,0,1,0,1,0,1,6795
1,1,2,1,3,1,4,6795
2,2,1,0,4,1,5,6795
3,3,2,0,6,1,7,6795
4,4,1,1,7,2,9,6795
5,5,1,0,8,2,10,6795
6,6,1,0,9,2,11,6795
7,7,0,0,9,2,11,6795
0,0,1,0,1,0,1,6796
1,1,2,0,3,0,3,6796
2,2,3,1,6,1,7,6796
3,3,0,2,6,3,9,6796
4,4,0,0,6,3,9,6796
0,0,1,0,1,0,1,6797
1,1,0,0,1,0,1,6797
0,0,1,0,1,0,1,6798
1,1,1,0,2,0,2,6798
2,2,1,0,3,0,3,6798
3,3,1,0,4,0,4,6798
4,4,1,0,5,0,5,6798
5,5,0,0,5,0,5,6798
0,0,1,0,1,0,1,6799
1,1,0,2,1,2,3,6799
2,2,1,0,2,2,4,6799
3,3,2,1,4,3,7,6799
4,4,0,0,4,3,7,6799
0,0,1,0,1,0,1,6800
1,1,1,0,2,0,2,6800
2,2,0,0,2,0,2,6800
0,0,1,0,1,0,1,6801
1,1,1,0,2,0,2,6801
2,2,1,2,3,2,5,6801
3,3,2,4,5,6,11,6801
4,4,3,0,8,6,14,6801
5,5,6,2,14,8,22,6801
6,6,4,2,18,10,28,6801
7,7,5,1,23,11,34,6801
8,8,3,0,26,11,37,6801
9,9,1,1,27,12,39,6801
10,10,0,3,27,15,42,6801
11,11,0,1,27,16,43,6801
12,12,0,1,27,17,44,6801
13,13,0,1,27,18,45,6801
14,14,0,1,27,19,46,6801
15,15,0,0,27,19,46,6801
0,0,1,0,1,0,1,6802
1,1,0,0,1,0,1,6802
0,0,1,0,1,0,1,6803
1,1,0,0,1,0,1,6803
0,0,1,0,1,0,1,6804
1,1,1,0,2,0,2,6804
2,2,2,1,4,1,5,6804
3,3,0,0,4,1,5,6804
0,0,1,0,1,0,1,6805
1,1,0,0,1,0,1,6805
0,0,1,0,1,0,1,6806
1,1,1,0,2,0,2,6806
2,2,2,0,4,0,4,6806
3,3,2,0,6,0,6,6806
4,4,0,0,6,0,6,6806
0,0,1,0,1,0,1,6807
1,1,1,0,2,0,2,6807
2,2,2,0,4,0,4,6807
3,3,1,1,5,1,6,6807
4,4,1,3,6,4,10,6807
5,5,0,3,6,7,13,6807
6,6,0,0,6,7,13,6807
0,0,1,0,1,0,1,6808
1,1,0,0,1,0,1,6808
0,0,1,0,1,0,1,6809
1,1,0,1,1,1,2,6809
2,2,0,1,1,2,3,6809
3,3,1,1,2,3,5,6809
4,4,1,2,3,5,8,6809
5,5,1,1,4,6,10,6809
6,6,1,0,5,6,11,6809
7,7,1,0,6,6,12,6809
8,8,0,0,6,6,12,6809
0,0,1,0,1,0,1,6810
1,1,2,1,3,1,4,6810
2,2,2,2,5,3,8,6810
3,3,2,0,7,3,10,6810
4,4,3,0,10,3,13,6810
5,5,1,0,11,3,14,6810
6,6,1,1,12,4,16,6810
7,7,0,0,12,4,16,6810
0,0,1,0,1,0,1,6811
1,1,0,0,1,0,1,6811
0,0,1,0,1,0,1,6812
1,1,0,0,1,0,1,6812
0,0,1,0,1,0,1,6813
1,1,0,0,1,0,1,6813
0,0,1,0,1,0,1,6814
1,1,1,1,2,1,3,6814
2,2,3,0,5,1,6,6814
3,3,2,1,7,2,9,6814
4,4,4,0,11,2,13,6814
5,5,4,0,15,2,17,6814
6,6,2,2,17,4,21,6814
7,7,1,0,18,4,22,6814
8,8,0,0,18,4,22,6814
0,0,1,0,1,0,1,6815
1,1,0,0,1,0,1,6815
0,0,1,0,1,0,1,6816
1,1,0,0,1,0,1,6816
0,0,1,0,1,0,1,6817
1,1,2,1,3,1,4,6817
2,2,2,4,5,5,10,6817
3,3,1,1,6,6,12,6817
4,4,0,1,6,7,13,6817
5,5,0,0,6,7,13,6817
0,0,1,0,1,0,1,6818
1,1,1,0,2,0,2,6818
2,2,1,0,3,0,3,6818
3,3,0,0,3,0,3,6818
0,0,1,0,1,0,1,6819
1,1,0,0,1,0,1,6819
0,0,1,0,1,0,1,6820
1,1,1,0,2,0,2,6820
2,2,1,0,3,0,3,6820
3,3,1,0,4,0,4,6820
4,4,1,0,5,0,5,6820
5,5,0,0,5,0,5,6820
0,0,1,0,1,0,1,6821
1,1,0,0,1,0,1,6821
0,0,1,0,1,0,1,6822
1,1,1,1,2,1,3,6822
2,2,1,1,3,2,5,6822
3,3,1,1,4,3,7,6822
4,4,0,0,4,3,7,6822
0,0,1,0,1,0,1,6823
1,1,1,0,2,0,2,6823
2,2,0,0,2,0,2,6823
0,0,1,0,1,0,1,6824
1,1,4,0,5,0,5,6824
2,2,4,1,9,1,10,6824
3,3,2,1,11,2,13,6824
4,4,1,0,12,2,14,6824
5,5,0,0,12,2,14,6824
0,0,1,0,1,0,1,6825
1,1,2,0,3,0,3,6825
2,2,2,0,5,0,5,6825
3,3,1,0,6,0,6,6825
4,4,1,0,7,0,7,6825
5,5,1,0,8,0,8,6825
6,6,1,1,9,1,10,6825
7,7,0,1,9,2,11,6825
8,8,0,1,9,3,12,6825
9,9,1,1,10,4,14,6825
10,10,1,0,11,4,15,6825
11,11,1,0,12,4,16,6825
12,12,2,0,14,4,18,6825
13,13,1,0,15,4,19,6825
14,14,2,0,17,4,21,6825
15,15,1,0,18,4,22,6825
16,16,0,0,18,4,22,6825
0,0,1,0,1,0,1,6826
1,1,0,1,1,1,2,6826
2,2,0,0,1,1,2,6826
0,0,1,0,1,0,1,6827
1,1,1,1,2,1,3,6827
2,2,2,1,4,2,6,6827
3,3,1,2,5,4,9,6827
4,4,4,0,9,4,13,6827
5,5,3,2,12,6,18,6827
6,6,2,1,14,7,21,6827
7,7,0,1,14,8,22,6827
8,8,0,0,14,8,22,6827
0,0,1,0,1,0,1,6828
1,1,1,0,2,0,2,6828
2,2,1,0,3,0,3,6828
3,3,1,0,4,0,4,6828
4,4,0,0,4,0,4,6828
0,0,1,0,1,0,1,6829
1,1,1,0,2,0,2,6829
2,2,0,0,2,0,2,6829
0,0,1,0,1,0,1,6830
1,1,0,0,1,0,1,6830
0,0,1,0,1,0,1,6831
1,1,0,0,1,0,1,6831
0,0,1,0,1,0,1,6832
1,1,0,0,1,0,1,6832
0,0,1,0,1,0,1,6833
1,1,0,0,1,0,1,6833
0,0,1,0,1,0,1,6834
1,1,0,0,1,0,1,6834
0,0,1,0,1,0,1,6835
1,1,1,1,2,1,3,6835
2,2,0,0,2,1,3,6835
0,0,1,0,1,0,1,6836
1,1,1,0,2,0,2,6836
2,2,0,0,2,0,2,6836
0,0,1,0,1,0,1,6837
1,1,0,0,1,0,1,6837
0,0,1,0,1,0,1,6838
1,1,0,0,1,0,1,6838
0,0,1,0,1,0,1,6839
1,1,1,0,2,0,2,6839
2,2,0,1,2,1,3,6839
3,3,0,0,2,1,3,6839
0,0,1,0,1,0,1,6840
1,1,4,0,5,0,5,6840
2,2,1,1,6,1,7,6840
3,3,0,0,6,1,7,6840
0,0,1,0,1,0,1,6841
1,1,4,0,5,0,5,6841
2,2,5,1,10,1,11,6841
3,3,1,1,11,2,13,6841
4,4,1,0,12,2,14,6841
5,5,1,0,13,2,15,6841
6,6,1,0,14,2,16,6841
7,7,3,0,17,2,19,6841
8,8,1,0,18,2,20,6841
9,9,0,0,18,2,20,6841
0,0,1,0,1,0,1,6842
1,1,0,0,1,0,1,6842
0,0,1,0,1,0,1,6843
1,1,0,0,1,0,1,6843
0,0,1,0,1,0,1,6844
1,1,2,0,3,0,3,6844
2,2,1,1,4,1,5,6844
3,3,2,2,6,3,9,6844
4,4,1,1,7,4,11,6844
5,5,1,2,8,6,14,6844
6,6,1,4,9,10,19,6844
7,7,2,3,11,13,24,6844
8,8,1,1,12,14,26,6844
9,9,1,1,13,15,28,6844
10,10,0,0,13,15,28,6844
0,0,1,0,1,0,1,6845
1,1,0,0,1,0,1,6845
0,0,1,0,1,0,1,6846
1,1,1,0,2,0,2,6846
2,2,0,0,2,0,2,6846
0,0,1,0,1,0,1,6847
1,1,0,0,1,0,1,6847
0,0,1,0,1,0,1,6848
1,1,0,0,1,0,1,6848
0,0,1,0,1,0,1,6849
1,1,1,0,2,0,2,6849
2,2,0,0,2,0,2,6849
0,0,1,0,1,0,1,6850
1,1,1,1,2,1,3,6850
2,2,2,1,4,2,6,6850
3,3,2,1,6,3,9,6850
4,4,1,2,7,5,12,6850
5,5,3,5,10,10,20,6850
6,6,4,5,14,15,29,6850
7,7,7,7,21,22,43,6850
8,8,5,7,26,29,55,6850
9,9,7,3,33,32,65,6850
10,10,3,1,36,33,69,6850
11,11,1,1,37,34,71,6850
12,12,0,1,37,35,72,6850
13,13,0,1,37,36,73,6850
14,14,1,2,38,38,76,6850
15,15,0,5,38,43,81,6850
16,16,1,2,39,45,84,6850
17,17,2,1,41,46,87,6850
18,18,3,0,44,46,90,6850
19,19,4,1,48,47,95,6850
20,20,6,3,54,50,104,6850
21,21,6,5,60,55,115,6850
22,22,6,4,66,59,125,6850
23,23,4,3,70,62,132,6850
24,24,3,2,73,64,137,6850
25,25,1,4,74,68,142,6850
26,26,2,5,76,73,149,6850
27,27,2,3,78,76,154,6850
28,28,0,3,78,79,157,6850
29,29,1,5,79,84,163,6850
30,30,3,2,82,86,168,6850
31,31,3,3,85,89,174,6850
32,32,1,3,86,92,178,6850
33,33,2,3,88,95,183,6850
34,34,3,2,91,97,188,6850
35,35,2,1,93,98,191,6850
36,36,2,1,95,99,194,6850
37,37,1,2,96,101,197,6850
38,38,1,1,97,102,199,6850
39,39,0,0,97,102,199,6850
0,0,1,0,1,0,1,6851
1,1,0,0,1,0,1,6851
0,0,1,0,1,0,1,6852
1,1,1,0,2,0,2,6852
2,2,1,0,3,0,3,6852
3,3,2,0,5,0,5,6852
4,4,4,0,9,0,9,6852
5,5,4,0,13,0,13,6852
6,6,2,1,15,1,16,6852
7,7,0,1,15,2,17,6852
8,8,1,2,16,4,20,6852
9,9,2,0,18,4,22,6852
10,10,1,0,19,4,23,6852
11,11,3,1,22,5,27,6852
12,12,6,2,28,7,35,6852
13,13,6,3,34,10,44,6852
14,14,3,5,37,15,52,6852
15,15,1,4,38,19,57,6852
16,16,0,4,38,23,61,6852
17,17,0,0,38,23,61,6852
0,0,1,0,1,0,1,6853
1,1,0,0,1,0,1,6853
0,0,1,0,1,0,1,6854
1,1,0,0,1,0,1,6854
0,0,1,0,1,0,1,6855
1,1,0,0,1,0,1,6855
0,0,1,0,1,0,1,6856
1,1,0,0,1,0,1,6856
0,0,1,0,1,0,1,6857
1,1,1,0,2,0,2,6857
2,2,1,0,3,0,3,6857
3,3,1,1,4,1,5,6857
4,4,2,0,6,1,7,6857
5,5,0,0,6,1,7,6857
0,0,1,0,1,0,1,6858
1,1,2,0,3,0,3,6858
2,2,2,0,5,0,5,6858
3,3,1,0,6,0,6,6858
4,4,0,0,6,0,6,6858
0,0,1,0,1,0,1,6859
1,1,0,2,1,2,3,6859
2,2,0,2,1,4,5,6859
3,3,0,5,1,9,10,6859
4,4,0,3,1,12,13,6859
5,5,0,4,1,16,17,6859
6,6,0,2,1,18,19,6859
7,7,1,0,2,18,20,6859
8,8,1,1,3,19,22,6859
9,9,1,0,4,19,23,6859
10,10,1,0,5,19,24,6859
11,11,2,1,7,20,27,6859
12,12,1,2,8,22,30,6859
13,13,1,0,9,22,31,6859
14,14,1,0,10,22,32,6859
15,15,2,1,12,23,35,6859
16,16,2,0,14,23,37,6859
17,17,0,0,14,23,37,6859
0,0,1,0,1,0,1,6860
1,1,1,0,2,0,2,6860
2,2,0,0,2,0,2,6860
0,0,1,0,1,0,1,6861
1,1,0,1,1,1,2,6861
2,2,1,2,2,3,5,6861
3,3,0,0,2,3,5,6861
0,0,1,0,1,0,1,6862
1,1,0,0,1,0,1,6862
0,0,1,0,1,0,1,6863
1,1,0,0,1,0,1,6863
0,0,1,0,1,0,1,6864
1,1,1,0,2,0,2,6864
2,2,0,0,2,0,2,6864
0,0,1,0,1,0,1,6865
1,1,2,0,3,0,3,6865
2,2,0,0,3,0,3,6865
0,0,1,0,1,0,1,6866
1,1,2,0,3,0,3,6866
2,2,0,0,3,0,3,6866
0,0,1,0,1,0,1,6867
1,1,1,1,2,1,3,6867
2,2,1,3,3,4,7,6867
3,3,1,1,4,5,9,6867
4,4,1,2,5,7,12,6867
5,5,0,4,5,11,16,6867
6,6,0,2,5,13,18,6867
7,7,0,1,5,14,19,6867
8,8,0,1,5,15,20,6867
9,9,0,1,5,16,21,6867
10,10,1,0,6,16,22,6867
11,11,1,0,7,16,23,6867
12,12,0,0,7,16,23,6867
0,0,1,0,1,0,1,6868
1,1,1,0,2,0,2,6868
2,2,0,0,2,0,2,6868
0,0,1,0,1,0,1,6869
1,1,0,0,1,0,1,6869
0,0,1,0,1,0,1,6870
1,1,1,0,2,0,2,6870
2,2,1,0,3,0,3,6870
3,3,0,0,3,0,3,6870
0,0,1,0,1,0,1,6871
1,1,1,0,2,0,2,6871
2,2,0,0,2,0,2,6871
0,0,1,0,1,0,1,6872
1,1,2,0,3,0,3,6872
2,2,2,2,5,2,7,6872
3,3,3,2,8,4,12,6872
4,4,0,4,8,8,16,6872
5,5,1,1,9,9,18,6872
6,6,0,1,9,10,19,6872
7,7,0,0,9,10,19,6872
0,0,1,0,1,0,1,6873
1,1,2,0,3,0,3,6873
2,2,1,0,4,0,4,6873
3,3,0,0,4,0,4,6873
0,0,1,0,1,0,1,6874
1,1,1,0,2,0,2,6874
2,2,0,0,2,0,2,6874
0,0,1,0,1,0,1,6875
1,1,0,0,1,0,1,6875
0,0,1,0,1,0,1,6876
1,1,0,0,1,0,1,6876
0,0,1,0,1,0,1,6877
1,1,1,0,2,0,2,6877
2,2,0,1,2,1,3,6877
3,3,0,0,2,1,3,6877
0,0,1,0,1,0,1,6878
1,1,1,0,2,0,2,6878
2,2,0,0,2,0,2,6878
0,0,1,0,1,0,1,6879
1,1,0,0,1,0,1,6879
0,0,1,0,1,0,1,6880
1,1,1,1,2,1,3,6880
2,2,0,0,2,1,3,6880
0,0,1,0,1,0,1,6881
1,1,2,0,3,0,3,6881
2,2,0,3,3,3,6,6881
3,3,0,2,3,5,8,6881
4,4,0,0,3,5,8,6881
0,0,1,0,1,0,1,6882
1,1,0,0,1,0,1,6882
0,0,1,0,1,0,1,6883
1,1,0,0,1,0,1,6883
0,0,1,0,1,0,1,6884
1,1,1,0,2,0,2,6884
2,2,0,3,2,3,5,6884
3,3,0,0,2,3,5,6884
0,0,1,0,1,0,1,6885
1,1,0,0,1,0,1,6885
0,0,1,0,1,0,1,6886
1,1,0,0,1,0,1,6886
0,0,1,0,1,0,1,6887
1,1,1,0,2,0,2,6887
2,2,1,0,3,0,3,6887
3,3,0,0,3,0,3,6887
0,0,1,0,1,0,1,6888
1,1,1,0,2,0,2,6888
2,2,1,0,3,0,3,6888
3,3,0,0,3,0,3,6888
0,0,1,0,1,0,1,6889
1,1,2,0,3,0,3,6889
2,2,0,0,3,0,3,6889
0,0,1,0,1,0,1,6890
1,1,2,0,3,0,3,6890
2,2,0,0,3,0,3,6890
0,0,1,0,1,0,1,6891
1,1,2,0,3,0,3,6891
2,2,2,0,5,0,5,6891
3,3,0,0,5,0,5,6891
0,0,1,0,1,0,1,6892
1,1,0,1,1,1,2,6892
2,2,0,3,1,4,5,6892
3,3,1,1,2,5,7,6892
4,4,0,2,2,7,9,6892
5,5,0,1,2,8,10,6892
6,6,0,1,2,9,11,6892
7,7,0,1,2,10,12,6892
8,8,0,2,2,12,14,6892
9,9,0,3,2,15,17,6892
10,10,0,2,2,17,19,6892
11,11,1,1,3,18,21,6892
12,12,1,1,4,19,23,6892
13,13,0,1,4,20,24,6892
14,14,1,1,5,21,26,6892
15,15,1,1,6,22,28,6892
16,16,1,1,7,23,30,6892
17,17,2,1,9,24,33,6892
18,18,0,0,9,24,33,6892
0,0,1,0,1,0,1,6893
1,1,0,0,1,0,1,6893
0,0,1,0,1,0,1,6894
1,1,1,0,2,0,2,6894
2,2,1,0,3,0,3,6894
3,3,1,0,4,0,4,6894
4,4,3,0,7,0,7,6894
5,5,1,1,8,1,9,6894
6,6,0,2,8,3,11,6894
7,7,1,2,9,5,14,6894
8,8,2,3,11,8,19,6894
9,9,3,2,14,10,24,6894
10,10,3,4,17,14,31,6894
11,11,1,2,18,16,34,6894
12,12,1,2,19,18,37,6894
13,13,0,1,19,19,38,6894
14,14,0,0,19,19,38,6894
0,0,1,0,1,0,1,6895
1,1,1,0,2,0,2,6895
2,2,0,1,2,1,3,6895
3,3,0,0,2,1,3,6895
0,0,1,0,1,0,1,6896
1,1,1,0,2,0,2,6896
2,2,2,1,4,1,5,6896
3,3,1,1,5,2,7,6896
4,4,3,0,8,2,10,6896
5,5,3,0,11,2,13,6896
6,6,0,0,11,2,13,6896
0,0,1,0,1,0,1,6897
1,1,1,0,2,0,2,6897
2,2,3,0,5,0,5,6897
3,3,1,0,6,0,6,6897
4,4,1,0,7,0,7,6897
5,5,0,0,7,0,7,6897
0,0,1,0,1,0,1,6898
1,1,0,0,1,0,1,6898
0,0,1,0,1,0,1,6899
1,1,0,0,1,0,1,6899
0,0,1,0,1,0,1,6900
1,1,1,0,2,0,2,6900
2,2,2,0,4,0,4,6900
3,3,1,1,5,1,6,6900
4,4,0,3,5,4,9,6900
5,5,0,1,5,5,10,6900
6,6,0,0,5,5,10,6900
0,0,1,0,1,0,1,6901
1,1,0,0,1,0,1,6901
0,0,1,0,1,0,1,6902
1,1,2,0,3,0,3,6902
2,2,3,0,6,0,6,6902
3,3,0,0,6,0,6,6902
0,0,1,0,1,0,1,6903
1,1,0,0,1,0,1,6903
0,0,1,0,1,0,1,6904
1,1,0,1,1,1,2,6904
2,2,0,2,1,3,4,6904
3,3,1,0,2,3,5,6904
4,4,0,0,2,3,5,6904
0,0,1,0,1,0,1,6905
1,1,0,0,1,0,1,6905
0,0,1,0,1,0,1,6906
1,1,0,0,1,0,1,6906
0,0,1,0,1,0,1,6907
1,1,1,1,2,1,3,6907
2,2,1,0,3,1,4,6907
3,3,3,0,6,1,7,6907
4,4,2,0,8,1,9,6907
5,5,5,0,13,1,14,6907
6,6,2,0,15,1,16,6907
7,7,2,0,17,1,18,6907
8,8,3,0,20,1,21,6907
9,9,1,0,21,1,22,6907
10,10,0,0,21,1,22,6907
0,0,1,0,1,0,1,6908
1,1,2,1,3,1,4,6908
2,2,0,1,3,2,5,6908
3,3,0,1,3,3,6,6908
4,4,0,0,3,3,6,6908
0,0,1,0,1,0,1,6909
1,1,0,0,1,0,1,6909
0,0,1,0,1,0,1,6910
1,1,1,0,2,0,2,6910
2,2,0,0,2,0,2,6910
0,0,1,0,1,0,1,6911
1,1,2,0,3,0,3,6911
2,2,0,0,3,0,3,6911
0,0,1,0,1,0,1,6912
1,1,1,0,2,0,2,6912
2,2,0,0,2,0,2,6912
0,0,1,0,1,0,1,6913
1,1,1,0,2,0,2,6913
2,2,1,1,3,1,4,6913
3,3,1,1,4,2,6,6913
4,4,0,1,4,3,7,6913
5,5,0,2,4,5,9,6913
6,6,0,1,4,6,10,6913
7,7,1,1,5,7,12,6913
8,8,0,1,5,8,13,6913
9,9,0,1,5,9,14,6913
10,10,0,0,5,9,14,6913
0,0,1,0,1,0,1,6914
1,1,1,0,2,0,2,6914
2,2,0,0,2,0,2,6914
0,0,1,0,1,0,1,6915
1,1,0,0,1,0,1,6915
0,0,1,0,1,0,1,6916
1,1,1,0,2,0,2,6916
2,2,2,0,4,0,4,6916
3,3,3,0,7,0,7,6916
4,4,4,0,11,0,11,6916
5,5,4,1,15,1,16,6916
6,6,1,1,16,2,18,6916
7,7,1,2,17,4,21,6916
8,8,2,1,19,5,24,6916
9,9,1,1,20,6,26,6916
10,10,0,1,20,7,27,6916
11,11,0,1,20,8,28,6916
12,12,0,0,20,8,28,6916
0,0,1,0,1,0,1,6917
1,1,1,0,2,0,2,6917
2,2,0,0,2,0,2,6917
0,0,1,0,1,0,1,6918
1,1,0,0,1,0,1,6918
0,0,1,0,1,0,1,6919
1,1,2,0,3,0,3,6919
2,2,2,0,5,0,5,6919
3,3,0,2,5,2,7,6919
4,4,0,3,5,5,10,6919
5,5,1,2,6,7,13,6919
6,6,3,2,9,9,18,6919
7,7,2,1,11,10,21,6919
8,8,3,1,14,11,25,6919
9,9,2,4,16,15,31,6919
10,10,3,4,19,19,38,6919
11,11,2,5,21,24,45,6919
12,12,4,4,25,28,53,6919
13,13,5,6,30,34,64,6919
14,14,4,8,34,42,76,6919
15,15,3,6,37,48,85,6919
16,16,2,2,39,50,89,6919
17,17,1,3,40,53,93,6919
18,18,2,4,42,57,99,6919
19,19,0,3,42,60,102,6919
20,20,1,2,43,62,105,6919
21,21,0,7,43,69,112,6919
22,22,3,5,46,74,120,6919
23,23,5,7,51,81,132,6919
24,24,5,4,56,85,141,6919
25,25,2,8,58,93,151,6919
26,26,4,4,62,97,159,6919
27,27,2,3,64,100,164,6919
28,28,1,2,65,102,167,6919
29,29,1,4,66,106,172,6919
30,30,3,1,69,107,176,6919
31,31,3,1,72,108,180,6919
32,32,3,1,75,109,184,6919
33,33,1,2,76,111,187,6919
34,34,2,1,78,112,190,6919
35,35,1,1,79,113,192,6919
36,36,1,3,80,116,196,6919
37,37,0,3,80,119,199,6919
38,38,0,5,80,124,204,6919
39,39,1,3,81,127,208,6919
40,40,1,0,82,127,209,6919
41,41,1,0,83,127,210,6919
42,42,1,1,84,128,212,6919
43,43,0,2,84,130,214,6919
44,44,1,0,85,130,215,6919
45,45,1,0,86,130,216,6919
46,46,0,0,86,130,216,6919
0,0,1,0,1,0,1,6920
1,1,1,0,2,0,2,6920
2,2,0,0,2,0,2,6920
0,0,1,0,1,0,1,6921
1,1,1,0,2,0,2,6921
2,2,0,0,2,0,2,6921
0,0,1,0,1,0,1,6922
1,1,0,0,1,0,1,6922
0,0,1,0,1,0,1,6923
1,1,1,0,2,0,2,6923
2,2,2,0,4,0,4,6923
3,3,3,0,7,0,7,6923
4,4,2,0,9,0,9,6923
5,5,3,0,12,0,12,6923
6,6,3,2,15,2,17,6923
7,7,5,1,20,3,23,6923
8,8,1,4,21,7,28,6923
9,9,1,2,22,9,31,6923
10,10,0,1,22,10,32,6923
11,11,0,2,22,12,34,6923
12,12,1,1,23,13,36,6923
13,13,0,1,23,14,37,6923
14,14,0,1,23,15,38,6923
15,15,0,1,23,16,39,6923
16,16,1,0,24,16,40,6923
17,17,0,0,24,16,40,6923
0,0,1,0,1,0,1,6924
1,1,0,0,1,0,1,6924
0,0,1,0,1,0,1,6925
1,1,1,0,2,0,2,6925
2,2,0,0,2,0,2,6925
0,0,1,0,1,0,1,6926
1,1,1,0,2,0,2,6926
2,2,1,0,3,0,3,6926
3,3,0,0,3,0,3,6926
0,0,1,0,1,0,1,6927
1,1,2,1,3,1,4,6927
2,2,1,0,4,1,5,6927
3,3,0,1,4,2,6,6927
4,4,0,1,4,3,7,6927
5,5,0,0,4,3,7,6927
0,0,1,0,1,0,1,6928
1,1,1,0,2,0,2,6928
2,2,0,0,2,0,2,6928
0,0,1,0,1,0,1,6929
1,1,0,1,1,1,2,6929
2,2,0,1,1,2,3,6929
3,3,0,0,1,2,3,6929
0,0,1,0,1,0,1,6930
1,1,1,0,2,0,2,6930
2,2,1,1,3,1,4,6930
3,3,2,1,5,2,7,6930
4,4,4,4,9,6,15,6930
5,5,4,5,13,11,24,6930
6,6,5,2,18,13,31,6930
7,7,3,1,21,14,35,6930
8,8,5,0,26,14,40,6930
9,9,3,1,29,15,44,6930
10,10,6,1,35,16,51,6930
11,11,5,2,40,18,58,6930
12,12,6,2,46,20,66,6930
13,13,6,1,52,21,73,6930
14,14,1,2,53,23,76,6930
15,15,1,0,54,23,77,6930
16,16,1,0,55,23,78,6930
17,17,1,0,56,23,79,6930
18,18,0,0,56,23,79,6930
0,0,1,0,1,0,1,6931
1,1,0,0,1,0,1,6931
0,0,1,0,1,0,1,6932
1,1,0,0,1,0,1,6932
0,0,1,0,1,0,1,6933
1,1,2,0,3,0,3,6933
2,2,4,0,7,0,7,6933
3,3,0,4,7,4,11,6933
4,4,2,3,9,7,16,6933
5,5,0,1,9,8,17,6933
6,6,0,0,9,8,17,6933
0,0,1,0,1,0,1,6934
1,1,2,0,3,0,3,6934
2,2,0,0,3,0,3,6934
0,0,1,0,1,0,1,6935
1,1,0,0,1,0,1,6935
0,0,1,0,1,0,1,6936
1,1,2,0,3,0,3,6936
2,2,1,0,4,0,4,6936
3,3,0,0,4,0,4,6936
0,0,1,0,1,0,1,6937
1,1,1,0,2,0,2,6937
2,2,1,0,3,0,3,6937
3,3,2,0,5,0,5,6937
4,4,1,0,6,0,6,6937
5,5,1,0,7,0,7,6937
6,6,0,0,7,0,7,6937
0,0,1,0,1,0,1,6938
1,1,1,0,2,0,2,6938
2,2,0,0,2,0,2,6938
0,0,1,0,1,0,1,6939
1,1,0,1,1,1,2,6939
2,2,0,0,1,1,2,6939
0,0,1,0,1,0,1,6940
1,1,0,0,1,0,1,6940
0,0,1,0,1,0,1,6941
1,1,0,0,1,0,1,6941
0,0,1,0,1,0,1,6942
1,1,1,0,2,0,2,6942
2,2,1,0,3,0,3,6942
3,3,1,1,4,1,5,6942
4,4,0,1,4,2,6,6942
5,5,0,0,4,2,6,6942
0,0,1,0,1,0,1,6943
1,1,0,0,1,0,1,6943
0,0,1,0,1,0,1,6944
1,1,0,0,1,0,1,6944
0,0,1,0,1,0,1,6945
1,1,1,0,2,0,2,6945
2,2,0,0,2,0,2,6945
0,0,1,0,1,0,1,6946
1,1,0,0,1,0,1,6946
0,0,1,0,1,0,1,6947
1,1,0,0,1,0,1,6947
0,0,1,0,1,0,1,6948
1,1,0,0,1,0,1,6948
0,0,1,0,1,0,1,6949
1,1,1,0,2,0,2,6949
2,2,2,0,4,0,4,6949
3,3,4,0,8,0,8,6949
4,4,3,2,11,2,13,6949
5,5,5,0,16,2,18,6949
6,6,6,0,22,2,24,6949
7,7,5,0,27,2,29,6949
8,8,4,0,31,2,33,6949
9,9,3,0,34,2,36,6949
10,10,0,1,34,3,37,6949
11,11,0,1,34,4,38,6949
12,12,0,1,34,5,39,6949
13,13,0,2,34,7,41,6949
14,14,0,3,34,10,44,6949
15,15,0,6,34,16,50,6949
16,16,0,2,34,18,52,6949
17,17,2,3,36,21,57,6949
18,18,2,2,38,23,61,6949
19,19,2,1,40,24,64,6949
20,20,1,0,41,24,65,6949
21,21,1,1,42,25,67,6949
22,22,0,0,42,25,67,6949
0,0,1,0,1,0,1,6950
1,1,1,0,2,0,2,6950
2,2,0,0,2,0,2,6950
0,0,1,0,1,0,1,6951
1,1,1,0,2,0,2,6951
2,2,1,0,3,0,3,6951
3,3,1,0,4,0,4,6951
4,4,0,0,4,0,4,6951
0,0,1,0,1,0,1,6952
1,1,2,0,3,0,3,6952
2,2,2,0,5,0,5,6952
3,3,3,0,8,0,8,6952
4,4,3,0,11,0,11,6952
5,5,2,0,13,0,13,6952
6,6,0,1,13,1,14,6952
7,7,0,2,13,3,16,6952
8,8,0,0,13,3,16,6952
0,0,1,0,1,0,1,6953
1,1,0,0,1,0,1,6953
0,0,1,0,1,0,1,6954
1,1,0,0,1,0,1,6954
0,0,1,0,1,0,1,6955
1,1,0,0,1,0,1,6955
0,0,1,0,1,0,1,6956
1,1,3,0,4,0,4,6956
2,2,1,1,5,1,6,6956
3,3,1,2,6,3,9,6956
4,4,0,0,6,3,9,6956
0,0,1,0,1,0,1,6957
1,1,1,0,2,0,2,6957
2,2,1,1,3,1,4,6957
3,3,1,1,4,2,6,6957
4,4,2,0,6,2,8,6957
5,5,0,1,6,3,9,6957
6,6,1,1,7,4,11,6957
7,7,0,1,7,5,12,6957
8,8,0,1,7,6,13,6957
9,9,0,1,7,7,14,6957
10,10,0,0,7,7,14,6957
0,0,1,0,1,0,1,6958
1,1,1,0,2,0,2,6958
2,2,1,0,3,0,3,6958
3,3,2,1,5,1,6,6958
4,4,3,1,8,2,10,6958
5,5,3,0,11,2,13,6958
6,6,4,0,15,2,17,6958
7,7,3,0,18,2,20,6958
8,8,2,0,20,2,22,6958
9,9,2,1,22,3,25,6958
10,10,2,1,24,4,28,6958
11,11,2,0,26,4,30,6958
12,12,0,0,26,4,30,6958
0,0,1,0,1,0,1,6959
1,1,3,0,4,0,4,6959
2,2,3,2,7,2,9,6959
3,3,5,5,12,7,19,6959
4,4,6,4,18,11,29,6959
5,5,1,3,19,14,33,6959
6,6,1,7,20,21,41,6959
7,7,2,2,22,23,45,6959
8,8,0,3,22,26,48,6959
9,9,1,1,23,27,50,6959
10,10,1,1,24,28,52,6959
11,11,1,0,25,28,53,6959
12,12,1,0,26,28,54,6959
13,13,0,0,26,28,54,6959
0,0,1,0,1,0,1,6960
1,1,1,0,2,0,2,6960
2,2,0,1,2,1,3,6960
3,3,0,3,2,4,6,6960
4,4,0,1,2,5,7,6960
5,5,1,2,3,7,10,6960
6,6,1,5,4,12,16,6960
7,7,2,2,6,14,20,6960
8,8,2,1,8,15,23,6960
9,9,1,2,9,17,26,6960
10,10,0,1,9,18,27,6960
11,11,0,3,9,21,30,6960
12,12,0,4,9,25,34,6960
13,13,0,1,9,26,35,6960
14,14,0,1,9,27,36,6960
15,15,0,0,9,27,36,6960
0,0,1,0,1,0,1,6961
1,1,1,0,2,0,2,6961
2,2,0,0,2,0,2,6961
0,0,1,0,1,0,1,6962
1,1,1,0,2,0,2,6962
2,2,0,0,2,0,2,6962
0,0,1,0,1,0,1,6963
1,1,0,1,1,1,2,6963
2,2,0,1,1,2,3,6963
3,3,0,0,1,2,3,6963
0,0,1,0,1,0,1,6964
1,1,1,1,2,1,3,6964
2,2,1,2,3,3,6,6964
3,3,1,2,4,5,9,6964
4,4,1,3,5,8,13,6964
5,5,0,0,5,8,13,6964
0,0,1,0,1,0,1,6965
1,1,0,0,1,0,1,6965
0,0,1,0,1,0,1,6966
1,1,0,0,1,0,1,6966
0,0,1,0,1,0,1,6967
1,1,1,0,2,0,2,6967
2,2,1,0,3,0,3,6967
3,3,0,0,3,0,3,6967
0,0,1,0,1,0,1,6968
1,1,2,0,3,0,3,6968
2,2,0,0,3,0,3,6968
0,0,1,0,1,0,1,6969
1,1,2,0,3,0,3,6969
2,2,1,0,4,0,4,6969
3,3,1,0,5,0,5,6969
4,4,2,0,7,0,7,6969
5,5,2,0,9,0,9,6969
6,6,1,0,10,0,10,6969
7,7,2,0,12,0,12,6969
8,8,3,0,15,0,15,6969
9,9,3,1,18,1,19,6969
10,10,1,2,19,3,22,6969
11,11,3,1,22,4,26,6969
12,12,3,3,25,7,32,6969
13,13,3,4,28,11,39,6969
14,14,1,1,29,12,41,6969
15,15,3,1,32,13,45,6969
16,16,4,2,36,15,51,6969
17,17,3,4,39,19,58,6969
18,18,1,4,40,23,63,6969
19,19,2,0,42,23,65,6969
20,20,1,0,43,23,66,6969
21,21,0,0,43,23,66,6969
0,0,1,0,1,0,1,6970
1,1,0,0,1,0,1,6970
0,0,1,0,1,0,1,6971
1,1,0,0,1,0,1,6971
0,0,1,0,1,0,1,6972
1,1,1,0,2,0,2,6972
2,2,1,0,3,0,3,6972
3,3,0,0,3,0,3,6972
0,0,1,0,1,0,1,6973
1,1,0,0,1,0,1,6973
0,0,1,0,1,0,1,6974
1,1,1,0,2,0,2,6974
2,2,1,0,3,0,3,6974
3,3,0,0,3,0,3,6974
0,0,1,0,1,0,1,6975
1,1,1,0,2,0,2,6975
2,2,3,0,5,0,5,6975
3,3,4,0,9,0,9,6975
4,4,3,1,12,1,13,6975
5,5,5,1,17,2,19,6975
6,6,4,3,21,5,26,6975
7,7,5,2,26,7,33,6975
8,8,3,3,29,10,39,6975
9,9,3,0,32,10,42,6975
10,10,5,1,37,11,48,6975
11,11,4,1,41,12,53,6975
12,12,3,3,44,15,59,6975
13,13,3,4,47,19,66,6975
14,14,5,6,52,25,77,6975
15,15,5,5,57,30,87,6975
16,16,2,3,59,33,92,6975
17,17,2,4,61,37,98,6975
18,18,2,1,63,38,101,6975
19,19,2,1,65,39,104,6975
20,20,5,2,70,41,111,6975
21,21,2,2,72,43,115,6975
22,22,0,0,72,43,115,6975
0,0,1,0,1,0,1,6976
1,1,0,0,1,0,1,6976
0,0,1,0,1,0,1,6977
1,1,0,0,1,0,1,6977
0,0,1,0,1,0,1,6978
1,1,1,1,2,1,3,6978
2,2,2,2,4,3,7,6978
3,3,2,3,6,6,12,6978
4,4,1,2,7,8,15,6978
5,5,0,1,7,9,16,6978
6,6,0,1,7,10,17,6978
7,7,0,1,7,11,18,6978
8,8,0,2,7,13,20,6978
9,9,0,0,7,13,20,6978
0,0,1,0,1,0,1,6979
1,1,1,0,2,0,2,6979
2,2,0,0,2,0,2,6979
0,0,1,0,1,0,1,6980
1,1,0,0,1,0,1,6980
0,0,1,0,1,0,1,6981
1,1,0,0,1,0,1,6981
0,0,1,0,1,0,1,6982
1,1,0,0,1,0,1,6982
0,0,1,0,1,0,1,6983
1,1,1,0,2,0,2,6983
2,2,1,0,3,0,3,6983
3,3,0,0,3,0,3,6983
0,0,1,0,1,0,1,6984
1,1,1,0,2,0,2,6984
2,2,1,0,3,0,3,6984
3,3,0,0,3,0,3,6984
0,0,1,0,1,0,1,6985
1,1,0,0,1,0,1,6985
0,0,1,0,1,0,1,6986
1,1,0,0,1,0,1,6986
0,0,1,0,1,0,1,6987
1,1,1,0,2,0,2,6987
2,2,0,0,2,0,2,6987
0,0,1,0,1,0,1,6988
1,1,0,2,1,2,3,6988
2,2,0,0,1,2,3,6988
0,0,1,0,1,0,1,6989
1,1,1,0,2,0,2,6989
2,2,2,0,4,0,4,6989
3,3,3,0,7,0,7,6989
4,4,1,0,8,0,8,6989
5,5,1,0,9,0,9,6989
6,6,1,0,10,0,10,6989
7,7,0,0,10,0,10,6989
0,0,1,0,1,0,1,6990
1,1,0,1,1,1,2,6990
2,2,0,0,1,1,2,6990
0,0,1,0,1,0,1,6991
1,1,0,0,1,0,1,6991
0,0,1,0,1,0,1,6992
1,1,0,0,1,0,1,6992
0,0,1,0,1,0,1,6993
1,1,0,1,1,1,2,6993
2,2,1,0,2,1,3,6993
3,3,0,1,2,2,4,6993
4,4,0,0,2,2,4,6993
0,0,1,0,1,0,1,6994
1,1,0,0,1,0,1,6994
0,0,1,0,1,0,1,6995
1,1,0,0,1,0,1,6995
0,0,1,0,1,0,1,6996
1,1,2,0,3,0,3,6996
2,2,2,2,5,2,7,6996
3,3,1,2,6,4,10,6996
4,4,0,1,6,5,11,6996
5,5,0,0,6,5,11,6996
0,0,1,0,1,0,1,6997
1,1,0,0,1,0,1,6997
0,0,1,0,1,0,1,6998
1,1,0,0,1,0,1,6998
0,0,1,0,1,0,1,6999
1,1,1,0,2,0,2,6999
2,2,0,0,2,0,2,6999
0,0,1,0,1,0,1,7000
1,1,1,0,2,0,2,7000
2,2,1,2,3,2,5,7000
3,3,2,3,5,5,10,7000
4,4,0,4,5,9,14,7000
5,5,0,4,5,13,18,7000
6,6,0,0,5,13,18,7000
0,0,1,0,1,0,1,7001
1,1,1,1,2,1,3,7001
2,2,0,2,2,3,5,7001
3,3,1,1,3,4,7,7001
4,4,1,1,4,5,9,7001
5,5,1,0,5,5,10,7001
6,6,1,0,6,5,11,7001
7,7,0,0,6,5,11,7001
0,0,1,0,1,0,1,7002
1,1,1,1,2,1,3,7002
2,2,0,0,2,1,3,7002
0,0,1,0,1,0,1,7003
1,1,1,1,2,1,3,7003
2,2,0,0,2,1,3,7003
0,0,1,0,1,0,1,7004
1,1,0,0,1,0,1,7004
0,0,1,0,1,0,1,7005
1,1,0,0,1,0,1,7005
0,0,1,0,1,0,1,7006
1,1,0,0,1,0,1,7006
0,0,1,0,1,0,1,7007
1,1,0,0,1,0,1,7007
0,0,1,0,1,0,1,7008
1,1,0,0,1,0,1,7008
0,0,1,0,1,0,1,7009
1,1,0,0,1,0,1,7009
0,0,1,0,1,0,1,7010
1,1,3,0,4,0,4,7010
2,2,2,1,6,1,7,7010
3,3,2,0,8,1,9,7010
4,4,1,0,9,1,10,7010
5,5,0,0,9,1,10,7010
0,0,1,0,1,0,1,7011
1,1,1,0,2,0,2,7011
2,2,0,0,2,0,2,7011
0,0,1,0,1,0,1,7012
1,1,0,0,1,0,1,7012
0,0,1,0,1,0,1,7013
1,1,1,1,2,1,3,7013
2,2,2,0,4,1,5,7013
3,3,2,2,6,3,9,7013
4,4,3,2,9,5,14,7013
5,5,1,3,10,8,18,7013
6,6,1,4,11,12,23,7013
7,7,1,2,12,14,26,7013
8,8,1,2,13,16,29,7013
9,9,0,2,13,18,31,7013
10,10,0,0,13,18,31,7013
0,0,1,0,1,0,1,7014
1,1,1,1,2,1,3,7014
2,2,0,0,2,1,3,7014
0,0,1,0,1,0,1,7015
1,1,0,0,1,0,1,7015
0,0,1,0,1,0,1,7016
1,1,2,0,3,0,3,7016
2,2,2,0,5,0,5,7016
3,3,1,1,6,1,7,7016
4,4,1,0,7,1,8,7016
5,5,1,0,8,1,9,7016
6,6,0,0,8,1,9,7016
0,0,1,0,1,0,1,7017
1,1,1,0,2,0,2,7017
2,2,1,0,3,0,3,7017
3,3,0,0,3,0,3,7017
0,0,1,0,1,0,1,7018
1,1,1,1,2,1,3,7018
2,2,1,0,3,1,4,7018
3,3,0,1,3,2,5,7018
4,4,1,0,4,2,6,7018
5,5,1,0,5,2,7,7018
6,6,3,0,8,2,10,7018
7,7,1,0,9,2,11,7018
8,8,0,0,9,2,11,7018
0,0,1,0,1,0,1,7019
1,1,1,0,2,0,2,7019
2,2,2,1,4,1,5,7019
3,3,1,0,5,1,6,7019
4,4,0,0,5,1,6,7019
0,0,1,0,1,0,1,7020
1,1,0,0,1,0,1,7020
0,0,1,0,1,0,1,7021
1,1,1,0,2,0,2,7021
2,2,0,0,2,0,2,7021
0,0,1,0,1,0,1,7022
1,1,0,0,1,0,1,7022
0,0,1,0,1,0,1,7023
1,1,0,0,1,0,1,7023
0,0,1,0,1,0,1,7024
1,1,0,1,1,1,2,7024
2,2,0,0,1,1,2,7024
0,0,1,0,1,0,1,7025
1,1,0,0,1,0,1,7025
0,0,1,0,1,0,1,7026
1,1,1,0,2,0,2,7026
2,2,1,1,3,1,4,7026
3,3,0,2,3,3,6,7026
4,4,0,0,3,3,6,7026
0,0,1,0,1,0,1,7027
1,1,1,0,2,0,2,7027
2,2,0,1,2,1,3,7027
3,3,0,0,2,1,3,7027
0,0,1,0,1,0,1,7028
1,1,1,0,2,0,2,7028
2,2,0,0,2,0,2,7028
0,0,1,0,1,0,1,7029
1,1,1,0,2,0,2,7029
2,2,0,0,2,0,2,7029
0,0,1,0,1,0,1,7030
1,1,0,1,1,1,2,7030
2,2,1,0,2,1,3,7030
3,3,1,0,3,1,4,7030
4,4,0,0,3,1,4,7030
0,0,1,0,1,0,1,7031
1,1,1,0,2,0,2,7031
2,2,0,1,2,1,3,7031
3,3,0,2,2,3,5,7031
4,4,1,0,3,3,6,7031
5,5,2,0,5,3,8,7031
6,6,2,0,7,3,10,7031
7,7,4,0,11,3,14,7031
8,8,6,0,17,3,20,7031
9,9,7,1,24,4,28,7031
10,10,7,4,31,8,39,7031
11,11,8,5,39,13,52,7031
12,12,4,2,43,15,58,7031
13,13,6,4,49,19,68,7031
14,14,5,3,54,22,76,7031
15,15,4,2,58,24,82,7031
16,16,3,0,61,24,85,7031
17,17,1,0,62,24,86,7031
18,18,0,0,62,24,86,7031
0,0,1,0,1,0,1,7032
1,1,0,0,1,0,1,7032
0,0,1,0,1,0,1,7033
1,1,0,1,1,1,2,7033
2,2,0,0,1,1,2,7033
0,0,1,0,1,0,1,7034
1,1,1,0,2,0,2,7034
2,2,1,0,3,0,3,7034
3,3,0,0,3,0,3,7034
0,0,1,0,1,0,1,7035
1,1,1,0,2,0,2,7035
2,2,2,0,4,0,4,7035
3,3,1,0,5,0,5,7035
4,4,0,1,5,1,6,7035
5,5,0,2,5,3,8,7035
6,6,0,2,5,5,10,7035
7,7,0,1,5,6,11,7035
8,8,0,3,5,9,14,7035
9,9,1,1,6,10,16,7035
10,10,2,1,8,11,19,7035
11,11,3,0,11,11,22,7035
12,12,1,0,12,11,23,7035
13,13,1,0,13,11,24,7035
14,14,0,0,13,11,24,7035
0,0,1,0,1,0,1,7036
1,1,1,0,2,0,2,7036
2,2,0,1,2,1,3,7036
3,3,0,1,2,2,4,7036
4,4,0,0,2,2,4,7036
0,0,1,0,1,0,1,7037
1,1,1,0,2,0,2,7037
2,2,2,0,4,0,4,7037
3,3,2,0,6,0,6,7037
4,4,0,0,6,0,6,7037
0,0,1,0,1,0,1,7038
1,1,0,0,1,0,1,7038
0,0,1,0,1,0,1,7039
1,1,1,0,2,0,2,7039
2,2,2,1,4,1,5,7039
3,3,2,3,6,4,10,7039
4,4,0,0,6,4,10,7039
0,0,1,0,1,0,1,7040
1,1,0,0,1,0,1,7040
0,0,1,0,1,0,1,7041
1,1,2,0,3,0,3,7041
2,2,1,0,4,0,4,7041
3,3,1,0,5,0,5,7041
4,4,1,0,6,0,6,7041
5,5,0,0,6,0,6,7041
0,0,1,0,1,0,1,7042
1,1,1,1,2,1,3,7042
2,2,2,0,4,1,5,7042
3,3,1,0,5,1,6,7042
4,4,0,0,5,1,6,7042
0,0,1,0,1,0,1,7043
1,1,0,0,1,0,1,7043
0,0,1,0,1,0,1,7044
1,1,2,0,3,0,3,7044
2,2,2,0,5,0,5,7044
3,3,1,1,6,1,7,7044
4,4,2,0,8,1,9,7044
5,5,2,2,10,3,13,7044
6,6,2,1,12,4,16,7044
7,7,2,0,14,4,18,7044
8,8,0,0,14,4,18,7044
0,0,1,0,1,0,1,7045
1,1,1,0,2,0,2,7045
2,2,1,0,3,0,3,7045
3,3,0,0,3,0,3,7045
0,0,1,0,1,0,1,7046
1,1,0,0,1,0,1,7046
0,0,1,0,1,0,1,7047
1,1,0,0,1,0,1,7047
0,0,1,0,1,0,1,7048
1,1,0,0,1,0,1,7048
0,0,1,0,1,0,1,7049
1,1,0,0,1,0,1,7049
0,0,1,0,1,0,1,7050
1,1,1,0,2,0,2,7050
2,2,1,0,3,0,3,7050
3,3,0,0,3,0,3,7050
0,0,1,0,1,0,1,7051
1,1,1,0,2,0,2,7051
2,2,1,1,3,1,4,7051
3,3,1,0,4,1,5,7051
4,4,2,1,6,2,8,7051
5,5,1,1,7,3,10,7051
6,6,2,0,9,3,12,7051
7,7,3,0,12,3,15,7051
8,8,1,0,13,3,16,7051
9,9,1,1,14,4,18,7051
10,10,2,1,16,5,21,7051
11,11,1,0,17,5,22,7051
12,12,0,0,17,5,22,7051
0,0,1,0,1,0,1,7052
1,1,0,0,1,0,1,7052
0,0,1,0,1,0,1,7053
1,1,2,0,3,0,3,7053
2,2,2,0,5,0,5,7053
3,3,1,0,6,0,6,7053
4,4,1,0,7,0,7,7053
5,5,1,0,8,0,8,7053
6,6,1,0,9,0,9,7053
7,7,1,0,10,0,10,7053
8,8,0,0,10,0,10,7053
0,0,1,0,1,0,1,7054
1,1,2,0,3,0,3,7054
2,2,3,0,6,0,6,7054
3,3,1,0,7,0,7,7054
4,4,1,0,8,0,8,7054
5,5,2,0,10,0,10,7054
6,6,0,0,10,0,10,7054
0,0,1,0,1,0,1,7055
1,1,0,0,1,0,1,7055
0,0,1,0,1,0,1,7056
1,1,0,0,1,0,1,7056
0,0,1,0,1,0,1,7057
1,1,1,0,2,0,2,7057
2,2,2,0,4,0,4,7057
3,3,1,1,5,1,6,7057
4,4,1,0,6,1,7,7057
5,5,0,1,6,2,8,7057
6,6,0,0,6,2,8,7057
0,0,1,0,1,0,1,7058
1,1,2,0,3,0,3,7058
2,2,0,0,3,0,3,7058
0,0,1,0,1,0,1,7059
1,1,2,0,3,0,3,7059
2,2,1,1,4,1,5,7059
3,3,2,0,6,1,7,7059
4,4,0,0,6,1,7,7059
0,0,1,0,1,0,1,7060
1,1,1,0,2,0,2,7060
2,2,0,0,2,0,2,7060
0,0,1,0,1,0,1,7061
1,1,0,0,1,0,1,7061
0,0,1,0,1,0,1,7062
1,1,0,0,1,0,1,7062
0,0,1,0,1,0,1,7063
1,1,2,0,3,0,3,7063
2,2,0,0,3,0,3,7063
0,0,1,0,1,0,1,7064
1,1,1,1,2,1,3,7064
2,2,0,0,2,1,3,7064
0,0,1,0,1,0,1,7065
1,1,1,0,2,0,2,7065
2,2,0,0,2,0,2,7065
0,0,1,0,1,0,1,7066
1,1,0,0,1,0,1,7066
0,0,1,0,1,0,1,7067
1,1,1,1,2,1,3,7067
2,2,2,2,4,3,7,7067
3,3,2,1,6,4,10,7067
4,4,3,2,9,6,15,7067
5,5,1,3,10,9,19,7067
6,6,0,4,10,13,23,7067
7,7,0,2,10,15,25,7067
8,8,1,0,11,15,26,7067
9,9,2,0,13,15,28,7067
10,10,0,0,13,15,28,7067
0,0,1,0,1,0,1,7068
1,1,2,0,3,0,3,7068
2,2,3,0,6,0,6,7068
3,3,4,2,10,2,12,7068
4,4,2,2,12,4,16,7068
5,5,2,1,14,5,19,7068
6,6,1,0,15,5,20,7068
7,7,0,0,15,5,20,7068
0,0,1,0,1,0,1,7069
1,1,1,0,2,0,2,7069
2,2,1,0,3,0,3,7069
3,3,1,0,4,0,4,7069
4,4,1,1,5,1,6,7069
5,5,1,5,6,6,12,7069
6,6,1,7,7,13,20,7069
7,7,6,3,13,16,29,7069
8,8,9,4,22,20,42,7069
9,9,8,5,30,25,55,7069
10,10,8,6,38,31,69,7069
11,11,2,5,40,36,76,7069
12,12,1,4,41,40,81,7069
13,13,1,5,42,45,87,7069
14,14,2,5,44,50,94,7069
15,15,4,5,48,55,103,7069
16,16,3,3,51,58,109,7069
17,17,6,7,57,65,122,7069
18,18,5,5,62,70,132,7069
19,19,8,6,70,76,146,7069
20,20,3,7,73,83,156,7069
21,21,6,2,79,85,164,7069
22,22,7,0,86,85,171,7069
23,23,3,1,89,86,175,7069
24,24,2,2,91,88,179,7069
25,25,1,2,92,90,182,7069
26,26,1,3,93,93,186,7069
27,27,0,2,93,95,188,7069
28,28,0,1,93,96,189,7069
29,29,0,1,93,97,190,7069
30,30,0,0,93,97,190,7069
0,0,1,0,1,0,1,7070
1,1,0,0,1,0,1,7070
0,0,1,0,1,0,1,7071
1,1,1,0,2,0,2,7071
2,2,0,0,2,0,2,7071
0,0,1,0,1,0,1,7072
1,1,0,0,1,0,1,7072
0,0,1,0,1,0,1,7073
1,1,1,0,2,0,2,7073
2,2,0,0,2,0,2,7073
0,0,1,0,1,0,1,7074
1,1,4,1,5,1,6,7074
2,2,5,2,10,3,13,7074
3,3,2,0,12,3,15,7074
4,4,1,0,13,3,16,7074
5,5,1,0,14,3,17,7074
6,6,1,0,15,3,18,7074
7,7,1,0,16,3,19,7074
8,8,0,0,16,3,19,7074
0,0,1,0,1,0,1,7075
1,1,0,0,1,0,1,7075
0,0,1,0,1,0,1,7076
1,1,0,2,1,2,3,7076
2,2,0,1,1,3,4,7076
3,3,0,2,1,5,6,7076
4,4,0,1,1,6,7,7076
5,5,2,0,3,6,9,7076
6,6,1,0,4,6,10,7076
7,7,1,0,5,6,11,7076
8,8,1,0,6,6,12,7076
9,9,1,0,7,6,13,7076
10,10,1,0,8,6,14,7076
11,11,0,1,8,7,15,7076
12,12,0,0,8,7,15,7076
0,0,1,0,1,0,1,7077
1,1,0,2,1,2,3,7077
2,2,0,4,1,6,7,7077
3,3,1,0,2,6,8,7077
4,4,3,0,5,6,11,7077
5,5,4,0,9,6,15,7077
6,6,6,2,15,8,23,7077
7,7,9,6,24,14,38,7077
8,8,5,5,29,19,48,7077
9,9,3,5,32,24,56,7077
10,10,0,1,32,25,57,7077
11,11,0,1,32,26,58,7077
12,12,0,1,32,27,59,7077
13,13,0,1,32,28,60,7077
14,14,0,1,32,29,61,7077
15,15,0,0,32,29,61,7077
0,0,1,0,1,0,1,7078
1,1,0,0,1,0,1,7078
0,0,1,0,1,0,1,7079
1,1,1,0,2,0,2,7079
2,2,0,0,2,0,2,7079
0,0,1,0,1,0,1,7080
1,1,0,0,1,0,1,7080
0,0,1,0,1,0,1,7081
1,1,0,0,1,0,1,7081
0,0,1,0,1,0,1,7082
1,1,1,0,2,0,2,7082
2,2,0,1,2,1,3,7082
3,3,0,1,2,2,4,7082
4,4,0,0,2,2,4,7082
0,0,1,0,1,0,1,7083
1,1,0,0,1,0,1,7083
0,0,1,0,1,0,1,7084
1,1,0,0,1,0,1,7084
0,0,1,0,1,0,1,7085
1,1,0,0,1,0,1,7085
0,0,1,0,1,0,1,7086
1,1,0,0,1,0,1,7086
0,0,1,0,1,0,1,7087
1,1,0,0,1,0,1,7087
0,0,1,0,1,0,1,7088
1,1,1,0,2,0,2,7088
2,2,1,0,3,0,3,7088
3,3,1,0,4,0,4,7088
4,4,0,0,4,0,4,7088
0,0,1,0,1,0,1,7089
1,1,0,1,1,1,2,7089
2,2,0,2,1,3,4,7089
3,3,0,6,1,9,10,7089
4,4,1,4,2,13,15,7089
5,5,0,3,2,16,18,7089
6,6,0,1,2,17,19,7089
7,7,0,1,2,18,20,7089
8,8,0,1,2,19,21,7089
9,9,0,1,2,20,22,7089
10,10,0,0,2,20,22,7089
0,0,1,0,1,0,1,7090
1,1,0,1,1,1,2,7090
2,2,0,1,1,2,3,7090
3,3,0,0,1,2,3,7090
0,0,1,0,1,0,1,7091
1,1,0,1,1,1,2,7091
2,2,0,2,1,3,4,7091
3,3,1,2,2,5,7,7091
4,4,1,1,3,6,9,7091
5,5,3,3,6,9,15,7091
6,6,1,1,7,10,17,7091
7,7,0,0,7,10,17,7091
0,0,1,0,1,0,1,7092
1,1,0,0,1,0,1,7092
0,0,1,0,1,0,1,7093
1,1,0,0,1,0,1,7093
0,0,1,0,1,0,1,7094
1,1,3,0,4,0,4,7094
2,2,1,3,5,3,8,7094
3,3,0,1,5,4,9,7094
4,4,0,1,5,5,10,7094
5,5,1,1,6,6,12,7094
6,6,1,0,7,6,13,7094
7,7,1,0,8,6,14,7094
8,8,2,0,10,6,16,7094
9,9,1,0,11,6,17,7094
10,10,1,1,12,7,19,7094
11,11,0,0,12,7,19,7094
0,0,1,0,1,0,1,7095
1,1,0,0,1,0,1,7095
0,0,1,0,1,0,1,7096
1,1,0,0,1,0,1,7096
0,0,1,0,1,0,1,7097
1,1,2,0,3,0,3,7097
2,2,2,0,5,0,5,7097
3,3,2,0,7,0,7,7097
4,4,1,0,8,0,8,7097
5,5,2,0,10,0,10,7097
6,6,2,1,12,1,13,7097
7,7,0,1,12,2,14,7097
8,8,1,2,13,4,17,7097
9,9,0,1,13,5,18,7097
10,10,0,1,13,6,19,7097
11,11,0,5,13,11,24,7097
12,12,1,1,14,12,26,7097
13,13,0,0,14,12,26,7097
0,0,1,0,1,0,1,7098
1,1,1,0,2,0,2,7098
2,2,0,0,2,0,2,7098
0,0,1,0,1,0,1,7099
1,1,0,1,1,1,2,7099
2,2,0,0,1,1,2,7099
0,0,1,0,1,0,1,7100
1,1,1,0,2,0,2,7100
2,2,0,0,2,0,2,7100
0,0,1,0,1,0,1,7101
1,1,1,1,2,1,3,7101
2,2,3,1,5,2,7,7101
3,3,2,0,7,2,9,7101
4,4,1,1,8,3,11,7101
5,5,1,0,9,3,12,7101
6,6,0,1,9,4,13,7101
7,7,0,0,9,4,13,7101
0,0,1,0,1,0,1,7102
1,1,1,0,2,0,2,7102
2,2,2,0,4,0,4,7102
3,3,1,1,5,1,6,7102
4,4,0,0,5,1,6,7102
0,0,1,0,1,0,1,7103
1,1,1,0,2,0,2,7103
2,2,1,0,3,0,3,7103
3,3,1,1,4,1,5,7103
4,4,0,1,4,2,6,7103
5,5,0,1,4,3,7,7103
6,6,0,0,4,3,7,7103
0,0,1,0,1,0,1,7104
1,1,0,0,1,0,1,7104
0,0,1,0,1,0,1,7105
1,1,1,0,2,0,2,7105
2,2,0,0,2,0,2,7105
0,0,1,0,1,0,1,7106
1,1,2,0,3,0,3,7106
2,2,1,0,4,0,4,7106
3,3,1,0,5,0,5,7106
4,4,0,0,5,0,5,7106
0,0,1,0,1,0,1,7107
1,1,0,0,1,0,1,7107
0,0,1,0,1,0,1,7108
1,1,2,0,3,0,3,7108
2,2,0,0,3,0,3,7108
0,0,1,0,1,0,1,7109
1,1,0,0,1,0,1,7109
0,0,1,0,1,0,1,7110
1,1,0,0,1,0,1,7110
0,0,1,0,1,0,1,7111
1,1,1,0,2,0,2,7111
2,2,0,0,2,0,2,7111
0,0,1,0,1,0,1,7112
1,1,0,0,1,0,1,7112
0,0,1,0,1,0,1,7113
1,1,0,0,1,0,1,7113
0,0,1,0,1,0,1,7114
1,1,0,0,1,0,1,7114
0,0,1,0,1,0,1,7115
1,1,3,0,4,0,4,7115
2,2,2,0,6,0,6,7115
3,3,0,0,6,0,6,7115
0,0,1,0,1,0,1,7116
1,1,1,0,2,0,2,7116
2,2,0,0,2,0,2,7116
0,0,1,0,1,0,1,7117
1,1,0,0,1,0,1,7117
0,0,1,0,1,0,1,7118
1,1,1,0,2,0,2,7118
2,2,1,0,3,0,3,7118
3,3,1,0,4,0,4,7118
4,4,2,0,6,0,6,7118
5,5,3,0,9,0,9,7118
6,6,2,0,11,0,11,7118
7,7,1,1,12,1,13,7118
8,8,0,1,12,2,14,7118
9,9,2,0,14,2,16,7118
10,10,3,0,17,2,19,7118
11,11,2,0,19,2,21,7118
12,12,1,0,20,2,22,7118
13,13,1,0,21,2,23,7118
14,14,2,1,23,3,26,7118
15,15,2,1,25,4,29,7118
16,16,1,1,26,5,31,7118
17,17,1,1,27,6,33,7118
18,18,0,3,27,9,36,7118
19,19,0,0,27,9,36,7118
0,0,1,0,1,0,1,7119
1,1,1,0,2,0,2,7119
2,2,0,1,2,1,3,7119
3,3,0,2,2,3,5,7119
4,4,0,1,2,4,6,7119
5,5,0,0,2,4,6,7119
0,0,1,0,1,0,1,7120
1,1,1,0,2,0,2,7120
2,2,1,0,3,0,3,7120
3,3,1,0,4,0,4,7120
4,4,1,0,5,0,5,7120
5,5,1,0,6,0,6,7120
6,6,1,0,7,0,7,7120
7,7,0,1,7,1,8,7120
8,8,0,1,7,2,9,7120
9,9,1,1,8,3,11,7120
10,10,1,1,9,4,13,7120
11,11,0,0,9,4,13,7120
0,0,1,0,1,0,1,7121
1,1,2,0,3,0,3,7121
2,2,1,0,4,0,4,7121
3,3,1,0,5,0,5,7121
4,4,0,0,5,0,5,7121
0,0,1,0,1,0,1,7122
1,1,2,0,3,0,3,7122
2,2,1,1,4,1,5,7122
3,3,1,1,5,2,7,7122
4,4,1,1,6,3,9,7122
5,5,1,1,7,4,11,7122
6,6,0,0,7,4,11,7122
0,0,1,0,1,0,1,7123
1,1,0,0,1,0,1,7123
0,0,1,0,1,0,1,7124
1,1,1,1,2,1,3,7124
2,2,0,0,2,1,3,7124
0,0,1,0,1,0,1,7125
1,1,1,0,2,0,2,7125
2,2,0,1,2,1,3,7125
3,3,0,1,2,2,4,7125
4,4,0,0,2,2,4,7125
0,0,1,0,1,0,1,7126
1,1,1,0,2,0,2,7126
2,2,0,0,2,0,2,7126
0,0,1,0,1,0,1,7127
1,1,0,0,1,0,1,7127
0,0,1,0,1,0,1,7128
1,1,0,0,1,0,1,7128
0,0,1,0,1,0,1,7129
1,1,2,0,3,0,3,7129
2,2,5,0,8,0,8,7129
3,3,3,1,11,1,12,7129
4,4,1,0,12,1,13,7129
5,5,0,0,12,1,13,7129
0,0,1,0,1,0,1,7130
1,1,4,0,5,0,5,7130
2,2,5,1,10,1,11,7130
3,3,1,0,11,1,12,7130
4,4,2,0,13,1,14,7130
5,5,2,0,15,1,16,7130
6,6,3,0,18,1,19,7130
7,7,2,1,20,2,22,7130
8,8,1,1,21,3,24,7130
9,9,1,1,22,4,26,7130
10,10,0,0,22,4,26,7130
0,0,1,0,1,0,1,7131
1,1,1,0,2,0,2,7131
2,2,0,0,2,0,2,7131
0,0,1,0,1,0,1,7132
1,1,0,1,1,1,2,7132
2,2,1,1,2,2,4,7132
3,3,3,2,5,4,9,7132
4,4,1,7,6,11,17,7132
5,5,2,4,8,15,23,7132
6,6,1,3,9,18,27,7132
7,7,3,1,12,19,31,7132
8,8,3,0,15,19,34,7132
9,9,4,1,19,20,39,7132
10,10,2,1,21,21,42,7132
11,11,3,0,24,21,45,7132
12,12,5,2,29,23,52,7132
13,13,2,2,31,25,56,7132
14,14,1,4,32,29,61,7132
15,15,0,0,32,29,61,7132
0,0,1,0,1,0,1,7133
1,1,1,0,2,0,2,7133
2,2,0,0,2,0,2,7133
0,0,1,0,1,0,1,7134
1,1,0,0,1,0,1,7134
0,0,1,0,1,0,1,7135
1,1,0,0,1,0,1,7135
0,0,1,0,1,0,1,7136
1,1,0,0,1,0,1,7136
0,0,1,0,1,0,1,7137
1,1,0,0,1,0,1,7137
0,0,1,0,1,0,1,7138
1,1,2,0,3,0,3,7138
2,2,0,0,3,0,3,7138
0,0,1,0,1,0,1,7139
1,1,1,0,2,0,2,7139
2,2,0,0,2,0,2,7139
0,0,1,0,1,0,1,7140
1,1,1,0,2,0,2,7140
2,2,0,1,2,1,3,7140
3,3,0,0,2,1,3,7140
0,0,1,0,1,0,1,7141
1,1,1,0,2,0,2,7141
2,2,0,0,2,0,2,7141
0,0,1,0,1,0,1,7142
1,1,0,0,1,0,1,7142
0,0,1,0,1,0,1,7143
1,1,0,1,1,1,2,7143
2,2,0,1,1,2,3,7143
3,3,0,0,1,2,3,7143
0,0,1,0,1,0,1,7144
1,1,0,0,1,0,1,7144
0,0,1,0,1,0,1,7145
1,1,1,0,2,0,2,7145
2,2,1,0,3,0,3,7145
3,3,0,0,3,0,3,7145
0,0,1,0,1,0,1,7146
1,1,2,0,3,0,3,7146
2,2,2,0,5,0,5,7146
3,3,2,0,7,0,7,7146
4,4,1,0,8,0,8,7146
5,5,1,0,9,0,9,7146
6,6,3,0,12,0,12,7146
7,7,1,0,13,0,13,7146
8,8,0,0,13,0,13,7146
0,0,1,0,1,0,1,7147
1,1,2,1,3,1,4,7147
2,2,1,2,4,3,7,7147
3,3,0,2,4,5,9,7147
4,4,0,4,4,9,13,7147
5,5,0,4,4,13,17,7147
6,6,0,1,4,14,18,7147
7,7,0,0,4,14,18,7147
0,0,1,0,1,0,1,7148
1,1,1,0,2,0,2,7148
2,2,2,0,4,0,4,7148
3,3,0,1,4,1,5,7148
4,4,0,1,4,2,6,7148
5,5,1,1,5,3,8,7148
6,6,0,5,5,8,13,7148
7,7,0,2,5,10,15,7148
8,8,0,4,5,14,19,7148
9,9,0,0,5,14,19,7148
0,0,1,0,1,0,1,7149
1,1,1,0,2,0,2,7149
2,2,1,0,3,0,3,7149
3,3,1,0,4,0,4,7149
4,4,0,0,4,0,4,7149
0,0,1,0,1,0,1,7150
1,1,0,1,1,1,2,7150
2,2,1,0,2,1,3,7150
3,3,0,0,2,1,3,7150
0,0,1,0,1,0,1,7151
1,1,0,0,1,0,1,7151
0,0,1,0,1,0,1,7152
1,1,1,0,2,0,2,7152
2,2,2,0,4,0,4,7152
3,3,0,1,4,1,5,7152
4,4,0,2,4,3,7,7152
5,5,0,3,4,6,10,7152
6,6,0,1,4,7,11,7152
7,7,0,0,4,7,11,7152
0,0,1,0,1,0,1,7153
1,1,1,0,2,0,2,7153
2,2,0,0,2,0,2,7153
0,0,1,0,1,0,1,7154
1,1,1,1,2,1,3,7154
2,2,1,1,3,2,5,7154
3,3,0,2,3,4,7,7154
4,4,0,2,3,6,9,7154
5,5,0,1,3,7,10,7154
6,6,0,2,3,9,12,7154
7,7,1,1,4,10,14,7154
8,8,2,2,6,12,18,7154
9,9,3,7,9,19,28,7154
10,10,5,3,14,22,36,7154
11,11,4,3,18,25,43,7154
12,12,2,2,20,27,47,7154
13,13,3,1,23,28,51,7154
14,14,1,1,24,29,53,7154
15,15,2,1,26,30,56,7154
16,16,3,0,29,30,59,7154
17,17,1,0,30,30,60,7154
18,18,1,0,31,30,61,7154
19,19,0,0,31,30,61,7154
0,0,1,0,1,0,1,7155
1,1,0,0,1,0,1,7155
0,0,1,0,1,0,1,7156
1,1,2,1,3,1,4,7156
2,2,2,2,5,3,8,7156
3,3,1,1,6,4,10,7156
4,4,0,1,6,5,11,7156
5,5,0,0,6,5,11,7156
0,0,1,0,1,0,1,7157
1,1,0,0,1,0,1,7157
0,0,1,0,1,0,1,7158
1,1,1,0,2,0,2,7158
2,2,2,0,4,0,4,7158
3,3,2,0,6,0,6,7158
4,4,0,0,6,0,6,7158
0,0,1,0,1,0,1,7159
1,1,0,0,1,0,1,7159
0,0,1,0,1,0,1,7160
1,1,3,0,4,0,4,7160
2,2,1,1,5,1,6,7160
3,3,3,0,8,1,9,7160
4,4,4,2,12,3,15,7160
5,5,2,0,14,3,17,7160
6,6,1,0,15,3,18,7160
7,7,1,0,16,3,19,7160
8,8,0,0,16,3,19,7160
0,0,1,0,1,0,1,7161
1,1,1,0,2,0,2,7161
2,2,0,0,2,0,2,7161
0,0,1,0,1,0,1,7162
1,1,0,0,1,0,1,7162
0,0,1,0,1,0,1,7163
1,1,3,0,4,0,4,7163
2,2,4,0,8,0,8,7163
3,3,3,1,11,1,12,7163
4,4,3,1,14,2,16,7163
5,5,4,1,18,3,21,7163
6,6,4,0,22,3,25,7163
7,7,0,2,22,5,27,7163
8,8,0,0,22,5,27,7163
0,0,1,0,1,0,1,7164
1,1,0,0,1,0,1,7164
0,0,1,0,1,0,1,7165
1,1,1,0,2,0,2,7165
2,2,0,0,2,0,2,7165
0,0,1,0,1,0,1,7166
1,1,2,0,3,0,3,7166
2,2,2,0,5,0,5,7166
3,3,0,0,5,0,5,7166
0,0,1,0,1,0,1,7167
1,1,3,0,4,0,4,7167
2,2,2,1,6,1,7,7167
3,3,1,3,7,4,11,7167
4,4,2,1,9,5,14,7167
5,5,0,0,9,5,14,7167
0,0,1,0,1,0,1,7168
1,1,0,0,1,0,1,7168
0,0,1,0,1,0,1,7169
1,1,2,0,3,0,3,7169
2,2,1,0,4,0,4,7169
3,3,0,0,4,0,4,7169
0,0,1,0,1,0,1,7170
1,1,1,0,2,0,2,7170
2,2,1,0,3,0,3,7170
3,3,1,1,4,1,5,7170
4,4,0,3,4,4,8,7170
5,5,0,2,4,6,10,7170
6,6,0,1,4,7,11,7170
7,7,0,0,4,7,11,7170
0,0,1,0,1,0,1,7171
1,1,1,0,2,0,2,7171
2,2,0,0,2,0,2,7171
0,0,1,0,1,0,1,7172
1,1,0,1,1,1,2,7172
2,2,1,0,2,1,3,7172
3,3,0,0,2,1,3,7172
0,0,1,0,1,0,1,7173
1,1,1,0,2,0,2,7173
2,2,1,0,3,0,3,7173
3,3,0,0,3,0,3,7173
0,0,1,0,1,0,1,7174
1,1,1,0,2,0,2,7174
2,2,2,0,4,0,4,7174
3,3,0,0,4,0,4,7174
0,0,1,0,1,0,1,7175
1,1,0,1,1,1,2,7175
2,2,1,0,2,1,3,7175
3,3,0,0,2,1,3,7175
0,0,1,0,1,0,1,7176
1,1,0,0,1,0,1,7176
0,0,1,0,1,0,1,7177
1,1,0,0,1,0,1,7177
0,0,1,0,1,0,1,7178
1,1,0,1,1,1,2,7178
2,2,0,0,1,1,2,7178
0,0,1,0,1,0,1,7179
1,1,0,0,1,0,1,7179
0,0,1,0,1,0,1,7180
1,1,0,0,1,0,1,7180
0,0,1,0,1,0,1,7181
1,1,1,0,2,0,2,7181
2,2,0,0,2,0,2,7181
0,0,1,0,1,0,1,7182
1,1,0,0,1,0,1,7182
0,0,1,0,1,0,1,7183
1,1,1,0,2,0,2,7183
2,2,1,0,3,0,3,7183
3,3,1,0,4,0,4,7183
4,4,0,0,4,0,4,7183
0,0,1,0,1,0,1,7184
1,1,0,1,1,1,2,7184
2,2,0,0,1,1,2,7184
0,0,1,0,1,0,1,7185
1,1,1,0,2,0,2,7185
2,2,1,0,3,0,3,7185
3,3,1,1,4,1,5,7185
4,4,1,1,5,2,7,7185
5,5,0,1,5,3,8,7185
6,6,0,1,5,4,9,7185
7,7,0,1,5,5,10,7185
8,8,0,1,5,6,11,7185
9,9,0,1,5,7,12,7185
10,10,0,3,5,10,15,7185
11,11,1,2,6,12,18,7185
12,12,0,1,6,13,19,7185
13,13,0,0,6,13,19,7185
0,0,1,0,1,0,1,7186
1,1,0,1,1,1,2,7186
2,2,1,0,2,1,3,7186
3,3,0,0,2,1,3,7186
0,0,1,0,1,0,1,7187
1,1,4,0,5,0,5,7187
2,2,0,2,5,2,7,7187
3,3,0,0,5,2,7,7187
0,0,1,0,1,0,1,7188
1,1,1,0,2,0,2,7188
2,2,1,0,3,0,3,7188
3,3,0,0,3,0,3,7188
0,0,1,0,1,0,1,7189
1,1,0,1,1,1,2,7189
2,2,0,0,1,1,2,7189
0,0,1,0,1,0,1,7190
1,1,0,0,1,0,1,7190
0,0,1,0,1,0,1,7191
1,1,1,0,2,0,2,7191
2,2,2,0,4,0,4,7191
3,3,0,0,4,0,4,7191
0,0,1,0,1,0,1,7192
1,1,0,1,1,1,2,7192
2,2,0,0,1,1,2,7192
0,0,1,0,1,0,1,7193
1,1,0,0,1,0,1,7193
0,0,1,0,1,0,1,7194
1,1,0,0,1,0,1,7194
0,0,1,0,1,0,1,7195
1,1,2,0,3,0,3,7195
2,2,1,0,4,0,4,7195
3,3,1,0,5,0,5,7195
4,4,0,0,5,0,5,7195
0,0,1,0,1,0,1,7196
1,1,0,0,1,0,1,7196
0,0,1,0,1,0,1,7197
1,1,0,0,1,0,1,7197
0,0,1,0,1,0,1,7198
1,1,0,0,1,0,1,7198
0,0,1,0,1,0,1,7199
1,1,1,1,2,1,3,7199
2,2,0,1,2,2,4,7199
3,3,0,0,2,2,4,7199
0,0,1,0,1,0,1,7200
1,1,0,0,1,0,1,7200
0,0,1,0,1,0,1,7201
1,1,2,0,3,0,3,7201
2,2,1,1,4,1,5,7201
3,3,1,1,5,2,7,7201
4,4,1,1,6,3,9,7201
5,5,0,1,6,4,10,7201
6,6,1,2,7,6,13,7201
7,7,2,0,9,6,15,7201
8,8,0,0,9,6,15,7201
0,0,1,0,1,0,1,7202
1,1,1,1,2,1,3,7202
2,2,1,1,3,2,5,7202
3,3,1,2,4,4,8,7202
4,4,1,2,5,6,11,7202
5,5,0,2,5,8,13,7202
6,6,1,2,6,10,16,7202
7,7,2,0,8,10,18,7202
8,8,3,0,11,10,21,7202
9,9,1,1,12,11,23,7202
10,10,2,1,14,12,26,7202
11,11,0,2,14,14,28,7202
12,12,0,2,14,16,30,7202
13,13,1,2,15,18,33,7202
14,14,2,0,17,18,35,7202
15,15,2,2,19,20,39,7202
16,16,1,1,20,21,41,7202
17,17,0,1,20,22,42,7202
18,18,0,0,20,22,42,7202
0,0,1,0,1,0,1,7203
1,1,1,0,2,0,2,7203
2,2,1,1,3,1,4,7203
3,3,0,0,3,1,4,7203
0,0,1,0,1,0,1,7204
1,1,1,1,2,1,3,7204
2,2,0,2,2,3,5,7204
3,3,1,1,3,4,7,7204
4,4,3,2,6,6,12,7204
5,5,6,2,12,8,20,7204
6,6,3,2,15,10,25,7204
7,7,7,2,22,12,34,7204
8,8,13,3,35,15,50,7204
9,9,6,2,41,17,58,7204
10,10,5,1,46,18,64,7204
11,11,3,3,49,21,70,7204
12,12,2,4,51,25,76,7204
13,13,2,4,53,29,82,7204
14,14,4,3,57,32,89,7204
15,15,1,1,58,33,91,7204
16,16,0,0,58,33,91,7204
0,0,1,0,1,0,1,7205
1,1,1,1,2,1,3,7205
2,2,0,2,2,3,5,7205
3,3,0,1,2,4,6,7205
4,4,0,0,2,4,6,7205
0,0,1,0,1,0,1,7206
1,1,0,1,1,1,2,7206
2,2,0,1,1,2,3,7206
3,3,0,0,1,2,3,7206
0,0,1,0,1,0,1,7207
1,1,0,0,1,0,1,7207
0,0,1,0,1,0,1,7208
1,1,0,1,1,1,2,7208
2,2,0,0,1,1,2,7208
0,0,1,0,1,0,1,7209
1,1,1,0,2,0,2,7209
2,2,1,0,3,0,3,7209
3,3,1,1,4,1,5,7209
4,4,2,0,6,1,7,7209
5,5,2,0,8,1,9,7209
6,6,2,0,10,1,11,7209
7,7,1,1,11,2,13,7209
8,8,1,1,12,3,15,7209
9,9,0,1,12,4,16,7209
10,10,0,2,12,6,18,7209
11,11,0,2,12,8,20,7209
12,12,0,1,12,9,21,7209
13,13,0,2,12,11,23,7209
14,14,1,1,13,12,25,7209
15,15,0,0,13,12,25,7209
0,0,1,0,1,0,1,7210
1,1,0,0,1,0,1,7210
0,0,1,0,1,0,1,7211
1,1,0,0,1,0,1,7211
0,0,1,0,1,0,1,7212
1,1,0,0,1,0,1,7212
0,0,1,0,1,0,1,7213
1,1,0,0,1,0,1,7213
0,0,1,0,1,0,1,7214
1,1,0,0,1,0,1,7214
0,0,1,0,1,0,1,7215
1,1,1,0,2,0,2,7215
2,2,1,0,3,0,3,7215
3,3,0,0,3,0,3,7215
0,0,1,0,1,0,1,7216
1,1,1,0,2,0,2,7216
2,2,1,0,3,0,3,7216
3,3,1,0,4,0,4,7216
4,4,1,0,5,0,5,7216
5,5,1,0,6,0,6,7216
6,6,1,0,7,0,7,7216
7,7,0,0,7,0,7,7216
0,0,1,0,1,0,1,7217
1,1,3,0,4,0,4,7217
2,2,3,1,7,1,8,7217
3,3,2,1,9,2,11,7217
4,4,0,2,9,4,13,7217
5,5,0,0,9,4,13,7217
0,0,1,0,1,0,1,7218
1,1,2,0,3,0,3,7218
2,2,3,1,6,1,7,7218
3,3,3,2,9,3,12,7218
4,4,5,2,14,5,19,7218
5,5,2,3,16,8,24,7218
6,6,3,1,19,9,28,7218
7,7,3,4,22,13,35,7218
8,8,3,1,25,14,39,7218
9,9,2,2,27,16,43,7218
10,10,1,5,28,21,49,7218
11,11,4,1,32,22,54,7218
12,12,4,0,36,22,58,7218
13,13,4,1,40,23,63,7218
14,14,1,1,41,24,65,7218
15,15,0,1,41,25,66,7218
16,16,0,0,41,25,66,7218
0,0,1,0,1,0,1,7219
1,1,0,0,1,0,1,7219
0,0,1,0,1,0,1,7220
1,1,0,0,1,0,1,7220
0,0,1,0,1,0,1,7221
1,1,2,0,3,0,3,7221
2,2,1,2,4,2,6,7221
3,3,1,0,5,2,7,7221
4,4,0,1,5,3,8,7221
5,5,0,0,5,3,8,7221
0,0,1,0,1,0,1,7222
1,1,0,0,1,0,1,7222
0,0,1,0,1,0,1,7223
1,1,0,0,1,0,1,7223
0,0,1,0,1,0,1,7224
1,1,0,0,1,0,1,7224
0,0,1,0,1,0,1,7225
1,1,2,0,3,0,3,7225
2,2,0,1,3,1,4,7225
3,3,1,1,4,2,6,7225
4,4,0,0,4,2,6,7225
0,0,1,0,1,0,1,7226
1,1,0,1,1,1,2,7226
2,2,0,0,1,1,2,7226
0,0,1,0,1,0,1,7227
1,1,0,0,1,0,1,7227
0,0,1,0,1,0,1,7228
1,1,0,0,1,0,1,7228
0,0,1,0,1,0,1,7229
1,1,1,0,2,0,2,7229
2,2,0,1,2,1,3,7229
3,3,1,4,3,5,8,7229
4,4,3,2,6,7,13,7229
5,5,0,1,6,8,14,7229
6,6,0,2,6,10,16,7229
7,7,0,0,6,10,16,7229
0,0,1,0,1,0,1,7230
1,1,0,0,1,0,1,7230
0,0,1,0,1,0,1,7231
1,1,0,0,1,0,1,7231
0,0,1,0,1,0,1,7232
1,1,0,0,1,0,1,7232
0,0,1,0,1,0,1,7233
1,1,0,0,1,0,1,7233
0,0,1,0,1,0,1,7234
1,1,0,0,1,0,1,7234
0,0,1,0,1,0,1,7235
1,1,2,0,3,0,3,7235
2,2,2,0,5,0,5,7235
3,3,0,1,5,1,6,7235
4,4,0,1,5,2,7,7235
5,5,0,0,5,2,7,7235
0,0,1,0,1,0,1,7236
1,1,0,0,1,0,1,7236
0,0,1,0,1,0,1,7237
1,1,1,0,2,0,2,7237
2,2,2,0,4,0,4,7237
3,3,3,2,7,2,9,7237
4,4,3,5,10,7,17,7237
5,5,5,3,15,10,25,7237
6,6,5,1,20,11,31,7237
7,7,3,1,23,12,35,7237
8,8,3,1,26,13,39,7237
9,9,3,0,29,13,42,7237
10,10,2,0,31,13,44,7237
11,11,0,0,31,13,44,7237
0,0,1,0,1,0,1,7238
1,1,3,0,4,0,4,7238
2,2,2,2,6,2,8,7238
3,3,0,2,6,4,10,7238
4,4,0,1,6,5,11,7238
5,5,0,1,6,6,12,7238
6,6,0,0,6,6,12,7238
0,0,1,0,1,0,1,7239
1,1,2,0,3,0,3,7239
2,2,1,0,4,0,4,7239
3,3,1,0,5,0,5,7239
4,4,2,0,7,0,7,7239
5,5,0,0,7,0,7,7239
0,0,1,0,1,0,1,7240
1,1,0,0,1,0,1,7240
0,0,1,0,1,0,1,7241
1,1,0,0,1,0,1,7241
0,0,1,0,1,0,1,7242
1,1,3,0,4,0,4,7242
2,2,2,0,6,0,6,7242
3,3,3,0,9,0,9,7242
4,4,1,1,10,1,11,7242
5,5,2,1,12,2,14,7242
6,6,2,1,14,3,17,7242
7,7,3,3,17,6,23,7242
8,8,2,2,19,8,27,7242
9,9,2,5,21,13,34,7242
10,10,2,2,23,15,38,7242
11,11,1,0,24,15,39,7242
12,12,1,0,25,15,40,7242
13,13,1,1,26,16,42,7242
14,14,2,2,28,18,46,7242
15,15,1,2,29,20,49,7242
16,16,1,3,30,23,53,7242
17,17,3,1,33,24,57,7242
18,18,3,1,36,25,61,7242
19,19,1,1,37,26,63,7242
20,20,0,1,37,27,64,7242
21,21,0,0,37,27,64,7242
0,0,1,0,1,0,1,7243
1,1,0,0,1,0,1,7243
0,0,1,0,1,0,1,7244
1,1,1,2,2,2,4,7244
2,2,1,1,3,3,6,7244
3,3,0,1,3,4,7,7244
4,4,0,3,3,7,10,7244
5,5,0,2,3,9,12,7244
6,6,0,2,3,11,14,7244
7,7,0,0,3,11,14,7244
0,0,1,0,1,0,1,7245
1,1,1,1,2,1,3,7245
2,2,0,1,2,2,4,7245
3,3,0,4,2,6,8,7245
4,4,0,2,2,8,10,7245
5,5,0,1,2,9,11,7245
6,6,0,0,2,9,11,7245
0,0,1,0,1,0,1,7246
1,1,0,0,1,0,1,7246
0,0,1,0,1,0,1,7247
1,1,0,0,1,0,1,7247
0,0,1,0,1,0,1,7248
1,1,1,0,2,0,2,7248
2,2,1,0,3,0,3,7248
3,3,0,0,3,0,3,7248
0,0,1,0,1,0,1,7249
1,1,1,0,2,0,2,7249
2,2,0,0,2,0,2,7249
0,0,1,0,1,0,1,7250
1,1,1,0,2,0,2,7250
2,2,1,0,3,0,3,7250
3,3,1,0,4,0,4,7250
4,4,1,1,5,1,6,7250
5,5,1,0,6,1,7,7250
6,6,1,0,7,1,8,7250
7,7,0,0,7,1,8,7250
0,0,1,0,1,0,1,7251
1,1,1,0,2,0,2,7251
2,2,3,1,5,1,6,7251
3,3,1,0,6,1,7,7251
4,4,1,0,7,1,8,7251
5,5,0,0,7,1,8,7251
0,0,1,0,1,0,1,7252
1,1,0,0,1,0,1,7252
0,0,1,0,1,0,1,7253
1,1,3,0,4,0,4,7253
2,2,3,0,7,0,7,7253
3,3,1,0,8,0,8,7253
4,4,0,0,8,0,8,7253
0,0,1,0,1,0,1,7254
1,1,1,0,2,0,2,7254
2,2,1,0,3,0,3,7254
3,3,1,0,4,0,4,7254
4,4,1,1,5,1,6,7254
5,5,2,2,7,3,10,7254
6,6,0,4,7,7,14,7254
7,7,4,3,11,10,21,7254
8,8,5,3,16,13,29,7254
9,9,1,4,17,17,34,7254
10,10,2,6,19,23,42,7254
11,11,2,4,21,27,48,7254
12,12,1,1,22,28,50,7254
13,13,0,0,22,28,50,7254
0,0,1,0,1,0,1,7255
1,1,1,1,2,1,3,7255
2,2,1,0,3,1,4,7255
3,3,3,0,6,1,7,7255
4,4,0,1,6,2,8,7255
5,5,0,0,6,2,8,7255
0,0,1,0,1,0,1,7256
1,1,1,0,2,0,2,7256
2,2,0,0,2,0,2,7256
0,0,1,0,1,0,1,7257
1,1,2,0,3,0,3,7257
2,2,2,1,5,1,6,7257
3,3,1,1,6,2,8,7257
4,4,0,0,6,2,8,7257
0,0,1,0,1,0,1,7258
1,1,0,0,1,0,1,7258
0,0,1,0,1,0,1,7259
1,1,3,0,4,0,4,7259
2,2,1,1,5,1,6,7259
3,3,0,0,5,1,6,7259
0,0,1,0,1,0,1,7260
1,1,0,0,1,0,1,7260
0,0,1,0,1,0,1,7261
1,1,0,1,1,1,2,7261
2,2,0,0,1,1,2,7261
0,0,1,0,1,0,1,7262
1,1,1,0,2,0,2,7262
2,2,1,0,3,0,3,7262
3,3,1,0,4,0,4,7262
4,4,1,0,5,0,5,7262
5,5,0,0,5,0,5,7262
0,0,1,0,1,0,1,7263
1,1,0,0,1,0,1,7263
0,0,1,0,1,0,1,7264
1,1,1,0,2,0,2,7264
2,2,0,0,2,0,2,7264
0,0,1,0,1,0,1,7265
1,1,0,1,1,1,2,7265
2,2,0,1,1,2,3,7265
3,3,0,1,1,3,4,7265
4,4,0,1,1,4,5,7265
5,5,0,0,1,4,5,7265
0,0,1,0,1,0,1,7266
1,1,0,0,1,0,1,7266
0,0,1,0,1,0,1,7267
1,1,0,0,1,0,1,7267
0,0,1,0,1,0,1,7268
1,1,1,0,2,0,2,7268
2,2,4,1,6,1,7,7268
3,3,3,2,9,3,12,7268
4,4,3,1,12,4,16,7268
5,5,2,2,14,6,20,7268
6,6,2,1,16,7,23,7268
7,7,2,1,18,8,26,7268
8,8,3,0,21,8,29,7268
9,9,2,1,23,9,32,7268
10,10,0,1,23,10,33,7268
11,11,0,1,23,11,34,7268
12,12,1,1,24,12,36,7268
13,13,0,1,24,13,37,7268
14,14,0,0,24,13,37,7268
0,0,1,0,1,0,1,7269
1,1,1,0,2,0,2,7269
2,2,1,0,3,0,3,7269
3,3,1,0,4,0,4,7269
4,4,2,0,6,0,6,7269
5,5,1,1,7,1,8,7269
6,6,0,1,7,2,9,7269
7,7,0,0,7,2,9,7269
0,0,1,0,1,0,1,7270
1,1,0,0,1,0,1,7270
0,0,1,0,1,0,1,7271
1,1,1,0,2,0,2,7271
2,2,0,0,2,0,2,7271
0,0,1,0,1,0,1,7272
1,1,0,0,1,0,1,7272
0,0,1,0,1,0,1,7273
1,1,1,0,2,0,2,7273
2,2,0,1,2,1,3,7273
3,3,0,2,2,3,5,7273
4,4,0,1,2,4,6,7273
5,5,0,0,2,4,6,7273
0,0,1,0,1,0,1,7274
1,1,2,0,3,0,3,7274
2,2,3,0,6,0,6,7274
3,3,2,0,8,0,8,7274
4,4,4,0,12,0,12,7274
5,5,2,1,14,1,15,7274
6,6,2,1,16,2,18,7274
7,7,1,1,17,3,20,7274
8,8,1,0,18,3,21,7274
9,9,2,0,20,3,23,7274
10,10,2,1,22,4,26,7274
11,11,1,0,23,4,27,7274
12,12,1,1,24,5,29,7274
13,13,1,0,25,5,30,7274
14,14,1,0,26,5,31,7274
15,15,1,0,27,5,32,7274
16,16,1,0,28,5,33,7274
17,17,0,0,28,5,33,7274
0,0,1,0,1,0,1,7275
1,1,3,0,4,0,4,7275
2,2,2,0,6,0,6,7275
3,3,0,0,6,0,6,7275
0,0,1,0,1,0,1,7276
1,1,1,0,2,0,2,7276
2,2,2,0,4,0,4,7276
3,3,1,0,5,0,5,7276
4,4,0,0,5,0,5,7276
0,0,1,0,1,0,1,7277
1,1,0,1,1,1,2,7277
2,2,0,1,1,2,3,7277
3,3,1,1,2,3,5,7277
4,4,2,1,4,4,8,7277
5,5,4,0,8,4,12,7277
6,6,1,0,9,4,13,7277
7,7,0,0,9,4,13,7277
0,0,1,0,1,0,1,7278
1,1,1,0,2,0,2,7278
2,2,0,0,2,0,2,7278
0,0,1,0,1,0,1,7279
1,1,2,0,3,0,3,7279
2,2,4,0,7,0,7,7279
3,3,3,1,10,1,11,7279
4,4,2,2,12,3,15,7279
5,5,1,1,13,4,17,7279
6,6,0,0,13,4,17,7279
0,0,1,0,1,0,1,7280
1,1,0,0,1,0,1,7280
0,0,1,0,1,0,1,7281
1,1,1,1,2,1,3,7281
2,2,2,1,4,2,6,7281
3,3,1,0,5,2,7,7281
4,4,1,0,6,2,8,7281
5,5,0,0,6,2,8,7281
0,0,1,0,1,0,1,7282
1,1,0,0,1,0,1,7282
0,0,1,0,1,0,1,7283
1,1,2,0,3,0,3,7283
2,2,1,0,4,0,4,7283
3,3,2,0,6,0,6,7283
4,4,4,0,10,0,10,7283
5,5,0,0,10,0,10,7283
0,0,1,0,1,0,1,7284
1,1,1,0,2,0,2,7284
2,2,4,0,6,0,6,7284
3,3,2,0,8,0,8,7284
4,4,0,1,8,1,9,7284
5,5,0,0,8,1,9,7284
0,0,1,0,1,0,1,7285
1,1,2,0,3,0,3,7285
2,2,3,0,6,0,6,7285
3,3,2,1,8,1,9,7285
4,4,1,0,9,1,10,7285
5,5,0,0,9,1,10,7285
0,0,1,0,1,0,1,7286
1,1,0,0,1,0,1,7286
0,0,1,0,1,0,1,7287
1,1,1,0,2,0,2,7287
2,2,1,0,3,0,3,7287
3,3,1,0,4,0,4,7287
4,4,0,0,4,0,4,7287
0,0,1,0,1,0,1,7288
1,1,0,0,1,0,1,7288
0,0,1,0,1,0,1,7289
1,1,0,0,1,0,1,7289
0,0,1,0,1,0,1,7290
1,1,0,0,1,0,1,7290
0,0,1,0,1,0,1,7291
1,1,0,0,1,0,1,7291
0,0,1,0,1,0,1,7292
1,1,1,0,2,0,2,7292
2,2,1,0,3,0,3,7292
3,3,0,0,3,0,3,7292
0,0,1,0,1,0,1,7293
1,1,1,0,2,0,2,7293
2,2,3,0,5,0,5,7293
3,3,1,0,6,0,6,7293
4,4,0,0,6,0,6,7293
0,0,1,0,1,0,1,7294
1,1,0,0,1,0,1,7294
0,0,1,0,1,0,1,7295
1,1,1,0,2,0,2,7295
2,2,0,2,2,2,4,7295
3,3,0,0,2,2,4,7295
0,0,1,0,1,0,1,7296
1,1,2,0,3,0,3,7296
2,2,1,1,4,1,5,7296
3,3,0,0,4,1,5,7296
0,0,1,0,1,0,1,7297
1,1,3,0,4,0,4,7297
2,2,0,2,4,2,6,7297
3,3,0,2,4,4,8,7297
4,4,0,2,4,6,10,7297
5,5,0,1,4,7,11,7297
6,6,0,0,4,7,11,7297
0,0,1,0,1,0,1,7298
1,1,3,0,4,0,4,7298
2,2,3,0,7,0,7,7298
3,3,1,0,8,0,8,7298
4,4,1,1,9,1,10,7298
5,5,0,0,9,1,10,7298
0,0,1,0,1,0,1,7299
1,1,0,0,1,0,1,7299
0,0,1,0,1,0,1,7300
1,1,0,0,1,0,1,7300
0,0,1,0,1,0,1,7301
1,1,2,0,3,0,3,7301
2,2,1,1,4,1,5,7301
3,3,0,2,4,3,7,7301
4,4,2,2,6,5,11,7301
5,5,4,1,10,6,16,7301
6,6,2,1,12,7,19,7301
7,7,1,0,13,7,20,7301
8,8,3,1,16,8,24,7301
9,9,2,1,18,9,27,7301
10,10,1,1,19,10,29,7301
11,11,0,2,19,12,31,7301
12,12,0,2,19,14,33,7301
13,13,2,2,21,16,37,7301
14,14,2,2,23,18,41,7301
15,15,1,0,24,18,42,7301
16,16,1,1,25,19,44,7301
17,17,0,2,25,21,46,7301
18,18,0,1,25,22,47,7301
19,19,0,0,25,22,47,7301
0,0,1,0,1,0,1,7302
1,1,2,0,3,0,3,7302
2,2,3,0,6,0,6,7302
3,3,3,0,9,0,9,7302
4,4,5,0,14,0,14,7302
5,5,3,1,17,1,18,7302
6,6,5,2,22,3,25,7302
7,7,5,3,27,6,33,7302
8,8,5,2,32,8,40,7302
9,9,6,3,38,11,49,7302
10,10,3,6,41,17,58,7302
11,11,4,5,45,22,67,7302
12,12,4,5,49,27,76,7302
13,13,2,3,51,30,81,7302
14,14,3,4,54,34,88,7302
15,15,4,3,58,37,95,7302
16,16,2,0,60,37,97,7302
17,17,3,0,63,37,100,7302
18,18,1,0,64,37,101,7302
19,19,1,0,65,37,102,7302
20,20,1,0,66,37,103,7302
21,21,0,0,66,37,103,7302
0,0,1,0,1,0,1,7303
1,1,0,0,1,0,1,7303
0,0,1,0,1,0,1,7304
1,1,1,0,2,0,2,7304
2,2,2,0,4,0,4,7304
3,3,1,0,5,0,5,7304
4,4,0,0,5,0,5,7304
0,0,1,0,1,0,1,7305
1,1,1,0,2,0,2,7305
2,2,3,1,5,1,6,7305
3,3,2,1,7,2,9,7305
4,4,0,0,7,2,9,7305
0,0,1,0,1,0,1,7306
1,1,2,0,3,0,3,7306
2,2,2,0,5,0,5,7306
3,3,2,0,7,0,7,7306
4,4,1,0,8,0,8,7306
5,5,1,1,9,1,10,7306
6,6,2,1,11,2,13,7306
7,7,2,1,13,3,16,7306
8,8,2,0,15,3,18,7306
9,9,1,0,16,3,19,7306
10,10,0,0,16,3,19,7306
0,0,1,0,1,0,1,7307
1,1,1,0,2,0,2,7307
2,2,0,0,2,0,2,7307
0,0,1,0,1,0,1,7308
1,1,1,0,2,0,2,7308
2,2,0,0,2,0,2,7308
0,0,1,0,1,0,1,7309
1,1,1,0,2,0,2,7309
2,2,0,0,2,0,2,7309
0,0,1,0,1,0,1,7310
1,1,0,0,1,0,1,7310
0,0,1,0,1,0,1,7311
1,1,1,0,2,0,2,7311
2,2,3,1,5,1,6,7311
3,3,5,1,10,2,12,7311
4,4,2,2,12,4,16,7311
5,5,2,2,14,6,20,7311
6,6,2,2,16,8,24,7311
7,7,2,3,18,11,29,7311
8,8,1,3,19,14,33,7311
9,9,2,2,21,16,37,7311
10,10,1,1,22,17,39,7311
11,11,4,0,26,17,43,7311
12,12,2,3,28,20,48,7311
13,13,4,1,32,21,53,7311
14,14,3,2,35,23,58,7311
15,15,6,3,41,26,67,7311
16,16,7,4,48,30,78,7311
17,17,6,4,54,34,88,7311
18,18,4,5,58,39,97,7311
19,19,5,1,63,40,103,7311
20,20,5,1,68,41,109,7311
21,21,4,1,72,42,114,7311
22,22,5,1,77,43,120,7311
23,23,2,2,79,45,124,7311
24,24,6,2,85,47,132,7311
25,25,8,5,93,52,145,7311
26,26,12,6,105,58,163,7311
27,27,14,4,119,62,181,7311
28,28,13,4,132,66,198,7311
29,29,12,5,144,71,215,7311
30,30,7,6,151,77,228,7311
31,31,6,3,157,80,237,7311
32,32,8,2,165,82,247,7311
33,33,9,2,174,84,258,7311
34,34,3,2,177,86,263,7311
35,35,3,1,180,87,267,7311
36,36,5,1,185,88,273,7311
37,37,3,3,188,91,279,7311
38,38,5,4,193,95,288,7311
39,39,1,6,194,101,295,7311
40,40,1,5,195,106,301,7311
41,41,2,2,197,108,305,7311
42,42,0,3,197,111,308,7311
43,43,0,2,197,113,310,7311
44,44,0,3,197,116,313,7311
45,45,1,3,198,119,317,7311
46,46,1,0,199,119,318,7311
47,47,3,0,202,119,321,7311
48,48,0,1,202,120,322,7311
49,49,0,0,202,120,322,7311
0,0,1,0,1,0,1,7312
1,1,2,0,3,0,3,7312
2,2,3,2,6,2,8,7312
3,3,1,3,7,5,12,7312
4,4,3,3,10,8,18,7312
5,5,3,2,13,10,23,7312
6,6,2,2,15,12,27,7312
7,7,0,3,15,15,30,7312
8,8,0,4,15,19,34,7312
9,9,1,5,16,24,40,7312
10,10,1,6,17,30,47,7312
11,11,2,5,19,35,54,7312
12,12,5,6,24,41,65,7312
13,13,3,3,27,44,71,7312
14,14,3,3,30,47,77,7312
15,15,3,3,33,50,83,7312
16,16,3,3,36,53,89,7312
17,17,3,2,39,55,94,7312
18,18,5,3,44,58,102,7312
19,19,4,4,48,62,110,7312
20,20,2,2,50,64,114,7312
21,21,3,0,53,64,117,7312
22,22,1,1,54,65,119,7312
23,23,0,0,54,65,119,7312
0,0,1,0,1,0,1,7313
1,1,1,0,2,0,2,7313
2,2,3,1,5,1,6,7313
3,3,5,3,10,4,14,7313
4,4,3,4,13,8,21,7313
5,5,1,4,14,12,26,7313
6,6,2,2,16,14,30,7313
7,7,0,4,16,18,34,7313
8,8,0,2,16,20,36,7313
9,9,0,0,16,20,36,7313
0,0,1,0,1,0,1,7314
1,1,1,0,2,0,2,7314
2,2,1,1,3,1,4,7314
3,3,0,2,3,3,6,7314
4,4,0,5,3,8,11,7314
5,5,2,3,5,11,16,7314
6,6,0,7,5,18,23,7314
7,7,2,6,7,24,31,7314
8,8,0,8,7,32,39,7314
9,9,0,4,7,36,43,7314
10,10,1,3,8,39,47,7314
11,11,2,2,10,41,51,7314
12,12,3,3,13,44,57,7314
13,13,3,1,16,45,61,7314
14,14,2,0,18,45,63,7314
15,15,0,1,18,46,64,7314
16,16,0,1,18,47,65,7314
17,17,0,1,18,48,66,7314
18,18,0,0,18,48,66,7314
0,0,1,0,1,0,1,7315
1,1,1,0,2,0,2,7315
2,2,0,0,2,0,2,7315
0,0,1,0,1,0,1,7316
1,1,0,0,1,0,1,7316
0,0,1,0,1,0,1,7317
1,1,3,0,4,0,4,7317
2,2,0,0,4,0,4,7317
0,0,1,0,1,0,1,7318
1,1,1,0,2,0,2,7318
2,2,0,0,2,0,2,7318
0,0,1,0,1,0,1,7319
1,1,0,1,1,1,2,7319
2,2,0,0,1,1,2,7319
0,0,1,0,1,0,1,7320
1,1,1,0,2,0,2,7320
2,2,0,0,2,0,2,7320
0,0,1,0,1,0,1,7321
1,1,1,0,2,0,2,7321
2,2,0,0,2,0,2,7321
0,0,1,0,1,0,1,7322
1,1,0,0,1,0,1,7322
0,0,1,0,1,0,1,7323
1,1,0,0,1,0,1,7323
0,0,1,0,1,0,1,7324
1,1,0,0,1,0,1,7324
0,0,1,0,1,0,1,7325
1,1,1,0,2,0,2,7325
2,2,1,0,3,0,3,7325
3,3,0,0,3,0,3,7325
0,0,1,0,1,0,1,7326
1,1,1,0,2,0,2,7326
2,2,1,0,3,0,3,7326
3,3,1,0,4,0,4,7326
4,4,0,0,4,0,4,7326
0,0,1,0,1,0,1,7327
1,1,0,0,1,0,1,7327
0,0,1,0,1,0,1,7328
1,1,0,0,1,0,1,7328
0,0,1,0,1,0,1,7329
1,1,0,0,1,0,1,7329
0,0,1,0,1,0,1,7330
1,1,0,0,1,0,1,7330
0,0,1,0,1,0,1,7331
1,1,0,0,1,0,1,7331
0,0,1,0,1,0,1,7332
1,1,1,0,2,0,2,7332
2,2,0,1,2,1,3,7332
3,3,0,2,2,3,5,7332
4,4,0,0,2,3,5,7332
0,0,1,0,1,0,1,7333
1,1,1,0,2,0,2,7333
2,2,1,0,3,0,3,7333
3,3,1,0,4,0,4,7333
4,4,0,0,4,0,4,7333
0,0,1,0,1,0,1,7334
1,1,1,0,2,0,2,7334
2,2,0,0,2,0,2,7334
0,0,1,0,1,0,1,7335
1,1,2,0,3,0,3,7335
2,2,2,0,5,0,5,7335
3,3,4,1,9,1,10,7335
4,4,5,1,14,2,16,7335
5,5,5,3,19,5,24,7335
6,6,4,7,23,12,35,7335
7,7,3,7,26,19,45,7335
8,8,5,7,31,26,57,7335
9,9,3,4,34,30,64,7335
10,10,4,2,38,32,70,7335
11,11,4,2,42,34,76,7335
12,12,1,1,43,35,78,7335
13,13,0,0,43,35,78,7335
0,0,1,0,1,0,1,7336
1,1,1,0,2,0,2,7336
2,2,0,0,2,0,2,7336
0,0,1,0,1,0,1,7337
1,1,2,1,3,1,4,7337
2,2,0,0,3,1,4,7337
0,0,1,0,1,0,1,7338
1,1,1,0,2,0,2,7338
2,2,2,0,4,0,4,7338
3,3,2,0,6,0,6,7338
4,4,2,0,8,0,8,7338
5,5,3,1,11,1,12,7338
6,6,4,1,15,2,17,7338
7,7,1,0,16,2,18,7338
8,8,0,0,16,2,18,7338
0,0,1,0,1,0,1,7339
1,1,1,0,2,0,2,7339
2,2,1,0,3,0,3,7339
3,3,0,1,3,1,4,7339
4,4,0,1,3,2,5,7339
5,5,0,0,3,2,5,7339
0,0,1,0,1,0,1,7340
1,1,1,0,2,0,2,7340
2,2,1,1,3,1,4,7340
3,3,0,2,3,3,6,7340
4,4,0,0,3,3,6,7340
0,0,1,0,1,0,1,7341
1,1,1,0,2,0,2,7341
2,2,0,0,2,0,2,7341
0,0,1,0,1,0,1,7342
1,1,2,0,3,0,3,7342
2,2,1,0,4,0,4,7342
3,3,0,0,4,0,4,7342
0,0,1,0,1,0,1,7343
1,1,0,0,1,0,1,7343
0,0,1,0,1,0,1,7344
1,1,1,1,2,1,3,7344
2,2,1,2,3,3,6,7344
3,3,2,0,5,3,8,7344
4,4,2,1,7,4,11,7344
5,5,2,1,9,5,14,7344
6,6,1,0,10,5,15,7344
7,7,0,0,10,5,15,7344
0,0,1,0,1,0,1,7345
1,1,0,0,1,0,1,7345
0,0,1,0,1,0,1,7346
1,1,1,1,2,1,3,7346
2,2,0,0,2,1,3,7346
0,0,1,0,1,0,1,7347
1,1,1,1,2,1,3,7347
2,2,1,0,3,1,4,7347
3,3,0,0,3,1,4,7347
0,0,1,0,1,0,1,7348
1,1,1,0,2,0,2,7348
2,2,1,0,3,0,3,7348
3,3,0,0,3,0,3,7348
0,0,1,0,1,0,1,7349
1,1,0,0,1,0,1,7349
0,0,1,0,1,0,1,7350
1,1,2,0,3,0,3,7350
2,2,0,0,3,0,3,7350
0,0,1,0,1,0,1,7351
1,1,0,0,1,0,1,7351
0,0,1,0,1,0,1,7352
1,1,0,1,1,1,2,7352
2,2,1,1,2,2,4,7352
3,3,0,0,2,2,4,7352
0,0,1,0,1,0,1,7353
1,1,3,0,4,0,4,7353
2,2,4,1,8,1,9,7353
3,3,5,0,13,1,14,7353
4,4,2,0,15,1,16,7353
5,5,1,0,16,1,17,7353
6,6,0,0,16,1,17,7353
0,0,1,0,1,0,1,7354
1,1,3,0,4,0,4,7354
2,2,1,0,5,0,5,7354
3,3,0,0,5,0,5,7354
0,0,1,0,1,0,1,7355
1,1,2,0,3,0,3,7355
2,2,1,0,4,0,4,7355
3,3,0,0,4,0,4,7355
0,0,1,0,1,0,1,7356
1,1,2,0,3,0,3,7356
2,2,2,2,5,2,7,7356
3,3,4,4,9,6,15,7356
4,4,6,3,15,9,24,7356
5,5,3,4,18,13,31,7356
6,6,2,8,20,21,41,7356
7,7,4,5,24,26,50,7356
8,8,7,1,31,27,58,7356
9,9,7,1,38,28,66,7356
10,10,5,1,43,29,72,7356
11,11,6,5,49,34,83,7356
12,12,3,3,52,37,89,7356
13,13,5,1,57,38,95,7356
14,14,2,5,59,43,102,7356
15,15,1,2,60,45,105,7356
16,16,1,2,61,47,108,7356
17,17,4,1,65,48,113,7356
18,18,5,0,70,48,118,7356
19,19,1,0,71,48,119,7356
20,20,1,0,72,48,120,7356
21,21,0,0,72,48,120,7356
0,0,1,0,1,0,1,7357
1,1,1,1,2,1,3,7357
2,2,0,1,2,2,4,7357
3,3,1,0,3,2,5,7357
4,4,1,0,4,2,6,7357
5,5,0,0,4,2,6,7357
0,0,1,0,1,0,1,7358
1,1,0,1,1,1,2,7358
2,2,0,0,1,1,2,7358
0,0,1,0,1,0,1,7359
1,1,1,0,2,0,2,7359
2,2,0,0,2,0,2,7359
0,0,1,0,1,0,1,7360
1,1,1,0,2,0,2,7360
2,2,1,0,3,0,3,7360
3,3,2,0,5,0,5,7360
4,4,0,0,5,0,5,7360
0,0,1,0,1,0,1,7361
1,1,0,0,1,0,1,7361
0,0,1,0,1,0,1,7362
1,1,2,1,3,1,4,7362
2,2,1,0,4,1,5,7362
3,3,0,0,4,1,5,7362
0,0,1,0,1,0,1,7363
1,1,0,0,1,0,1,7363
0,0,1,0,1,0,1,7364
1,1,1,0,2,0,2,7364
2,2,0,0,2,0,2,7364
0,0,1,0,1,0,1,7365
1,1,0,1,1,1,2,7365
2,2,0,1,1,2,3,7365
3,3,0,1,1,3,4,7365
4,4,0,1,1,4,5,7365
5,5,0,1,1,5,6,7365
6,6,0,0,1,5,6,7365
0,0,1,0,1,0,1,7366
1,1,0,0,1,0,1,7366
0,0,1,0,1,0,1,7367
1,1,0,0,1,0,1,7367
0,0,1,0,1,0,1,7368
1,1,0,0,1,0,1,7368
0,0,1,0,1,0,1,7369
1,1,2,0,3,0,3,7369
2,2,4,0,7,0,7,7369
3,3,2,0,9,0,9,7369
4,4,2,0,11,0,11,7369
5,5,3,1,14,1,15,7369
6,6,5,2,19,3,22,7369
7,7,0,4,19,7,26,7369
8,8,1,3,20,10,30,7369
9,9,0,0,20,10,30,7369
0,0,1,0,1,0,1,7370
1,1,1,0,2,0,2,7370
2,2,1,1,3,1,4,7370
3,3,0,2,3,3,6,7370
4,4,0,0,3,3,6,7370
0,0,1,0,1,0,1,7371
1,1,0,0,1,0,1,7371
0,0,1,0,1,0,1,7372
1,1,1,0,2,0,2,7372
2,2,1,0,3,0,3,7372
3,3,2,0,5,0,5,7372
4,4,0,1,5,1,6,7372
5,5,0,1,5,2,7,7372
6,6,0,0,5,2,7,7372
0,0,1,0,1,0,1,7373
1,1,0,0,1,0,1,7373
0,0,1,0,1,0,1,7374
1,1,0,0,1,0,1,7374
0,0,1,0,1,0,1,7375
1,1,2,0,3,0,3,7375
2,2,2,0,5,0,5,7375
3,3,1,0,6,0,6,7375
4,4,1,0,7,0,7,7375
5,5,0,0,7,0,7,7375
0,0,1,0,1,0,1,7376
1,1,2,0,3,0,3,7376
2,2,1,0,4,0,4,7376
3,3,1,0,5,0,5,7376
4,4,1,0,6,0,6,7376
5,5,0,0,6,0,6,7376
0,0,1,0,1,0,1,7377
1,1,0,0,1,0,1,7377
0,0,1,0,1,0,1,7378
1,1,3,0,4,0,4,7378
2,2,4,1,8,1,9,7378
3,3,1,0,9,1,10,7378
4,4,1,0,10,1,11,7378
5,5,0,0,10,1,11,7378
0,0,1,0,1,0,1,7379
1,1,1,0,2,0,2,7379
2,2,2,0,4,0,4,7379
3,3,1,0,5,0,5,7379
4,4,1,0,6,0,6,7379
5,5,0,0,6,0,6,7379
0,0,1,0,1,0,1,7380
1,1,0,1,1,1,2,7380
2,2,0,0,1,1,2,7380
0,0,1,0,1,0,1,7381
1,1,0,1,1,1,2,7381
2,2,0,1,1,2,3,7381
3,3,0,4,1,6,7,7381
4,4,0,3,1,9,10,7381
5,5,1,1,2,10,12,7381
6,6,1,1,3,11,14,7381
7,7,1,0,4,11,15,7381
8,8,1,0,5,11,16,7381
9,9,1,0,6,11,17,7381
10,10,0,0,6,11,17,7381
0,0,1,0,1,0,1,7382
1,1,1,0,2,0,2,7382
2,2,0,0,2,0,2,7382
0,0,1,0,1,0,1,7383
1,1,4,0,5,0,5,7383
2,2,4,0,9,0,9,7383
3,3,3,0,12,0,12,7383
4,4,2,0,14,0,14,7383
5,5,1,1,15,1,16,7383
6,6,0,1,15,2,17,7383
7,7,0,0,15,2,17,7383
0,0,1,0,1,0,1,7384
1,1,0,1,1,1,2,7384
2,2,0,1,1,2,3,7384
3,3,0,1,1,3,4,7384
4,4,0,0,1,3,4,7384
0,0,1,0,1,0,1,7385
1,1,0,0,1,0,1,7385
0,0,1,0,1,0,1,7386
1,1,1,0,2,0,2,7386
2,2,0,0,2,0,2,7386
0,0,1,0,1,0,1,7387
1,1,0,0,1,0,1,7387
0,0,1,0,1,0,1,7388
1,1,2,0,3,0,3,7388
2,2,2,0,5,0,5,7388
3,3,2,0,7,0,7,7388
4,4,0,0,7,0,7,7388
0,0,1,0,1,0,1,7389
1,1,0,0,1,0,1,7389
0,0,1,0,1,0,1,7390
1,1,2,0,3,0,3,7390
2,2,0,0,3,0,3,7390
0,0,1,0,1,0,1,7391
1,1,3,0,4,0,4,7391
2,2,2,1,6,1,7,7391
3,3,1,0,7,1,8,7391
4,4,1,0,8,1,9,7391
5,5,1,0,9,1,10,7391
6,6,0,0,9,1,10,7391
0,0,1,0,1,0,1,7392
1,1,1,0,2,0,2,7392
2,2,1,0,3,0,3,7392
3,3,0,1,3,1,4,7392
4,4,0,0,3,1,4,7392
0,0,1,0,1,0,1,7393
1,1,0,1,1,1,2,7393
2,2,0,1,1,2,3,7393
3,3,1,0,2,2,4,7393
4,4,0,0,2,2,4,7393
0,0,1,0,1,0,1,7394
1,1,0,0,1,0,1,7394
0,0,1,0,1,0,1,7395
1,1,0,0,1,0,1,7395
0,0,1,0,1,0,1,7396
1,1,0,1,1,1,2,7396
2,2,0,0,1,1,2,7396
0,0,1,0,1,0,1,7397
1,1,0,1,1,1,2,7397
2,2,0,0,1,1,2,7397
0,0,1,0,1,0,1,7398
1,1,1,1,2,1,3,7398
2,2,1,2,3,3,6,7398
3,3,2,4,5,7,12,7398
4,4,2,3,7,10,17,7398
5,5,3,1,10,11,21,7398
6,6,2,2,12,13,25,7398
7,7,2,2,14,15,29,7398
8,8,0,2,14,17,31,7398
9,9,0,3,14,20,34,7398
10,10,0,0,14,20,34,7398
0,0,1,0,1,0,1,7399
1,1,0,0,1,0,1,7399
0,0,1,0,1,0,1,7400
1,1,1,0,2,0,2,7400
2,2,1,0,3,0,3,7400
3,3,1,0,4,0,4,7400
4,4,0,0,4,0,4,7400
0,0,1,0,1,0,1,7401
1,1,2,0,3,0,3,7401
2,2,3,0,6,0,6,7401
3,3,1,0,7,0,7,7401
4,4,0,0,7,0,7,7401
0,0,1,0,1,0,1,7402
1,1,0,0,1,0,1,7402
0,0,1,0,1,0,1,7403
1,1,0,0,1,0,1,7403
0,0,1,0,1,0,1,7404
1,1,0,0,1,0,1,7404
0,0,1,0,1,0,1,7405
1,1,0,1,1,1,2,7405
2,2,0,0,1,1,2,7405
0,0,1,0,1,0,1,7406
1,1,0,0,1,0,1,7406
0,0,1,0,1,0,1,7407
1,1,1,0,2,0,2,7407
2,2,1,1,3,1,4,7407
3,3,1,0,4,1,5,7407
4,4,1,0,5,1,6,7407
5,5,2,0,7,1,8,7407
6,6,1,0,8,1,9,7407
7,7,0,0,8,1,9,7407
0,0,1,0,1,0,1,7408
1,1,3,1,4,1,5,7408
2,2,0,2,4,3,7,7408
3,3,0,2,4,5,9,7408
4,4,1,1,5,6,11,7408
5,5,1,0,6,6,12,7408
6,6,1,0,7,6,13,7408
7,7,1,0,8,6,14,7408
8,8,1,0,9,6,15,7408
9,9,1,0,10,6,16,7408
10,10,1,0,11,6,17,7408
11,11,1,0,12,6,18,7408
12,12,2,0,14,6,20,7408
13,13,0,0,14,6,20,7408
0,0,1,0,1,0,1,7409
1,1,1,0,2,0,2,7409
2,2,0,0,2,0,2,7409
0,0,1,0,1,0,1,7410
1,1,1,0,2,0,2,7410
2,2,1,0,3,0,3,7410
3,3,0,1,3,1,4,7410
4,4,0,0,3,1,4,7410
0,0,1,0,1,0,1,7411
1,1,1,0,2,0,2,7411
2,2,1,0,3,0,3,7411
3,3,0,0,3,0,3,7411
0,0,1,0,1,0,1,7412
1,1,0,0,1,0,1,7412
0,0,1,0,1,0,1,7413
1,1,1,0,2,0,2,7413
2,2,1,1,3,1,4,7413
3,3,0,0,3,1,4,7413
0,0,1,0,1,0,1,7414
1,1,0,0,1,0,1,7414
0,0,1,0,1,0,1,7415
1,1,0,0,1,0,1,7415
0,0,1,0,1,0,1,7416
1,1,1,0,2,0,2,7416
2,2,0,0,2,0,2,7416
0,0,1,0,1,0,1,7417
1,1,0,0,1,0,1,7417
0,0,1,0,1,0,1,7418
1,1,1,0,2,0,2,7418
2,2,2,1,4,1,5,7418
3,3,3,2,7,3,10,7418
4,4,2,3,9,6,15,7418
5,5,1,2,10,8,18,7418
6,6,1,2,11,10,21,7418
7,7,1,0,12,10,22,7418
8,8,0,0,12,10,22,7418
0,0,1,0,1,0,1,7419
1,1,0,0,1,0,1,7419
0,0,1,0,1,0,1,7420
1,1,0,0,1,0,1,7420
0,0,1,0,1,0,1,7421
1,1,1,0,2,0,2,7421
2,2,0,0,2,0,2,7421
0,0,1,0,1,0,1,7422
1,1,0,0,1,0,1,7422
0,0,1,0,1,0,1,7423
1,1,0,0,1,0,1,7423
0,0,1,0,1,0,1,7424
1,1,1,0,2,0,2,7424
2,2,1,0,3,0,3,7424
3,3,0,0,3,0,3,7424
0,0,1,0,1,0,1,7425
1,1,0,0,1,0,1,7425
0,0,1,0,1,0,1,7426
1,1,1,1,2,1,3,7426
2,2,1,1,3,2,5,7426
3,3,0,2,3,4,7,7426
4,4,0,0,3,4,7,7426
0,0,1,0,1,0,1,7427
1,1,0,0,1,0,1,7427
0,0,1,0,1,0,1,7428
1,1,1,0,2,0,2,7428
2,2,1,1,3,1,4,7428
3,3,1,0,4,1,5,7428
4,4,2,0,6,1,7,7428
5,5,2,0,8,1,9,7428
6,6,0,0,8,1,9,7428
0,0,1,0,1,0,1,7429
1,1,0,0,1,0,1,7429
0,0,1,0,1,0,1,7430
1,1,0,0,1,0,1,7430
0,0,1,0,1,0,1,7431
1,1,0,0,1,0,1,7431
0,0,1,0,1,0,1,7432
1,1,0,0,1,0,1,7432
0,0,1,0,1,0,1,7433
1,1,0,0,1,0,1,7433
0,0,1,0,1,0,1,7434
1,1,0,1,1,1,2,7434
2,2,0,0,1,1,2,7434
0,0,1,0,1,0,1,7435
1,1,0,0,1,0,1,7435
0,0,1,0,1,0,1,7436
1,1,2,0,3,0,3,7436
2,2,3,2,6,2,8,7436
3,3,1,1,7,3,10,7436
4,4,1,0,8,3,11,7436
5,5,0,0,8,3,11,7436
0,0,1,0,1,0,1,7437
1,1,1,0,2,0,2,7437
2,2,1,0,3,0,3,7437
3,3,2,1,5,1,6,7437
4,4,0,1,5,2,7,7437
5,5,0,3,5,5,10,7437
6,6,2,0,7,5,12,7437
7,7,1,2,8,7,15,7437
8,8,1,1,9,8,17,7437
9,9,0,1,9,9,18,7437
10,10,0,0,9,9,18,7437
0,0,1,0,1,0,1,7438
1,1,0,0,1,0,1,7438
0,0,1,0,1,0,1,7439
1,1,0,0,1,0,1,7439
0,0,1,0,1,0,1,7440
1,1,2,0,3,0,3,7440
2,2,1,0,4,0,4,7440
3,3,0,0,4,0,4,7440
0,0,1,0,1,0,1,7441
1,1,1,0,2,0,2,7441
2,2,2,0,4,0,4,7441
3,3,2,0,6,0,6,7441
4,4,3,1,9,1,10,7441
5,5,2,1,11,2,13,7441
6,6,2,3,13,5,18,7441
7,7,2,4,15,9,24,7441
8,8,2,3,17,12,29,7441
9,9,1,3,18,15,33,7441
10,10,1,4,19,19,38,7441
11,11,1,4,20,23,43,7441
12,12,3,1,23,24,47,7441
13,13,4,2,27,26,53,7441
14,14,4,0,31,26,57,7441
15,15,2,0,33,26,59,7441
16,16,1,0,34,26,60,7441
17,17,0,0,34,26,60,7441
0,0,1,0,1,0,1,7442
1,1,1,0,2,0,2,7442
2,2,1,0,3,0,3,7442
3,3,2,1,5,1,6,7442
4,4,3,3,8,4,12,7442
5,5,1,2,9,6,15,7442
6,6,1,1,10,7,17,7442
7,7,1,0,11,7,18,7442
8,8,1,0,12,7,19,7442
9,9,0,0,12,7,19,7442
0,0,1,0,1,0,1,7443
1,1,0,1,1,1,2,7443
2,2,0,1,1,2,3,7443
3,3,0,1,1,3,4,7443
4,4,0,0,1,3,4,7443
0,0,1,0,1,0,1,7444
1,1,0,0,1,0,1,7444
0,0,1,0,1,0,1,7445
1,1,2,0,3,0,3,7445
2,2,0,0,3,0,3,7445
0,0,1,0,1,0,1,7446
1,1,1,1,2,1,3,7446
2,2,1,0,3,1,4,7446
3,3,1,1,4,2,6,7446
4,4,0,1,4,3,7,7446
5,5,0,1,4,4,8,7446
6,6,0,0,4,4,8,7446
0,0,1,0,1,0,1,7447
1,1,0,0,1,0,1,7447
0,0,1,0,1,0,1,7448
1,1,1,0,2,0,2,7448
2,2,0,0,2,0,2,7448
0,0,1,0,1,0,1,7449
1,1,1,0,2,0,2,7449
2,2,3,0,5,0,5,7449
3,3,2,2,7,2,9,7449
4,4,2,2,9,4,13,7449
5,5,3,1,12,5,17,7449
6,6,2,1,14,6,20,7449
7,7,0,0,14,6,20,7449
0,0,1,0,1,0,1,7450
1,1,0,0,1,0,1,7450
0,0,1,0,1,0,1,7451
1,1,1,1,2,1,3,7451
2,2,1,1,3,2,5,7451
3,3,0,0,3,2,5,7451
0,0,1,0,1,0,1,7452
1,1,1,0,2,0,2,7452
2,2,1,0,3,0,3,7452
3,3,2,0,5,0,5,7452
4,4,3,0,8,0,8,7452
5,5,1,2,9,2,11,7452
6,6,2,1,11,3,14,7452
7,7,2,3,13,6,19,7452
8,8,0,4,13,10,23,7452
9,9,1,4,14,14,28,7452
10,10,1,3,15,17,32,7452
11,11,1,2,16,19,35,7452
12,12,1,1,17,20,37,7452
13,13,0,4,17,24,41,7452
14,14,1,1,18,25,43,7452
15,15,0,0,18,25,43,7452
0,0,1,0,1,0,1,7453
1,1,1,0,2,0,2,7453
2,2,1,0,3,0,3,7453
3,3,0,0,3,0,3,7453
0,0,1,0,1,0,1,7454
1,1,0,0,1,0,1,7454
0,0,1,0,1,0,1,7455
1,1,0,1,1,1,2,7455
2,2,0,0,1,1,2,7455
0,0,1,0,1,0,1,7456
1,1,2,1,3,1,4,7456
2,2,3,1,6,2,8,7456
3,3,3,0,9,2,11,7456
4,4,3,1,12,3,15,7456
5,5,1,0,13,3,16,7456
6,6,3,1,16,4,20,7456
7,7,1,1,17,5,22,7456
8,8,2,0,19,5,24,7456
9,9,1,1,20,6,26,7456
10,10,1,3,21,9,30,7456
11,11,2,1,23,10,33,7456
12,12,3,0,26,10,36,7456
13,13,1,2,27,12,39,7456
14,14,4,1,31,13,44,7456
15,15,4,1,35,14,49,7456
16,16,0,2,35,16,51,7456
17,17,2,1,37,17,54,7456
18,18,0,3,37,20,57,7456
19,19,1,4,38,24,62,7456
20,20,0,1,38,25,63,7456
21,21,0,0,38,25,63,7456
0,0,1,0,1,0,1,7457
1,1,1,0,2,0,2,7457
2,2,1,1,3,1,4,7457
3,3,1,1,4,2,6,7457
4,4,1,1,5,3,8,7457
5,5,2,1,7,4,11,7457
6,6,1,0,8,4,12,7457
7,7,0,0,8,4,12,7457
0,0,1,0,1,0,1,7458
1,1,1,0,2,0,2,7458
2,2,1,0,3,0,3,7458
3,3,1,0,4,0,4,7458
4,4,0,0,4,0,4,7458
0,0,1,0,1,0,1,7459
1,1,0,0,1,0,1,7459
0,0,1,0,1,0,1,7460
1,1,0,0,1,0,1,7460
0,0,1,0,1,0,1,7461
1,1,0,0,1,0,1,7461
0,0,1,0,1,0,1,7462
1,1,0,1,1,1,2,7462
2,2,0,1,1,2,3,7462
3,3,0,0,1,2,3,7462
0,0,1,0,1,0,1,7463
1,1,0,0,1,0,1,7463
0,0,1,0,1,0,1,7464
1,1,2,0,3,0,3,7464
2,2,2,0,5,0,5,7464
3,3,2,0,7,0,7,7464
4,4,0,0,7,0,7,7464
0,0,1,0,1,0,1,7465
1,1,1,1,2,1,3,7465
2,2,0,3,2,4,6,7465
3,3,1,5,3,9,12,7465
4,4,2,4,5,13,18,7465
5,5,3,3,8,16,24,7465
6,6,1,2,9,18,27,7465
7,7,0,0,9,18,27,7465
0,0,1,0,1,0,1,7466
1,1,1,0,2,0,2,7466
2,2,1,0,3,0,3,7466
3,3,0,0,3,0,3,7466
0,0,1,0,1,0,1,7467
1,1,1,0,2,0,2,7467
2,2,0,0,2,0,2,7467
0,0,1,0,1,0,1,7468
1,1,2,0,3,0,3,7468
2,2,0,0,3,0,3,7468
0,0,1,0,1,0,1,7469
1,1,0,0,1,0,1,7469
0,0,1,0,1,0,1,7470
1,1,0,0,1,0,1,7470
0,0,1,0,1,0,1,7471
1,1,0,0,1,0,1,7471
0,0,1,0,1,0,1,7472
1,1,0,0,1,0,1,7472
0,0,1,0,1,0,1,7473
1,1,0,0,1,0,1,7473
0,0,1,0,1,0,1,7474
1,1,0,1,1,1,2,7474
2,2,0,1,1,2,3,7474
3,3,0,1,1,3,4,7474
4,4,1,1,2,4,6,7474
5,5,1,1,3,5,8,7474
6,6,0,1,3,6,9,7474
7,7,0,0,3,6,9,7474
0,0,1,0,1,0,1,7475
1,1,0,0,1,0,1,7475
0,0,1,0,1,0,1,7476
1,1,0,0,1,0,1,7476
0,0,1,0,1,0,1,7477
1,1,0,0,1,0,1,7477
0,0,1,0,1,0,1,7478
1,1,0,0,1,0,1,7478
0,0,1,0,1,0,1,7479
1,1,0,0,1,0,1,7479
0,0,1,0,1,0,1,7480
1,1,1,0,2,0,2,7480
2,2,1,0,3,0,3,7480
3,3,1,0,4,0,4,7480
4,4,0,0,4,0,4,7480
0,0,1,0,1,0,1,7481
1,1,1,1,2,1,3,7481
2,2,1,1,3,2,5,7481
3,3,1,2,4,4,8,7481
4,4,1,1,5,5,10,7481
5,5,2,0,7,5,12,7481
6,6,0,0,7,5,12,7481
0,0,1,0,1,0,1,7482
1,1,0,0,1,0,1,7482
0,0,1,0,1,0,1,7483
1,1,1,0,2,0,2,7483
2,2,0,0,2,0,2,7483
0,0,1,0,1,0,1,7484
1,1,0,1,1,1,2,7484
2,2,0,0,1,1,2,7484
0,0,1,0,1,0,1,7485
1,1,2,0,3,0,3,7485
2,2,2,0,5,0,5,7485
3,3,1,1,6,1,7,7485
4,4,2,2,8,3,11,7485
5,5,2,1,10,4,14,7485
6,6,0,1,10,5,15,7485
7,7,0,1,10,6,16,7485
8,8,0,1,10,7,17,7485
9,9,1,0,11,7,18,7485
10,10,1,0,12,7,19,7485
11,11,1,1,13,8,21,7485
12,12,2,1,15,9,24,7485
13,13,1,2,16,11,27,7485
14,14,0,1,16,12,28,7485
15,15,0,1,16,13,29,7485
16,16,0,2,16,15,31,7485
17,17,0,0,16,15,31,7485
0,0,1,0,1,0,1,7486
1,1,0,0,1,0,1,7486
0,0,1,0,1,0,1,7487
1,1,0,0,1,0,1,7487
0,0,1,0,1,0,1,7488
1,1,1,1,2,1,3,7488
2,2,3,0,5,1,6,7488
3,3,5,3,10,4,14,7488
4,4,4,6,14,10,24,7488
5,5,7,2,21,12,33,7488
6,6,5,3,26,15,41,7488
7,7,2,1,28,16,44,7488
8,8,0,1,28,17,45,7488
9,9,0,0,28,17,45,7488
0,0,1,0,1,0,1,7489
1,1,1,0,2,0,2,7489
2,2,0,0,2,0,2,7489
0,0,1,0,1,0,1,7490
1,1,0,0,1,0,1,7490
0,0,1,0,1,0,1,7491
1,1,0,0,1,0,1,7491
0,0,1,0,1,0,1,7492
1,1,1,0,2,0,2,7492
2,2,0,0,2,0,2,7492
0,0,1,0,1,0,1,7493
1,1,0,0,1,0,1,7493
0,0,1,0,1,0,1,7494
1,1,2,0,3,0,3,7494
2,2,0,0,3,0,3,7494
0,0,1,0,1,0,1,7495
1,1,0,0,1,0,1,7495
0,0,1,0,1,0,1,7496
1,1,2,0,3,0,3,7496
2,2,1,0,4,0,4,7496
3,3,0,0,4,0,4,7496
0,0,1,0,1,0,1,7497
1,1,1,0,2,0,2,7497
2,2,2,0,4,0,4,7497
3,3,3,1,7,1,8,7497
4,4,2,2,9,3,12,7497
5,5,0,2,9,5,14,7497
6,6,0,2,9,7,16,7497
7,7,0,2,9,9,18,7497
8,8,1,1,10,10,20,7497
9,9,0,1,10,11,21,7497
10,10,1,1,11,12,23,7497
11,11,1,2,12,14,26,7497
12,12,3,2,15,16,31,7497
13,13,3,1,18,17,35,7497
14,14,0,4,18,21,39,7497
15,15,0,1,18,22,40,7497
16,16,0,0,18,22,40,7497
0,0,1,0,1,0,1,7498
1,1,2,0,3,0,3,7498
2,2,0,0,3,0,3,7498
0,0,1,0,1,0,1,7499
1,1,1,0,2,0,2,7499
2,2,2,0,4,0,4,7499
3,3,1,3,5,3,8,7499
4,4,3,2,8,5,13,7499
5,5,1,1,9,6,15,7499
6,6,0,0,9,6,15,7499
0,0,1,0,1,0,1,7500
1,1,0,0,1,0,1,7500
0,0,1,0,1,0,1,7501
1,1,1,0,2,0,2,7501
2,2,0,0,2,0,2,7501
0,0,1,0,1,0,1,7502
1,1,0,0,1,0,1,7502
0,0,1,0,1,0,1,7503
1,1,2,0,3,0,3,7503
2,2,2,0,5,0,5,7503
3,3,0,0,5,0,5,7503
0,0,1,0,1,0,1,7504
1,1,1,0,2,0,2,7504
2,2,1,0,3,0,3,7504
3,3,0,0,3,0,3,7504
0,0,1,0,1,0,1,7505
1,1,1,0,2,0,2,7505
2,2,0,0,2,0,2,7505
0,0,1,0,1,0,1,7506
1,1,1,0,2,0,2,7506
2,2,1,0,3,0,3,7506
3,3,0,0,3,0,3,7506
0,0,1,0,1,0,1,7507
1,1,3,0,4,0,4,7507
2,2,4,0,8,0,8,7507
3,3,5,1,13,1,14,7507
4,4,2,5,15,6,21,7507
5,5,2,2,17,8,25,7507
6,6,2,2,19,10,29,7507
7,7,1,3,20,13,33,7507
8,8,1,2,21,15,36,7507
9,9,2,1,23,16,39,7507
10,10,3,1,26,17,43,7507
11,11,3,1,29,18,47,7507
12,12,2,3,31,21,52,7507
13,13,2,2,33,23,56,7507
14,14,2,3,35,26,61,7507
15,15,4,3,39,29,68,7507
16,16,1,0,40,29,69,7507
17,17,1,2,41,31,72,7507
18,18,0,2,41,33,74,7507
19,19,1,0,42,33,75,7507
20,20,1,1,43,34,77,7507
21,21,1,2,44,36,80,7507
22,22,0,1,44,37,81,7507
23,23,0,1,44,38,82,7507
24,24,0,0,44,38,82,7507
0,0,1,0,1,0,1,7508
1,1,1,0,2,0,2,7508
2,2,0,0,2,0,2,7508
0,0,1,0,1,0,1,7509
1,1,0,0,1,0,1,7509
0,0,1,0,1,0,1,7510
1,1,1,1,2,1,3,7510
2,2,1,4,3,5,8,7510
3,3,4,2,7,7,14,7510
4,4,2,2,9,9,18,7510
5,5,1,4,10,13,23,7510
6,6,0,3,10,16,26,7510
7,7,0,3,10,19,29,7510
8,8,1,3,11,22,33,7510
9,9,4,3,15,25,40,7510
10,10,4,2,19,27,46,7510
11,11,3,3,22,30,52,7510
12,12,2,4,24,34,58,7510
13,13,2,2,26,36,62,7510
14,14,2,2,28,38,66,7510
15,15,3,0,31,38,69,7510
16,16,2,2,33,40,73,7510
17,17,3,2,36,42,78,7510
18,18,1,1,37,43,80,7510
19,19,0,0,37,43,80,7510
0,0,1,0,1,0,1,7511
1,1,0,0,1,0,1,7511
0,0,1,0,1,0,1,7512
1,1,0,0,1,0,1,7512
0,0,1,0,1,0,1,7513
1,1,1,0,2,0,2,7513
2,2,0,0,2,0,2,7513
0,0,1,0,1,0,1,7514
1,1,2,0,3,0,3,7514
2,2,0,1,3,1,4,7514
3,3,2,1,5,2,7,7514
4,4,2,0,7,2,9,7514
5,5,0,1,7,3,10,7514
6,6,0,0,7,3,10,7514
0,0,1,0,1,0,1,7515
1,1,3,0,4,0,4,7515
2,2,1,0,5,0,5,7515
3,3,1,0,6,0,6,7515
4,4,0,0,6,0,6,7515
0,0,1,0,1,0,1,7516
1,1,0,0,1,0,1,7516
0,0,1,0,1,0,1,7517
1,1,3,0,4,0,4,7517
2,2,6,0,10,0,10,7517
3,3,6,1,16,1,17,7517
4,4,0,4,16,5,21,7517
5,5,1,3,17,8,25,7517
6,6,2,1,19,9,28,7517
7,7,0,1,19,10,29,7517
8,8,0,1,19,11,30,7517
9,9,0,0,19,11,30,7517
0,0,1,0,1,0,1,7518
1,1,0,3,1,3,4,7518
2,2,0,3,1,6,7,7518
3,3,0,2,1,8,9,7518
4,4,1,3,2,11,13,7518
5,5,1,2,3,13,16,7518
6,6,1,0,4,13,17,7518
7,7,2,0,6,13,19,7518
8,8,1,1,7,14,21,7518
9,9,0,0,7,14,21,7518
0,0,1,0,1,0,1,7519
1,1,0,0,1,0,1,7519
0,0,1,0,1,0,1,7520
1,1,1,0,2,0,2,7520
2,2,0,0,2,0,2,7520
0,0,1,0,1,0,1,7521
1,1,1,1,2,1,3,7521
2,2,1,0,3,1,4,7521
3,3,0,0,3,1,4,7521
0,0,1,0,1,0,1,7522
1,1,1,0,2,0,2,7522
2,2,1,0,3,0,3,7522
3,3,0,1,3,1,4,7522
4,4,0,3,3,4,7,7522
5,5,0,1,3,5,8,7522
6,6,1,1,4,6,10,7522
7,7,2,2,6,8,14,7522
8,8,4,2,10,10,20,7522
9,9,2,3,12,13,25,7522
10,10,4,1,16,14,30,7522
11,11,2,2,18,16,34,7522
12,12,1,3,19,19,38,7522
13,13,0,1,19,20,39,7522
14,14,0,3,19,23,42,7522
15,15,1,1,20,24,44,7522
16,16,1,0,21,24,45,7522
17,17,0,0,21,24,45,7522
0,0,1,0,1,0,1,7523
1,1,1,0,2,0,2,7523
2,2,0,0,2,0,2,7523
0,0,1,0,1,0,1,7524
1,1,1,0,2,0,2,7524
2,2,1,1,3,1,4,7524
3,3,1,0,4,1,5,7524
4,4,0,0,4,1,5,7524
0,0,1,0,1,0,1,7525
1,1,1,0,2,0,2,7525
2,2,0,0,2,0,2,7525
0,0,1,0,1,0,1,7526
1,1,1,1,2,1,3,7526
2,2,2,1,4,2,6,7526
3,3,1,0,5,2,7,7526
4,4,2,0,7,2,9,7526
5,5,1,0,8,2,10,7526
6,6,2,0,10,2,12,7526
7,7,1,0,11,2,13,7526
8,8,1,0,12,2,14,7526
9,9,0,1,12,3,15,7526
10,10,0,1,12,4,16,7526
11,11,0,1,12,5,17,7526
12,12,0,0,12,5,17,7526
0,0,1,0,1,0,1,7527
1,1,2,0,3,0,3,7527
2,2,3,0,6,0,6,7527
3,3,5,0,11,0,11,7527
4,4,2,2,13,2,15,7527
5,5,0,3,13,5,18,7527
6,6,0,0,13,5,18,7527
0,0,1,0,1,0,1,7528
1,1,1,1,2,1,3,7528
2,2,2,0,4,1,5,7528
3,3,2,0,6,1,7,7528
4,4,2,0,8,1,9,7528
5,5,1,0,9,1,10,7528
6,6,2,0,11,1,12,7528
7,7,1,0,12,1,13,7528
8,8,1,0,13,1,14,7528
9,9,0,2,13,3,16,7528
10,10,0,1,13,4,17,7528
11,11,0,0,13,4,17,7528
0,0,1,0,1,0,1,7529
1,1,0,0,1,0,1,7529
0,0,1,0,1,0,1,7530
1,1,1,0,2,0,2,7530
2,2,4,0,6,0,6,7530
3,3,3,0,9,0,9,7530
4,4,3,0,12,0,12,7530
5,5,3,0,15,0,15,7530
6,6,4,0,19,0,19,7530
7,7,5,0,24,0,24,7530
8,8,2,1,26,1,27,7530
9,9,1,1,27,2,29,7530
10,10,0,2,27,4,31,7530
11,11,0,0,27,4,31,7530
0,0,1,0,1,0,1,7531
1,1,2,0,3,0,3,7531
2,2,0,0,3,0,3,7531
0,0,1,0,1,0,1,7532
1,1,1,0,2,0,2,7532
2,2,2,0,4,0,4,7532
3,3,1,1,5,1,6,7532
4,4,2,0,7,1,8,7532
5,5,1,1,8,2,10,7532
6,6,1,1,9,3,12,7532
7,7,1,1,10,4,14,7532
8,8,3,1,13,5,18,7532
9,9,4,1,17,6,23,7532
10,10,2,3,19,9,28,7532
11,11,2,1,21,10,31,7532
12,12,2,1,23,11,34,7532
13,13,0,1,23,12,35,7532
14,14,0,1,23,13,36,7532
15,15,0,0,23,13,36,7532
0,0,1,0,1,0,1,7533
1,1,1,0,2,0,2,7533
2,2,0,2,2,2,4,7533
3,3,2,1,4,3,7,7533
4,4,0,2,4,5,9,7533
5,5,0,1,4,6,10,7533
6,6,0,1,4,7,11,7533
7,7,0,0,4,7,11,7533
0,0,1,0,1,0,1,7534
1,1,1,0,2,0,2,7534
2,2,1,0,3,0,3,7534
3,3,1,0,4,0,4,7534
4,4,0,0,4,0,4,7534
0,0,1,0,1,0,1,7535
1,1,0,1,1,1,2,7535
2,2,0,4,1,5,6,7535
3,3,0,2,1,7,8,7535
4,4,0,1,1,8,9,7535
5,5,0,2,1,10,11,7535
6,6,0,5,1,15,16,7535
7,7,1,1,2,16,18,7535
8,8,2,0,4,16,20,7535
9,9,0,0,4,16,20,7535
0,0,1,0,1,0,1,7536
1,1,0,0,1,0,1,7536
0,0,1,0,1,0,1,7537
1,1,2,0,3,0,3,7537
2,2,1,0,4,0,4,7537
3,3,1,0,5,0,5,7537
4,4,1,0,6,0,6,7537
5,5,1,0,7,0,7,7537
6,6,1,0,8,0,8,7537
7,7,3,0,11,0,11,7537
8,8,1,0,12,0,12,7537
9,9,0,0,12,0,12,7537
0,0,1,0,1,0,1,7538
1,1,1,0,2,0,2,7538
2,2,0,0,2,0,2,7538
0,0,1,0,1,0,1,7539
1,1,1,0,2,0,2,7539
2,2,0,0,2,0,2,7539
0,0,1,0,1,0,1,7540
1,1,1,1,2,1,3,7540
2,2,2,1,4,2,6,7540
3,3,1,0,5,2,7,7540
4,4,0,0,5,2,7,7540
0,0,1,0,1,0,1,7541
1,1,0,0,1,0,1,7541
0,0,1,0,1,0,1,7542
1,1,0,0,1,0,1,7542
0,0,1,0,1,0,1,7543
1,1,1,1,2,1,3,7543
2,2,2,1,4,2,6,7543
3,3,0,1,4,3,7,7543
4,4,0,0,4,3,7,7543
0,0,1,0,1,0,1,7544
1,1,1,0,2,0,2,7544
2,2,2,0,4,0,4,7544
3,3,3,0,7,0,7,7544
4,4,2,1,9,1,10,7544
5,5,1,3,10,4,14,7544
6,6,0,1,10,5,15,7544
7,7,0,2,10,7,17,7544
8,8,0,0,10,7,17,7544
0,0,1,0,1,0,1,7545
1,1,2,0,3,0,3,7545
2,2,4,0,7,0,7,7545
3,3,3,0,10,0,10,7545
4,4,2,0,12,0,12,7545
5,5,1,0,13,0,13,7545
6,6,1,0,14,0,14,7545
7,7,0,0,14,0,14,7545
0,0,1,0,1,0,1,7546
1,1,2,0,3,0,3,7546
2,2,4,0,7,0,7,7546
3,3,3,1,10,1,11,7546
4,4,4,2,14,3,17,7546
5,5,1,3,15,6,21,7546
6,6,1,1,16,7,23,7546
7,7,1,0,17,7,24,7546
8,8,1,0,18,7,25,7546
9,9,2,0,20,7,27,7546
10,10,2,0,22,7,29,7546
11,11,0,0,22,7,29,7546
0,0,1,0,1,0,1,7547
1,1,0,0,1,0,1,7547
0,0,1,0,1,0,1,7548
1,1,0,0,1,0,1,7548
0,0,1,0,1,0,1,7549
1,1,2,0,3,0,3,7549
2,2,1,1,4,1,5,7549
3,3,1,0,5,1,6,7549
4,4,1,0,6,1,7,7549
5,5,1,0,7,1,8,7549
6,6,1,0,8,1,9,7549
7,7,2,0,10,1,11,7549
8,8,1,1,11,2,13,7549
9,9,1,2,12,4,16,7549
10,10,4,0,16,4,20,7549
11,11,1,1,17,5,22,7549
12,12,1,0,18,5,23,7549
13,13,0,0,18,5,23,7549
0,0,1,0,1,0,1,7550
1,1,1,0,2,0,2,7550
2,2,0,0,2,0,2,7550
0,0,1,0,1,0,1,7551
1,1,0,0,1,0,1,7551
0,0,1,0,1,0,1,7552
1,1,1,0,2,0,2,7552
2,2,4,0,6,0,6,7552
3,3,3,1,9,1,10,7552
4,4,2,1,11,2,13,7552
5,5,3,0,14,2,16,7552
6,6,1,0,15,2,17,7552
7,7,1,0,16,2,18,7552
8,8,1,0,17,2,19,7552
9,9,2,0,19,2,21,7552
10,10,2,0,21,2,23,7552
11,11,1,1,22,3,25,7552
12,12,0,0,22,3,25,7552
0,0,1,0,1,0,1,7553
1,1,0,0,1,0,1,7553
0,0,1,0,1,0,1,7554
1,1,0,1,1,1,2,7554
2,2,0,0,1,1,2,7554
0,0,1,0,1,0,1,7555
1,1,1,0,2,0,2,7555
2,2,0,0,2,0,2,7555
0,0,1,0,1,0,1,7556
1,1,1,0,2,0,2,7556
2,2,0,0,2,0,2,7556
0,0,1,0,1,0,1,7557
1,1,2,2,3,2,5,7557
2,2,1,1,4,3,7,7557
3,3,1,1,5,4,9,7557
4,4,3,1,8,5,13,7557
5,5,3,3,11,8,19,7557
6,6,4,3,15,11,26,7557
7,7,2,5,17,16,33,7557
8,8,3,3,20,19,39,7557
9,9,4,1,24,20,44,7557
10,10,2,1,26,21,47,7557
11,11,2,1,28,22,50,7557
12,12,0,2,28,24,52,7557
13,13,0,2,28,26,54,7557
14,14,1,1,29,27,56,7557
15,15,0,0,29,27,56,7557
0,0,1,0,1,0,1,7558
1,1,0,0,1,0,1,7558
0,0,1,0,1,0,1,7559
1,1,2,0,3,0,3,7559
2,2,2,1,5,1,6,7559
3,3,1,1,6,2,8,7559
4,4,1,0,7,2,9,7559
5,5,1,0,8,2,10,7559
6,6,0,0,8,2,10,7559
0,0,1,0,1,0,1,7560
1,1,0,0,1,0,1,7560
0,0,1,0,1,0,1,7561
1,1,0,0,1,0,1,7561
0,0,1,0,1,0,1,7562
1,1,1,0,2,0,2,7562
2,2,1,0,3,0,3,7562
3,3,3,0,6,0,6,7562
4,4,2,1,8,1,9,7562
5,5,1,2,9,3,12,7562
6,6,2,2,11,5,16,7562
7,7,1,2,12,7,19,7562
8,8,1,1,13,8,21,7562
9,9,2,0,15,8,23,7562
10,10,0,0,15,8,23,7562
0,0,1,0,1,0,1,7563
1,1,1,0,2,0,2,7563
2,2,1,0,3,0,3,7563
3,3,1,0,4,0,4,7563
4,4,0,0,4,0,4,7563
0,0,1,0,1,0,1,7564
1,1,0,0,1,0,1,7564
0,0,1,0,1,0,1,7565
1,1,1,0,2,0,2,7565
2,2,0,1,2,1,3,7565
3,3,1,2,3,3,6,7565
4,4,2,1,5,4,9,7565
5,5,1,0,6,4,10,7565
6,6,1,0,7,4,11,7565
7,7,1,0,8,4,12,7565
8,8,1,1,9,5,14,7565
9,9,1,0,10,5,15,7565
10,10,0,0,10,5,15,7565
0,0,1,0,1,0,1,7566
1,1,1,0,2,0,2,7566
2,2,1,0,3,0,3,7566
3,3,0,0,3,0,3,7566
0,0,1,0,1,0,1,7567
1,1,0,0,1,0,1,7567
0,0,1,0,1,0,1,7568
1,1,0,0,1,0,1,7568
0,0,1,0,1,0,1,7569
1,1,2,0,3,0,3,7569
2,2,2,0,5,0,5,7569
3,3,3,0,8,0,8,7569
4,4,1,0,9,0,9,7569
5,5,1,1,10,1,11,7569
6,6,0,1,10,2,12,7569
7,7,0,0,10,2,12,7569
0,0,1,0,1,0,1,7570
1,1,5,0,6,0,6,7570
2,2,2,0,8,0,8,7570
3,3,3,0,11,0,11,7570
4,4,3,1,14,1,15,7570
5,5,1,2,15,3,18,7570
6,6,1,3,16,6,22,7570
7,7,2,1,18,7,25,7570
8,8,2,0,20,7,27,7570
9,9,2,0,22,7,29,7570
10,10,0,1,22,8,30,7570
11,11,0,1,22,9,31,7570
12,12,0,0,22,9,31,7570
0,0,1,0,1,0,1,7571
1,1,1,1,2,1,3,7571
2,2,1,1,3,2,5,7571
3,3,0,1,3,3,6,7571
4,4,0,0,3,3,6,7571
0,0,1,0,1,0,1,7572
1,1,0,1,1,1,2,7572
2,2,0,0,1,1,2,7572
0,0,1,0,1,0,1,7573
1,1,1,1,2,1,3,7573
2,2,1,0,3,1,4,7573
3,3,0,0,3,1,4,7573
0,0,1,0,1,0,1,7574
1,1,0,1,1,1,2,7574
2,2,0,0,1,1,2,7574
0,0,1,0,1,0,1,7575
1,1,0,0,1,0,1,7575
0,0,1,0,1,0,1,7576
1,1,1,0,2,0,2,7576
2,2,0,1,2,1,3,7576
3,3,0,1,2,2,4,7576
4,4,0,1,2,3,5,7576
5,5,0,1,2,4,6,7576
6,6,0,0,2,4,6,7576
0,0,1,0,1,0,1,7577
1,1,1,1,2,1,3,7577
2,2,0,3,2,4,6,7577
3,3,0,3,2,7,9,7577
4,4,0,2,2,9,11,7577
5,5,1,3,3,12,15,7577
6,6,2,1,5,13,18,7577
7,7,5,0,10,13,23,7577
8,8,8,0,18,13,31,7577
9,9,4,1,22,14,36,7577
10,10,1,1,23,15,38,7577
11,11,1,1,24,16,40,7577
12,12,1,1,25,17,42,7577
13,13,0,4,25,21,46,7577
14,14,1,7,26,28,54,7577
15,15,2,8,28,36,64,7577
16,16,3,4,31,40,71,7577
17,17,1,4,32,44,76,7577
18,18,0,8,32,52,84,7577
19,19,1,9,33,61,94,7577
20,20,2,4,35,65,100,7577
21,21,4,3,39,68,107,7577
22,22,7,2,46,70,116,7577
23,23,4,1,50,71,121,7577
24,24,1,0,51,71,122,7577
25,25,1,0,52,71,123,7577
26,26,0,0,52,71,123,7577
0,0,1,0,1,0,1,7578
1,1,0,0,1,0,1,7578
0,0,1,0,1,0,1,7579
1,1,0,0,1,0,1,7579
0,0,1,0,1,0,1,7580
1,1,0,0,1,0,1,7580
0,0,1,0,1,0,1,7581
1,1,0,0,1,0,1,7581
0,0,1,0,1,0,1,7582
1,1,2,0,3,0,3,7582
2,2,1,0,4,0,4,7582
3,3,1,1,5,1,6,7582
4,4,1,0,6,1,7,7582
5,5,0,0,6,1,7,7582
0,0,1,0,1,0,1,7583
1,1,1,0,2,0,2,7583
2,2,2,0,4,0,4,7583
3,3,0,0,4,0,4,7583
0,0,1,0,1,0,1,7584
1,1,0,0,1,0,1,7584
0,0,1,0,1,0,1,7585
1,1,1,1,2,1,3,7585
2,2,3,1,5,2,7,7585
3,3,2,1,7,3,10,7585
4,4,1,0,8,3,11,7585
5,5,3,0,11,3,14,7585
6,6,1,1,12,4,16,7585
7,7,1,0,13,4,17,7585
8,8,2,1,15,5,20,7585
9,9,2,0,17,5,22,7585
10,10,0,0,17,5,22,7585
0,0,1,0,1,0,1,7586
1,1,0,0,1,0,1,7586
0,0,1,0,1,0,1,7587
1,1,1,0,2,0,2,7587
2,2,2,1,4,1,5,7587
3,3,3,1,7,2,9,7587
4,4,3,3,10,5,15,7587
5,5,1,2,11,7,18,7587
6,6,1,5,12,12,24,7587
7,7,3,2,15,14,29,7587
8,8,1,3,16,17,33,7587
9,9,3,5,19,22,41,7587
10,10,5,1,24,23,47,7587
11,11,3,0,27,23,50,7587
12,12,3,0,30,23,53,7587
13,13,1,0,31,23,54,7587
14,14,2,0,33,23,56,7587
15,15,0,0,33,23,56,7587
0,0,1,0,1,0,1,7588
1,1,1,0,2,0,2,7588
2,2,0,0,2,0,2,7588
0,0,1,0,1,0,1,7589
1,1,1,0,2,0,2,7589
2,2,1,0,3,0,3,7589
3,3,0,0,3,0,3,7589
0,0,1,0,1,0,1,7590
1,1,2,0,3,0,3,7590
2,2,0,0,3,0,3,7590
0,0,1,0,1,0,1,7591
1,1,0,0,1,0,1,7591
0,0,1,0,1,0,1,7592
1,1,0,0,1,0,1,7592
0,0,1,0,1,0,1,7593
1,1,1,0,2,0,2,7593
2,2,0,0,2,0,2,7593
0,0,1,0,1,0,1,7594
1,1,0,0,1,0,1,7594
0,0,1,0,1,0,1,7595
1,1,0,0,1,0,1,7595
0,0,1,0,1,0,1,7596
1,1,1,1,2,1,3,7596
2,2,1,1,3,2,5,7596
3,3,1,2,4,4,8,7596
4,4,1,1,5,5,10,7596
5,5,0,0,5,5,10,7596
0,0,1,0,1,0,1,7597
1,1,0,0,1,0,1,7597
0,0,1,0,1,0,1,7598
1,1,1,0,2,0,2,7598
2,2,0,0,2,0,2,7598
0,0,1,0,1,0,1,7599
1,1,1,0,2,0,2,7599
2,2,0,1,2,1,3,7599
3,3,0,1,2,2,4,7599
4,4,0,2,2,4,6,7599
5,5,1,4,3,8,11,7599
6,6,0,6,3,14,17,7599
7,7,2,7,5,21,26,7599
8,8,3,2,8,23,31,7599
9,9,3,1,11,24,35,7599
10,10,3,2,14,26,40,7599
11,11,1,2,15,28,43,7599
12,12,3,2,18,30,48,7599
13,13,1,2,19,32,51,7599
14,14,0,4,19,36,55,7599
15,15,0,2,19,38,57,7599
16,16,1,3,20,41,61,7599
17,17,2,4,22,45,67,7599
18,18,0,4,22,49,71,7599
19,19,0,1,22,50,72,7599
20,20,0,0,22,50,72,7599
0,0,1,0,1,0,1,7600
1,1,0,0,1,0,1,7600
0,0,1,0,1,0,1,7601
1,1,1,0,2,0,2,7601
2,2,0,0,2,0,2,7601
0,0,1,0,1,0,1,7602
1,1,1,0,2,0,2,7602
2,2,0,0,2,0,2,7602
0,0,1,0,1,0,1,7603
1,1,1,0,2,0,2,7603
2,2,0,0,2,0,2,7603
0,0,1,0,1,0,1,7604
1,1,3,0,4,0,4,7604
2,2,2,0,6,0,6,7604
3,3,0,0,6,0,6,7604
0,0,1,0,1,0,1,7605
1,1,2,0,3,0,3,7605
2,2,2,1,5,1,6,7605
3,3,1,3,6,4,10,7605
4,4,0,4,6,8,14,7605
5,5,1,2,7,10,17,7605
6,6,2,1,9,11,20,7605
7,7,1,0,10,11,21,7605
8,8,2,2,12,13,25,7605
9,9,1,3,13,16,29,7605
10,10,1,4,14,20,34,7605
11,11,2,2,16,22,38,7605
12,12,2,3,18,25,43,7605
13,13,2,3,20,28,48,7605
14,14,3,3,23,31,54,7605
15,15,3,2,26,33,59,7605
16,16,3,4,29,37,66,7605
17,17,3,5,32,42,74,7605
18,18,2,5,34,47,81,7605
19,19,1,1,35,48,83,7605
20,20,2,2,37,50,87,7605
21,21,1,4,38,54,92,7605
22,22,4,3,42,57,99,7605
23,23,2,1,44,58,102,7605
24,24,0,0,44,58,102,7605
0,0,1,0,1,0,1,7606
1,1,0,0,1,0,1,7606
0,0,1,0,1,0,1,7607
1,1,1,1,2,1,3,7607
2,2,1,0,3,1,4,7607
3,3,0,0,3,1,4,7607
0,0,1,0,1,0,1,7608
1,1,1,0,2,0,2,7608
2,2,1,0,3,0,3,7608
3,3,0,0,3,0,3,7608
0,0,1,0,1,0,1,7609
1,1,0,0,1,0,1,7609
0,0,1,0,1,0,1,7610
1,1,0,0,1,0,1,7610
0,0,1,0,1,0,1,7611
1,1,0,0,1,0,1,7611
0,0,1,0,1,0,1,7612
1,1,1,0,2,0,2,7612
2,2,1,0,3,0,3,7612
3,3,1,1,4,1,5,7612
4,4,1,0,5,1,6,7612
5,5,1,0,6,1,7,7612
6,6,2,0,8,1,9,7612
7,7,1,0,9,1,10,7612
8,8,0,0,9,1,10,7612
0,0,1,0,1,0,1,7613
1,1,2,0,3,0,3,7613
2,2,1,0,4,0,4,7613
3,3,3,1,7,1,8,7613
4,4,1,2,8,3,11,7613
5,5,2,1,10,4,14,7613
6,6,2,0,12,4,16,7613
7,7,3,0,15,4,19,7613
8,8,1,0,16,4,20,7613
9,9,1,1,17,5,22,7613
10,10,1,0,18,5,23,7613
11,11,1,1,19,6,25,7613
12,12,1,1,20,7,27,7613
13,13,0,1,20,8,28,7613
14,14,1,0,21,8,29,7613
15,15,0,0,21,8,29,7613
0,0,1,0,1,0,1,7614
1,1,0,0,1,0,1,7614
0,0,1,0,1,0,1,7615
1,1,0,0,1,0,1,7615
0,0,1,0,1,0,1,7616
1,1,0,0,1,0,1,7616
0,0,1,0,1,0,1,7617
1,1,0,1,1,1,2,7617
2,2,0,0,1,1,2,7617
0,0,1,0,1,0,1,7618
1,1,1,0,2,0,2,7618
2,2,1,0,3,0,3,7618
3,3,1,0,4,0,4,7618
4,4,0,0,4,0,4,7618
0,0,1,0,1,0,1,7619
1,1,1,0,2,0,2,7619
2,2,0,0,2,0,2,7619
0,0,1,0,1,0,1,7620
1,1,1,2,2,2,4,7620
2,2,1,0,3,2,5,7620
3,3,1,0,4,2,6,7620
4,4,1,0,5,2,7,7620
5,5,1,0,6,2,8,7620
6,6,1,1,7,3,10,7620
7,7,0,3,7,6,13,7620
8,8,0,3,7,9,16,7620
9,9,0,1,7,10,17,7620
10,10,0,0,7,10,17,7620
0,0,1,0,1,0,1,7621
1,1,0,0,1,0,1,7621
0,0,1,0,1,0,1,7622
1,1,1,0,2,0,2,7622
2,2,0,0,2,0,2,7622
0,0,1,0,1,0,1,7623
1,1,2,0,3,0,3,7623
2,2,1,0,4,0,4,7623
3,3,1,0,5,0,5,7623
4,4,0,0,5,0,5,7623
0,0,1,0,1,0,1,7624
1,1,0,0,1,0,1,7624
0,0,1,0,1,0,1,7625
1,1,1,0,2,0,2,7625
2,2,0,0,2,0,2,7625
0,0,1,0,1,0,1,7626
1,1,0,0,1,0,1,7626
0,0,1,0,1,0,1,7627
1,1,1,0,2,0,2,7627
2,2,1,0,3,0,3,7627
3,3,0,0,3,0,3,7627
0,0,1,0,1,0,1,7628
1,1,1,0,2,0,2,7628
2,2,0,0,2,0,2,7628
0,0,1,0,1,0,1,7629
1,1,0,0,1,0,1,7629
0,0,1,0,1,0,1,7630
1,1,1,0,2,0,2,7630
2,2,3,0,5,0,5,7630
3,3,3,0,8,0,8,7630
4,4,0,0,8,0,8,7630
0,0,1,0,1,0,1,7631
1,1,0,0,1,0,1,7631
0,0,1,0,1,0,1,7632
1,1,3,0,4,0,4,7632
2,2,0,1,4,1,5,7632
3,3,1,1,5,2,7,7632
4,4,0,1,5,3,8,7632
5,5,1,0,6,3,9,7632
6,6,0,0,6,3,9,7632
0,0,1,0,1,0,1,7633
1,1,0,0,1,0,1,7633
0,0,1,0,1,0,1,7634
1,1,1,0,2,0,2,7634
2,2,1,0,3,0,3,7634
3,3,0,0,3,0,3,7634
0,0,1,0,1,0,1,7635
1,1,2,0,3,0,3,7635
2,2,0,1,3,1,4,7635
3,3,0,2,3,3,6,7635
4,4,0,0,3,3,6,7635
0,0,1,0,1,0,1,7636
1,1,0,0,1,0,1,7636
0,0,1,0,1,0,1,7637
1,1,2,1,3,1,4,7637
2,2,2,0,5,1,6,7637
3,3,0,0,5,1,6,7637
0,0,1,0,1,0,1,7638
1,1,0,0,1,0,1,7638
0,0,1,0,1,0,1,7639
1,1,2,0,3,0,3,7639
2,2,0,2,3,2,5,7639
3,3,1,3,4,5,9,7639
4,4,1,5,5,10,15,7639
5,5,0,5,5,15,20,7639
6,6,0,7,5,22,27,7639
7,7,1,5,6,27,33,7639
8,8,0,5,6,32,38,7639
9,9,0,9,6,41,47,7639
10,10,0,5,6,46,52,7639
11,11,1,3,7,49,56,7639
12,12,2,3,9,52,61,7639
13,13,2,0,11,52,63,7639
14,14,0,0,11,52,63,7639
0,0,1,0,1,0,1,7640
1,1,1,0,2,0,2,7640
2,2,1,0,3,0,3,7640
3,3,1,0,4,0,4,7640
4,4,0,0,4,0,4,7640
0,0,1,0,1,0,1,7641
1,1,0,0,1,0,1,7641
0,0,1,0,1,0,1,7642
1,1,0,0,1,0,1,7642
0,0,1,0,1,0,1,7643
1,1,0,0,1,0,1,7643
0,0,1,0,1,0,1,7644
1,1,0,0,1,0,1,7644
0,0,1,0,1,0,1,7645
1,1,0,0,1,0,1,7645
0,0,1,0,1,0,1,7646
1,1,0,1,1,1,2,7646
2,2,0,0,1,1,2,7646
0,0,1,0,1,0,1,7647
1,1,3,0,4,0,4,7647
2,2,4,0,8,0,8,7647
3,3,2,0,10,0,10,7647
4,4,0,0,10,0,10,7647
0,0,1,0,1,0,1,7648
1,1,1,0,2,0,2,7648
2,2,0,0,2,0,2,7648
0,0,1,0,1,0,1,7649
1,1,0,0,1,0,1,7649
0,0,1,0,1,0,1,7650
1,1,0,0,1,0,1,7650
0,0,1,0,1,0,1,7651
1,1,2,1,3,1,4,7651
2,2,2,1,5,2,7,7651
3,3,3,1,8,3,11,7651
4,4,4,3,12,6,18,7651
5,5,0,2,12,8,20,7651
6,6,1,1,13,9,22,7651
7,7,0,3,13,12,25,7651
8,8,1,3,14,15,29,7651
9,9,5,2,19,17,36,7651
10,10,7,2,26,19,45,7651
11,11,9,2,35,21,56,7651
12,12,6,7,41,28,69,7651
13,13,10,5,51,33,84,7651
14,14,14,6,65,39,104,7651
15,15,9,12,74,51,125,7651
16,16,4,11,78,62,140,7651
17,17,4,13,82,75,157,7651
18,18,4,13,86,88,174,7651
19,19,7,10,93,98,191,7651
20,20,2,7,95,105,200,7651
21,21,1,6,96,111,207,7651
22,22,1,5,97,116,213,7651
23,23,1,2,98,118,216,7651
24,24,2,1,100,119,219,7651
25,25,0,0,100,119,219,7651
0,0,1,0,1,0,1,7652
1,1,1,0,2,0,2,7652
2,2,0,1,2,1,3,7652
3,3,0,1,2,2,4,7652
4,4,0,3,2,5,7,7652
5,5,2,3,4,8,12,7652
6,6,1,4,5,12,17,7652
7,7,2,6,7,18,25,7652
8,8,2,5,9,23,32,7652
9,9,5,2,14,25,39,7652
10,10,5,1,19,26,45,7652
11,11,4,0,23,26,49,7652
12,12,0,1,23,27,50,7652
13,13,0,0,23,27,50,7652
0,0,1,0,1,0,1,7653
1,1,1,0,2,0,2,7653
2,2,1,0,3,0,3,7653
3,3,0,0,3,0,3,7653
0,0,1,0,1,0,1,7654
1,1,1,0,2,0,2,7654
2,2,0,0,2,0,2,7654
0,0,1,0,1,0,1,7655
1,1,2,0,3,0,3,7655
2,2,2,0,5,0,5,7655
3,3,1,0,6,0,6,7655
4,4,0,0,6,0,6,7655
0,0,1,0,1,0,1,7656
1,1,1,0,2,0,2,7656
2,2,0,1,2,1,3,7656
3,3,0,0,2,1,3,7656
0,0,1,0,1,0,1,7657
1,1,1,0,2,0,2,7657
2,2,1,0,3,0,3,7657
3,3,0,0,3,0,3,7657
0,0,1,0,1,0,1,7658
1,1,0,0,1,0,1,7658
0,0,1,0,1,0,1,7659
1,1,0,0,1,0,1,7659
0,0,1,0,1,0,1,7660
1,1,0,0,1,0,1,7660
0,0,1,0,1,0,1,7661
1,1,2,0,3,0,3,7661
2,2,2,1,5,1,6,7661
3,3,0,1,5,2,7,7661
4,4,0,0,5,2,7,7661
0,0,1,0,1,0,1,7662
1,1,0,0,1,0,1,7662
0,0,1,0,1,0,1,7663
1,1,1,0,2,0,2,7663
2,2,1,0,3,0,3,7663
3,3,0,0,3,0,3,7663
0,0,1,0,1,0,1,7664
1,1,1,1,2,1,3,7664
2,2,1,0,3,1,4,7664
3,3,0,0,3,1,4,7664
0,0,1,0,1,0,1,7665
1,1,1,1,2,1,3,7665
2,2,0,1,2,2,4,7665
3,3,0,0,2,2,4,7665
0,0,1,0,1,0,1,7666
1,1,0,0,1,0,1,7666
0,0,1,0,1,0,1,7667
1,1,0,0,1,0,1,7667
0,0,1,0,1,0,1,7668
1,1,0,0,1,0,1,7668
0,0,1,0,1,0,1,7669
1,1,2,0,3,0,3,7669
2,2,4,0,7,0,7,7669
3,3,2,2,9,2,11,7669
4,4,2,1,11,3,14,7669
5,5,2,1,13,4,17,7669
6,6,2,0,15,4,19,7669
7,7,4,1,19,5,24,7669
8,8,1,0,20,5,25,7669
9,9,0,0,20,5,25,7669
0,0,1,0,1,0,1,7670
1,1,1,0,2,0,2,7670
2,2,0,0,2,0,2,7670
0,0,1,0,1,0,1,7671
1,1,1,0,2,0,2,7671
2,2,0,0,2,0,2,7671
0,0,1,0,1,0,1,7672
1,1,0,0,1,0,1,7672
0,0,1,0,1,0,1,7673
1,1,0,0,1,0,1,7673
0,0,1,0,1,0,1,7674
1,1,0,0,1,0,1,7674
0,0,1,0,1,0,1,7675
1,1,1,0,2,0,2,7675
2,2,3,0,5,0,5,7675
3,3,0,0,5,0,5,7675
0,0,1,0,1,0,1,7676
1,1,0,0,1,0,1,7676
0,0,1,0,1,0,1,7677
1,1,1,1,2,1,3,7677
2,2,0,0,2,1,3,7677
0,0,1,0,1,0,1,7678
1,1,0,0,1,0,1,7678
0,0,1,0,1,0,1,7679
1,1,0,0,1,0,1,7679
0,0,1,0,1,0,1,7680
1,1,0,0,1,0,1,7680
0,0,1,0,1,0,1,7681
1,1,0,1,1,1,2,7681
2,2,0,0,1,1,2,7681
0,0,1,0,1,0,1,7682
1,1,0,0,1,0,1,7682
0,0,1,0,1,0,1,7683
1,1,0,0,1,0,1,7683
0,0,1,0,1,0,1,7684
1,1,0,0,1,0,1,7684
0,0,1,0,1,0,1,7685
1,1,1,0,2,0,2,7685
2,2,4,0,6,0,6,7685
3,3,3,0,9,0,9,7685
4,4,3,0,12,0,12,7685
5,5,2,0,14,0,14,7685
6,6,1,0,15,0,15,7685
7,7,0,0,15,0,15,7685
0,0,1,0,1,0,1,7686
1,1,0,0,1,0,1,7686
0,0,1,0,1,0,1,7687
1,1,1,0,2,0,2,7687
2,2,2,0,4,0,4,7687
3,3,1,1,5,1,6,7687
4,4,1,2,6,3,9,7687
5,5,2,2,8,5,13,7687
6,6,3,1,11,6,17,7687
7,7,0,2,11,8,19,7687
8,8,0,0,11,8,19,7687
0,0,1,0,1,0,1,7688
1,1,0,0,1,0,1,7688
0,0,1,0,1,0,1,7689
1,1,1,0,2,0,2,7689
2,2,1,0,3,0,3,7689
3,3,0,0,3,0,3,7689
0,0,1,0,1,0,1,7690
1,1,2,1,3,1,4,7690
2,2,1,0,4,1,5,7690
3,3,1,0,5,1,6,7690
4,4,0,0,5,1,6,7690
0,0,1,0,1,0,1,7691
1,1,1,1,2,1,3,7691
2,2,0,0,2,1,3,7691
0,0,1,0,1,0,1,7692
1,1,0,0,1,0,1,7692
0,0,1,0,1,0,1,7693
1,1,2,0,3,0,3,7693
2,2,4,0,7,0,7,7693
3,3,2,0,9,0,9,7693
4,4,1,0,10,0,10,7693
5,5,0,0,10,0,10,7693
0,0,1,0,1,0,1,7694
1,1,0,1,1,1,2,7694
2,2,0,1,1,2,3,7694
3,3,0,0,1,2,3,7694
0,0,1,0,1,0,1,7695
1,1,1,0,2,0,2,7695
2,2,1,0,3,0,3,7695
3,3,1,0,4,0,4,7695
4,4,1,0,5,0,5,7695
5,5,0,2,5,2,7,7695
6,6,0,0,5,2,7,7695
0,0,1,0,1,0,1,7696
1,1,2,0,3,0,3,7696
2,2,0,2,3,2,5,7696
3,3,1,3,4,5,9,7696
4,4,3,4,7,9,16,7696
5,5,1,5,8,14,22,7696
6,6,2,3,10,17,27,7696
7,7,3,2,13,19,32,7696
8,8,1,1,14,20,34,7696
9,9,1,0,15,20,35,7696
10,10,3,2,18,22,40,7696
11,11,4,1,22,23,45,7696
12,12,4,2,26,25,51,7696
13,13,4,1,30,26,56,7696
14,14,4,2,34,28,62,7696
15,15,3,2,37,30,67,7696
16,16,2,3,39,33,72,7696
17,17,0,0,39,33,72,7696
0,0,1,0,1,0,1,7697
1,1,0,0,1,0,1,7697
0,0,1,0,1,0,1,7698
1,1,0,0,1,0,1,7698
0,0,1,0,1,0,1,7699
1,1,2,0,3,0,3,7699
2,2,1,1,4,1,5,7699
3,3,2,0,6,1,7,7699
4,4,1,0,7,1,8,7699
5,5,1,0,8,1,9,7699
6,6,1,0,9,1,10,7699
7,7,1,0,10,1,11,7699
8,8,0,0,10,1,11,7699
0,0,1,0,1,0,1,7700
1,1,1,0,2,0,2,7700
2,2,0,0,2,0,2,7700
0,0,1,0,1,0,1,7701
1,1,0,0,1,0,1,7701
0,0,1,0,1,0,1,7702
1,1,0,0,1,0,1,7702
0,0,1,0,1,0,1,7703
1,1,0,0,1,0,1,7703
0,0,1,0,1,0,1,7704
1,1,1,0,2,0,2,7704
2,2,1,0,3,0,3,7704
3,3,0,0,3,0,3,7704
0,0,1,0,1,0,1,7705
1,1,1,0,2,0,2,7705
2,2,0,0,2,0,2,7705
0,0,1,0,1,0,1,7706
1,1,1,0,2,0,2,7706
2,2,0,0,2,0,2,7706
0,0,1,0,1,0,1,7707
1,1,0,0,1,0,1,7707
0,0,1,0,1,0,1,7708
1,1,1,0,2,0,2,7708
2,2,1,0,3,0,3,7708
3,3,3,1,6,1,7,7708
4,4,0,2,6,3,9,7708
5,5,0,1,6,4,10,7708
6,6,0,0,6,4,10,7708
0,0,1,0,1,0,1,7709
1,1,1,0,2,0,2,7709
2,2,2,0,4,0,4,7709
3,3,2,1,6,1,7,7709
4,4,3,1,9,2,11,7709
5,5,0,1,9,3,12,7709
6,6,0,1,9,4,13,7709
7,7,0,0,9,4,13,7709
0,0,1,0,1,0,1,7710
1,1,0,1,1,1,2,7710
2,2,0,0,1,1,2,7710
0,0,1,0,1,0,1,7711
1,1,1,0,2,0,2,7711
2,2,2,0,4,0,4,7711
3,3,0,0,4,0,4,7711
0,0,1,0,1,0,1,7712
1,1,0,0,1,0,1,7712
0,0,1,0,1,0,1,7713
1,1,1,0,2,0,2,7713
2,2,1,0,3,0,3,7713
3,3,0,0,3,0,3,7713
0,0,1,0,1,0,1,7714
1,1,0,0,1,0,1,7714
0,0,1,0,1,0,1,7715
1,1,0,0,1,0,1,7715
0,0,1,0,1,0,1,7716
1,1,1,0,2,0,2,7716
2,2,0,0,2,0,2,7716
0,0,1,0,1,0,1,7717
1,1,2,1,3,1,4,7717
2,2,1,1,4,2,6,7717
3,3,0,0,4,2,6,7717
0,0,1,0,1,0,1,7718
1,1,1,0,2,0,2,7718
2,2,0,0,2,0,2,7718
0,0,1,0,1,0,1,7719
1,1,2,0,3,0,3,7719
2,2,0,0,3,0,3,7719
0,0,1,0,1,0,1,7720
1,1,1,1,2,1,3,7720
2,2,1,1,3,2,5,7720
3,3,1,1,4,3,7,7720
4,4,2,2,6,5,11,7720
5,5,3,5,9,10,19,7720
6,6,6,6,15,16,31,7720
7,7,5,7,20,23,43,7720
8,8,6,2,26,25,51,7720
9,9,8,3,34,28,62,7720
10,10,4,3,38,31,69,7720
11,11,4,3,42,34,76,7720
12,12,1,3,43,37,80,7720
13,13,1,3,44,40,84,7720
14,14,0,6,44,46,90,7720
15,15,1,5,45,51,96,7720
16,16,3,5,48,56,104,7720
17,17,1,8,49,64,113,7720
18,18,0,10,49,74,123,7720
19,19,2,7,51,81,132,7720
20,20,4,2,55,83,138,7720
21,21,1,4,56,87,143,7720
22,22,2,4,58,91,149,7720
23,23,1,0,59,91,150,7720
24,24,1,0,60,91,151,7720
25,25,2,0,62,91,153,7720
26,26,2,1,64,92,156,7720
27,27,0,1,64,93,157,7720
28,28,0,0,64,93,157,7720
0,0,1,0,1,0,1,7721
1,1,0,0,1,0,1,7721
0,0,1,0,1,0,1,7722
1,1,0,0,1,0,1,7722
0,0,1,0,1,0,1,7723
1,1,0,0,1,0,1,7723
0,0,1,0,1,0,1,7724
1,1,0,1,1,1,2,7724
2,2,1,0,2,1,3,7724
3,3,2,0,4,1,5,7724
4,4,4,0,8,1,9,7724
5,5,2,1,10,2,12,7724
6,6,2,0,12,2,14,7724
7,7,0,0,12,2,14,7724
0,0,1,0,1,0,1,7725
1,1,0,0,1,0,1,7725
0,0,1,0,1,0,1,7726
1,1,0,0,1,0,1,7726
0,0,1,0,1,0,1,7727
1,1,0,1,1,1,2,7727
2,2,0,1,1,2,3,7727
3,3,0,2,1,4,5,7727
4,4,0,3,1,7,8,7727
5,5,0,2,1,9,10,7727
6,6,1,0,2,9,11,7727
7,7,2,0,4,9,13,7727
8,8,1,1,5,10,15,7727
9,9,1,0,6,10,16,7727
10,10,0,0,6,10,16,7727
0,0,1,0,1,0,1,7728
1,1,1,0,2,0,2,7728
2,2,2,0,4,0,4,7728
3,3,0,0,4,0,4,7728
0,0,1,0,1,0,1,7729
1,1,1,0,2,0,2,7729
2,2,1,0,3,0,3,7729
3,3,0,0,3,0,3,7729
0,0,1,0,1,0,1,7730
1,1,0,0,1,0,1,7730
0,0,1,0,1,0,1,7731
1,1,1,0,2,0,2,7731
2,2,1,0,3,0,3,7731
3,3,0,0,3,0,3,7731
0,0,1,0,1,0,1,7732
1,1,2,1,3,1,4,7732
2,2,2,2,5,3,8,7732
3,3,1,2,6,5,11,7732
4,4,1,0,7,5,12,7732
5,5,1,0,8,5,13,7732
6,6,0,1,8,6,14,7732
7,7,0,0,8,6,14,7732
0,0,1,0,1,0,1,7733
1,1,1,0,2,0,2,7733
2,2,0,0,2,0,2,7733
0,0,1,0,1,0,1,7734
1,1,0,0,1,0,1,7734
0,0,1,0,1,0,1,7735
1,1,2,0,3,0,3,7735
2,2,1,0,4,0,4,7735
3,3,0,0,4,0,4,7735
0,0,1,0,1,0,1,7736
1,1,1,0,2,0,2,7736
2,2,1,0,3,0,3,7736
3,3,2,1,5,1,6,7736
4,4,0,1,5,2,7,7736
5,5,0,3,5,5,10,7736
6,6,0,1,5,6,11,7736
7,7,0,0,5,6,11,7736
0,0,1,0,1,0,1,7737
1,1,0,0,1,0,1,7737
0,0,1,0,1,0,1,7738
1,1,0,2,1,2,3,7738
2,2,1,0,2,2,4,7738
3,3,0,0,2,2,4,7738
0,0,1,0,1,0,1,7739
1,1,0,1,1,1,2,7739
2,2,0,0,1,1,2,7739
0,0,1,0,1,0,1,7740
1,1,2,0,3,0,3,7740
2,2,1,0,4,0,4,7740
3,3,1,0,5,0,5,7740
4,4,1,0,6,0,6,7740
5,5,2,0,8,0,8,7740
6,6,0,1,8,1,9,7740
7,7,0,2,8,3,11,7740
8,8,2,0,10,3,13,7740
9,9,4,0,14,3,17,7740
10,10,5,0,19,3,22,7740
11,11,4,1,23,4,27,7740
12,12,5,1,28,5,33,7740
13,13,4,3,32,8,40,7740
14,14,5,2,37,10,47,7740
15,15,6,3,43,13,56,7740
16,16,9,6,52,19,71,7740
17,17,11,5,63,24,87,7740
18,18,7,8,70,32,102,7740
19,19,8,7,78,39,117,7740
20,20,8,7,86,46,132,7740
21,21,8,5,94,51,145,7740
22,22,7,4,101,55,156,7740
23,23,7,7,108,62,170,7740
24,24,8,5,116,67,183,7740
25,25,6,8,122,75,197,7740
26,26,5,5,127,80,207,7740
27,27,8,5,135,85,220,7740
28,28,5,7,140,92,232,7740
29,29,8,4,148,96,244,7740
30,30,5,6,153,102,255,7740
31,31,5,6,158,108,266,7740
32,32,8,6,166,114,280,7740
33,33,13,5,179,119,298,7740
34,34,14,4,193,123,316,7740
35,35,11,6,204,129,333,7740
36,36,8,7,212,136,348,7740
37,37,9,6,221,142,363,7740
38,38,10,4,231,146,377,7740
39,39,4,2,235,148,383,7740
40,40,3,3,238,151,389,7740
41,41,0,3,238,154,392,7740
42,42,2,3,240,157,397,7740
43,43,3,0,243,157,400,7740
44,44,2,0,245,157,402,7740
45,45,2,0,247,157,404,7740
46,46,2,1,249,158,407,7740
47,47,1,0,250,158,408,7740
48,48,0,0,250,158,408,7740
0,0,1,0,1,0,1,7741
1,1,0,0,1,0,1,7741
0,0,1,0,1,0,1,7742
1,1,1,1,2,1,3,7742
2,2,1,2,3,3,6,7742
3,3,1,1,4,4,8,7742
4,4,0,0,4,4,8,7742
0,0,1,0,1,0,1,7743
1,1,0,0,1,0,1,7743
0,0,1,0,1,0,1,7744
1,1,0,0,1,0,1,7744
0,0,1,0,1,0,1,7745
1,1,2,0,3,0,3,7745
2,2,1,1,4,1,5,7745
3,3,1,0,5,1,6,7745
4,4,0,0,5,1,6,7745
0,0,1,0,1,0,1,7746
1,1,1,0,2,0,2,7746
2,2,0,0,2,0,2,7746
0,0,1,0,1,0,1,7747
1,1,0,0,1,0,1,7747
0,0,1,0,1,0,1,7748
1,1,2,0,3,0,3,7748
2,2,0,0,3,0,3,7748
0,0,1,0,1,0,1,7749
1,1,1,0,2,0,2,7749
2,2,1,0,3,0,3,7749
3,3,1,0,4,0,4,7749
4,4,1,1,5,1,6,7749
5,5,1,1,6,2,8,7749
6,6,0,0,6,2,8,7749
0,0,1,0,1,0,1,7750
1,1,0,0,1,0,1,7750
0,0,1,0,1,0,1,7751
1,1,0,0,1,0,1,7751
0,0,1,0,1,0,1,7752
1,1,0,0,1,0,1,7752
0,0,1,0,1,0,1,7753
1,1,0,0,1,0,1,7753
0,0,1,0,1,0,1,7754
1,1,2,0,3,0,3,7754
2,2,1,0,4,0,4,7754
3,3,0,0,4,0,4,7754
0,0,1,0,1,0,1,7755
1,1,0,0,1,0,1,7755
0,0,1,0,1,0,1,7756
1,1,1,0,2,0,2,7756
2,2,0,1,2,1,3,7756
3,3,0,1,2,2,4,7756
4,4,1,1,3,3,6,7756
5,5,1,0,4,3,7,7756
6,6,0,0,4,3,7,7756
0,0,1,0,1,0,1,7757
1,1,0,1,1,1,2,7757
2,2,0,2,1,3,4,7757
3,3,0,0,1,3,4,7757
0,0,1,0,1,0,1,7758
1,1,0,0,1,0,1,7758
0,0,1,0,1,0,1,7759
1,1,2,0,3,0,3,7759
2,2,4,2,7,2,9,7759
3,3,3,2,10,4,14,7759
4,4,4,2,14,6,20,7759
5,5,5,6,19,12,31,7759
6,6,9,6,28,18,46,7759
7,7,9,6,37,24,61,7759
8,8,8,6,45,30,75,7759
9,9,5,5,50,35,85,7759
10,10,3,4,53,39,92,7759
11,11,3,5,56,44,100,7759
12,12,3,3,59,47,106,7759
13,13,3,2,62,49,111,7759
14,14,2,2,64,51,115,7759
15,15,1,3,65,54,119,7759
16,16,3,2,68,56,124,7759
17,17,4,4,72,60,132,7759
18,18,3,3,75,63,138,7759
19,19,2,1,77,64,141,7759
20,20,0,0,77,64,141,7759
0,0,1,0,1,0,1,7760
1,1,1,0,2,0,2,7760
2,2,2,0,4,0,4,7760
3,3,1,3,5,3,8,7760
4,4,2,1,7,4,11,7760
5,5,4,1,11,5,16,7760
6,6,8,1,19,6,25,7760
7,7,8,2,27,8,35,7760
8,8,8,0,35,8,43,7760
9,9,3,5,38,13,51,7760
10,10,2,5,40,18,58,7760
11,11,3,3,43,21,64,7760
12,12,1,0,44,21,65,7760
13,13,1,0,45,21,66,7760
14,14,0,0,45,21,66,7760
0,0,1,0,1,0,1,7761
1,1,0,0,1,0,1,7761
0,0,1,0,1,0,1,7762
1,1,0,0,1,0,1,7762
0,0,1,0,1,0,1,7763
1,1,0,0,1,0,1,7763
0,0,1,0,1,0,1,7764
1,1,1,2,2,2,4,7764
2,2,1,1,3,3,6,7764
3,3,0,2,3,5,8,7764
4,4,0,0,3,5,8,7764
0,0,1,0,1,0,1,7765
1,1,0,0,1,0,1,7765
0,0,1,0,1,0,1,7766
1,1,0,0,1,0,1,7766
0,0,1,0,1,0,1,7767
1,1,1,0,2,0,2,7767
2,2,1,0,3,0,3,7767
3,3,1,0,4,0,4,7767
4,4,0,1,4,1,5,7767
5,5,0,1,4,2,6,7767
6,6,0,0,4,2,6,7767
0,0,1,0,1,0,1,7768
1,1,0,0,1,0,1,7768
0,0,1,0,1,0,1,7769
1,1,0,0,1,0,1,7769
0,0,1,0,1,0,1,7770
1,1,1,0,2,0,2,7770
2,2,1,0,3,0,3,7770
3,3,0,0,3,0,3,7770
0,0,1,0,1,0,1,7771
1,1,0,0,1,0,1,7771
0,0,1,0,1,0,1,7772
1,1,0,0,1,0,1,7772
0,0,1,0,1,0,1,7773
1,1,0,0,1,0,1,7773
0,0,1,0,1,0,1,7774
1,1,2,1,3,1,4,7774
2,2,2,0,5,1,6,7774
3,3,0,0,5,1,6,7774
0,0,1,0,1,0,1,7775
1,1,0,0,1,0,1,7775
0,0,1,0,1,0,1,7776
1,1,3,0,4,0,4,7776
2,2,1,2,5,2,7,7776
3,3,1,3,6,5,11,7776
4,4,1,3,7,8,15,7776
5,5,0,2,7,10,17,7776
6,6,0,0,7,10,17,7776
0,0,1,0,1,0,1,7777
1,1,1,0,2,0,2,7777
2,2,0,0,2,0,2,7777
0,0,1,0,1,0,1,7778
1,1,1,0,2,0,2,7778
2,2,1,0,3,0,3,7778
3,3,1,0,4,0,4,7778
4,4,0,0,4,0,4,7778
0,0,1,0,1,0,1,7779
1,1,2,0,3,0,3,7779
2,2,0,0,3,0,3,7779
0,0,1,0,1,0,1,7780
1,1,1,0,2,0,2,7780
2,2,0,1,2,1,3,7780
3,3,0,0,2,1,3,7780
0,0,1,0,1,0,1,7781
1,1,1,0,2,0,2,7781
2,2,0,0,2,0,2,7781
0,0,1,0,1,0,1,7782
1,1,1,0,2,0,2,7782
2,2,2,0,4,0,4,7782
3,3,1,1,5,1,6,7782
4,4,0,1,5,2,7,7782
5,5,0,0,5,2,7,7782
0,0,1,0,1,0,1,7783
1,1,1,0,2,0,2,7783
2,2,1,1,3,1,4,7783
3,3,0,2,3,3,6,7783
4,4,0,2,3,5,8,7783
5,5,0,1,3,6,9,7783
6,6,0,0,3,6,9,7783
0,0,1,0,1,0,1,7784
1,1,2,1,3,1,4,7784
2,2,2,2,5,3,8,7784
3,3,2,3,7,6,13,7784
4,4,1,1,8,7,15,7784
5,5,1,0,9,7,16,7784
6,6,0,0,9,7,16,7784
0,0,1,0,1,0,1,7785
1,1,1,0,2,0,2,7785
2,2,2,0,4,0,4,7785
3,3,1,1,5,1,6,7785
4,4,1,0,6,1,7,7785
5,5,0,0,6,1,7,7785
0,0,1,0,1,0,1,7786
1,1,4,0,5,0,5,7786
2,2,2,0,7,0,7,7786
3,3,3,0,10,0,10,7786
4,4,4,1,14,1,15,7786
5,5,2,1,16,2,18,7786
6,6,0,0,16,2,18,7786
0,0,1,0,1,0,1,7787
1,1,0,0,1,0,1,7787
0,0,1,0,1,0,1,7788
1,1,0,0,1,0,1,7788
0,0,1,0,1,0,1,7789
1,1,0,0,1,0,1,7789
0,0,1,0,1,0,1,7790
1,1,0,1,1,1,2,7790
2,2,0,1,1,2,3,7790
3,3,0,2,1,4,5,7790
4,4,0,1,1,5,6,7790
5,5,0,0,1,5,6,7790
0,0,1,0,1,0,1,7791
1,1,0,0,1,0,1,7791
0,0,1,0,1,0,1,7792
1,1,2,0,3,0,3,7792
2,2,1,0,4,0,4,7792
3,3,1,0,5,0,5,7792
4,4,1,0,6,0,6,7792
5,5,1,0,7,0,7,7792
6,6,2,0,9,0,9,7792
7,7,1,0,10,0,10,7792
8,8,0,0,10,0,10,7792
0,0,1,0,1,0,1,7793
1,1,1,0,2,0,2,7793
2,2,1,1,3,1,4,7793
3,3,0,1,3,2,5,7793
4,4,0,1,3,3,6,7793
5,5,0,1,3,4,7,7793
6,6,0,0,3,4,7,7793
0,0,1,0,1,0,1,7794
1,1,1,1,2,1,3,7794
2,2,1,0,3,1,4,7794
3,3,0,0,3,1,4,7794
0,0,1,0,1,0,1,7795
1,1,1,0,2,0,2,7795
2,2,0,0,2,0,2,7795
0,0,1,0,1,0,1,7796
1,1,1,0,2,0,2,7796
2,2,0,0,2,0,2,7796
0,0,1,0,1,0,1,7797
1,1,3,1,4,1,5,7797
2,2,1,1,5,2,7,7797
3,3,1,1,6,3,9,7797
4,4,0,0,6,3,9,7797
0,0,1,0,1,0,1,7798
1,1,0,0,1,0,1,7798
0,0,1,0,1,0,1,7799
1,1,1,0,2,0,2,7799
2,2,3,0,5,0,5,7799
3,3,1,2,6,2,8,7799
4,4,1,1,7,3,10,7799
5,5,1,1,8,4,12,7799
6,6,0,0,8,4,12,7799
0,0,1,0,1,0,1,7800
1,1,1,0,2,0,2,7800
2,2,1,1,3,1,4,7800
3,3,1,0,4,1,5,7800
4,4,0,0,4,1,5,7800
0,0,1,0,1,0,1,7801
1,1,0,0,1,0,1,7801
0,0,1,0,1,0,1,7802
1,1,0,0,1,0,1,7802
0,0,1,0,1,0,1,7803
1,1,1,0,2,0,2,7803
2,2,0,0,2,0,2,7803
0,0,1,0,1,0,1,7804
1,1,0,0,1,0,1,7804
0,0,1,0,1,0,1,7805
1,1,1,0,2,0,2,7805
2,2,3,0,5,0,5,7805
3,3,0,0,5,0,5,7805
0,0,1,0,1,0,1,7806
1,1,0,0,1,0,1,7806
0,0,1,0,1,0,1,7807
1,1,0,0,1,0,1,7807
0,0,1,0,1,0,1,7808
1,1,2,0,3,0,3,7808
2,2,3,0,6,0,6,7808
3,3,1,0,7,0,7,7808
4,4,0,1,7,1,8,7808
5,5,0,0,7,1,8,7808
0,0,1,0,1,0,1,7809
1,1,0,1,1,1,2,7809
2,2,0,1,1,2,3,7809
3,3,0,1,1,3,4,7809
4,4,0,0,1,3,4,7809
0,0,1,0,1,0,1,7810
1,1,0,0,1,0,1,7810
0,0,1,0,1,0,1,7811
1,1,0,0,1,0,1,7811
0,0,1,0,1,0,1,7812
1,1,1,1,2,1,3,7812
2,2,0,3,2,4,6,7812
3,3,1,3,3,7,10,7812
4,4,0,3,3,10,13,7812
5,5,1,1,4,11,15,7812
6,6,0,0,4,11,15,7812
0,0,1,0,1,0,1,7813
1,1,0,0,1,0,1,7813
0,0,1,0,1,0,1,7814
1,1,1,0,2,0,2,7814
2,2,2,1,4,1,5,7814
3,3,3,2,7,3,10,7814
4,4,5,5,12,8,20,7814
5,5,5,3,17,11,28,7814
6,6,5,4,22,15,37,7814
7,7,6,1,28,16,44,7814
8,8,5,3,33,19,52,7814
9,9,4,2,37,21,58,7814
10,10,3,1,40,22,62,7814
11,11,2,3,42,25,67,7814
12,12,2,7,44,32,76,7814
13,13,0,7,44,39,83,7814
14,14,1,7,45,46,91,7814
15,15,2,2,47,48,95,7814
16,16,3,2,50,50,100,7814
17,17,3,3,53,53,106,7814
18,18,2,0,55,53,108,7814
19,19,2,0,57,53,110,7814
20,20,1,0,58,53,111,7814
21,21,1,0,59,53,112,7814
22,22,1,0,60,53,113,7814
23,23,0,0,60,53,113,7814
0,0,1,0,1,0,1,7815
1,1,0,0,1,0,1,7815
0,0,1,0,1,0,1,7816
1,1,0,0,1,0,1,7816
0,0,1,0,1,0,1,7817
1,1,1,0,2,0,2,7817
2,2,1,0,3,0,3,7817
3,3,0,0,3,0,3,7817
0,0,1,0,1,0,1,7818
1,1,3,0,4,0,4,7818
2,2,3,0,7,0,7,7818
3,3,7,0,14,0,14,7818
4,4,6,0,20,0,20,7818
5,5,7,0,27,0,27,7818
6,6,3,1,30,1,31,7818
7,7,1,2,31,3,34,7818
8,8,3,2,34,5,39,7818
9,9,2,2,36,7,43,7818
10,10,3,1,39,8,47,7818
11,11,5,1,44,9,53,7818
12,12,3,1,47,10,57,7818
13,13,3,1,50,11,61,7818
14,14,2,0,52,11,63,7818
15,15,0,2,52,13,65,7818
16,16,0,1,52,14,66,7818
17,17,0,1,52,15,67,7818
18,18,0,0,52,15,67,7818
0,0,1,0,1,0,1,7819
1,1,0,0,1,0,1,7819
0,0,1,0,1,0,1,7820
1,1,1,0,2,0,2,7820
2,2,2,0,4,0,4,7820
3,3,1,1,5,1,6,7820
4,4,0,1,5,2,7,7820
5,5,0,0,5,2,7,7820
0,0,1,0,1,0,1,7821
1,1,0,0,1,0,1,7821
0,0,1,0,1,0,1,7822
1,1,0,0,1,0,1,7822
0,0,1,0,1,0,1,7823
1,1,0,0,1,0,1,7823
0,0,1,0,1,0,1,7824
1,1,0,0,1,0,1,7824
0,0,1,0,1,0,1,7825
1,1,1,0,2,0,2,7825
2,2,2,1,4,1,5,7825
3,3,3,1,7,2,9,7825
4,4,6,1,13,3,16,7825
5,5,3,1,16,4,20,7825
6,6,2,0,18,4,22,7825
7,7,1,0,19,4,23,7825
8,8,1,0,20,4,24,7825
9,9,1,1,21,5,26,7825
10,10,0,0,21,5,26,7825
0,0,1,0,1,0,1,7826
1,1,0,0,1,0,1,7826
0,0,1,0,1,0,1,7827
1,1,0,0,1,0,1,7827
0,0,1,0,1,0,1,7828
1,1,1,0,2,0,2,7828
2,2,1,0,3,0,3,7828
3,3,0,0,3,0,3,7828
0,0,1,0,1,0,1,7829
1,1,0,0,1,0,1,7829
0,0,1,0,1,0,1,7830
1,1,0,0,1,0,1,7830
0,0,1,0,1,0,1,7831
1,1,2,1,3,1,4,7831
2,2,2,1,5,2,7,7831
3,3,0,1,5,3,8,7831
4,4,0,1,5,4,9,7831
5,5,2,0,7,4,11,7831
6,6,1,0,8,4,12,7831
7,7,1,0,9,4,13,7831
8,8,1,0,10,4,14,7831
9,9,1,1,11,5,16,7831
10,10,0,1,11,6,17,7831
11,11,0,0,11,6,17,7831
0,0,1,0,1,0,1,7832
1,1,0,2,1,2,3,7832
2,2,2,1,3,3,6,7832
3,3,0,1,3,4,7,7832
4,4,0,1,3,5,8,7832
5,5,1,1,4,6,10,7832
6,6,0,1,4,7,11,7832
7,7,0,1,4,8,12,7832
8,8,0,0,4,8,12,7832
0,0,1,0,1,0,1,7833
1,1,0,0,1,0,1,7833
0,0,1,0,1,0,1,7834
1,1,0,0,1,0,1,7834
0,0,1,0,1,0,1,7835
1,1,2,0,3,0,3,7835
2,2,1,1,4,1,5,7835
3,3,1,2,5,3,8,7835
4,4,3,0,8,3,11,7835
5,5,2,2,10,5,15,7835
6,6,4,0,14,5,19,7835
7,7,4,1,18,6,24,7835
8,8,2,4,20,10,30,7835
9,9,1,4,21,14,35,7835
10,10,2,6,23,20,43,7835
11,11,2,3,25,23,48,7835
12,12,2,2,27,25,52,7835
13,13,3,4,30,29,59,7835
14,14,2,1,32,30,62,7835
15,15,4,1,36,31,67,7835
16,16,2,3,38,34,72,7835
17,17,2,3,40,37,77,7835
18,18,2,2,42,39,81,7835
19,19,1,1,43,40,83,7835
20,20,0,1,43,41,84,7835
21,21,0,0,43,41,84,7835
0,0,1,0,1,0,1,7836
1,1,1,0,2,0,2,7836
2,2,2,1,4,1,5,7836
3,3,0,0,4,1,5,7836
0,0,1,0,1,0,1,7837
1,1,1,1,2,1,3,7837
2,2,1,2,3,3,6,7837
3,3,2,4,5,7,12,7837
4,4,2,3,7,10,17,7837
5,5,3,4,10,14,24,7837
6,6,4,3,14,17,31,7837
7,7,2,2,16,19,35,7837
8,8,5,1,21,20,41,7837
9,9,4,2,25,22,47,7837
10,10,4,3,29,25,54,7837
11,11,2,1,31,26,57,7837
12,12,1,2,32,28,60,7837
13,13,2,1,34,29,63,7837
14,14,1,1,35,30,65,7837
15,15,1,0,36,30,66,7837
16,16,0,0,36,30,66,7837
0,0,1,0,1,0,1,7838
1,1,1,0,2,0,2,7838
2,2,1,0,3,0,3,7838
3,3,1,0,4,0,4,7838
4,4,0,0,4,0,4,7838
0,0,1,0,1,0,1,7839
1,1,0,0,1,0,1,7839
0,0,1,0,1,0,1,7840
1,1,2,0,3,0,3,7840
2,2,4,1,7,1,8,7840
3,3,7,1,14,2,16,7840
4,4,3,3,17,5,22,7840
5,5,2,4,19,9,28,7840
6,6,1,4,20,13,33,7840
7,7,0,3,20,16,36,7840
8,8,1,2,21,18,39,7840
9,9,0,1,21,19,40,7840
10,10,0,2,21,21,42,7840
11,11,1,2,22,23,45,7840
12,12,0,2,22,25,47,7840
13,13,0,3,22,28,50,7840
14,14,0,6,22,34,56,7840
15,15,0,6,22,40,62,7840
16,16,1,4,23,44,67,7840
17,17,0,1,23,45,68,7840
18,18,1,1,24,46,70,7840
19,19,1,1,25,47,72,7840
20,20,0,1,25,48,73,7840
21,21,0,1,25,49,74,7840
22,22,0,0,25,49,74,7840
0,0,1,0,1,0,1,7841
1,1,0,0,1,0,1,7841
0,0,1,0,1,0,1,7842
1,1,0,0,1,0,1,7842
0,0,1,0,1,0,1,7843
1,1,1,0,2,0,2,7843
2,2,0,1,2,1,3,7843
3,3,0,2,2,3,5,7843
4,4,0,3,2,6,8,7843
5,5,0,3,2,9,11,7843
6,6,0,2,2,11,13,7843
7,7,0,1,2,12,14,7843
8,8,0,0,2,12,14,7843
0,0,1,0,1,0,1,7844
1,1,1,0,2,0,2,7844
2,2,1,0,3,0,3,7844
3,3,0,1,3,1,4,7844
4,4,0,0,3,1,4,7844
0,0,1,0,1,0,1,7845
1,1,1,0,2,0,2,7845
2,2,0,0,2,0,2,7845
0,0,1,0,1,0,1,7846
1,1,4,1,5,1,6,7846
2,2,3,1,8,2,10,7846
3,3,2,0,10,2,12,7846
4,4,0,0,10,2,12,7846
0,0,1,0,1,0,1,7847
1,1,1,0,2,0,2,7847
2,2,0,0,2,0,2,7847
0,0,1,0,1,0,1,7848
1,1,0,0,1,0,1,7848
0,0,1,0,1,0,1,7849
1,1,2,0,3,0,3,7849
2,2,2,0,5,0,5,7849
3,3,1,0,6,0,6,7849
4,4,0,0,6,0,6,7849
0,0,1,0,1,0,1,7850
1,1,2,0,3,0,3,7850
2,2,2,1,5,1,6,7850
3,3,0,0,5,1,6,7850
0,0,1,0,1,0,1,7851
1,1,0,0,1,0,1,7851
0,0,1,0,1,0,1,7852
1,1,2,0,3,0,3,7852
2,2,0,0,3,0,3,7852
0,0,1,0,1,0,1,7853
1,1,0,0,1,0,1,7853
0,0,1,0,1,0,1,7854
1,1,0,2,1,2,3,7854
2,2,0,2,1,4,5,7854
3,3,0,0,1,4,5,7854
0,0,1,0,1,0,1,7855
1,1,0,0,1,0,1,7855
0,0,1,0,1,0,1,7856
1,1,1,1,2,1,3,7856
2,2,1,0,3,1,4,7856
3,3,0,0,3,1,4,7856
0,0,1,0,1,0,1,7857
1,1,0,1,1,1,2,7857
2,2,0,1,1,2,3,7857
3,3,0,0,1,2,3,7857
0,0,1,0,1,0,1,7858
1,1,1,0,2,0,2,7858
2,2,0,0,2,0,2,7858
0,0,1,0,1,0,1,7859
1,1,1,0,2,0,2,7859
2,2,3,0,5,0,5,7859
3,3,5,0,10,0,10,7859
4,4,2,3,12,3,15,7859
5,5,1,4,13,7,20,7859
6,6,3,2,16,9,25,7859
7,7,3,1,19,10,29,7859
8,8,3,0,22,10,32,7859
9,9,2,0,24,10,34,7859
10,10,0,0,24,10,34,7859
0,0,1,0,1,0,1,7860
1,1,1,1,2,1,3,7860
2,2,1,1,3,2,5,7860
3,3,1,3,4,5,9,7860
4,4,1,2,5,7,12,7860
5,5,0,1,5,8,13,7860
6,6,0,0,5,8,13,7860
0,0,1,0,1,0,1,7861
1,1,0,0,1,0,1,7861
0,0,1,0,1,0,1,7862
1,1,1,0,2,0,2,7862
2,2,0,1,2,1,3,7862
3,3,0,0,2,1,3,7862
0,0,1,0,1,0,1,7863
1,1,1,0,2,0,2,7863
2,2,0,0,2,0,2,7863
0,0,1,0,1,0,1,7864
1,1,0,0,1,0,1,7864
0,0,1,0,1,0,1,7865
1,1,2,0,3,0,3,7865
2,2,2,0,5,0,5,7865
3,3,2,0,7,0,7,7865
4,4,1,2,8,2,10,7865
5,5,1,2,9,4,13,7865
6,6,2,4,11,8,19,7865
7,7,1,2,12,10,22,7865
8,8,1,3,13,13,26,7865
9,9,0,1,13,14,27,7865
10,10,0,0,13,14,27,7865
0,0,1,0,1,0,1,7866
1,1,0,1,1,1,2,7866
2,2,1,0,2,1,3,7866
3,3,0,0,2,1,3,7866
0,0,1,0,1,0,1,7867
1,1,0,1,1,1,2,7867
2,2,0,0,1,1,2,7867
0,0,1,0,1,0,1,7868
1,1,0,0,1,0,1,7868
0,0,1,0,1,0,1,7869
1,1,0,1,1,1,2,7869
2,2,1,1,2,2,4,7869
3,3,0,0,2,2,4,7869
0,0,1,0,1,0,1,7870
1,1,2,0,3,0,3,7870
2,2,3,0,6,0,6,7870
3,3,3,0,9,0,9,7870
4,4,1,0,10,0,10,7870
5,5,0,0,10,0,10,7870
0,0,1,0,1,0,1,7871
1,1,0,0,1,0,1,7871
0,0,1,0,1,0,1,7872
1,1,0,0,1,0,1,7872
0,0,1,0,1,0,1,7873
1,1,3,0,4,0,4,7873
2,2,3,0,7,0,7,7873
3,3,1,1,8,1,9,7873
4,4,0,0,8,1,9,7873
0,0,1,0,1,0,1,7874
1,1,0,1,1,1,2,7874
2,2,0,0,1,1,2,7874
0,0,1,0,1,0,1,7875
1,1,1,0,2,0,2,7875
2,2,1,0,3,0,3,7875
3,3,1,0,4,0,4,7875
4,4,1,0,5,0,5,7875
5,5,0,0,5,0,5,7875
0,0,1,0,1,0,1,7876
1,1,1,0,2,0,2,7876
2,2,0,0,2,0,2,7876
0,0,1,0,1,0,1,7877
1,1,1,0,2,0,2,7877
2,2,1,0,3,0,3,7877
3,3,0,0,3,0,3,7877
0,0,1,0,1,0,1,7878
1,1,2,0,3,0,3,7878
2,2,0,2,3,2,5,7878
3,3,0,0,3,2,5,7878
0,0,1,0,1,0,1,7879
1,1,1,0,2,0,2,7879
2,2,2,1,4,1,5,7879
3,3,4,1,8,2,10,7879
4,4,2,0,10,2,12,7879
5,5,1,0,11,2,13,7879
6,6,0,0,11,2,13,7879
0,0,1,0,1,0,1,7880
1,1,1,0,2,0,2,7880
2,2,0,0,2,0,2,7880
0,0,1,0,1,0,1,7881
1,1,1,0,2,0,2,7881
2,2,2,0,4,0,4,7881
3,3,3,1,7,1,8,7881
4,4,2,0,9,1,10,7881
5,5,0,0,9,1,10,7881
0,0,1,0,1,0,1,7882
1,1,4,0,5,0,5,7882
2,2,3,2,8,2,10,7882
3,3,3,1,11,3,14,7882
4,4,3,1,14,4,18,7882
5,5,1,0,15,4,19,7882
6,6,0,0,15,4,19,7882
0,0,1,0,1,0,1,7883
1,1,2,0,3,0,3,7883
2,2,0,1,3,1,4,7883
3,3,0,1,3,2,5,7883
4,4,0,0,3,2,5,7883
0,0,1,0,1,0,1,7884
1,1,1,0,2,0,2,7884
2,2,5,0,7,0,7,7884
3,3,1,1,8,1,9,7884
4,4,0,0,8,1,9,7884
0,0,1,0,1,0,1,7885
1,1,1,0,2,0,2,7885
2,2,0,0,2,0,2,7885
0,0,1,0,1,0,1,7886
1,1,1,0,2,0,2,7886
2,2,0,1,2,1,3,7886
3,3,0,0,2,1,3,7886
0,0,1,0,1,0,1,7887
1,1,0,0,1,0,1,7887
0,0,1,0,1,0,1,7888
1,1,1,0,2,0,2,7888
2,2,0,0,2,0,2,7888
0,0,1,0,1,0,1,7889
1,1,1,0,2,0,2,7889
2,2,1,0,3,0,3,7889
3,3,2,0,5,0,5,7889
4,4,2,0,7,0,7,7889
5,5,3,2,10,2,12,7889
6,6,2,1,12,3,15,7889
7,7,1,2,13,5,18,7889
8,8,1,1,14,6,20,7889
9,9,1,2,15,8,23,7889
10,10,2,1,17,9,26,7889
11,11,0,2,17,11,28,7889
12,12,1,1,18,12,30,7889
13,13,2,1,20,13,33,7889
14,14,1,0,21,13,34,7889
15,15,0,0,21,13,34,7889
0,0,1,0,1,0,1,7890
1,1,1,0,2,0,2,7890
2,2,1,0,3,0,3,7890
3,3,0,0,3,0,3,7890
0,0,1,0,1,0,1,7891
1,1,0,2,1,2,3,7891
2,2,0,1,1,3,4,7891
3,3,0,0,1,3,4,7891
0,0,1,0,1,0,1,7892
1,1,2,1,3,1,4,7892
2,2,1,0,4,1,5,7892
3,3,1,0,5,1,6,7892
4,4,0,0,5,1,6,7892
0,0,1,0,1,0,1,7893
1,1,0,0,1,0,1,7893
0,0,1,0,1,0,1,7894
1,1,1,0,2,0,2,7894
2,2,0,1,2,1,3,7894
3,3,0,0,2,1,3,7894
0,0,1,0,1,0,1,7895
1,1,0,0,1,0,1,7895
0,0,1,0,1,0,1,7896
1,1,1,0,2,0,2,7896
2,2,0,0,2,0,2,7896
0,0,1,0,1,0,1,7897
1,1,0,0,1,0,1,7897
0,0,1,0,1,0,1,7898
1,1,0,0,1,0,1,7898
0,0,1,0,1,0,1,7899
1,1,1,1,2,1,3,7899
2,2,0,1,2,2,4,7899
3,3,0,1,2,3,5,7899
4,4,0,1,2,4,6,7899
5,5,0,2,2,6,8,7899
6,6,0,3,2,9,11,7899
7,7,1,4,3,13,16,7899
8,8,1,0,4,13,17,7899
9,9,0,0,4,13,17,7899
0,0,1,0,1,0,1,7900
1,1,1,0,2,0,2,7900
2,2,0,0,2,0,2,7900
0,0,1,0,1,0,1,7901
1,1,0,0,1,0,1,7901
0,0,1,0,1,0,1,7902
1,1,0,0,1,0,1,7902
0,0,1,0,1,0,1,7903
1,1,0,1,1,1,2,7903
2,2,0,2,1,3,4,7903
3,3,1,0,2,3,5,7903
4,4,0,0,2,3,5,7903
0,0,1,0,1,0,1,7904
1,1,2,0,3,0,3,7904
2,2,1,1,4,1,5,7904
3,3,0,0,4,1,5,7904
0,0,1,0,1,0,1,7905
1,1,1,0,2,0,2,7905
2,2,1,0,3,0,3,7905
3,3,0,0,3,0,3,7905
0,0,1,0,1,0,1,7906
1,1,1,0,2,0,2,7906
2,2,0,1,2,1,3,7906
3,3,0,1,2,2,4,7906
4,4,0,0,2,2,4,7906
0,0,1,0,1,0,1,7907
1,1,1,1,2,1,3,7907
2,2,2,1,4,2,6,7907
3,3,1,2,5,4,9,7907
4,4,0,4,5,8,13,7907
5,5,0,1,5,9,14,7907
6,6,1,1,6,10,16,7907
7,7,1,2,7,12,19,7907
8,8,1,1,8,13,21,7907
9,9,0,1,8,14,22,7907
10,10,0,0,8,14,22,7907
0,0,1,0,1,0,1,7908
1,1,0,0,1,0,1,7908
0,0,1,0,1,0,1,7909
1,1,0,0,1,0,1,7909
0,0,1,0,1,0,1,7910
1,1,2,1,3,1,4,7910
2,2,3,0,6,1,7,7910
3,3,1,0,7,1,8,7910
4,4,1,0,8,1,9,7910
5,5,0,0,8,1,9,7910
0,0,1,0,1,0,1,7911
1,1,0,0,1,0,1,7911
0,0,1,0,1,0,1,7912
1,1,0,0,1,0,1,7912
0,0,1,0,1,0,1,7913
1,1,1,0,2,0,2,7913
2,2,1,0,3,0,3,7913
3,3,0,0,3,0,3,7913
0,0,1,0,1,0,1,7914
1,1,1,0,2,0,2,7914
2,2,1,0,3,0,3,7914
3,3,0,1,3,1,4,7914
4,4,0,0,3,1,4,7914
0,0,1,0,1,0,1,7915
1,1,0,0,1,0,1,7915
0,0,1,0,1,0,1,7916
1,1,2,0,3,0,3,7916
2,2,0,0,3,0,3,7916
0,0,1,0,1,0,1,7917
1,1,0,0,1,0,1,7917
0,0,1,0,1,0,1,7918
1,1,0,0,1,0,1,7918
0,0,1,0,1,0,1,7919
1,1,1,0,2,0,2,7919
2,2,1,1,3,1,4,7919
3,3,0,0,3,1,4,7919
0,0,1,0,1,0,1,7920
1,1,0,0,1,0,1,7920
0,0,1,0,1,0,1,7921
1,1,1,0,2,0,2,7921
2,2,0,0,2,0,2,7921
0,0,1,0,1,0,1,7922
1,1,0,0,1,0,1,7922
0,0,1,0,1,0,1,7923
1,1,0,0,1,0,1,7923
0,0,1,0,1,0,1,7924
1,1,0,2,1,2,3,7924
2,2,0,1,1,3,4,7924
3,3,0,1,1,4,5,7924
4,4,0,1,1,5,6,7924
5,5,0,0,1,5,6,7924
0,0,1,0,1,0,1,7925
1,1,1,0,2,0,2,7925
2,2,0,0,2,0,2,7925
0,0,1,0,1,0,1,7926
1,1,0,0,1,0,1,7926
0,0,1,0,1,0,1,7927
1,1,0,0,1,0,1,7927
0,0,1,0,1,0,1,7928
1,1,0,2,1,2,3,7928
2,2,0,1,1,3,4,7928
3,3,0,1,1,4,5,7928
4,4,0,2,1,6,7,7928
5,5,0,4,1,10,11,7928
6,6,0,2,1,12,13,7928
7,7,0,2,1,14,15,7928
8,8,0,2,1,16,17,7928
9,9,2,1,3,17,20,7928
10,10,2,2,5,19,24,7928
11,11,4,1,9,20,29,7928
12,12,3,2,12,22,34,7928
13,13,3,4,15,26,41,7928
14,14,5,1,20,27,47,7928
15,15,4,1,24,28,52,7928
16,16,6,0,30,28,58,7928
17,17,4,3,34,31,65,7928
18,18,3,5,37,36,73,7928
19,19,0,2,37,38,75,7928
20,20,0,1,37,39,76,7928
21,21,0,0,37,39,76,7928
0,0,1,0,1,0,1,7929
1,1,0,0,1,0,1,7929
0,0,1,0,1,0,1,7930
1,1,0,0,1,0,1,7930
0,0,1,0,1,0,1,7931
1,1,0,0,1,0,1,7931
0,0,1,0,1,0,1,7932
1,1,0,0,1,0,1,7932
0,0,1,0,1,0,1,7933
1,1,0,0,1,0,1,7933
0,0,1,0,1,0,1,7934
1,1,1,0,2,0,2,7934
2,2,2,0,4,0,4,7934
3,3,1,0,5,0,5,7934
4,4,2,2,7,2,9,7934
5,5,3,6,10,8,18,7934
6,6,6,5,16,13,29,7934
7,7,4,4,20,17,37,7934
8,8,2,2,22,19,41,7934
9,9,4,3,26,22,48,7934
10,10,2,3,28,25,53,7934
11,11,2,1,30,26,56,7934
12,12,1,0,31,26,57,7934
13,13,0,0,31,26,57,7934
0,0,1,0,1,0,1,7935
1,1,2,0,3,0,3,7935
2,2,3,0,6,0,6,7935
3,3,1,0,7,0,7,7935
4,4,1,0,8,0,8,7935
5,5,1,0,9,0,9,7935
6,6,0,0,9,0,9,7935
0,0,1,0,1,0,1,7936
1,1,2,0,3,0,3,7936
2,2,1,0,4,0,4,7936
3,3,1,0,5,0,5,7936
4,4,3,1,8,1,9,7936
5,5,1,2,9,3,12,7936
6,6,1,1,10,4,14,7936
7,7,0,0,10,4,14,7936
0,0,1,0,1,0,1,7937
1,1,2,0,3,0,3,7937
2,2,1,0,4,0,4,7937
3,3,3,0,7,0,7,7937
4,4,0,0,7,0,7,7937
0,0,1,0,1,0,1,7938
1,1,0,0,1,0,1,7938
0,0,1,0,1,0,1,7939
1,1,2,0,3,0,3,7939
2,2,0,1,3,1,4,7939
3,3,1,0,4,1,5,7939
4,4,0,0,4,1,5,7939
0,0,1,0,1,0,1,7940
1,1,0,0,1,0,1,7940
0,0,1,0,1,0,1,7941
1,1,1,0,2,0,2,7941
2,2,0,1,2,1,3,7941
3,3,0,0,2,1,3,7941
0,0,1,0,1,0,1,7942
1,1,0,0,1,0,1,7942
0,0,1,0,1,0,1,7943
1,1,1,0,2,0,2,7943
2,2,1,0,3,0,3,7943
3,3,0,0,3,0,3,7943
0,0,1,0,1,0,1,7944
1,1,2,0,3,0,3,7944
2,2,0,1,3,1,4,7944
3,3,0,0,3,1,4,7944
0,0,1,0,1,0,1,7945
1,1,1,1,2,1,3,7945
2,2,3,1,5,2,7,7945
3,3,3,1,8,3,11,7945
4,4,4,1,12,4,16,7945
5,5,1,0,13,4,17,7945
6,6,0,0,13,4,17,7945
0,0,1,0,1,0,1,7946
1,1,0,0,1,0,1,7946
0,0,1,0,1,0,1,7947
1,1,0,0,1,0,1,7947
0,0,1,0,1,0,1,7948
1,1,1,0,2,0,2,7948
2,2,1,0,3,0,3,7948
3,3,0,0,3,0,3,7948
0,0,1,0,1,0,1,7949
1,1,1,1,2,1,3,7949
2,2,1,3,3,4,7,7949
3,3,2,1,5,5,10,7949
4,4,2,1,7,6,13,7949
5,5,0,1,7,7,14,7949
6,6,0,0,7,7,14,7949
0,0,1,0,1,0,1,7950
1,1,0,0,1,0,1,7950
0,0,1,0,1,0,1,7951
1,1,0,0,1,0,1,7951
0,0,1,0,1,0,1,7952
1,1,1,0,2,0,2,7952
2,2,1,0,3,0,3,7952
3,3,1,0,4,0,4,7952
4,4,0,0,4,0,4,7952
0,0,1,0,1,0,1,7953
1,1,0,0,1,0,1,7953
0,0,1,0,1,0,1,7954
1,1,0,1,1,1,2,7954
2,2,1,1,2,2,4,7954
3,3,1,0,3,2,5,7954
4,4,0,0,3,2,5,7954
0,0,1,0,1,0,1,7955
1,1,0,0,1,0,1,7955
0,0,1,0,1,0,1,7956
1,1,4,0,5,0,5,7956
2,2,4,0,9,0,9,7956
3,3,4,1,13,1,14,7956
4,4,2,1,15,2,17,7956
5,5,3,2,18,4,22,7956
6,6,4,4,22,8,30,7956
7,7,2,4,24,12,36,7956
8,8,0,7,24,19,43,7956
9,9,3,4,27,23,50,7956
10,10,3,10,30,33,63,7956
11,11,4,5,34,38,72,7956
12,12,3,5,37,43,80,7956
13,13,3,5,40,48,88,7956
14,14,0,2,40,50,90,7956
15,15,1,0,41,50,91,7956
16,16,0,0,41,50,91,7956
0,0,1,0,1,0,1,7957
1,1,1,0,2,0,2,7957
2,2,3,1,5,1,6,7957
3,3,2,1,7,2,9,7957
4,4,3,1,10,3,13,7957
5,5,3,2,13,5,18,7957
6,6,2,6,15,11,26,7957
7,7,3,6,18,17,35,7957
8,8,2,7,20,24,44,7957
9,9,1,9,21,33,54,7957
10,10,1,9,22,42,64,7957
11,11,3,5,25,47,72,7957
12,12,3,2,28,49,77,7957
13,13,5,0,33,49,82,7957
14,14,4,3,37,52,89,7957
15,15,2,4,39,56,95,7957
16,16,1,7,40,63,103,7957
17,17,0,3,40,66,106,7957
18,18,0,3,40,69,109,7957
19,19,0,3,40,72,112,7957
20,20,2,2,42,74,116,7957
21,21,2,1,44,75,119,7957
22,22,3,1,47,76,123,7957
23,23,1,1,48,77,125,7957
24,24,0,2,48,79,127,7957
25,25,1,1,49,80,129,7957
26,26,1,2,50,82,132,7957
27,27,0,2,50,84,134,7957
28,28,0,3,50,87,137,7957
29,29,0,2,50,89,139,7957
30,30,1,1,51,90,141,7957
31,31,1,1,52,91,143,7957
32,32,1,0,53,91,144,7957
33,33,1,0,54,91,145,7957
34,34,0,0,54,91,145,7957
0,0,1,0,1,0,1,7958
1,1,1,0,2,0,2,7958
2,2,0,0,2,0,2,7958
0,0,1,0,1,0,1,7959
1,1,0,0,1,0,1,7959
0,0,1,0,1,0,1,7960
1,1,0,0,1,0,1,7960
0,0,1,0,1,0,1,7961
1,1,1,0,2,0,2,7961
2,2,0,0,2,0,2,7961
0,0,1,0,1,0,1,7962
1,1,1,0,2,0,2,7962
2,2,0,0,2,0,2,7962
0,0,1,0,1,0,1,7963
1,1,1,0,2,0,2,7963
2,2,1,1,3,1,4,7963
3,3,1,0,4,1,5,7963
4,4,0,0,4,1,5,7963
0,0,1,0,1,0,1,7964
1,1,0,0,1,0,1,7964
0,0,1,0,1,0,1,7965
1,1,0,0,1,0,1,7965
0,0,1,0,1,0,1,7966
1,1,0,0,1,0,1,7966
0,0,1,0,1,0,1,7967
1,1,0,0,1,0,1,7967
0,0,1,0,1,0,1,7968
1,1,3,0,4,0,4,7968
2,2,6,0,10,0,10,7968
3,3,6,0,16,0,16,7968
4,4,5,0,21,0,21,7968
5,5,5,0,26,0,26,7968
6,6,4,0,30,0,30,7968
7,7,3,1,33,1,34,7968
8,8,1,0,34,1,35,7968
9,9,0,0,34,1,35,7968
0,0,1,0,1,0,1,7969
1,1,0,1,1,1,2,7969
2,2,0,0,1,1,2,7969
0,0,1,0,1,0,1,7970
1,1,0,0,1,0,1,7970
0,0,1,0,1,0,1,7971
1,1,0,0,1,0,1,7971
0,0,1,0,1,0,1,7972
1,1,1,0,2,0,2,7972
2,2,0,1,2,1,3,7972
3,3,0,0,2,1,3,7972
0,0,1,0,1,0,1,7973
1,1,0,0,1,0,1,7973
0,0,1,0,1,0,1,7974
1,1,1,0,2,0,2,7974
2,2,1,0,3,0,3,7974
3,3,0,0,3,0,3,7974
0,0,1,0,1,0,1,7975
1,1,1,0,2,0,2,7975
2,2,1,0,3,0,3,7975
3,3,0,1,3,1,4,7975
4,4,1,0,4,1,5,7975
5,5,6,0,10,1,11,7975
6,6,7,1,17,2,19,7975
7,7,8,2,25,4,29,7975
8,8,8,2,33,6,39,7975
9,9,4,4,37,10,47,7975
10,10,5,1,42,11,53,7975
11,11,2,3,44,14,58,7975
12,12,3,7,47,21,68,7975
13,13,6,9,53,30,83,7975
14,14,7,4,60,34,94,7975
15,15,6,5,66,39,105,7975
16,16,8,4,74,43,117,7975
17,17,5,1,79,44,123,7975
18,18,5,0,84,44,128,7975
19,19,6,0,90,44,134,7975
20,20,3,3,93,47,140,7975
21,21,3,1,96,48,144,7975
22,22,3,1,99,49,148,7975
23,23,2,3,101,52,153,7975
24,24,1,5,102,57,159,7975
25,25,1,4,103,61,164,7975
26,26,0,4,103,65,168,7975
27,27,0,1,103,66,169,7975
28,28,1,1,104,67,171,7975
29,29,1,0,105,67,172,7975
30,30,2,0,107,67,174,7975
31,31,2,0,109,67,176,7975
32,32,3,2,112,69,181,7975
33,33,3,1,115,70,185,7975
34,34,5,1,120,71,191,7975
35,35,2,1,122,72,194,7975
36,36,5,2,127,74,201,7975
37,37,4,1,131,75,206,7975
38,38,3,1,134,76,210,7975
39,39,1,3,135,79,214,7975
40,40,2,0,137,79,216,7975
41,41,1,0,138,79,217,7975
42,42,0,0,138,79,217,7975
0,0,1,0,1,0,1,7976
1,1,1,0,2,0,2,7976
2,2,0,0,2,0,2,7976
0,0,1,0,1,0,1,7977
1,1,0,0,1,0,1,7977
0,0,1,0,1,0,1,7978
1,1,0,0,1,0,1,7978
0,0,1,0,1,0,1,7979
1,1,0,0,1,0,1,7979
0,0,1,0,1,0,1,7980
1,1,0,0,1,0,1,7980
0,0,1,0,1,0,1,7981
1,1,1,1,2,1,3,7981
2,2,1,0,3,1,4,7981
3,3,0,0,3,1,4,7981
0,0,1,0,1,0,1,7982
1,1,0,1,1,1,2,7982
2,2,0,0,1,1,2,7982
0,0,1,0,1,0,1,7983
1,1,0,0,1,0,1,7983
0,0,1,0,1,0,1,7984
1,1,3,0,4,0,4,7984
2,2,4,0,8,0,8,7984
3,3,1,1,9,1,10,7984
4,4,2,1,11,2,13,7984
5,5,3,2,14,4,18,7984
6,6,3,2,17,6,23,7984
7,7,2,2,19,8,27,7984
8,8,3,1,22,9,31,7984
9,9,2,0,24,9,33,7984
10,10,0,0,24,9,33,7984
0,0,1,0,1,0,1,7985
1,1,0,0,1,0,1,7985
0,0,1,0,1,0,1,7986
1,1,0,0,1,0,1,7986
0,0,1,0,1,0,1,7987
1,1,1,1,2,1,3,7987
2,2,0,0,2,1,3,7987
0,0,1,0,1,0,1,7988
1,1,1,0,2,0,2,7988
2,2,1,0,3,0,3,7988
3,3,0,0,3,0,3,7988
0,0,1,0,1,0,1,7989
1,1,2,0,3,0,3,7989
2,2,2,0,5,0,5,7989
3,3,2,2,7,2,9,7989
4,4,0,0,7,2,9,7989
0,0,1,0,1,0,1,7990
1,1,1,1,2,1,3,7990
2,2,1,1,3,2,5,7990
3,3,1,1,4,3,7,7990
4,4,0,3,4,6,10,7990
5,5,0,2,4,8,12,7990
6,6,0,4,4,12,16,7990
7,7,2,3,6,15,21,7990
8,8,2,1,8,16,24,7990
9,9,2,0,10,16,26,7990
10,10,4,1,14,17,31,7990
11,11,4,0,18,17,35,7990
12,12,4,1,22,18,40,7990
13,13,4,0,26,18,44,7990
14,14,1,0,27,18,45,7990
15,15,0,0,27,18,45,7990
0,0,1,0,1,0,1,7991
1,1,0,0,1,0,1,7991
0,0,1,0,1,0,1,7992
1,1,1,0,2,0,2,7992
2,2,1,0,3,0,3,7992
3,3,0,0,3,0,3,7992
0,0,1,0,1,0,1,7993
1,1,0,0,1,0,1,7993
0,0,1,0,1,0,1,7994
1,1,0,0,1,0,1,7994
0,0,1,0,1,0,1,7995
1,1,1,1,2,1,3,7995
2,2,0,1,2,2,4,7995
3,3,1,1,3,3,6,7995
4,4,0,3,3,6,9,7995
5,5,1,1,4,7,11,7995
6,6,2,0,6,7,13,7995
7,7,2,1,8,8,16,7995
8,8,1,2,9,10,19,7995
9,9,2,4,11,14,25,7995
10,10,2,3,13,17,30,7995
11,11,0,2,13,19,32,7995
12,12,1,1,14,20,34,7995
13,13,2,0,16,20,36,7995
14,14,2,0,18,20,38,7995
15,15,0,1,18,21,39,7995
16,16,0,0,18,21,39,7995
0,0,1,0,1,0,1,7996
1,1,0,0,1,0,1,7996
0,0,1,0,1,0,1,7997
1,1,0,0,1,0,1,7997
0,0,1,0,1,0,1,7998
1,1,0,0,1,0,1,7998
0,0,1,0,1,0,1,7999
1,1,0,0,1,0,1,7999
0,0,1,0,1,0,1,8000
1,1,0,0,1,0,1,8000
0,0,1,0,1,0,1,8001
1,1,1,0,2,0,2,8001
2,2,0,0,2,0,2,8001
0,0,1,0,1,0,1,8002
1,1,1,1,2,1,3,8002
2,2,0,0,2,1,3,8002
0,0,1,0,1,0,1,8003
1,1,1,0,2,0,2,8003
2,2,1,0,3,0,3,8003
3,3,1,0,4,0,4,8003
4,4,1,0,5,0,5,8003
5,5,0,1,5,1,6,8003
6,6,0,0,5,1,6,8003
0,0,1,0,1,0,1,8004
1,1,1,0,2,0,2,8004
2,2,0,0,2,0,2,8004
0,0,1,0,1,0,1,8005
1,1,1,0,2,0,2,8005
2,2,1,1,3,1,4,8005
3,3,0,1,3,2,5,8005
4,4,0,2,3,4,7,8005
5,5,1,3,4,7,11,8005
6,6,0,0,4,7,11,8005
0,0,1,0,1,0,1,8006
1,1,0,0,1,0,1,8006
0,0,1,0,1,0,1,8007
1,1,1,1,2,1,3,8007
2,2,0,0,2,1,3,8007
0,0,1,0,1,0,1,8008
1,1,1,0,2,0,2,8008
2,2,0,0,2,0,2,8008
0,0,1,0,1,0,1,8009
1,1,0,0,1,0,1,8009
0,0,1,0,1,0,1,8010
1,1,0,0,1,0,1,8010
0,0,1,0,1,0,1,8011
1,1,1,0,2,0,2,8011
2,2,2,0,4,0,4,8011
3,3,0,0,4,0,4,8011
0,0,1,0,1,0,1,8012
1,1,1,0,2,0,2,8012
2,2,1,0,3,0,3,8012
3,3,3,0,6,0,6,8012
4,4,1,1,7,1,8,8012
5,5,0,0,7,1,8,8012
0,0,1,0,1,0,1,8013
1,1,0,1,1,1,2,8013
2,2,0,1,1,2,3,8013
3,3,0,2,1,4,5,8013
4,4,0,2,1,6,7,8013
5,5,1,2,2,8,10,8013
6,6,0,2,2,10,12,8013
7,7,0,0,2,10,12,8013
0,0,1,0,1,0,1,8014
1,1,1,0,2,0,2,8014
2,2,1,0,3,0,3,8014
3,3,0,0,3,0,3,8014
0,0,1,0,1,0,1,8015
1,1,0,0,1,0,1,8015
0,0,1,0,1,0,1,8016
1,1,0,0,1,0,1,8016
0,0,1,0,1,0,1,8017
1,1,1,0,2,0,2,8017
2,2,0,0,2,0,2,8017
0,0,1,0,1,0,1,8018
1,1,2,0,3,0,3,8018
2,2,1,0,4,0,4,8018
3,3,0,0,4,0,4,8018
0,0,1,0,1,0,1,8019
1,1,0,1,1,1,2,8019
2,2,0,1,1,2,3,8019
3,3,0,0,1,2,3,8019
0,0,1,0,1,0,1,8020
1,1,1,0,2,0,2,8020
2,2,0,0,2,0,2,8020
0,0,1,0,1,0,1,8021
1,1,1,0,2,0,2,8021
2,2,0,2,2,2,4,8021
3,3,0,0,2,2,4,8021
0,0,1,0,1,0,1,8022
1,1,1,0,2,0,2,8022
2,2,0,1,2,1,3,8022
3,3,0,0,2,1,3,8022
0,0,1,0,1,0,1,8023
1,1,0,0,1,0,1,8023
0,0,1,0,1,0,1,8024
1,1,1,0,2,0,2,8024
2,2,0,0,2,0,2,8024
0,0,1,0,1,0,1,8025
1,1,0,0,1,0,1,8025
0,0,1,0,1,0,1,8026
1,1,1,0,2,0,2,8026
2,2,0,0,2,0,2,8026
0,0,1,0,1,0,1,8027
1,1,1,0,2,0,2,8027
2,2,0,0,2,0,2,8027
0,0,1,0,1,0,1,8028
1,1,1,0,2,0,2,8028
2,2,0,0,2,0,2,8028
0,0,1,0,1,0,1,8029
1,1,0,0,1,0,1,8029
0,0,1,0,1,0,1,8030
1,1,2,0,3,0,3,8030
2,2,3,0,6,0,6,8030
3,3,5,0,11,0,11,8030
4,4,3,0,14,0,14,8030
5,5,0,0,14,0,14,8030
0,0,1,0,1,0,1,8031
1,1,0,0,1,0,1,8031
0,0,1,0,1,0,1,8032
1,1,2,0,3,0,3,8032
2,2,2,0,5,0,5,8032
3,3,1,1,6,1,7,8032
4,4,1,0,7,1,8,8032
5,5,0,0,7,1,8,8032
0,0,1,0,1,0,1,8033
1,1,0,0,1,0,1,8033
0,0,1,0,1,0,1,8034
1,1,0,0,1,0,1,8034
0,0,1,0,1,0,1,8035
1,1,0,0,1,0,1,8035
0,0,1,0,1,0,1,8036
1,1,0,1,1,1,2,8036
2,2,1,0,2,1,3,8036
3,3,1,0,3,1,4,8036
4,4,1,0,4,1,5,8036
5,5,0,0,4,1,5,8036
0,0,1,0,1,0,1,8037
1,1,1,0,2,0,2,8037
2,2,1,0,3,0,3,8037
3,3,0,0,3,0,3,8037
0,0,1,0,1,0,1,8038
1,1,2,0,3,0,3,8038
2,2,1,0,4,0,4,8038
3,3,1,0,5,0,5,8038
4,4,1,0,6,0,6,8038
5,5,2,0,8,0,8,8038
6,6,1,0,9,0,9,8038
7,7,2,0,11,0,11,8038
8,8,0,1,11,1,12,8038
9,9,0,1,11,2,13,8038
10,10,1,1,12,3,15,8038
11,11,1,0,13,3,16,8038
12,12,1,1,14,4,18,8038
13,13,0,0,14,4,18,8038
0,0,1,0,1,0,1,8039
1,1,0,0,1,0,1,8039
0,0,1,0,1,0,1,8040
1,1,1,1,2,1,3,8040
2,2,1,1,3,2,5,8040
3,3,1,1,4,3,7,8040
4,4,1,1,5,4,9,8040
5,5,2,1,7,5,12,8040
6,6,1,1,8,6,14,8040
7,7,2,3,10,9,19,8040
8,8,0,0,10,9,19,8040
0,0,1,0,1,0,1,8041
1,1,2,0,3,0,3,8041
2,2,2,0,5,0,5,8041
3,3,0,0,5,0,5,8041
0,0,1,0,1,0,1,8042
1,1,0,0,1,0,1,8042
0,0,1,0,1,0,1,8043
1,1,1,0,2,0,2,8043
2,2,1,0,3,0,3,8043
3,3,0,0,3,0,3,8043
0,0,1,0,1,0,1,8044
1,1,0,0,1,0,1,8044
0,0,1,0,1,0,1,8045
1,1,0,0,1,0,1,8045
0,0,1,0,1,0,1,8046
1,1,0,1,1,1,2,8046
2,2,0,0,1,1,2,8046
0,0,1,0,1,0,1,8047
1,1,4,2,5,2,7,8047
2,2,3,1,8,3,11,8047
3,3,6,1,14,4,18,8047
4,4,5,1,19,5,24,8047
5,5,4,2,23,7,30,8047
6,6,6,2,29,9,38,8047
7,7,3,3,32,12,44,8047
8,8,0,4,32,16,48,8047
9,9,1,1,33,17,50,8047
10,10,1,0,34,17,51,8047
11,11,1,0,35,17,52,8047
12,12,1,0,36,17,53,8047
13,13,0,0,36,17,53,8047
0,0,1,0,1,0,1,8048
1,1,2,0,3,0,3,8048
2,2,2,1,5,1,6,8048
3,3,1,2,6,3,9,8048
4,4,1,2,7,5,12,8048
5,5,3,4,10,9,19,8048
6,6,2,2,12,11,23,8048
7,7,1,0,13,11,24,8048
8,8,1,0,14,11,25,8048
9,9,1,0,15,11,26,8048
10,10,1,0,16,11,27,8048
11,11,1,0,17,11,28,8048
12,12,2,0,19,11,30,8048
13,13,1,1,20,12,32,8048
14,14,0,1,20,13,33,8048
15,15,0,0,20,13,33,8048
0,0,1,0,1,0,1,8049
1,1,1,0,2,0,2,8049
2,2,1,0,3,0,3,8049
3,3,1,0,4,0,4,8049
4,4,3,0,7,0,7,8049
5,5,3,0,10,0,10,8049
6,6,3,1,13,1,14,8049
7,7,1,1,14,2,16,8049
8,8,0,0,14,2,16,8049
0,0,1,0,1,0,1,8050
1,1,2,0,3,0,3,8050
2,2,3,1,6,1,7,8050
3,3,0,1,6,2,8,8050
4,4,1,1,7,3,10,8050
5,5,1,0,8,3,11,8050
6,6,2,0,10,3,13,8050
7,7,0,2,10,5,15,8050
8,8,0,1,10,6,16,8050
9,9,0,0,10,6,16,8050
0,0,1,0,1,0,1,8051
1,1,0,0,1,0,1,8051
0,0,1,0,1,0,1,8052
1,1,1,0,2,0,2,8052
2,2,2,0,4,0,4,8052
3,3,1,0,5,0,5,8052
4,4,1,1,6,1,7,8052
5,5,0,1,6,2,8,8052
6,6,0,1,6,3,9,8052
7,7,0,0,6,3,9,8052
0,0,1,0,1,0,1,8053
1,1,1,1,2,1,3,8053
2,2,1,0,3,1,4,8053
3,3,0,0,3,1,4,8053
0,0,1,0,1,0,1,8054
1,1,0,0,1,0,1,8054
0,0,1,0,1,0,1,8055
1,1,1,1,2,1,3,8055
2,2,0,0,2,1,3,8055
0,0,1,0,1,0,1,8056
1,1,0,0,1,0,1,8056
0,0,1,0,1,0,1,8057
1,1,0,0,1,0,1,8057
0,0,1,0,1,0,1,8058
1,1,0,0,1,0,1,8058
0,0,1,0,1,0,1,8059
1,1,0,0,1,0,1,8059
0,0,1,0,1,0,1,8060
1,1,0,0,1,0,1,8060
0,0,1,0,1,0,1,8061
1,1,2,0,3,0,3,8061
2,2,2,0,5,0,5,8061
3,3,2,0,7,0,7,8061
4,4,0,0,7,0,7,8061
0,0,1,0,1,0,1,8062
1,1,0,0,1,0,1,8062
0,0,1,0,1,0,1,8063
1,1,0,0,1,0,1,8063
0,0,1,0,1,0,1,8064
1,1,0,0,1,0,1,8064
0,0,1,0,1,0,1,8065
1,1,0,0,1,0,1,8065
0,0,1,0,1,0,1,8066
1,1,0,0,1,0,1,8066
0,0,1,0,1,0,1,8067
1,1,1,0,2,0,2,8067
2,2,0,0,2,0,2,8067
0,0,1,0,1,0,1,8068
1,1,1,0,2,0,2,8068
2,2,0,0,2,0,2,8068
0,0,1,0,1,0,1,8069
1,1,1,0,2,0,2,8069
2,2,0,0,2,0,2,8069
0,0,1,0,1,0,1,8070
1,1,0,0,1,0,1,8070
0,0,1,0,1,0,1,8071
1,1,1,0,2,0,2,8071
2,2,0,0,2,0,2,8071
0,0,1,0,1,0,1,8072
1,1,0,0,1,0,1,8072
0,0,1,0,1,0,1,8073
1,1,2,0,3,0,3,8073
2,2,1,1,4,1,5,8073
3,3,1,0,5,1,6,8073
4,4,1,1,6,2,8,8073
5,5,2,0,8,2,10,8073
6,6,3,0,11,2,13,8073
7,7,1,0,12,2,14,8073
8,8,1,1,13,3,16,8073
9,9,1,0,14,3,17,8073
10,10,0,2,14,5,19,8073
11,11,0,1,14,6,20,8073
12,12,0,0,14,6,20,8073
0,0,1,0,1,0,1,8074
1,1,2,0,3,0,3,8074
2,2,0,1,3,1,4,8074
3,3,0,0,3,1,4,8074
0,0,1,0,1,0,1,8075
1,1,0,0,1,0,1,8075
0,0,1,0,1,0,1,8076
1,1,0,0,1,0,1,8076
0,0,1,0,1,0,1,8077
1,1,0,0,1,0,1,8077
0,0,1,0,1,0,1,8078
1,1,0,0,1,0,1,8078
0,0,1,0,1,0,1,8079
1,1,1,0,2,0,2,8079
2,2,0,0,2,0,2,8079
0,0,1,0,1,0,1,8080
1,1,1,0,2,0,2,8080
2,2,0,0,2,0,2,8080
0,0,1,0,1,0,1,8081
1,1,1,0,2,0,2,8081
2,2,0,0,2,0,2,8081
0,0,1,0,1,0,1,8082
1,1,0,0,1,0,1,8082
0,0,1,0,1,0,1,8083
1,1,1,0,2,0,2,8083
2,2,0,0,2,0,2,8083
0,0,1,0,1,0,1,8084
1,1,0,0,1,0,1,8084
0,0,1,0,1,0,1,8085
1,1,0,0,1,0,1,8085
0,0,1,0,1,0,1,8086
1,1,0,0,1,0,1,8086
0,0,1,0,1,0,1,8087
1,1,1,0,2,0,2,8087
2,2,0,0,2,0,2,8087
0,0,1,0,1,0,1,8088
1,1,0,0,1,0,1,8088
0,0,1,0,1,0,1,8089
1,1,0,0,1,0,1,8089
0,0,1,0,1,0,1,8090
1,1,1,0,2,0,2,8090
2,2,1,1,3,1,4,8090
3,3,1,2,4,3,7,8090
4,4,0,1,4,4,8,8090
5,5,1,0,5,4,9,8090
6,6,0,0,5,4,9,8090
0,0,1,0,1,0,1,8091
1,1,0,0,1,0,1,8091
0,0,1,0,1,0,1,8092
1,1,0,1,1,1,2,8092
2,2,1,1,2,2,4,8092
3,3,1,0,3,2,5,8092
4,4,0,0,3,2,5,8092
0,0,1,0,1,0,1,8093
1,1,1,0,2,0,2,8093
2,2,0,0,2,0,2,8093
0,0,1,0,1,0,1,8094
1,1,0,0,1,0,1,8094
0,0,1,0,1,0,1,8095
1,1,1,1,2,1,3,8095
2,2,1,2,3,3,6,8095
3,3,0,4,3,7,10,8095
4,4,0,2,3,9,12,8095
5,5,1,1,4,10,14,8095
6,6,0,2,4,12,16,8095
7,7,0,2,4,14,18,8095
8,8,1,0,5,14,19,8095
9,9,1,0,6,14,20,8095
10,10,0,0,6,14,20,8095
0,0,1,0,1,0,1,8096
1,1,1,0,2,0,2,8096
2,2,0,2,2,2,4,8096
3,3,1,1,3,3,6,8096
4,4,1,0,4,3,7,8096
5,5,0,1,4,4,8,8096
6,6,0,0,4,4,8,8096
0,0,1,0,1,0,1,8097
1,1,0,0,1,0,1,8097
0,0,1,0,1,0,1,8098
1,1,0,0,1,0,1,8098
0,0,1,0,1,0,1,8099
1,1,1,0,2,0,2,8099
2,2,1,0,3,0,3,8099
3,3,1,0,4,0,4,8099
4,4,0,0,4,0,4,8099
0,0,1,0,1,0,1,8100
1,1,0,0,1,0,1,8100
0,0,1,0,1,0,1,8101
1,1,1,0,2,0,2,8101
2,2,0,1,2,1,3,8101
3,3,1,0,3,1,4,8101
4,4,0,1,3,2,5,8101
5,5,0,0,3,2,5,8101
0,0,1,0,1,0,1,8102
1,1,1,0,2,0,2,8102
2,2,0,0,2,0,2,8102
0,0,1,0,1,0,1,8103
1,1,0,0,1,0,1,8103
0,0,1,0,1,0,1,8104
1,1,0,0,1,0,1,8104
0,0,1,0,1,0,1,8105
1,1,1,0,2,0,2,8105
2,2,0,1,2,1,3,8105
3,3,0,0,2,1,3,8105
0,0,1,0,1,0,1,8106
1,1,0,0,1,0,1,8106
0,0,1,0,1,0,1,8107
1,1,0,0,1,0,1,8107
0,0,1,0,1,0,1,8108
1,1,2,1,3,1,4,8108
2,2,2,0,5,1,6,8108
3,3,1,2,6,3,9,8108
4,4,1,0,7,3,10,8108
5,5,0,0,7,3,10,8108
0,0,1,0,1,0,1,8109
1,1,3,0,4,0,4,8109
2,2,2,1,6,1,7,8109
3,3,1,0,7,1,8,8109
4,4,0,0,7,1,8,8109
0,0,1,0,1,0,1,8110
1,1,2,0,3,0,3,8110
2,2,0,2,3,2,5,8110
3,3,0,4,3,6,9,8110
4,4,0,5,3,11,14,8110
5,5,2,1,5,12,17,8110
6,6,1,2,6,14,20,8110
7,7,1,0,7,14,21,8110
8,8,0,0,7,14,21,8110
0,0,1,0,1,0,1,8111
1,1,1,0,2,0,2,8111
2,2,0,0,2,0,2,8111
0,0,1,0,1,0,1,8112
1,1,0,0,1,0,1,8112
0,0,1,0,1,0,1,8113
1,1,0,0,1,0,1,8113
0,0,1,0,1,0,1,8114
1,1,2,0,3,0,3,8114
2,2,1,1,4,1,5,8114
3,3,0,0,4,1,5,8114
0,0,1,0,1,0,1,8115
1,1,0,0,1,0,1,8115
0,0,1,0,1,0,1,8116
1,1,1,0,2,0,2,8116
2,2,1,0,3,0,3,8116
3,3,2,1,5,1,6,8116
4,4,0,1,5,2,7,8116
5,5,0,2,5,4,9,8116
6,6,1,0,6,4,10,8116
7,7,1,0,7,4,11,8116
8,8,0,3,7,7,14,8116
9,9,2,1,9,8,17,8116
10,10,4,0,13,8,21,8116
11,11,0,1,13,9,22,8116
12,12,1,0,14,9,23,8116
13,13,0,0,14,9,23,8116
0,0,1,0,1,0,1,8117
1,1,0,0,1,0,1,8117
0,0,1,0,1,0,1,8118
1,1,0,0,1,0,1,8118
0,0,1,0,1,0,1,8119
1,1,0,0,1,0,1,8119
0,0,1,0,1,0,1,8120
1,1,0,0,1,0,1,8120
0,0,1,0,1,0,1,8121
1,1,0,1,1,1,2,8121
2,2,0,4,1,5,6,8121
3,3,1,4,2,9,11,8121
4,4,0,6,2,15,17,8121
5,5,0,7,2,22,24,8121
6,6,2,2,4,24,28,8121
7,7,6,2,10,26,36,8121
8,8,9,7,19,33,52,8121
9,9,9,7,28,40,68,8121
10,10,7,7,35,47,82,8121
11,11,3,4,38,51,89,8121
12,12,4,2,42,53,95,8121
13,13,2,1,44,54,98,8121
14,14,0,1,44,55,99,8121
15,15,0,0,44,55,99,8121
0,0,1,0,1,0,1,8122
1,1,0,1,1,1,2,8122
2,2,0,3,1,4,5,8122
3,3,0,2,1,6,7,8122
4,4,0,1,1,7,8,8122
5,5,0,2,1,9,10,8122
6,6,0,0,1,9,10,8122
0,0,1,0,1,0,1,8123
1,1,2,0,3,0,3,8123
2,2,1,0,4,0,4,8123
3,3,1,0,5,0,5,8123
4,4,1,0,6,0,6,8123
5,5,0,0,6,0,6,8123
0,0,1,0,1,0,1,8124
1,1,1,0,2,0,2,8124
2,2,1,1,3,1,4,8124
3,3,2,3,5,4,9,8124
4,4,1,3,6,7,13,8124
5,5,1,2,7,9,16,8124
6,6,1,1,8,10,18,8124
7,7,4,1,12,11,23,8124
8,8,5,1,17,12,29,8124
9,9,5,0,22,12,34,8124
10,10,2,1,24,13,37,8124
11,11,1,1,25,14,39,8124
12,12,0,1,25,15,40,8124
13,13,0,0,25,15,40,8124
0,0,1,0,1,0,1,8125
1,1,0,0,1,0,1,8125
0,0,1,0,1,0,1,8126
1,1,3,1,4,1,5,8126
2,2,3,2,7,3,10,8126
3,3,4,1,11,4,15,8126
4,4,2,3,13,7,20,8126
5,5,0,4,13,11,24,8126
6,6,0,2,13,13,26,8126
7,7,0,2,13,15,28,8126
8,8,0,1,13,16,29,8126
9,9,1,0,14,16,30,8126
10,10,1,0,15,16,31,8126
11,11,0,0,15,16,31,8126
0,0,1,0,1,0,1,8127
1,1,2,1,3,1,4,8127
2,2,2,1,5,2,7,8127
3,3,1,0,6,2,8,8127
4,4,0,0,6,2,8,8127
0,0,1,0,1,0,1,8128
1,1,3,0,4,0,4,8128
2,2,1,0,5,0,5,8128
3,3,1,0,6,0,6,8128
4,4,1,1,7,1,8,8128
5,5,2,3,9,4,13,8128
6,6,2,3,11,7,18,8128
7,7,1,4,12,11,23,8128
8,8,0,6,12,17,29,8128
9,9,3,7,15,24,39,8128
10,10,3,1,18,25,43,8128
11,11,1,0,19,25,44,8128
12,12,0,0,19,25,44,8128
0,0,1,0,1,0,1,8129
1,1,0,1,1,1,2,8129
2,2,1,1,2,2,4,8129
3,3,0,1,2,3,5,8129
4,4,0,0,2,3,5,8129
0,0,1,0,1,0,1,8130
1,1,1,0,2,0,2,8130
2,2,0,0,2,0,2,8130
0,0,1,0,1,0,1,8131
1,1,2,0,3,0,3,8131
2,2,2,0,5,0,5,8131
3,3,1,0,6,0,6,8131
4,4,0,0,6,0,6,8131
0,0,1,0,1,0,1,8132
1,1,2,0,3,0,3,8132
2,2,3,1,6,1,7,8132
3,3,3,1,9,2,11,8132
4,4,2,0,11,2,13,8132
5,5,2,0,13,2,15,8132
6,6,2,3,15,5,20,8132
7,7,6,1,21,6,27,8132
8,8,8,0,29,6,35,8132
9,9,5,1,34,7,41,8132
10,10,2,1,36,8,44,8132
11,11,1,2,37,10,47,8132
12,12,2,1,39,11,50,8132
13,13,1,1,40,12,52,8132
14,14,1,1,41,13,54,8132
15,15,0,0,41,13,54,8132
0,0,1,0,1,0,1,8133
1,1,0,1,1,1,2,8133
2,2,0,0,1,1,2,8133
0,0,1,0,1,0,1,8134
1,1,0,0,1,0,1,8134
0,0,1,0,1,0,1,8135
1,1,3,0,4,0,4,8135
2,2,0,0,4,0,4,8135
0,0,1,0,1,0,1,8136
1,1,0,1,1,1,2,8136
2,2,0,1,1,2,3,8136
3,3,0,1,1,3,4,8136
4,4,0,1,1,4,5,8136
5,5,0,0,1,4,5,8136
0,0,1,0,1,0,1,8137
1,1,0,0,1,0,1,8137
0,0,1,0,1,0,1,8138
1,1,1,0,2,0,2,8138
2,2,2,0,4,0,4,8138
3,3,1,1,5,1,6,8138
4,4,0,2,5,3,8,8138
5,5,0,2,5,5,10,8138
6,6,1,1,6,6,12,8138
7,7,0,0,6,6,12,8138
0,0,1,0,1,0,1,8139
1,1,0,0,1,0,1,8139
0,0,1,0,1,0,1,8140
1,1,0,0,1,0,1,8140
0,0,1,0,1,0,1,8141
1,1,0,0,1,0,1,8141
0,0,1,0,1,0,1,8142
1,1,3,0,4,0,4,8142
2,2,4,1,8,1,9,8142
3,3,1,2,9,3,12,8142
4,4,1,3,10,6,16,8142
5,5,1,1,11,7,18,8142
6,6,1,2,12,9,21,8142
7,7,1,2,13,11,24,8142
8,8,2,0,15,11,26,8142
9,9,0,1,15,12,27,8142
10,10,0,0,15,12,27,8142
0,0,1,0,1,0,1,8143
1,1,3,0,4,0,4,8143
2,2,1,0,5,0,5,8143
3,3,1,0,6,0,6,8143
4,4,1,0,7,0,7,8143
5,5,1,1,8,1,9,8143
6,6,1,0,9,1,10,8143
7,7,1,0,10,1,11,8143
8,8,2,0,12,1,13,8143
9,9,1,1,13,2,15,8143
10,10,1,0,14,2,16,8143
11,11,2,0,16,2,18,8143
12,12,2,1,18,3,21,8143
13,13,3,1,21,4,25,8143
14,14,3,2,24,6,30,8143
15,15,3,3,27,9,36,8143
16,16,1,5,28,14,42,8143
17,17,2,7,30,21,51,8143
18,18,2,5,32,26,58,8143
19,19,4,5,36,31,67,8143
20,20,2,1,38,32,70,8143
21,21,0,2,38,34,72,8143
22,22,0,3,38,37,75,8143
23,23,2,4,40,41,81,8143
24,24,1,3,41,44,85,8143
25,25,3,1,44,45,89,8143
26,26,2,2,46,47,93,8143
27,27,3,0,49,47,96,8143
28,28,3,1,52,48,100,8143
29,29,3,1,55,49,104,8143
30,30,2,0,57,49,106,8143
31,31,2,0,59,49,108,8143
32,32,0,0,59,49,108,8143
0,0,1,0,1,0,1,8144
1,1,0,0,1,0,1,8144
0,0,1,0,1,0,1,8145
1,1,2,0,3,0,3,8145
2,2,1,0,4,0,4,8145
3,3,0,1,4,1,5,8145
4,4,0,3,4,4,8,8145
5,5,3,5,7,9,16,8145
6,6,2,1,9,10,19,8145
7,7,0,2,9,12,21,8145
8,8,1,5,10,17,27,8145
9,9,4,1,14,18,32,8145
10,10,1,2,15,20,35,8145
11,11,4,0,19,20,39,8145
12,12,5,1,24,21,45,8145
13,13,3,3,27,24,51,8145
14,14,2,2,29,26,55,8145
15,15,1,4,30,30,60,8145
16,16,1,1,31,31,62,8145
17,17,0,1,31,32,63,8145
18,18,0,1,31,33,64,8145
19,19,0,0,31,33,64,8145
0,0,1,0,1,0,1,8146
1,1,0,0,1,0,1,8146
0,0,1,0,1,0,1,8147
1,1,0,0,1,0,1,8147
0,0,1,0,1,0,1,8148
1,1,1,0,2,0,2,8148
2,2,1,1,3,1,4,8148
3,3,0,1,3,2,5,8148
4,4,1,0,4,2,6,8148
5,5,0,0,4,2,6,8148
0,0,1,0,1,0,1,8149
1,1,2,0,3,0,3,8149
2,2,2,0,5,0,5,8149
3,3,2,1,7,1,8,8149
4,4,1,0,8,1,9,8149
5,5,0,0,8,1,9,8149
0,0,1,0,1,0,1,8150
1,1,0,0,1,0,1,8150
0,0,1,0,1,0,1,8151
1,1,0,0,1,0,1,8151
0,0,1,0,1,0,1,8152
1,1,0,0,1,0,1,8152
0,0,1,0,1,0,1,8153
1,1,1,0,2,0,2,8153
2,2,1,0,3,0,3,8153
3,3,1,0,4,0,4,8153
4,4,1,1,5,1,6,8153
5,5,3,1,8,2,10,8153
6,6,1,2,9,4,13,8153
7,7,0,3,9,7,16,8153
8,8,0,0,9,7,16,8153
0,0,1,0,1,0,1,8154
1,1,0,1,1,1,2,8154
2,2,0,1,1,2,3,8154
3,3,2,1,3,3,6,8154
4,4,1,0,4,3,7,8154
5,5,0,0,4,3,7,8154
0,0,1,0,1,0,1,8155
1,1,4,0,5,0,5,8155
2,2,7,0,12,0,12,8155
3,3,4,1,16,1,17,8155
4,4,1,0,17,1,18,8155
5,5,0,0,17,1,18,8155
0,0,1,0,1,0,1,8156
1,1,1,0,2,0,2,8156
2,2,0,0,2,0,2,8156
0,0,1,0,1,0,1,8157
1,1,2,0,3,0,3,8157
2,2,1,0,4,0,4,8157
3,3,0,0,4,0,4,8157
0,0,1,0,1,0,1,8158
1,1,1,0,2,0,2,8158
2,2,1,0,3,0,3,8158
3,3,2,1,5,1,6,8158
4,4,1,1,6,2,8,8158
5,5,1,2,7,4,11,8158
6,6,1,2,8,6,14,8158
7,7,1,0,9,6,15,8158
8,8,1,0,10,6,16,8158
9,9,1,0,11,6,17,8158
10,10,1,0,12,6,18,8158
11,11,0,0,12,6,18,8158
0,0,1,0,1,0,1,8159
1,1,0,0,1,0,1,8159
0,0,1,0,1,0,1,8160
1,1,0,0,1,0,1,8160
0,0,1,0,1,0,1,8161
1,1,0,1,1,1,2,8161
2,2,0,3,1,4,5,8161
3,3,0,0,1,4,5,8161
0,0,1,0,1,0,1,8162
1,1,1,0,2,0,2,8162
2,2,1,0,3,0,3,8162
3,3,2,0,5,0,5,8162
4,4,3,0,8,0,8,8162
5,5,1,0,9,0,9,8162
6,6,1,0,10,0,10,8162
7,7,0,1,10,1,11,8162
8,8,0,0,10,1,11,8162
0,0,1,0,1,0,1,8163
1,1,2,0,3,0,3,8163
2,2,2,2,5,2,7,8163
3,3,1,2,6,4,10,8163
4,4,0,1,6,5,11,8163
5,5,1,1,7,6,13,8163
6,6,3,0,10,6,16,8163
7,7,3,1,13,7,20,8163
8,8,3,2,16,9,25,8163
9,9,1,4,17,13,30,8163
10,10,1,6,18,19,37,8163
11,11,1,3,19,22,41,8163
12,12,0,4,19,26,45,8163
13,13,0,5,19,31,50,8163
14,14,0,1,19,32,51,8163
15,15,1,0,20,32,52,8163
16,16,0,0,20,32,52,8163
0,0,1,0,1,0,1,8164
1,1,0,0,1,0,1,8164
0,0,1,0,1,0,1,8165
1,1,0,0,1,0,1,8165
0,0,1,0,1,0,1,8166
1,1,1,0,2,0,2,8166
2,2,1,1,3,1,4,8166
3,3,1,2,4,3,7,8166
4,4,1,1,5,4,9,8166
5,5,1,1,6,5,11,8166
6,6,0,0,6,5,11,8166
0,0,1,0,1,0,1,8167
1,1,2,0,3,0,3,8167
2,2,1,0,4,0,4,8167
3,3,1,0,5,0,5,8167
4,4,0,1,5,1,6,8167
5,5,0,1,5,2,7,8167
6,6,0,2,5,4,9,8167
7,7,0,0,5,4,9,8167
0,0,1,0,1,0,1,8168
1,1,2,1,3,1,4,8168
2,2,0,0,3,1,4,8168
0,0,1,0,1,0,1,8169
1,1,1,0,2,0,2,8169
2,2,1,0,3,0,3,8169
3,3,1,0,4,0,4,8169
4,4,3,0,7,0,7,8169
5,5,3,1,10,1,11,8169
6,6,2,2,12,3,15,8169
7,7,2,0,14,3,17,8169
8,8,1,1,15,4,19,8169
9,9,0,2,15,6,21,8169
10,10,1,0,16,6,22,8169
11,11,2,0,18,6,24,8169
12,12,0,2,18,8,26,8169
13,13,2,2,20,10,30,8169
14,14,1,2,21,12,33,8169
15,15,2,1,23,13,36,8169
16,16,1,3,24,16,40,8169
17,17,3,1,27,17,44,8169
18,18,2,1,29,18,47,8169
19,19,0,3,29,21,50,8169
20,20,0,7,29,28,57,8169
21,21,3,8,32,36,68,8169
22,22,4,7,36,43,79,8169
23,23,8,3,44,46,90,8169
24,24,8,3,52,49,101,8169
25,25,2,4,54,53,107,8169
26,26,1,6,55,59,114,8169
27,27,2,4,57,63,120,8169
28,28,1,0,58,63,121,8169
29,29,1,0,59,63,122,8169
30,30,1,0,60,63,123,8169
31,31,1,1,61,64,125,8169
32,32,1,1,62,65,127,8169
33,33,1,2,63,67,130,8169
34,34,1,2,64,69,133,8169
35,35,1,1,65,70,135,8169
36,36,1,2,66,72,138,8169
37,37,0,0,66,72,138,8169
0,0,1,0,1,0,1,8170
1,1,1,0,2,0,2,8170
2,2,0,0,2,0,2,8170
0,0,1,0,1,0,1,8171
1,1,3,0,4,0,4,8171
2,2,0,0,4,0,4,8171
0,0,1,0,1,0,1,8172
1,1,0,0,1,0,1,8172
0,0,1,0,1,0,1,8173
1,1,1,0,2,0,2,8173
2,2,3,0,5,0,5,8173
3,3,3,0,8,0,8,8173
4,4,1,0,9,0,9,8173
5,5,1,0,10,0,10,8173
6,6,0,0,10,0,10,8173
0,0,1,0,1,0,1,8174
1,1,1,0,2,0,2,8174
2,2,0,0,2,0,2,8174
0,0,1,0,1,0,1,8175
1,1,3,0,4,0,4,8175
2,2,3,0,7,0,7,8175
3,3,3,0,10,0,10,8175
4,4,0,0,10,0,10,8175
0,0,1,0,1,0,1,8176
1,1,0,0,1,0,1,8176
0,0,1,0,1,0,1,8177
1,1,1,2,2,2,4,8177
2,2,0,4,2,6,8,8177
3,3,2,1,4,7,11,8177
4,4,2,0,6,7,13,8177
5,5,2,0,8,7,15,8177
6,6,4,0,12,7,19,8177
7,7,3,1,15,8,23,8177
8,8,5,1,20,9,29,8177
9,9,3,2,23,11,34,8177
10,10,2,1,25,12,37,8177
11,11,2,0,27,12,39,8177
12,12,1,0,28,12,40,8177
13,13,0,0,28,12,40,8177
0,0,1,0,1,0,1,8178
1,1,1,0,2,0,2,8178
2,2,0,0,2,0,2,8178
0,0,1,0,1,0,1,8179
1,1,0,0,1,0,1,8179
0,0,1,0,1,0,1,8180
1,1,1,0,2,0,2,8180
2,2,2,0,4,0,4,8180
3,3,2,0,6,0,6,8180
4,4,1,0,7,0,7,8180
5,5,1,1,8,1,9,8180
6,6,2,1,10,2,12,8180
7,7,1,1,11,3,14,8180
8,8,1,1,12,4,16,8180
9,9,1,1,13,5,18,8180
10,10,1,2,14,7,21,8180
11,11,1,0,15,7,22,8180
12,12,1,0,16,7,23,8180
13,13,0,0,16,7,23,8180
0,0,1,0,1,0,1,8181
1,1,0,0,1,0,1,8181
0,0,1,0,1,0,1,8182
1,1,0,1,1,1,2,8182
2,2,0,1,1,2,3,8182
3,3,0,0,1,2,3,8182
0,0,1,0,1,0,1,8183
1,1,2,0,3,0,3,8183
2,2,1,0,4,0,4,8183
3,3,0,0,4,0,4,8183
0,0,1,0,1,0,1,8184
1,1,0,0,1,0,1,8184
0,0,1,0,1,0,1,8185
1,1,1,0,2,0,2,8185
2,2,1,0,3,0,3,8185
3,3,1,0,4,0,4,8185
4,4,0,0,4,0,4,8185
0,0,1,0,1,0,1,8186
1,1,0,0,1,0,1,8186
0,0,1,0,1,0,1,8187
1,1,2,0,3,0,3,8187
2,2,3,0,6,0,6,8187
3,3,2,4,8,4,12,8187
4,4,3,3,11,7,18,8187
5,5,2,3,13,10,23,8187
6,6,2,5,15,15,30,8187
7,7,7,5,22,20,42,8187
8,8,4,7,26,27,53,8187
9,9,5,5,31,32,63,8187
10,10,2,3,33,35,68,8187
11,11,4,2,37,37,74,8187
12,12,4,4,41,41,82,8187
13,13,1,3,42,44,86,8187
14,14,1,1,43,45,88,8187
15,15,2,0,45,45,90,8187
16,16,2,1,47,46,93,8187
17,17,3,0,50,46,96,8187
18,18,3,1,53,47,100,8187
19,19,2,0,55,47,102,8187
20,20,1,0,56,47,103,8187
21,21,0,0,56,47,103,8187
0,0,1,0,1,0,1,8188
1,1,0,1,1,1,2,8188
2,2,0,0,1,1,2,8188
0,0,1,0,1,0,1,8189
1,1,1,0,2,0,2,8189
2,2,0,0,2,0,2,8189
0,0,1,0,1,0,1,8190
1,1,1,0,2,0,2,8190
2,2,1,0,3,0,3,8190
3,3,1,1,4,1,5,8190
4,4,1,1,5,2,7,8190
5,5,2,4,7,6,13,8190
6,6,2,7,9,13,22,8190
7,7,5,7,14,20,34,8190
8,8,7,5,21,25,46,8190
9,9,12,10,33,35,68,8190
10,10,5,7,38,42,80,8190
11,11,4,7,42,49,91,8190
12,12,3,3,45,52,97,8190
13,13,2,4,47,56,103,8190
14,14,2,4,49,60,109,8190
15,15,1,5,50,65,115,8190
16,16,2,5,52,70,122,8190
17,17,2,6,54,76,130,8190
18,18,2,2,56,78,134,8190
19,19,1,0,57,78,135,8190
20,20,0,0,57,78,135,8190
0,0,1,0,1,0,1,8191
1,1,0,0,1,0,1,8191
0,0,1,0,1,0,1,8192
1,1,1,0,2,0,2,8192
2,2,1,0,3,0,3,8192
3,3,0,0,3,0,3,8192
0,0,1,0,1,0,1,8193
1,1,0,0,1,0,1,8193
0,0,1,0,1,0,1,8194
1,1,1,0,2,0,2,8194
2,2,1,1,3,1,4,8194
3,3,1,0,4,1,5,8194
4,4,0,0,4,1,5,8194
0,0,1,0,1,0,1,8195
1,1,0,0,1,0,1,8195
0,0,1,0,1,0,1,8196
1,1,0,0,1,0,1,8196
0,0,1,0,1,0,1,8197
1,1,1,0,2,0,2,8197
2,2,0,0,2,0,2,8197
0,0,1,0,1,0,1,8198
1,1,1,0,2,0,2,8198
2,2,0,1,2,1,3,8198
3,3,0,2,2,3,5,8198
4,4,0,1,2,4,6,8198
5,5,0,0,2,4,6,8198
0,0,1,0,1,0,1,8199
1,1,0,0,1,0,1,8199
0,0,1,0,1,0,1,8200
1,1,0,0,1,0,1,8200
0,0,1,0,1,0,1,8201
1,1,0,0,1,0,1,8201
0,0,1,0,1,0,1,8202
1,1,1,1,2,1,3,8202
2,2,4,2,6,3,9,8202
3,3,1,2,7,5,12,8202
4,4,0,1,7,6,13,8202
5,5,0,0,7,6,13,8202
0,0,1,0,1,0,1,8203
1,1,0,0,1,0,1,8203
0,0,1,0,1,0,1,8204
1,1,1,1,2,1,3,8204
2,2,1,0,3,1,4,8204
3,3,0,0,3,1,4,8204
0,0,1,0,1,0,1,8205
1,1,0,0,1,0,1,8205
0,0,1,0,1,0,1,8206
1,1,1,1,2,1,3,8206
2,2,1,2,3,3,6,8206
3,3,1,1,4,4,8,8206
4,4,3,0,7,4,11,8206
5,5,4,1,11,5,16,8206
6,6,2,1,13,6,19,8206
7,7,1,2,14,8,22,8206
8,8,2,1,16,9,25,8206
9,9,1,4,17,13,30,8206
10,10,0,1,17,14,31,8206
11,11,0,1,17,15,32,8206
12,12,0,1,17,16,33,8206
13,13,1,2,18,18,36,8206
14,14,0,1,18,19,37,8206
15,15,0,2,18,21,39,8206
16,16,1,2,19,23,42,8206
17,17,1,1,20,24,44,8206
18,18,1,1,21,25,46,8206
19,19,0,4,21,29,50,8206
20,20,0,3,21,32,53,8206
21,21,0,2,21,34,55,8206
22,22,0,1,21,35,56,8206
23,23,0,0,21,35,56,8206
0,0,1,0,1,0,1,8207
1,1,0,0,1,0,1,8207
0,0,1,0,1,0,1,8208
1,1,1,0,2,0,2,8208
2,2,0,0,2,0,2,8208
0,0,1,0,1,0,1,8209
1,1,1,0,2,0,2,8209
2,2,1,0,3,0,3,8209
3,3,0,0,3,0,3,8209
0,0,1,0,1,0,1,8210
1,1,2,0,3,0,3,8210
2,2,0,0,3,0,3,8210
0,0,1,0,1,0,1,8211
1,1,0,0,1,0,1,8211
0,0,1,0,1,0,1,8212
1,1,0,0,1,0,1,8212
0,0,1,0,1,0,1,8213
1,1,2,0,3,0,3,8213
2,2,1,0,4,0,4,8213
3,3,0,0,4,0,4,8213
0,0,1,0,1,0,1,8214
1,1,1,0,2,0,2,8214
2,2,2,0,4,0,4,8214
3,3,2,1,6,1,7,8214
4,4,2,2,8,3,11,8214
5,5,3,1,11,4,15,8214
6,6,1,0,12,4,16,8214
7,7,0,0,12,4,16,8214
0,0,1,0,1,0,1,8215
1,1,1,0,2,0,2,8215
2,2,1,0,3,0,3,8215
3,3,3,0,6,0,6,8215
4,4,3,0,9,0,9,8215
5,5,1,2,10,2,12,8215
6,6,0,2,10,4,14,8215
7,7,0,1,10,5,15,8215
8,8,1,0,11,5,16,8215
9,9,1,0,12,5,17,8215
10,10,1,0,13,5,18,8215
11,11,0,0,13,5,18,8215
0,0,1,0,1,0,1,8216
1,1,3,0,4,0,4,8216
2,2,0,0,4,0,4,8216
0,0,1,0,1,0,1,8217
1,1,0,0,1,0,1,8217
0,0,1,0,1,0,1,8218
1,1,0,0,1,0,1,8218
0,0,1,0,1,0,1,8219
1,1,0,0,1,0,1,8219
0,0,1,0,1,0,1,8220
1,1,0,0,1,0,1,8220
0,0,1,0,1,0,1,8221
1,1,0,1,1,1,2,8221
2,2,0,0,1,1,2,8221
0,0,1,0,1,0,1,8222
1,1,3,0,4,0,4,8222
2,2,0,0,4,0,4,8222
0,0,1,0,1,0,1,8223
1,1,2,0,3,0,3,8223
2,2,2,0,5,0,5,8223
3,3,1,1,6,1,7,8223
4,4,0,0,6,1,7,8223
0,0,1,0,1,0,1,8224
1,1,0,0,1,0,1,8224
0,0,1,0,1,0,1,8225
1,1,1,0,2,0,2,8225
2,2,2,0,4,0,4,8225
3,3,1,0,5,0,5,8225
4,4,1,1,6,1,7,8225
5,5,2,2,8,3,11,8225
6,6,3,4,11,7,18,8225
7,7,4,5,15,12,27,8225
8,8,5,4,20,16,36,8225
9,9,2,5,22,21,43,8225
10,10,1,3,23,24,47,8225
11,11,1,3,24,27,51,8225
12,12,2,5,26,32,58,8225
13,13,3,7,29,39,68,8225
14,14,5,7,34,46,80,8225
15,15,4,5,38,51,89,8225
16,16,6,2,44,53,97,8225
17,17,1,1,45,54,99,8225
18,18,2,0,47,54,101,8225
19,19,1,0,48,54,102,8225
20,20,2,0,50,54,104,8225
21,21,0,0,50,54,104,8225
0,0,1,0,1,0,1,8226
1,1,0,0,1,0,1,8226
0,0,1,0,1,0,1,8227
1,1,1,0,2,0,2,8227
2,2,0,0,2,0,2,8227
0,0,1,0,1,0,1,8228
1,1,0,0,1,0,1,8228
0,0,1,0,1,0,1,8229
1,1,0,0,1,0,1,8229
0,0,1,0,1,0,1,8230
1,1,0,0,1,0,1,8230
0,0,1,0,1,0,1,8231
1,1,1,1,2,1,3,8231
2,2,1,0,3,1,4,8231
3,3,1,0,4,1,5,8231
4,4,1,0,5,1,6,8231
5,5,1,0,6,1,7,8231
6,6,1,0,7,1,8,8231
7,7,0,0,7,1,8,8231
0,0,1,0,1,0,1,8232
1,1,1,0,2,0,2,8232
2,2,0,0,2,0,2,8232
0,0,1,0,1,0,1,8233
1,1,1,0,2,0,2,8233
2,2,1,0,3,0,3,8233
3,3,0,0,3,0,3,8233
0,0,1,0,1,0,1,8234
1,1,2,0,3,0,3,8234
2,2,0,1,3,1,4,8234
3,3,0,2,3,3,6,8234
4,4,0,4,3,7,10,8234
5,5,1,1,4,8,12,8234
6,6,2,1,6,9,15,8234
7,7,4,2,10,11,21,8234
8,8,3,2,13,13,26,8234
9,9,4,1,17,14,31,8234
10,10,5,4,22,18,40,8234
11,11,4,2,26,20,46,8234
12,12,3,2,29,22,51,8234
13,13,6,0,35,22,57,8234
14,14,6,0,41,22,63,8234
15,15,8,0,49,22,71,8234
16,16,3,3,52,25,77,8234
17,17,2,2,54,27,81,8234
18,18,5,1,59,28,87,8234
19,19,5,3,64,31,95,8234
20,20,1,2,65,33,98,8234
21,21,1,3,66,36,102,8234
22,22,2,3,68,39,107,8234
23,23,3,3,71,42,113,8234
24,24,4,2,75,44,119,8234
25,25,3,1,78,45,123,8234
26,26,1,2,79,47,126,8234
27,27,1,0,80,47,127,8234
28,28,0,0,80,47,127,8234
0,0,1,0,1,0,1,8235
1,1,1,0,2,0,2,8235
2,2,0,0,2,0,2,8235
0,0,1,0,1,0,1,8236
1,1,0,0,1,0,1,8236
0,0,1,0,1,0,1,8237
1,1,0,0,1,0,1,8237
0,0,1,0,1,0,1,8238
1,1,0,0,1,0,1,8238
0,0,1,0,1,0,1,8239
1,1,1,1,2,1,3,8239
2,2,0,1,2,2,4,8239
3,3,0,2,2,4,6,8239
4,4,1,1,3,5,8,8239
5,5,1,0,4,5,9,8239
6,6,1,0,5,5,10,8239
7,7,1,0,6,5,11,8239
8,8,0,0,6,5,11,8239
0,0,1,0,1,0,1,8240
1,1,1,0,2,0,2,8240
2,2,2,0,4,0,4,8240
3,3,1,1,5,1,6,8240
4,4,1,0,6,1,7,8240
5,5,1,0,7,1,8,8240
6,6,1,0,8,1,9,8240
7,7,0,1,8,2,10,8240
8,8,0,2,8,4,12,8240
9,9,1,3,9,7,16,8240
10,10,3,2,12,9,21,8240
11,11,2,3,14,12,26,8240
12,12,0,2,14,14,28,8240
13,13,0,2,14,16,30,8240
14,14,2,1,16,17,33,8240
15,15,2,0,18,17,35,8240
16,16,1,0,19,17,36,8240
17,17,0,1,19,18,37,8240
18,18,1,1,20,19,39,8240
19,19,1,1,21,20,41,8240
20,20,1,1,22,21,43,8240
21,21,1,2,23,23,46,8240
22,22,1,2,24,25,49,8240
23,23,0,1,24,26,50,8240
24,24,1,0,25,26,51,8240
25,25,0,0,25,26,51,8240
0,0,1,0,1,0,1,8241
1,1,1,0,2,0,2,8241
2,2,0,0,2,0,2,8241
0,0,1,0,1,0,1,8242
1,1,0,0,1,0,1,8242
0,0,1,0,1,0,1,8243
1,1,3,1,4,1,5,8243
2,2,2,3,6,4,10,8243
3,3,4,3,10,7,17,8243
4,4,2,1,12,8,20,8243
5,5,3,0,15,8,23,8243
6,6,0,1,15,9,24,8243
7,7,0,0,15,9,24,8243
0,0,1,0,1,0,1,8244
1,1,1,0,2,0,2,8244
2,2,0,1,2,1,3,8244
3,3,0,1,2,2,4,8244
4,4,1,1,3,3,6,8244
5,5,0,2,3,5,8,8244
6,6,0,0,3,5,8,8244
0,0,1,0,1,0,1,8245
1,1,0,0,1,0,1,8245
0,0,1,0,1,0,1,8246
1,1,1,0,2,0,2,8246
2,2,3,0,5,0,5,8246
3,3,3,1,8,1,9,8246
4,4,3,0,11,1,12,8246
5,5,1,0,12,1,13,8246
6,6,0,0,12,1,13,8246
0,0,1,0,1,0,1,8247
1,1,0,0,1,0,1,8247
0,0,1,0,1,0,1,8248
1,1,2,0,3,0,3,8248
2,2,1,0,4,0,4,8248
3,3,2,0,6,0,6,8248
4,4,2,1,8,1,9,8248
5,5,1,0,9,1,10,8248
6,6,0,0,9,1,10,8248
0,0,1,0,1,0,1,8249
1,1,0,0,1,0,1,8249
0,0,1,0,1,0,1,8250
1,1,0,0,1,0,1,8250
0,0,1,0,1,0,1,8251
1,1,1,0,2,0,2,8251
2,2,1,0,3,0,3,8251
3,3,0,0,3,0,3,8251
0,0,1,0,1,0,1,8252
1,1,0,0,1,0,1,8252
0,0,1,0,1,0,1,8253
1,1,1,2,2,2,4,8253
2,2,1,2,3,4,7,8253
3,3,0,0,3,4,7,8253
0,0,1,0,1,0,1,8254
1,1,1,0,2,0,2,8254
2,2,0,1,2,1,3,8254
3,3,0,1,2,2,4,8254
4,4,0,0,2,2,4,8254
0,0,1,0,1,0,1,8255
1,1,2,0,3,0,3,8255
2,2,0,0,3,0,3,8255
0,0,1,0,1,0,1,8256
1,1,0,0,1,0,1,8256
0,0,1,0,1,0,1,8257
1,1,2,0,3,0,3,8257
2,2,0,2,3,2,5,8257
3,3,0,0,3,2,5,8257
0,0,1,0,1,0,1,8258
1,1,2,0,3,0,3,8258
2,2,3,0,6,0,6,8258
3,3,0,0,6,0,6,8258
0,0,1,0,1,0,1,8259
1,1,1,1,2,1,3,8259
2,2,1,1,3,2,5,8259
3,3,1,3,4,5,9,8259
4,4,1,2,5,7,12,8259
5,5,0,2,5,9,14,8259
6,6,0,0,5,9,14,8259
0,0,1,0,1,0,1,8260
1,1,3,0,4,0,4,8260
2,2,2,0,6,0,6,8260
3,3,0,1,6,1,7,8260
4,4,1,0,7,1,8,8260
5,5,2,0,9,1,10,8260
6,6,0,0,9,1,10,8260
0,0,1,0,1,0,1,8261
1,1,1,1,2,1,3,8261
2,2,0,0,2,1,3,8261
0,0,1,0,1,0,1,8262
1,1,0,0,1,0,1,8262
0,0,1,0,1,0,1,8263
1,1,0,0,1,0,1,8263
0,0,1,0,1,0,1,8264
1,1,1,1,2,1,3,8264
2,2,1,2,3,3,6,8264
3,3,1,0,4,3,7,8264
4,4,0,0,4,3,7,8264
0,0,1,0,1,0,1,8265
1,1,0,0,1,0,1,8265
0,0,1,0,1,0,1,8266
1,1,0,0,1,0,1,8266
0,0,1,0,1,0,1,8267
1,1,1,0,2,0,2,8267
2,2,0,0,2,0,2,8267
0,0,1,0,1,0,1,8268
1,1,2,0,3,0,3,8268
2,2,1,1,4,1,5,8268
3,3,0,3,4,4,8,8268
4,4,0,2,4,6,10,8268
5,5,1,2,5,8,13,8268
6,6,0,2,5,10,15,8268
7,7,0,3,5,13,18,8268
8,8,0,4,5,17,22,8268
9,9,2,1,7,18,25,8268
10,10,4,3,11,21,32,8268
11,11,3,3,14,24,38,8268
12,12,2,5,16,29,45,8268
13,13,7,2,23,31,54,8268
14,14,5,2,28,33,61,8268
15,15,5,4,33,37,70,8268
16,16,6,3,39,40,79,8268
17,17,5,5,44,45,89,8268
18,18,5,2,49,47,96,8268
19,19,6,1,55,48,103,8268
20,20,3,1,58,49,107,8268
21,21,4,1,62,50,112,8268
22,22,2,1,64,51,115,8268
23,23,1,1,65,52,117,8268
24,24,2,1,67,53,120,8268
25,25,2,1,69,54,123,8268
26,26,1,1,70,55,125,8268
27,27,2,2,72,57,129,8268
28,28,2,1,74,58,132,8268
29,29,2,0,76,58,134,8268
30,30,0,0,76,58,134,8268
0,0,1,0,1,0,1,8269
1,1,1,0,2,0,2,8269
2,2,2,1,4,1,5,8269
3,3,1,0,5,1,6,8269
4,4,1,0,6,1,7,8269
5,5,1,1,7,2,9,8269
6,6,1,0,8,2,10,8269
7,7,0,0,8,2,10,8269
0,0,1,0,1,0,1,8270
1,1,0,0,1,0,1,8270
0,0,1,0,1,0,1,8271
1,1,1,0,2,0,2,8271
2,2,0,1,2,1,3,8271
3,3,0,1,2,2,4,8271
4,4,0,0,2,2,4,8271
0,0,1,0,1,0,1,8272
1,1,0,1,1,1,2,8272
2,2,1,1,2,2,4,8272
3,3,0,1,2,3,5,8272
4,4,0,1,2,4,6,8272
5,5,0,5,2,9,11,8272
6,6,1,2,3,11,14,8272
7,7,1,0,4,11,15,8272
8,8,0,1,4,12,16,8272
9,9,0,2,4,14,18,8272
10,10,0,0,4,14,18,8272
0,0,1,0,1,0,1,8273
1,1,0,0,1,0,1,8273
0,0,1,0,1,0,1,8274
1,1,1,0,2,0,2,8274
2,2,0,1,2,1,3,8274
3,3,0,1,2,2,4,8274
4,4,0,0,2,2,4,8274
0,0,1,0,1,0,1,8275
1,1,1,0,2,0,2,8275
2,2,0,0,2,0,2,8275
0,0,1,0,1,0,1,8276
1,1,0,0,1,0,1,8276
0,0,1,0,1,0,1,8277
1,1,0,0,1,0,1,8277
0,0,1,0,1,0,1,8278
1,1,1,1,2,1,3,8278
2,2,0,1,2,2,4,8278
3,3,0,1,2,3,5,8278
4,4,1,0,3,3,6,8278
5,5,0,0,3,3,6,8278
0,0,1,0,1,0,1,8279
1,1,1,1,2,1,3,8279
2,2,0,0,2,1,3,8279
0,0,1,0,1,0,1,8280
1,1,0,0,1,0,1,8280
0,0,1,0,1,0,1,8281
1,1,1,1,2,1,3,8281
2,2,2,1,4,2,6,8281
3,3,1,0,5,2,7,8281
4,4,1,0,6,2,8,8281
5,5,0,0,6,2,8,8281
0,0,1,0,1,0,1,8282
1,1,0,0,1,0,1,8282
0,0,1,0,1,0,1,8283
1,1,3,1,4,1,5,8283
2,2,1,4,5,5,10,8283
3,3,1,5,6,10,16,8283
4,4,3,3,9,13,22,8283
5,5,6,1,15,14,29,8283
6,6,4,0,19,14,33,8283
7,7,1,2,20,16,36,8283
8,8,2,1,22,17,39,8283
9,9,4,2,26,19,45,8283
10,10,2,7,28,26,54,8283
11,11,4,4,32,30,62,8283
12,12,1,3,33,33,66,8283
13,13,0,2,33,35,68,8283
14,14,0,2,33,37,70,8283
15,15,0,1,33,38,71,8283
16,16,0,1,33,39,72,8283
17,17,0,2,33,41,74,8283
18,18,0,1,33,42,75,8283
19,19,2,1,35,43,78,8283
20,20,0,1,35,44,79,8283
21,21,1,0,36,44,80,8283
22,22,1,0,37,44,81,8283
23,23,0,1,37,45,82,8283
24,24,1,0,38,45,83,8283
25,25,1,0,39,45,84,8283
26,26,1,0,40,45,85,8283
27,27,0,0,40,45,85,8283
0,0,1,0,1,0,1,8284
1,1,1,1,2,1,3,8284
2,2,1,0,3,1,4,8284
3,3,0,1,3,2,5,8284
4,4,1,0,4,2,6,8284
5,5,1,0,5,2,7,8284
6,6,0,0,5,2,7,8284
0,0,1,0,1,0,1,8285
1,1,3,0,4,0,4,8285
2,2,1,2,5,2,7,8285
3,3,3,1,8,3,11,8285
4,4,0,0,8,3,11,8285
0,0,1,0,1,0,1,8286
1,1,0,0,1,0,1,8286
0,0,1,0,1,0,1,8287
1,1,0,0,1,0,1,8287
0,0,1,0,1,0,1,8288
1,1,1,0,2,0,2,8288
2,2,0,0,2,0,2,8288
0,0,1,0,1,0,1,8289
1,1,0,0,1,0,1,8289
0,0,1,0,1,0,1,8290
1,1,2,0,3,0,3,8290
2,2,1,0,4,0,4,8290
3,3,1,0,5,0,5,8290
4,4,0,0,5,0,5,8290
0,0,1,0,1,0,1,8291
1,1,0,1,1,1,2,8291
2,2,0,2,1,3,4,8291
3,3,0,2,1,5,6,8291
4,4,1,1,2,6,8,8291
5,5,0,0,2,6,8,8291
0,0,1,0,1,0,1,8292
1,1,1,0,2,0,2,8292
2,2,1,0,3,0,3,8292
3,3,1,1,4,1,5,8292
4,4,4,0,8,1,9,8292
5,5,4,0,12,1,13,8292
6,6,3,1,15,2,17,8292
7,7,2,1,17,3,20,8292
8,8,1,0,18,3,21,8292
9,9,0,0,18,3,21,8292
0,0,1,0,1,0,1,8293
1,1,2,0,3,0,3,8293
2,2,1,2,4,2,6,8293
3,3,0,0,4,2,6,8293
0,0,1,0,1,0,1,8294
1,1,1,0,2,0,2,8294
2,2,2,0,4,0,4,8294
3,3,1,0,5,0,5,8294
4,4,2,0,7,0,7,8294
5,5,1,0,8,0,8,8294
6,6,2,0,10,0,10,8294
7,7,2,1,12,1,13,8294
8,8,0,2,12,3,15,8294
9,9,0,1,12,4,16,8294
10,10,1,1,13,5,18,8294
11,11,1,0,14,5,19,8294
12,12,0,0,14,5,19,8294
0,0,1,0,1,0,1,8295
1,1,0,0,1,0,1,8295
0,0,1,0,1,0,1,8296
1,1,0,0,1,0,1,8296
0,0,1,0,1,0,1,8297
1,1,2,0,3,0,3,8297
2,2,0,0,3,0,3,8297
0,0,1,0,1,0,1,8298
1,1,0,0,1,0,1,8298
0,0,1,0,1,0,1,8299
1,1,1,0,2,0,2,8299
2,2,1,0,3,0,3,8299
3,3,0,0,3,0,3,8299
0,0,1,0,1,0,1,8300
1,1,0,0,1,0,1,8300
0,0,1,0,1,0,1,8301
1,1,2,1,3,1,4,8301
2,2,0,2,3,3,6,8301
3,3,1,3,4,6,10,8301
4,4,1,0,5,6,11,8301
5,5,1,0,6,6,12,8301
6,6,0,1,6,7,13,8301
7,7,0,2,6,9,15,8301
8,8,0,3,6,12,18,8301
9,9,0,2,6,14,20,8301
10,10,0,0,6,14,20,8301
0,0,1,0,1,0,1,8302
1,1,1,0,2,0,2,8302
2,2,1,0,3,0,3,8302
3,3,1,0,4,0,4,8302
4,4,0,0,4,0,4,8302
0,0,1,0,1,0,1,8303
1,1,1,0,2,0,2,8303
2,2,1,0,3,0,3,8303
3,3,0,1,3,1,4,8303
4,4,0,3,3,4,7,8303
5,5,1,0,4,4,8,8303
6,6,1,0,5,4,9,8303
7,7,1,0,6,4,10,8303
8,8,2,0,8,4,12,8303
9,9,0,0,8,4,12,8303
0,0,1,0,1,0,1,8304
1,1,0,0,1,0,1,8304
0,0,1,0,1,0,1,8305
1,1,1,1,2,1,3,8305
2,2,2,0,4,1,5,8305
3,3,1,0,5,1,6,8305
4,4,0,1,5,2,7,8305
5,5,0,1,5,3,8,8305
6,6,0,0,5,3,8,8305
0,0,1,0,1,0,1,8306
1,1,0,0,1,0,1,8306
0,0,1,0,1,0,1,8307
1,1,0,0,1,0,1,8307
0,0,1,0,1,0,1,8308
1,1,0,0,1,0,1,8308
0,0,1,0,1,0,1,8309
1,1,0,0,1,0,1,8309
0,0,1,0,1,0,1,8310
1,1,2,0,3,0,3,8310
2,2,0,2,3,2,5,8310
3,3,0,3,3,5,8,8310
4,4,0,1,3,6,9,8310
5,5,0,2,3,8,11,8310
6,6,1,1,4,9,13,8310
7,7,0,0,4,9,13,8310
0,0,1,0,1,0,1,8311
1,1,2,0,3,0,3,8311
2,2,2,0,5,0,5,8311
3,3,1,0,6,0,6,8311
4,4,0,0,6,0,6,8311
0,0,1,0,1,0,1,8312
1,1,1,0,2,0,2,8312
2,2,1,0,3,0,3,8312
3,3,0,0,3,0,3,8312
0,0,1,0,1,0,1,8313
1,1,1,1,2,1,3,8313
2,2,0,3,2,4,6,8313
3,3,1,1,3,5,8,8313
4,4,1,0,4,5,9,8313
5,5,1,0,5,5,10,8313
6,6,0,0,5,5,10,8313
0,0,1,0,1,0,1,8314
1,1,1,0,2,0,2,8314
2,2,1,0,3,0,3,8314
3,3,0,1,3,1,4,8314
4,4,2,0,5,1,6,8314
5,5,3,0,8,1,9,8314
6,6,1,0,9,1,10,8314
7,7,1,1,10,2,12,8314
8,8,1,0,11,2,13,8314
9,9,1,1,12,3,15,8314
10,10,3,1,15,4,19,8314
11,11,4,0,19,4,23,8314
12,12,3,1,22,5,27,8314
13,13,1,1,23,6,29,8314
14,14,0,2,23,8,31,8314
15,15,0,2,23,10,33,8314
16,16,0,0,23,10,33,8314
0,0,1,0,1,0,1,8315
1,1,2,0,3,0,3,8315
2,2,1,0,4,0,4,8315
3,3,1,0,5,0,5,8315
4,4,1,1,6,1,7,8315
5,5,1,0,7,1,8,8315
6,6,1,0,8,1,9,8315
7,7,1,0,9,1,10,8315
8,8,0,0,9,1,10,8315
0,0,1,0,1,0,1,8316
1,1,0,0,1,0,1,8316
0,0,1,0,1,0,1,8317
1,1,0,0,1,0,1,8317
0,0,1,0,1,0,1,8318
1,1,2,0,3,0,3,8318
2,2,2,1,5,1,6,8318
3,3,3,3,8,4,12,8318
4,4,1,3,9,7,16,8318
5,5,2,3,11,10,21,8318
6,6,0,3,11,13,24,8318
7,7,2,2,13,15,28,8318
8,8,1,1,14,16,30,8318
9,9,1,0,15,16,31,8318
10,10,2,0,17,16,33,8318
11,11,1,1,18,17,35,8318
12,12,3,0,21,17,38,8318
13,13,3,0,24,17,41,8318
14,14,1,1,25,18,43,8318
15,15,2,1,27,19,46,8318
16,16,1,1,28,20,48,8318
17,17,1,0,29,20,49,8318
18,18,0,0,29,20,49,8318
0,0,1,0,1,0,1,8319
1,1,1,0,2,0,2,8319
2,2,2,0,4,0,4,8319
3,3,1,0,5,0,5,8319
4,4,1,0,6,0,6,8319
5,5,0,0,6,0,6,8319
0,0,1,0,1,0,1,8320
1,1,0,0,1,0,1,8320
0,0,1,0,1,0,1,8321
1,1,0,0,1,0,1,8321
0,0,1,0,1,0,1,8322
1,1,0,0,1,0,1,8322
0,0,1,0,1,0,1,8323
1,1,0,2,1,2,3,8323
2,2,2,1,3,3,6,8323
3,3,0,1,3,4,7,8323
4,4,0,1,3,5,8,8323
5,5,0,2,3,7,10,8323
6,6,0,0,3,7,10,8323
0,0,1,0,1,0,1,8324
1,1,0,0,1,0,1,8324
0,0,1,0,1,0,1,8325
1,1,4,0,5,0,5,8325
2,2,3,1,8,1,9,8325
3,3,3,2,11,3,14,8325
4,4,3,3,14,6,20,8325
5,5,3,2,17,8,25,8325
6,6,4,4,21,12,33,8325
7,7,5,4,26,16,42,8325
8,8,3,8,29,24,53,8325
9,9,6,11,35,35,70,8325
10,10,7,10,42,45,87,8325
11,11,7,10,49,55,104,8325
12,12,4,8,53,63,116,8325
13,13,3,5,56,68,124,8325
14,14,3,5,59,73,132,8325
15,15,2,5,61,78,139,8325
16,16,2,6,63,84,147,8325
17,17,2,6,65,90,155,8325
18,18,0,2,65,92,157,8325
19,19,0,0,65,92,157,8325
0,0,1,0,1,0,1,8326
1,1,0,0,1,0,1,8326
0,0,1,0,1,0,1,8327
1,1,1,2,2,2,4,8327
2,2,1,0,3,2,5,8327
3,3,0,0,3,2,5,8327
0,0,1,0,1,0,1,8328
1,1,1,1,2,1,3,8328
2,2,0,1,2,2,4,8328
3,3,0,1,2,3,5,8328
4,4,0,0,2,3,5,8328
0,0,1,0,1,0,1,8329
1,1,0,0,1,0,1,8329
0,0,1,0,1,0,1,8330
1,1,3,0,4,0,4,8330
2,2,1,0,5,0,5,8330
3,3,0,0,5,0,5,8330
0,0,1,0,1,0,1,8331
1,1,1,0,2,0,2,8331
2,2,2,0,4,0,4,8331
3,3,2,0,6,0,6,8331
4,4,0,0,6,0,6,8331
0,0,1,0,1,0,1,8332
1,1,0,0,1,0,1,8332
0,0,1,0,1,0,1,8333
1,1,0,0,1,0,1,8333
0,0,1,0,1,0,1,8334
1,1,1,0,2,0,2,8334
2,2,1,0,3,0,3,8334
3,3,0,0,3,0,3,8334
0,0,1,0,1,0,1,8335
1,1,1,0,2,0,2,8335
2,2,0,0,2,0,2,8335
0,0,1,0,1,0,1,8336
1,1,0,0,1,0,1,8336
0,0,1,0,1,0,1,8337
1,1,2,2,3,2,5,8337
2,2,2,3,5,5,10,8337
3,3,1,2,6,7,13,8337
4,4,3,2,9,9,18,8337
5,5,4,2,13,11,24,8337
6,6,2,4,15,15,30,8337
7,7,4,4,19,19,38,8337
8,8,2,6,21,25,46,8337
9,9,4,4,25,29,54,8337
10,10,3,1,28,30,58,8337
11,11,2,1,30,31,61,8337
12,12,5,0,35,31,66,8337
13,13,5,2,40,33,73,8337
14,14,1,5,41,38,79,8337
15,15,1,3,42,41,83,8337
16,16,3,2,45,43,88,8337
17,17,3,3,48,46,94,8337
18,18,2,3,50,49,99,8337
19,19,0,3,50,52,102,8337
20,20,0,3,50,55,105,8337
21,21,0,4,50,59,109,8337
22,22,1,0,51,59,110,8337
23,23,0,0,51,59,110,8337
0,0,1,0,1,0,1,8338
1,1,2,0,3,0,3,8338
2,2,2,0,5,0,5,8338
3,3,5,0,10,0,10,8338
4,4,4,1,14,1,15,8338
5,5,3,2,17,3,20,8338
6,6,3,0,20,3,23,8338
7,7,2,1,22,4,26,8338
8,8,3,2,25,6,31,8338
9,9,2,3,27,9,36,8338
10,10,1,3,28,12,40,8338
11,11,2,6,30,18,48,8338
12,12,4,6,34,24,58,8338
13,13,5,7,39,31,70,8338
14,14,6,1,45,32,77,8338
15,15,4,1,49,33,82,8338
16,16,2,2,51,35,86,8338
17,17,3,1,54,36,90,8338
18,18,1,1,55,37,92,8338
19,19,0,0,55,37,92,8338
0,0,1,0,1,0,1,8339
1,1,2,0,3,0,3,8339
2,2,2,0,5,0,5,8339
3,3,0,0,5,0,5,8339
0,0,1,0,1,0,1,8340
1,1,0,0,1,0,1,8340
0,0,1,0,1,0,1,8341
1,1,1,0,2,0,2,8341
2,2,1,0,3,0,3,8341
3,3,0,0,3,0,3,8341
0,0,1,0,1,0,1,8342
1,1,1,0,2,0,2,8342
2,2,1,0,3,0,3,8342
3,3,1,0,4,0,4,8342
4,4,2,0,6,0,6,8342
5,5,1,1,7,1,8,8342
6,6,0,0,7,1,8,8342
0,0,1,0,1,0,1,8343
1,1,0,0,1,0,1,8343
0,0,1,0,1,0,1,8344
1,1,1,0,2,0,2,8344
2,2,3,1,5,1,6,8344
3,3,2,1,7,2,9,8344
4,4,1,1,8,3,11,8344
5,5,0,2,8,5,13,8344
6,6,0,3,8,8,16,8344
7,7,1,2,9,10,19,8344
8,8,0,2,9,12,21,8344
9,9,0,2,9,14,23,8344
10,10,0,0,9,14,23,8344
0,0,1,0,1,0,1,8345
1,1,0,0,1,0,1,8345
0,0,1,0,1,0,1,8346
1,1,1,1,2,1,3,8346
2,2,1,1,3,2,5,8346
3,3,1,1,4,3,7,8346
4,4,1,1,5,4,9,8346
5,5,0,1,5,5,10,8346
6,6,1,2,6,7,13,8346
7,7,0,2,6,9,15,8346
8,8,0,2,6,11,17,8346
9,9,0,2,6,13,19,8346
10,10,0,0,6,13,19,8346
0,0,1,0,1,0,1,8347
1,1,0,0,1,0,1,8347
0,0,1,0,1,0,1,8348
1,1,3,0,4,0,4,8348
2,2,2,1,6,1,7,8348
3,3,2,1,8,2,10,8348
4,4,1,1,9,3,12,8348
5,5,3,1,12,4,16,8348
6,6,4,2,16,6,22,8348
7,7,5,3,21,9,30,8348
8,8,2,3,23,12,35,8348
9,9,1,0,24,12,36,8348
10,10,0,0,24,12,36,8348
0,0,1,0,1,0,1,8349
1,1,0,0,1,0,1,8349
0,0,1,0,1,0,1,8350
1,1,2,0,3,0,3,8350
2,2,0,0,3,0,3,8350
0,0,1,0,1,0,1,8351
1,1,1,0,2,0,2,8351
2,2,0,0,2,0,2,8351
0,0,1,0,1,0,1,8352
1,1,1,0,2,0,2,8352
2,2,2,0,4,0,4,8352
3,3,1,2,5,2,7,8352
4,4,0,1,5,3,8,8352
5,5,0,0,5,3,8,8352
0,0,1,0,1,0,1,8353
1,1,1,0,2,0,2,8353
2,2,2,0,4,0,4,8353
3,3,1,0,5,0,5,8353
4,4,0,1,5,1,6,8353
5,5,1,2,6,3,9,8353
6,6,2,2,8,5,13,8353
7,7,0,2,8,7,15,8353
8,8,0,0,8,7,15,8353
0,0,1,0,1,0,1,8354
1,1,0,0,1,0,1,8354
0,0,1,0,1,0,1,8355
1,1,0,0,1,0,1,8355
0,0,1,0,1,0,1,8356
1,1,1,0,2,0,2,8356
2,2,0,1,2,1,3,8356
3,3,0,3,2,4,6,8356
4,4,1,3,3,7,10,8356
5,5,2,5,5,12,17,8356
6,6,4,6,9,18,27,8356
7,7,7,7,16,25,41,8356
8,8,8,1,24,26,50,8356
9,9,5,0,29,26,55,8356
10,10,3,0,32,26,58,8356
11,11,2,2,34,28,62,8356
12,12,1,1,35,29,64,8356
13,13,1,0,36,29,65,8356
14,14,1,0,37,29,66,8356
15,15,0,0,37,29,66,8356
0,0,1,0,1,0,1,8357
1,1,0,0,1,0,1,8357
0,0,1,0,1,0,1,8358
1,1,2,0,3,0,3,8358
2,2,0,0,3,0,3,8358
0,0,1,0,1,0,1,8359
1,1,0,0,1,0,1,8359
0,0,1,0,1,0,1,8360
1,1,1,0,2,0,2,8360
2,2,2,0,4,0,4,8360
3,3,0,0,4,0,4,8360
0,0,1,0,1,0,1,8361
1,1,1,0,2,0,2,8361
2,2,1,0,3,0,3,8361
3,3,0,0,3,0,3,8361
0,0,1,0,1,0,1,8362
1,1,0,0,1,0,1,8362
0,0,1,0,1,0,1,8363
1,1,0,0,1,0,1,8363
0,0,1,0,1,0,1,8364
1,1,1,0,2,0,2,8364
2,2,2,1,4,1,5,8364
3,3,2,1,6,2,8,8364
4,4,3,1,9,3,12,8364
5,5,2,3,11,6,17,8364
6,6,2,5,13,11,24,8364
7,7,1,3,14,14,28,8364
8,8,2,1,16,15,31,8364
9,9,3,0,19,15,34,8364
10,10,4,1,23,16,39,8364
11,11,1,3,24,19,43,8364
12,12,0,3,24,22,46,8364
13,13,1,2,25,24,49,8364
14,14,0,5,25,29,54,8364
15,15,0,3,25,32,57,8364
16,16,0,2,25,34,59,8364
17,17,1,2,26,36,62,8364
18,18,1,1,27,37,64,8364
19,19,1,0,28,37,65,8364
20,20,0,0,28,37,65,8364
0,0,1,0,1,0,1,8365
1,1,1,0,2,0,2,8365
2,2,0,0,2,0,2,8365
0,0,1,0,1,0,1,8366
1,1,0,0,1,0,1,8366
0,0,1,0,1,0,1,8367
1,1,0,0,1,0,1,8367
0,0,1,0,1,0,1,8368
1,1,1,0,2,0,2,8368
2,2,0,0,2,0,2,8368
0,0,1,0,1,0,1,8369
1,1,2,0,3,0,3,8369
2,2,2,0,5,0,5,8369
3,3,4,1,9,1,10,8369
4,4,3,2,12,3,15,8369
5,5,1,2,13,5,18,8369
6,6,1,2,14,7,21,8369
7,7,0,1,14,8,22,8369
8,8,0,0,14,8,22,8369
0,0,1,0,1,0,1,8370
1,1,0,1,1,1,2,8370
2,2,0,1,1,2,3,8370
3,3,0,1,1,3,4,8370
4,4,1,2,2,5,7,8370
5,5,0,1,2,6,8,8370
6,6,0,0,2,6,8,8370
0,0,1,0,1,0,1,8371
1,1,1,0,2,0,2,8371
2,2,0,0,2,0,2,8371
0,0,1,0,1,0,1,8372
1,1,0,0,1,0,1,8372
0,0,1,0,1,0,1,8373
1,1,0,0,1,0,1,8373
0,0,1,0,1,0,1,8374
1,1,1,0,2,0,2,8374
2,2,1,0,3,0,3,8374
3,3,0,1,3,1,4,8374
4,4,0,2,3,3,6,8374
5,5,3,2,6,5,11,8374
6,6,2,2,8,7,15,8374
7,7,3,4,11,11,22,8374
8,8,1,2,12,13,25,8374
9,9,1,1,13,14,27,8374
10,10,1,0,14,14,28,8374
11,11,0,1,14,15,29,8374
12,12,1,0,15,15,30,8374
13,13,0,0,15,15,30,8374
0,0,1,0,1,0,1,8375
1,1,1,1,2,1,3,8375
2,2,0,0,2,1,3,8375
0,0,1,0,1,0,1,8376
1,1,0,0,1,0,1,8376
0,0,1,0,1,0,1,8377
1,1,1,0,2,0,2,8377
2,2,0,0,2,0,2,8377
0,0,1,0,1,0,1,8378
1,1,1,0,2,0,2,8378
2,2,1,0,3,0,3,8378
3,3,0,0,3,0,3,8378
0,0,1,0,1,0,1,8379
1,1,0,0,1,0,1,8379
0,0,1,0,1,0,1,8380
1,1,2,0,3,0,3,8380
2,2,0,0,3,0,3,8380
0,0,1,0,1,0,1,8381
1,1,3,0,4,0,4,8381
2,2,1,0,5,0,5,8381
3,3,0,0,5,0,5,8381
0,0,1,0,1,0,1,8382
1,1,1,1,2,1,3,8382
2,2,1,1,3,2,5,8382
3,3,1,1,4,3,7,8382
4,4,0,0,4,3,7,8382
0,0,1,0,1,0,1,8383
1,1,0,0,1,0,1,8383
0,0,1,0,1,0,1,8384
1,1,1,0,2,0,2,8384
2,2,2,0,4,0,4,8384
3,3,1,0,5,0,5,8384
4,4,1,0,6,0,6,8384
5,5,4,1,10,1,11,8384
6,6,6,2,16,3,19,8384
7,7,1,3,17,6,23,8384
8,8,0,1,17,7,24,8384
9,9,0,1,17,8,25,8384
10,10,0,1,17,9,26,8384
11,11,1,1,18,10,28,8384
12,12,1,2,19,12,31,8384
13,13,1,1,20,13,33,8384
14,14,2,1,22,14,36,8384
15,15,0,1,22,15,37,8384
16,16,1,0,23,15,38,8384
17,17,0,0,23,15,38,8384
0,0,1,0,1,0,1,8385
1,1,1,0,2,0,2,8385
2,2,2,0,4,0,4,8385
3,3,2,0,6,0,6,8385
4,4,3,0,9,0,9,8385
5,5,1,0,10,0,10,8385
6,6,1,0,11,0,11,8385
7,7,1,0,12,0,12,8385
8,8,0,0,12,0,12,8385
0,0,1,0,1,0,1,8386
1,1,1,1,2,1,3,8386
2,2,0,0,2,1,3,8386
0,0,1,0,1,0,1,8387
1,1,2,0,3,0,3,8387
2,2,1,0,4,0,4,8387
3,3,1,1,5,1,6,8387
4,4,0,1,5,2,7,8387
5,5,1,0,6,2,8,8387
6,6,0,0,6,2,8,8387
0,0,1,0,1,0,1,8388
1,1,1,0,2,0,2,8388
2,2,1,0,3,0,3,8388
3,3,1,1,4,1,5,8388
4,4,0,1,4,2,6,8388
5,5,0,0,4,2,6,8388
0,0,1,0,1,0,1,8389
1,1,0,0,1,0,1,8389
0,0,1,0,1,0,1,8390
1,1,1,0,2,0,2,8390
2,2,1,0,3,0,3,8390
3,3,0,0,3,0,3,8390
0,0,1,0,1,0,1,8391
1,1,0,0,1,0,1,8391
0,0,1,0,1,0,1,8392
1,1,0,0,1,0,1,8392
0,0,1,0,1,0,1,8393
1,1,3,0,4,0,4,8393
2,2,3,1,7,1,8,8393
3,3,0,1,7,2,9,8393
4,4,0,1,7,3,10,8393
5,5,1,1,8,4,12,8393
6,6,0,2,8,6,14,8393
7,7,0,4,8,10,18,8393
8,8,0,4,8,14,22,8393
9,9,2,2,10,16,26,8393
10,10,3,1,13,17,30,8393
11,11,1,1,14,18,32,8393
12,12,0,0,14,18,32,8393
0,0,1,0,1,0,1,8394
1,1,0,0,1,0,1,8394
0,0,1,0,1,0,1,8395
1,1,1,0,2,0,2,8395
2,2,0,0,2,0,2,8395
0,0,1,0,1,0,1,8396
1,1,1,2,2,2,4,8396
2,2,1,2,3,4,7,8396
3,3,1,1,4,5,9,8396
4,4,1,2,5,7,12,8396
5,5,2,1,7,8,15,8396
6,6,4,1,11,9,20,8396
7,7,5,2,16,11,27,8396
8,8,5,3,21,14,35,8396
9,9,8,4,29,18,47,8396
10,10,4,6,33,24,57,8396
11,11,3,4,36,28,64,8396
12,12,3,4,39,32,71,8396
13,13,3,6,42,38,80,8396
14,14,4,7,46,45,91,8396
15,15,7,5,53,50,103,8396
16,16,3,4,56,54,110,8396
17,17,0,1,56,55,111,8396
18,18,0,1,56,56,112,8396
19,19,0,3,56,59,115,8396
20,20,1,2,57,61,118,8396
21,21,0,1,57,62,119,8396
22,22,1,1,58,63,121,8396
23,23,3,2,61,65,126,8396
24,24,4,1,65,66,131,8396
25,25,5,1,70,67,137,8396
26,26,3,3,73,70,143,8396
27,27,2,4,75,74,149,8396
28,28,0,0,75,74,149,8396
0,0,1,0,1,0,1,8397
1,1,2,0,3,0,3,8397
2,2,1,1,4,1,5,8397
3,3,3,2,7,3,10,8397
4,4,4,4,11,7,18,8397
5,5,4,4,15,11,26,8397
6,6,2,2,17,13,30,8397
7,7,2,1,19,14,33,8397
8,8,2,0,21,14,35,8397
9,9,0,0,21,14,35,8397
0,0,1,0,1,0,1,8398
1,1,1,0,2,0,2,8398
2,2,0,0,2,0,2,8398
0,0,1,0,1,0,1,8399
1,1,0,0,1,0,1,8399
0,0,1,0,1,0,1,8400
1,1,1,1,2,1,3,8400
2,2,1,2,3,3,6,8400
3,3,0,1,3,4,7,8400
4,4,0,1,3,5,8,8400
5,5,0,0,3,5,8,8400
0,0,1,0,1,0,1,8401
1,1,0,0,1,0,1,8401
0,0,1,0,1,0,1,8402
1,1,1,0,2,0,2,8402
2,2,0,0,2,0,2,8402
0,0,1,0,1,0,1,8403
1,1,1,0,2,0,2,8403
2,2,1,0,3,0,3,8403
3,3,0,0,3,0,3,8403
0,0,1,0,1,0,1,8404
1,1,1,0,2,0,2,8404
2,2,2,0,4,0,4,8404
3,3,1,0,5,0,5,8404
4,4,0,0,5,0,5,8404
0,0,1,0,1,0,1,8405
1,1,0,1,1,1,2,8405
2,2,0,0,1,1,2,8405
0,0,1,0,1,0,1,8406
1,1,0,1,1,1,2,8406
2,2,0,0,1,1,2,8406
0,0,1,0,1,0,1,8407
1,1,0,0,1,0,1,8407
0,0,1,0,1,0,1,8408
1,1,2,0,3,0,3,8408
2,2,2,0,5,0,5,8408
3,3,0,0,5,0,5,8408
0,0,1,0,1,0,1,8409
1,1,1,1,2,1,3,8409
2,2,0,0,2,1,3,8409
0,0,1,0,1,0,1,8410
1,1,2,0,3,0,3,8410
2,2,3,0,6,0,6,8410
3,3,0,2,6,2,8,8410
4,4,0,4,6,6,12,8410
5,5,1,3,7,9,16,8410
6,6,1,2,8,11,19,8410
7,7,0,1,8,12,20,8410
8,8,0,0,8,12,20,8410
0,0,1,0,1,0,1,8411
1,1,1,1,2,1,3,8411
2,2,1,2,3,3,6,8411
3,3,1,1,4,4,8,8411
4,4,2,1,6,5,11,8411
5,5,5,2,11,7,18,8411
6,6,7,3,18,10,28,8411
7,7,8,3,26,13,39,8411
8,8,2,7,28,20,48,8411
9,9,4,6,32,26,58,8411
10,10,2,3,34,29,63,8411
11,11,0,2,34,31,65,8411
12,12,0,3,34,34,68,8411
13,13,2,1,36,35,71,8411
14,14,3,2,39,37,76,8411
15,15,3,6,42,43,85,8411
16,16,3,4,45,47,92,8411
17,17,6,3,51,50,101,8411
18,18,7,4,58,54,112,8411
19,19,5,2,63,56,119,8411
20,20,8,4,71,60,131,8411
21,21,10,8,81,68,149,8411
22,22,7,8,88,76,164,8411
23,23,6,6,94,82,176,8411
24,24,8,3,102,85,187,8411
25,25,7,4,109,89,198,8411
26,26,0,7,109,96,205,8411
27,27,2,7,111,103,214,8411
28,28,2,4,113,107,220,8411
29,29,1,3,114,110,224,8411
30,30,1,3,115,113,228,8411
31,31,0,3,115,116,231,8411
32,32,0,4,115,120,235,8411
33,33,0,2,115,122,237,8411
34,34,1,0,116,122,238,8411
35,35,1,1,117,123,240,8411
36,36,0,0,117,123,240,8411
0,0,1,0,1,0,1,8412
1,1,1,0,2,0,2,8412
2,2,1,1,3,1,4,8412
3,3,1,3,4,4,8,8412
4,4,2,4,6,8,14,8412
5,5,3,5,9,13,22,8412
6,6,3,5,12,18,30,8412
7,7,3,6,15,24,39,8412
8,8,1,5,16,29,45,8412
9,9,2,1,18,30,48,8412
10,10,0,1,18,31,49,8412
11,11,0,0,18,31,49,8412
0,0,1,0,1,0,1,8413
1,1,0,0,1,0,1,8413
0,0,1,0,1,0,1,8414
1,1,0,0,1,0,1,8414
0,0,1,0,1,0,1,8415
1,1,2,0,3,0,3,8415
2,2,1,0,4,0,4,8415
3,3,1,0,5,0,5,8415
4,4,0,0,5,0,5,8415
0,0,1,0,1,0,1,8416
1,1,1,1,2,1,3,8416
2,2,2,1,4,2,6,8416
3,3,1,0,5,2,7,8416
4,4,1,0,6,2,8,8416
5,5,0,0,6,2,8,8416
0,0,1,0,1,0,1,8417
1,1,0,0,1,0,1,8417
0,0,1,0,1,0,1,8418
1,1,0,0,1,0,1,8418
0,0,1,0,1,0,1,8419
1,1,0,1,1,1,2,8419
2,2,0,1,1,2,3,8419
3,3,0,2,1,4,5,8419
4,4,1,1,2,5,7,8419
5,5,1,0,3,5,8,8419
6,6,1,2,4,7,11,8419
7,7,2,1,6,8,14,8419
8,8,1,1,7,9,16,8419
9,9,1,1,8,10,18,8419
10,10,0,1,8,11,19,8419
11,11,1,2,9,13,22,8419
12,12,1,3,10,16,26,8419
13,13,1,1,11,17,28,8419
14,14,0,0,11,17,28,8419
0,0,1,0,1,0,1,8420
1,1,1,0,2,0,2,8420
2,2,0,0,2,0,2,8420
0,0,1,0,1,0,1,8421
1,1,2,0,3,0,3,8421
2,2,0,0,3,0,3,8421
0,0,1,0,1,0,1,8422
1,1,2,0,3,0,3,8422
2,2,1,1,4,1,5,8422
3,3,0,2,4,3,7,8422
4,4,0,1,4,4,8,8422
5,5,0,1,4,5,9,8422
6,6,0,0,4,5,9,8422
0,0,1,0,1,0,1,8423
1,1,1,0,2,0,2,8423
2,2,2,0,4,0,4,8423
3,3,2,0,6,0,6,8423
4,4,1,0,7,0,7,8423
5,5,0,0,7,0,7,8423
0,0,1,0,1,0,1,8424
1,1,0,1,1,1,2,8424
2,2,1,0,2,1,3,8424
3,3,0,0,2,1,3,8424
0,0,1,0,1,0,1,8425
1,1,3,0,4,0,4,8425
2,2,1,1,5,1,6,8425
3,3,0,1,5,2,7,8425
4,4,2,0,7,2,9,8425
5,5,1,2,8,4,12,8425
6,6,0,5,8,9,17,8425
7,7,1,6,9,15,24,8425
8,8,4,6,13,21,34,8425
9,9,3,2,16,23,39,8425
10,10,4,2,20,25,45,8425
11,11,2,3,22,28,50,8425
12,12,1,3,23,31,54,8425
13,13,2,2,25,33,58,8425
14,14,1,2,26,35,61,8425
15,15,2,0,28,35,63,8425
16,16,2,0,30,35,65,8425
17,17,0,0,30,35,65,8425
0,0,1,0,1,0,1,8426
1,1,0,0,1,0,1,8426
0,0,1,0,1,0,1,8427
1,1,0,0,1,0,1,8427
0,0,1,0,1,0,1,8428
1,1,2,0,3,0,3,8428
2,2,3,0,6,0,6,8428
3,3,2,1,8,1,9,8428
4,4,7,3,15,4,19,8428
5,5,5,1,20,5,25,8428
6,6,3,1,23,6,29,8428
7,7,2,1,25,7,32,8428
8,8,2,1,27,8,35,8428
9,9,0,4,27,12,39,8428
10,10,0,4,27,16,43,8428
11,11,1,7,28,23,51,8428
12,12,3,4,31,27,58,8428
13,13,1,4,32,31,63,8428
14,14,0,2,32,33,65,8428
15,15,1,2,33,35,68,8428
16,16,0,1,33,36,69,8428
17,17,0,0,33,36,69,8428
0,0,1,0,1,0,1,8429
1,1,1,0,2,0,2,8429
2,2,2,0,4,0,4,8429
3,3,2,0,6,0,6,8429
4,4,3,2,9,2,11,8429
5,5,3,2,12,4,16,8429
6,6,1,1,13,5,18,8429
7,7,2,0,15,5,20,8429
8,8,1,0,16,5,21,8429
9,9,1,0,17,5,22,8429
10,10,1,0,18,5,23,8429
11,11,1,0,19,5,24,8429
12,12,0,0,19,5,24,8429
0,0,1,0,1,0,1,8430
1,1,1,1,2,1,3,8430
2,2,1,1,3,2,5,8430
3,3,2,2,5,4,9,8430
4,4,1,2,6,6,12,8430
5,5,3,3,9,9,18,8430
6,6,1,4,10,13,23,8430
7,7,0,0,10,13,23,8430
0,0,1,0,1,0,1,8431
1,1,0,1,1,1,2,8431
2,2,0,0,1,1,2,8431
0,0,1,0,1,0,1,8432
1,1,0,0,1,0,1,8432
0,0,1,0,1,0,1,8433
1,1,0,0,1,0,1,8433
0,0,1,0,1,0,1,8434
1,1,0,0,1,0,1,8434
0,0,1,0,1,0,1,8435
1,1,1,0,2,0,2,8435
2,2,0,0,2,0,2,8435
0,0,1,0,1,0,1,8436
1,1,1,0,2,0,2,8436
2,2,1,0,3,0,3,8436
3,3,1,1,4,1,5,8436
4,4,0,1,4,2,6,8436
5,5,0,0,4,2,6,8436
0,0,1,0,1,0,1,8437
1,1,1,0,2,0,2,8437
2,2,1,0,3,0,3,8437
3,3,0,0,3,0,3,8437
0,0,1,0,1,0,1,8438
1,1,1,0,2,0,2,8438
2,2,0,1,2,1,3,8438
3,3,0,1,2,2,4,8438
4,4,0,0,2,2,4,8438
0,0,1,0,1,0,1,8439
1,1,2,0,3,0,3,8439
2,2,0,0,3,0,3,8439
0,0,1,0,1,0,1,8440
1,1,1,0,2,0,2,8440
2,2,0,0,2,0,2,8440
0,0,1,0,1,0,1,8441
1,1,2,0,3,0,3,8441
2,2,2,0,5,0,5,8441
3,3,1,0,6,0,6,8441
4,4,1,0,7,0,7,8441
5,5,0,0,7,0,7,8441
0,0,1,0,1,0,1,8442
1,1,0,1,1,1,2,8442
2,2,1,0,2,1,3,8442
3,3,0,0,2,1,3,8442
0,0,1,0,1,0,1,8443
1,1,0,0,1,0,1,8443
0,0,1,0,1,0,1,8444
1,1,0,0,1,0,1,8444
0,0,1,0,1,0,1,8445
1,1,0,0,1,0,1,8445
0,0,1,0,1,0,1,8446
1,1,0,0,1,0,1,8446
0,0,1,0,1,0,1,8447
1,1,2,0,3,0,3,8447
2,2,5,0,8,0,8,8447
3,3,2,4,10,4,14,8447
4,4,1,3,11,7,18,8447
5,5,0,0,11,7,18,8447
0,0,1,0,1,0,1,8448
1,1,2,0,3,0,3,8448
2,2,0,0,3,0,3,8448
0,0,1,0,1,0,1,8449
1,1,0,0,1,0,1,8449
0,0,1,0,1,0,1,8450
1,1,0,1,1,1,2,8450
2,2,0,1,1,2,3,8450
3,3,0,1,1,3,4,8450
4,4,0,0,1,3,4,8450
0,0,1,0,1,0,1,8451
1,1,1,0,2,0,2,8451
2,2,2,0,4,0,4,8451
3,3,2,2,6,2,8,8451
4,4,4,2,10,4,14,8451
5,5,3,3,13,7,20,8451
6,6,1,4,14,11,25,8451
7,7,3,2,17,13,30,8451
8,8,2,0,19,13,32,8451
9,9,2,1,21,14,35,8451
10,10,0,0,21,14,35,8451
0,0,1,0,1,0,1,8452
1,1,1,0,2,0,2,8452
2,2,1,0,3,0,3,8452
3,3,0,0,3,0,3,8452
0,0,1,0,1,0,1,8453
1,1,0,0,1,0,1,8453
0,0,1,0,1,0,1,8454
1,1,1,1,2,1,3,8454
2,2,1,0,3,1,4,8454
3,3,1,0,4,1,5,8454
4,4,1,1,5,2,7,8454
5,5,0,1,5,3,8,8454
6,6,0,0,5,3,8,8454
0,0,1,0,1,0,1,8455
1,1,0,0,1,0,1,8455
0,0,1,0,1,0,1,8456
1,1,3,0,4,0,4,8456
2,2,1,0,5,0,5,8456
3,3,0,0,5,0,5,8456
0,0,1,0,1,0,1,8457
1,1,1,0,2,0,2,8457
2,2,1,2,3,2,5,8457
3,3,0,1,3,3,6,8457
4,4,0,2,3,5,8,8457
5,5,0,0,3,5,8,8457
0,0,1,0,1,0,1,8458
1,1,1,0,2,0,2,8458
2,2,0,0,2,0,2,8458
0,0,1,0,1,0,1,8459
1,1,0,2,1,2,3,8459
2,2,1,0,2,2,4,8459
3,3,1,1,3,3,6,8459
4,4,1,1,4,4,8,8459
5,5,0,0,4,4,8,8459
0,0,1,0,1,0,1,8460
1,1,3,0,4,0,4,8460
2,2,2,0,6,0,6,8460
3,3,3,0,9,0,9,8460
4,4,0,0,9,0,9,8460
0,0,1,0,1,0,1,8461
1,1,1,0,2,0,2,8461
2,2,0,1,2,1,3,8461
3,3,0,0,2,1,3,8461
0,0,1,0,1,0,1,8462
1,1,0,0,1,0,1,8462
0,0,1,0,1,0,1,8463
1,1,1,0,2,0,2,8463
2,2,1,0,3,0,3,8463
3,3,2,0,5,0,5,8463
4,4,0,0,5,0,5,8463
0,0,1,0,1,0,1,8464
1,1,1,0,2,0,2,8464
2,2,0,0,2,0,2,8464
0,0,1,0,1,0,1,8465
1,1,2,0,3,0,3,8465
2,2,0,1,3,1,4,8465
3,3,0,0,3,1,4,8465
0,0,1,0,1,0,1,8466
1,1,0,1,1,1,2,8466
2,2,0,0,1,1,2,8466
0,0,1,0,1,0,1,8467
1,1,1,0,2,0,2,8467
2,2,0,0,2,0,2,8467
0,0,1,0,1,0,1,8468
1,1,0,0,1,0,1,8468
0,0,1,0,1,0,1,8469
1,1,2,0,3,0,3,8469
2,2,1,0,4,0,4,8469
3,3,2,0,6,0,6,8469
4,4,2,0,8,0,8,8469
5,5,1,0,9,0,9,8469
6,6,2,0,11,0,11,8469
7,7,2,0,13,0,13,8469
8,8,0,1,13,1,14,8469
9,9,0,2,13,3,16,8469
10,10,0,3,13,6,19,8469
11,11,0,3,13,9,22,8469
12,12,0,2,13,11,24,8469
13,13,0,0,13,11,24,8469
0,0,1,0,1,0,1,8470
1,1,0,1,1,1,2,8470
2,2,0,1,1,2,3,8470
3,3,0,3,1,5,6,8470
4,4,0,0,1,5,6,8470
0,0,1,0,1,0,1,8471
1,1,0,1,1,1,2,8471
2,2,0,0,1,1,2,8471
0,0,1,0,1,0,1,8472
1,1,2,0,3,0,3,8472
2,2,1,1,4,1,5,8472
3,3,1,2,5,3,8,8472
4,4,0,4,5,7,12,8472
5,5,0,1,5,8,13,8472
6,6,0,3,5,11,16,8472
7,7,1,3,6,14,20,8472
8,8,2,1,8,15,23,8472
9,9,1,0,9,15,24,8472
10,10,0,1,9,16,25,8472
11,11,0,0,9,16,25,8472
0,0,1,0,1,0,1,8473
1,1,3,0,4,0,4,8473
2,2,1,0,5,0,5,8473
3,3,0,0,5,0,5,8473
0,0,1,0,1,0,1,8474
1,1,0,0,1,0,1,8474
0,0,1,0,1,0,1,8475
1,1,0,0,1,0,1,8475
0,0,1,0,1,0,1,8476
1,1,0,0,1,0,1,8476
0,0,1,0,1,0,1,8477
1,1,1,0,2,0,2,8477
2,2,1,0,3,0,3,8477
3,3,1,0,4,0,4,8477
4,4,2,0,6,0,6,8477
5,5,1,0,7,0,7,8477
6,6,1,0,8,0,8,8477
7,7,1,0,9,0,9,8477
8,8,2,1,11,1,12,8477
9,9,3,1,14,2,16,8477
10,10,3,2,17,4,21,8477
11,11,0,2,17,6,23,8477
12,12,0,2,17,8,25,8477
13,13,0,0,17,8,25,8477
0,0,1,0,1,0,1,8478
1,1,1,0,2,0,2,8478
2,2,0,0,2,0,2,8478
0,0,1,0,1,0,1,8479
1,1,1,1,2,1,3,8479
2,2,1,1,3,2,5,8479
3,3,2,0,5,2,7,8479
4,4,5,1,10,3,13,8479
5,5,5,1,15,4,19,8479
6,6,6,1,21,5,26,8479
7,7,3,1,24,6,30,8479
8,8,2,0,26,6,32,8479
9,9,2,0,28,6,34,8479
10,10,3,1,31,7,38,8479
11,11,2,0,33,7,40,8479
12,12,1,0,34,7,41,8479
13,13,1,0,35,7,42,8479
14,14,2,0,37,7,44,8479
15,15,3,0,40,7,47,8479
16,16,2,2,42,9,51,8479
17,17,1,0,43,9,52,8479
18,18,1,0,44,9,53,8479
19,19,1,0,45,9,54,8479
20,20,1,0,46,9,55,8479
21,21,1,1,47,10,57,8479
22,22,0,1,47,11,58,8479
23,23,0,1,47,12,59,8479
24,24,0,0,47,12,59,8479
0,0,1,0,1,0,1,8480
1,1,1,0,2,0,2,8480
2,2,2,0,4,0,4,8480
3,3,2,0,6,0,6,8480
4,4,0,1,6,1,7,8480
5,5,0,0,6,1,7,8480
0,0,1,0,1,0,1,8481
1,1,2,0,3,0,3,8481
2,2,2,0,5,0,5,8481
3,3,0,1,5,1,6,8481
4,4,0,1,5,2,7,8481
5,5,0,2,5,4,9,8481
6,6,0,1,5,5,10,8481
7,7,0,1,5,6,11,8481
8,8,0,1,5,7,12,8481
9,9,0,1,5,8,13,8481
10,10,0,0,5,8,13,8481
0,0,1,0,1,0,1,8482
1,1,1,0,2,0,2,8482
2,2,0,0,2,0,2,8482
0,0,1,0,1,0,1,8483
1,1,0,0,1,0,1,8483
0,0,1,0,1,0,1,8484
1,1,1,0,2,0,2,8484
2,2,2,0,4,0,4,8484
3,3,0,0,4,0,4,8484
0,0,1,0,1,0,1,8485
1,1,1,0,2,0,2,8485
2,2,1,0,3,0,3,8485
3,3,0,0,3,0,3,8485
0,0,1,0,1,0,1,8486
1,1,0,0,1,0,1,8486
0,0,1,0,1,0,1,8487
1,1,0,0,1,0,1,8487
0,0,1,0,1,0,1,8488
1,1,2,0,3,0,3,8488
2,2,4,0,7,0,7,8488
3,3,1,1,8,1,9,8488
4,4,2,1,10,2,12,8488
5,5,2,0,12,2,14,8488
6,6,0,0,12,2,14,8488
0,0,1,0,1,0,1,8489
1,1,1,0,2,0,2,8489
2,2,2,0,4,0,4,8489
3,3,0,0,4,0,4,8489
0,0,1,0,1,0,1,8490
1,1,0,0,1,0,1,8490
0,0,1,0,1,0,1,8491
1,1,0,0,1,0,1,8491
0,0,1,0,1,0,1,8492
1,1,0,0,1,0,1,8492
0,0,1,0,1,0,1,8493
1,1,2,0,3,0,3,8493
2,2,3,1,6,1,7,8493
3,3,2,2,8,3,11,8493
4,4,2,2,10,5,15,8493
5,5,1,1,11,6,17,8493
6,6,1,1,12,7,19,8493
7,7,0,4,12,11,23,8493
8,8,2,1,14,12,26,8493
9,9,1,2,15,14,29,8493
10,10,2,3,17,17,34,8493
11,11,1,3,18,20,38,8493
12,12,2,5,20,25,45,8493
13,13,3,2,23,27,50,8493
14,14,5,0,28,27,55,8493
15,15,4,2,32,29,61,8493
16,16,0,2,32,31,63,8493
17,17,0,0,32,31,63,8493
0,0,1,0,1,0,1,8494
1,1,0,0,1,0,1,8494
0,0,1,0,1,0,1,8495
1,1,0,0,1,0,1,8495
0,0,1,0,1,0,1,8496
1,1,0,0,1,0,1,8496
0,0,1,0,1,0,1,8497
1,1,1,0,2,0,2,8497
2,2,0,0,2,0,2,8497
0,0,1,0,1,0,1,8498
1,1,1,0,2,0,2,8498
2,2,0,0,2,0,2,8498
0,0,1,0,1,0,1,8499
1,1,0,0,1,0,1,8499
0,0,1,0,1,0,1,8500
1,1,1,0,2,0,2,8500
2,2,1,0,3,0,3,8500
3,3,1,1,4,1,5,8500
4,4,3,1,7,2,9,8500
5,5,2,2,9,4,13,8500
6,6,0,1,9,5,14,8500
7,7,0,2,9,7,16,8500
8,8,0,2,9,9,18,8500
9,9,0,1,9,10,19,8500
10,10,0,0,9,10,19,8500
0,0,1,0,1,0,1,8501
1,1,0,1,1,1,2,8501
2,2,0,0,1,1,2,8501
0,0,1,0,1,0,1,8502
1,1,0,0,1,0,1,8502
0,0,1,0,1,0,1,8503
1,1,0,0,1,0,1,8503
0,0,1,0,1,0,1,8504
1,1,0,1,1,1,2,8504
2,2,1,1,2,2,4,8504
3,3,1,1,3,3,6,8504
4,4,1,0,4,3,7,8504
5,5,2,0,6,3,9,8504
6,6,0,0,6,3,9,8504
0,0,1,0,1,0,1,8505
1,1,1,1,2,1,3,8505
2,2,0,0,2,1,3,8505
0,0,1,0,1,0,1,8506
1,1,1,0,2,0,2,8506
2,2,0,0,2,0,2,8506
0,0,1,0,1,0,1,8507
1,1,0,0,1,0,1,8507
0,0,1,0,1,0,1,8508
1,1,0,0,1,0,1,8508
0,0,1,0,1,0,1,8509
1,1,0,0,1,0,1,8509
0,0,1,0,1,0,1,8510
1,1,0,0,1,0,1,8510
0,0,1,0,1,0,1,8511
1,1,1,0,2,0,2,8511
2,2,1,0,3,0,3,8511
3,3,0,0,3,0,3,8511
0,0,1,0,1,0,1,8512
1,1,0,0,1,0,1,8512
0,0,1,0,1,0,1,8513
1,1,1,1,2,1,3,8513
2,2,0,1,2,2,4,8513
3,3,0,0,2,2,4,8513
0,0,1,0,1,0,1,8514
1,1,0,0,1,0,1,8514
0,0,1,0,1,0,1,8515
1,1,1,0,2,0,2,8515
2,2,2,0,4,0,4,8515
3,3,2,0,6,0,6,8515
4,4,1,1,7,1,8,8515
5,5,0,0,7,1,8,8515
0,0,1,0,1,0,1,8516
1,1,0,0,1,0,1,8516
0,0,1,0,1,0,1,8517
1,1,0,0,1,0,1,8517
0,0,1,0,1,0,1,8518
1,1,0,0,1,0,1,8518
0,0,1,0,1,0,1,8519
1,1,0,0,1,0,1,8519
0,0,1,0,1,0,1,8520
1,1,0,0,1,0,1,8520
0,0,1,0,1,0,1,8521
1,1,0,0,1,0,1,8521
0,0,1,0,1,0,1,8522
1,1,2,0,3,0,3,8522
2,2,3,0,6,0,6,8522
3,3,1,1,7,1,8,8522
4,4,0,0,7,1,8,8522
0,0,1,0,1,0,1,8523
1,1,1,0,2,0,2,8523
2,2,2,0,4,0,4,8523
3,3,0,0,4,0,4,8523
0,0,1,0,1,0,1,8524
1,1,1,1,2,1,3,8524
2,2,0,0,2,1,3,8524
0,0,1,0,1,0,1,8525
1,1,0,1,1,1,2,8525
2,2,0,0,1,1,2,8525
0,0,1,0,1,0,1,8526
1,1,0,0,1,0,1,8526
0,0,1,0,1,0,1,8527
1,1,0,0,1,0,1,8527
0,0,1,0,1,0,1,8528
1,1,2,0,3,0,3,8528
2,2,2,0,5,0,5,8528
3,3,2,1,7,1,8,8528
4,4,1,0,8,1,9,8528
5,5,0,0,8,1,9,8528
0,0,1,0,1,0,1,8529
1,1,1,0,2,0,2,8529
2,2,0,0,2,0,2,8529
0,0,1,0,1,0,1,8530
1,1,0,0,1,0,1,8530
0,0,1,0,1,0,1,8531
1,1,0,0,1,0,1,8531
0,0,1,0,1,0,1,8532
1,1,1,0,2,0,2,8532
2,2,1,0,3,0,3,8532
3,3,1,0,4,0,4,8532
4,4,0,1,4,1,5,8532
5,5,0,0,4,1,5,8532
0,0,1,0,1,0,1,8533
1,1,0,0,1,0,1,8533
0,0,1,0,1,0,1,8534
1,1,1,0,2,0,2,8534
2,2,1,0,3,0,3,8534
3,3,0,0,3,0,3,8534
0,0,1,0,1,0,1,8535
1,1,1,0,2,0,2,8535
2,2,1,0,3,0,3,8535
3,3,0,0,3,0,3,8535
0,0,1,0,1,0,1,8536
1,1,2,0,3,0,3,8536
2,2,1,1,4,1,5,8536
3,3,1,0,5,1,6,8536
4,4,1,1,6,2,8,8536
5,5,1,2,7,4,11,8536
6,6,0,1,7,5,12,8536
7,7,0,1,7,6,13,8536
8,8,0,1,7,7,14,8536
9,9,0,0,7,7,14,8536
0,0,1,0,1,0,1,8537
1,1,1,0,2,0,2,8537
2,2,2,0,4,0,4,8537
3,3,3,0,7,0,7,8537
4,4,2,0,9,0,9,8537
5,5,0,1,9,1,10,8537
6,6,1,1,10,2,12,8537
7,7,0,2,10,4,14,8537
8,8,1,0,11,4,15,8537
9,9,0,0,11,4,15,8537
0,0,1,0,1,0,1,8538
1,1,0,1,1,1,2,8538
2,2,0,0,1,1,2,8538
0,0,1,0,1,0,1,8539
1,1,0,0,1,0,1,8539
0,0,1,0,1,0,1,8540
1,1,0,0,1,0,1,8540
0,0,1,0,1,0,1,8541
1,1,2,0,3,0,3,8541
2,2,4,1,7,1,8,8541
3,3,2,1,9,2,11,8541
4,4,1,3,10,5,15,8541
5,5,0,2,10,7,17,8541
6,6,0,2,10,9,19,8541
7,7,0,2,10,11,21,8541
8,8,0,1,10,12,22,8541
9,9,0,3,10,15,25,8541
10,10,0,1,10,16,26,8541
11,11,0,0,10,16,26,8541
0,0,1,0,1,0,1,8542
1,1,1,1,2,1,3,8542
2,2,1,2,3,3,6,8542
3,3,0,2,3,5,8,8542
4,4,0,2,3,7,10,8542
5,5,1,2,4,9,13,8542
6,6,3,1,7,10,17,8542
7,7,4,3,11,13,24,8542
8,8,4,3,15,16,31,8542
9,9,3,7,18,23,41,8542
10,10,5,4,23,27,50,8542
11,11,5,6,28,33,61,8542
12,12,2,6,30,39,69,8542
13,13,2,6,32,45,77,8542
14,14,3,6,35,51,86,8542
15,15,3,4,38,55,93,8542
16,16,5,3,43,58,101,8542
17,17,4,4,47,62,109,8542
18,18,2,1,49,63,112,8542
19,19,3,0,52,63,115,8542
20,20,1,0,53,63,116,8542
21,21,2,0,55,63,118,8542
22,22,2,1,57,64,121,8542
23,23,1,0,58,64,122,8542
24,24,0,0,58,64,122,8542
0,0,1,0,1,0,1,8543
1,1,0,0,1,0,1,8543
0,0,1,0,1,0,1,8544
1,1,1,0,2,0,2,8544
2,2,0,0,2,0,2,8544
0,0,1,0,1,0,1,8545
1,1,1,0,2,0,2,8545
2,2,0,0,2,0,2,8545
0,0,1,0,1,0,1,8546
1,1,0,0,1,0,1,8546
0,0,1,0,1,0,1,8547
1,1,1,0,2,0,2,8547
2,2,1,0,3,0,3,8547
3,3,0,0,3,0,3,8547
0,0,1,0,1,0,1,8548
1,1,1,0,2,0,2,8548
2,2,2,0,4,0,4,8548
3,3,3,0,7,0,7,8548
4,4,4,1,11,1,12,8548
5,5,4,0,15,1,16,8548
6,6,2,3,17,4,21,8548
7,7,2,4,19,8,27,8548
8,8,3,2,22,10,32,8548
9,9,2,2,24,12,36,8548
10,10,3,2,27,14,41,8548
11,11,3,2,30,16,46,8548
12,12,1,3,31,19,50,8548
13,13,0,1,31,20,51,8548
14,14,0,1,31,21,52,8548
15,15,0,1,31,22,53,8548
16,16,0,0,31,22,53,8548
0,0,1,0,1,0,1,8549
1,1,1,0,2,0,2,8549
2,2,0,0,2,0,2,8549
0,0,1,0,1,0,1,8550
1,1,1,0,2,0,2,8550
2,2,1,0,3,0,3,8550
3,3,0,0,3,0,3,8550
0,0,1,0,1,0,1,8551
1,1,0,0,1,0,1,8551
0,0,1,0,1,0,1,8552
1,1,2,0,3,0,3,8552
2,2,2,1,5,1,6,8552
3,3,2,2,7,3,10,8552
4,4,0,2,7,5,12,8552
5,5,0,1,7,6,13,8552
6,6,0,0,7,6,13,8552
0,0,1,0,1,0,1,8553
1,1,1,1,2,1,3,8553
2,2,1,1,3,2,5,8553
3,3,1,1,4,3,7,8553
4,4,1,1,5,4,9,8553
5,5,0,0,5,4,9,8553
0,0,1,0,1,0,1,8554
1,1,0,1,1,1,2,8554
2,2,1,0,2,1,3,8554
3,3,1,0,3,1,4,8554
4,4,3,0,6,1,7,8554
5,5,2,0,8,1,9,8554
6,6,2,0,10,1,11,8554
7,7,6,0,16,1,17,8554
8,8,5,2,21,3,24,8554
9,9,1,3,22,6,28,8554
10,10,2,1,24,7,31,8554
11,11,2,0,26,7,33,8554
12,12,2,1,28,8,36,8554
13,13,2,0,30,8,38,8554
14,14,1,0,31,8,39,8554
15,15,0,0,31,8,39,8554
0,0,1,0,1,0,1,8555
1,1,0,0,1,0,1,8555
0,0,1,0,1,0,1,8556
1,1,1,0,2,0,2,8556
2,2,0,1,2,1,3,8556
3,3,0,0,2,1,3,8556
0,0,1,0,1,0,1,8557
1,1,2,1,3,1,4,8557
2,2,1,1,4,2,6,8557
3,3,2,0,6,2,8,8557
4,4,0,1,6,3,9,8557
5,5,1,1,7,4,11,8557
6,6,0,1,7,5,12,8557
7,7,0,0,7,5,12,8557
0,0,1,0,1,0,1,8558
1,1,0,0,1,0,1,8558
0,0,1,0,1,0,1,8559
1,1,0,0,1,0,1,8559
0,0,1,0,1,0,1,8560
1,1,1,0,2,0,2,8560
2,2,2,1,4,1,5,8560
3,3,2,2,6,3,9,8560
4,4,5,1,11,4,15,8560
5,5,6,2,17,6,23,8560
6,6,6,2,23,8,31,8560
7,7,8,1,31,9,40,8560
8,8,2,4,33,13,46,8560
9,9,1,10,34,23,57,8560
10,10,4,7,38,30,68,8560
11,11,4,5,42,35,77,8560
12,12,6,8,48,43,91,8560
13,13,5,6,53,49,102,8560
14,14,7,3,60,52,112,8560
15,15,5,6,65,58,123,8560
16,16,4,5,69,63,132,8560
17,17,2,4,71,67,138,8560
18,18,2,7,73,74,147,8560
19,19,2,11,75,85,160,8560
20,20,1,11,76,96,172,8560
21,21,3,7,79,103,182,8560
22,22,5,8,84,111,195,8560
23,23,6,5,90,116,206,8560
24,24,7,2,97,118,215,8560
25,25,6,5,103,123,226,8560
26,26,6,2,109,125,234,8560
27,27,8,3,117,128,245,8560
28,28,5,1,122,129,251,8560
29,29,3,2,125,131,256,8560
30,30,4,1,129,132,261,8560
31,31,2,1,131,133,264,8560
32,32,2,1,133,134,267,8560
33,33,0,3,133,137,270,8560
34,34,1,2,134,139,273,8560
35,35,3,1,137,140,277,8560
36,36,6,2,143,142,285,8560
37,37,3,2,146,144,290,8560
38,38,2,3,148,147,295,8560
39,39,2,0,150,147,297,8560
40,40,1,0,151,147,298,8560
41,41,1,1,152,148,300,8560
42,42,0,1,152,149,301,8560
43,43,0,1,152,150,302,8560
44,44,1,3,153,153,306,8560
45,45,1,2,154,155,309,8560
46,46,1,2,155,157,312,8560
47,47,0,2,155,159,314,8560
48,48,0,1,155,160,315,8560
49,49,1,2,156,162,318,8560
50,50,1,1,157,163,320,8560
51,51,2,0,159,163,322,8560
52,52,2,0,161,163,324,8560
53,53,2,0,163,163,326,8560
54,54,2,2,165,165,330,8560
55,55,0,2,165,167,332,8560
56,56,1,1,166,168,334,8560
57,57,1,2,167,170,337,8560
58,58,0,5,167,175,342,8560
59,59,1,2,168,177,345,8560
60,60,3,3,171,180,351,8560
61,61,2,1,173,181,354,8560
62,62,4,4,177,185,362,8560
63,63,6,2,183,187,370,8560
64,64,2,2,185,189,374,8560
65,65,6,2,191,191,382,8560
66,66,1,1,192,192,384,8560
67,67,1,0,193,192,385,8560
68,68,3,0,196,192,388,8560
69,69,2,0,198,192,390,8560
70,70,2,0,200,192,392,8560
71,71,3,0,203,192,395,8560
72,72,1,1,204,193,397,8560
73,73,0,1,204,194,398,8560
74,74,1,3,205,197,402,8560
75,75,3,6,208,203,411,8560
76,76,5,5,213,208,421,8560
77,77,1,1,214,209,423,8560
78,78,0,2,214,211,425,8560
79,79,0,0,214,211,425,8560
0,0,1,0,1,0,1,8561
1,1,0,0,1,0,1,8561
0,0,1,0,1,0,1,8562
1,1,1,1,2,1,3,8562
2,2,1,3,3,4,7,8562
3,3,1,3,4,7,11,8562
4,4,1,4,5,11,16,8562
5,5,1,4,6,15,21,8562
6,6,3,6,9,21,30,8562
7,7,6,2,15,23,38,8562
8,8,5,3,20,26,46,8562
9,9,6,0,26,26,52,8562
10,10,4,0,30,26,56,8562
11,11,3,0,33,26,59,8562
12,12,0,0,33,26,59,8562
0,0,1,0,1,0,1,8563
1,1,1,0,2,0,2,8563
2,2,0,0,2,0,2,8563
0,0,1,0,1,0,1,8564
1,1,1,0,2,0,2,8564
2,2,1,0,3,0,3,8564
3,3,1,0,4,0,4,8564
4,4,0,0,4,0,4,8564
0,0,1,0,1,0,1,8565
1,1,0,0,1,0,1,8565
0,0,1,0,1,0,1,8566
1,1,1,0,2,0,2,8566
2,2,0,0,2,0,2,8566
0,0,1,0,1,0,1,8567
1,1,0,1,1,1,2,8567
2,2,1,0,2,1,3,8567
3,3,2,0,4,1,5,8567
4,4,2,0,6,1,7,8567
5,5,1,0,7,1,8,8567
6,6,0,0,7,1,8,8567
0,0,1,0,1,0,1,8568
1,1,0,0,1,0,1,8568
0,0,1,0,1,0,1,8569
1,1,0,0,1,0,1,8569
0,0,1,0,1,0,1,8570
1,1,4,1,5,1,6,8570
2,2,6,5,11,6,17,8570
3,3,4,13,15,19,34,8570
4,4,7,9,22,28,50,8570
5,5,4,9,26,37,63,8570
6,6,4,7,30,44,74,8570
7,7,3,2,33,46,79,8570
8,8,2,0,35,46,81,8570
9,9,3,0,38,46,84,8570
10,10,0,0,38,46,84,8570
0,0,1,0,1,0,1,8571
1,1,3,1,4,1,5,8571
2,2,2,0,6,1,7,8571
3,3,0,1,6,2,8,8571
4,4,2,1,8,3,11,8571
5,5,1,1,9,4,13,8571
6,6,0,1,9,5,14,8571
7,7,0,0,9,5,14,8571
0,0,1,0,1,0,1,8572
1,1,1,0,2,0,2,8572
2,2,0,0,2,0,2,8572
0,0,1,0,1,0,1,8573
1,1,2,0,3,0,3,8573
2,2,2,0,5,0,5,8573
3,3,2,0,7,0,7,8573
4,4,0,0,7,0,7,8573
0,0,1,0,1,0,1,8574
1,1,0,0,1,0,1,8574
0,0,1,0,1,0,1,8575
1,1,2,0,3,0,3,8575
2,2,1,0,4,0,4,8575
3,3,2,0,6,0,6,8575
4,4,1,1,7,1,8,8575
5,5,0,1,7,2,9,8575
6,6,0,1,7,3,10,8575
7,7,0,3,7,6,13,8575
8,8,0,0,7,6,13,8575
0,0,1,0,1,0,1,8576
1,1,1,0,2,0,2,8576
2,2,1,0,3,0,3,8576
3,3,3,0,6,0,6,8576
4,4,5,1,11,1,12,8576
5,5,2,0,13,1,14,8576
6,6,0,0,13,1,14,8576
0,0,1,0,1,0,1,8577
1,1,1,0,2,0,2,8577
2,2,0,0,2,0,2,8577
0,0,1,0,1,0,1,8578
1,1,0,1,1,1,2,8578
2,2,0,2,1,3,4,8578
3,3,0,1,1,4,5,8578
4,4,0,1,1,5,6,8578
5,5,0,0,1,5,6,8578
0,0,1,0,1,0,1,8579
1,1,1,0,2,0,2,8579
2,2,0,0,2,0,2,8579
0,0,1,0,1,0,1,8580
1,1,1,1,2,1,3,8580
2,2,2,0,4,1,5,8580
3,3,1,0,5,1,6,8580
4,4,2,0,7,1,8,8580
5,5,1,0,8,1,9,8580
6,6,0,1,8,2,10,8580
7,7,1,0,9,2,11,8580
8,8,0,0,9,2,11,8580
0,0,1,0,1,0,1,8581
1,1,1,0,2,0,2,8581
2,2,0,0,2,0,2,8581
0,0,1,0,1,0,1,8582
1,1,0,0,1,0,1,8582
0,0,1,0,1,0,1,8583
1,1,0,0,1,0,1,8583
0,0,1,0,1,0,1,8584
1,1,0,1,1,1,2,8584
2,2,0,2,1,3,4,8584
3,3,0,0,1,3,4,8584
0,0,1,0,1,0,1,8585
1,1,1,0,2,0,2,8585
2,2,0,1,2,1,3,8585
3,3,0,2,2,3,5,8585
4,4,1,3,3,6,9,8585
5,5,2,1,5,7,12,8585
6,6,1,1,6,8,14,8585
7,7,3,0,9,8,17,8585
8,8,2,0,11,8,19,8585
9,9,0,0,11,8,19,8585
0,0,1,0,1,0,1,8586
1,1,0,0,1,0,1,8586
0,0,1,0,1,0,1,8587
1,1,1,0,2,0,2,8587
2,2,0,0,2,0,2,8587
0,0,1,0,1,0,1,8588
1,1,1,0,2,0,2,8588
2,2,0,0,2,0,2,8588
0,0,1,0,1,0,1,8589
1,1,1,0,2,0,2,8589
2,2,2,1,4,1,5,8589
3,3,0,0,4,1,5,8589
0,0,1,0,1,0,1,8590
1,1,2,0,3,0,3,8590
2,2,4,0,7,0,7,8590
3,3,3,1,10,1,11,8590
4,4,1,4,11,5,16,8590
5,5,1,0,12,5,17,8590
6,6,1,0,13,5,18,8590
7,7,0,0,13,5,18,8590
0,0,1,0,1,0,1,8591
1,1,1,0,2,0,2,8591
2,2,1,0,3,0,3,8591
3,3,0,0,3,0,3,8591
0,0,1,0,1,0,1,8592
1,1,0,0,1,0,1,8592
0,0,1,0,1,0,1,8593
1,1,0,0,1,0,1,8593
0,0,1,0,1,0,1,8594
1,1,0,0,1,0,1,8594
0,0,1,0,1,0,1,8595
1,1,0,1,1,1,2,8595
2,2,0,0,1,1,2,8595
0,0,1,0,1,0,1,8596
1,1,3,0,4,0,4,8596
2,2,2,1,6,1,7,8596
3,3,4,0,10,1,11,8596
4,4,3,0,13,1,14,8596
5,5,3,0,16,1,17,8596
6,6,3,0,19,1,20,8596
7,7,2,0,21,1,22,8596
8,8,2,0,23,1,24,8596
9,9,1,0,24,1,25,8596
10,10,0,0,24,1,25,8596
0,0,1,0,1,0,1,8597
1,1,0,0,1,0,1,8597
0,0,1,0,1,0,1,8598
1,1,2,0,3,0,3,8598
2,2,3,2,6,2,8,8598
3,3,1,0,7,2,9,8598
4,4,0,0,7,2,9,8598
0,0,1,0,1,0,1,8599
1,1,1,0,2,0,2,8599
2,2,0,0,2,0,2,8599
0,0,1,0,1,0,1,8600
1,1,0,0,1,0,1,8600
0,0,1,0,1,0,1,8601
1,1,0,1,1,1,2,8601
2,2,1,0,2,1,3,8601
3,3,0,0,2,1,3,8601
0,0,1,0,1,0,1,8602
1,1,1,1,2,1,3,8602
2,2,0,1,2,2,4,8602
3,3,0,1,2,3,5,8602
4,4,0,0,2,3,5,8602
0,0,1,0,1,0,1,8603
1,1,0,0,1,0,1,8603
0,0,1,0,1,0,1,8604
1,1,2,0,3,0,3,8604
2,2,1,1,4,1,5,8604
3,3,0,1,4,2,6,8604
4,4,1,0,5,2,7,8604
5,5,2,0,7,2,9,8604
6,6,2,0,9,2,11,8604
7,7,3,1,12,3,15,8604
8,8,1,0,13,3,16,8604
9,9,2,0,15,3,18,8604
10,10,1,0,16,3,19,8604
11,11,0,0,16,3,19,8604
0,0,1,0,1,0,1,8605
1,1,0,0,1,0,1,8605
0,0,1,0,1,0,1,8606
1,1,1,0,2,0,2,8606
2,2,1,0,3,0,3,8606
3,3,1,0,4,0,4,8606
4,4,3,0,7,0,7,8606
5,5,0,1,7,1,8,8606
6,6,0,0,7,1,8,8606
0,0,1,0,1,0,1,8607
1,1,0,0,1,0,1,8607
0,0,1,0,1,0,1,8608
1,1,1,1,2,1,3,8608
2,2,1,0,3,1,4,8608
3,3,0,0,3,1,4,8608
0,0,1,0,1,0,1,8609
1,1,1,0,2,0,2,8609
2,2,4,0,6,0,6,8609
3,3,3,1,9,1,10,8609
4,4,2,2,11,3,14,8609
5,5,1,1,12,4,16,8609
6,6,0,2,12,6,18,8609
7,7,1,3,13,9,22,8609
8,8,1,2,14,11,25,8609
9,9,0,0,14,11,25,8609
0,0,1,0,1,0,1,8610
1,1,0,0,1,0,1,8610
0,0,1,0,1,0,1,8611
1,1,0,0,1,0,1,8611
0,0,1,0,1,0,1,8612
1,1,2,0,3,0,3,8612
2,2,1,0,4,0,4,8612
3,3,0,0,4,0,4,8612
0,0,1,0,1,0,1,8613
1,1,1,0,2,0,2,8613
2,2,1,0,3,0,3,8613
3,3,0,1,3,1,4,8613
4,4,1,1,4,2,6,8613
5,5,0,0,4,2,6,8613
0,0,1,0,1,0,1,8614
1,1,0,1,1,1,2,8614
2,2,0,0,1,1,2,8614
0,0,1,0,1,0,1,8615
1,1,1,0,2,0,2,8615
2,2,1,0,3,0,3,8615
3,3,0,0,3,0,3,8615
0,0,1,0,1,0,1,8616
1,1,0,0,1,0,1,8616
0,0,1,0,1,0,1,8617
1,1,0,0,1,0,1,8617
0,0,1,0,1,0,1,8618
1,1,1,0,2,0,2,8618
2,2,0,0,2,0,2,8618
0,0,1,0,1,0,1,8619
1,1,1,0,2,0,2,8619
2,2,1,1,3,1,4,8619
3,3,2,2,5,3,8,8619
4,4,2,5,7,8,15,8619
5,5,3,6,10,14,24,8619
6,6,5,3,15,17,32,8619
7,7,7,3,22,20,42,8619
8,8,5,3,27,23,50,8619
9,9,3,2,30,25,55,8619
10,10,4,2,34,27,61,8619
11,11,3,4,37,31,68,8619
12,12,3,3,40,34,74,8619
13,13,5,2,45,36,81,8619
14,14,3,3,48,39,87,8619
15,15,2,2,50,41,91,8619
16,16,2,2,52,43,95,8619
17,17,3,1,55,44,99,8619
18,18,1,3,56,47,103,8619
19,19,0,1,56,48,104,8619
20,20,0,4,56,52,108,8619
21,21,1,2,57,54,111,8619
22,22,0,2,57,56,113,8619
23,23,0,0,57,56,113,8619
0,0,1,0,1,0,1,8620
1,1,0,0,1,0,1,8620
0,0,1,0,1,0,1,8621
1,1,0,0,1,0,1,8621
0,0,1,0,1,0,1,8622
1,1,0,0,1,0,1,8622
0,0,1,0,1,0,1,8623
1,1,2,0,3,0,3,8623
2,2,1,1,4,1,5,8623
3,3,0,2,4,3,7,8623
4,4,1,2,5,5,10,8623
5,5,0,0,5,5,10,8623
0,0,1,0,1,0,1,8624
1,1,0,0,1,0,1,8624
0,0,1,0,1,0,1,8625
1,1,0,0,1,0,1,8625
0,0,1,0,1,0,1,8626
1,1,2,0,3,0,3,8626
2,2,0,0,3,0,3,8626
0,0,1,0,1,0,1,8627
1,1,1,0,2,0,2,8627
2,2,0,1,2,1,3,8627
3,3,0,1,2,2,4,8627
4,4,1,2,3,4,7,8627
5,5,1,1,4,5,9,8627
6,6,2,0,6,5,11,8627
7,7,2,0,8,5,13,8627
8,8,0,0,8,5,13,8627
0,0,1,0,1,0,1,8628
1,1,1,0,2,0,2,8628
2,2,0,0,2,0,2,8628
0,0,1,0,1,0,1,8629
1,1,0,0,1,0,1,8629
0,0,1,0,1,0,1,8630
1,1,1,0,2,0,2,8630
2,2,1,0,3,0,3,8630
3,3,0,0,3,0,3,8630
0,0,1,0,1,0,1,8631
1,1,2,0,3,0,3,8631
2,2,1,1,4,1,5,8631
3,3,0,0,4,1,5,8631
0,0,1,0,1,0,1,8632
1,1,0,0,1,0,1,8632
0,0,1,0,1,0,1,8633
1,1,0,0,1,0,1,8633
0,0,1,0,1,0,1,8634
1,1,0,0,1,0,1,8634
0,0,1,0,1,0,1,8635
1,1,0,1,1,1,2,8635
2,2,0,1,1,2,3,8635
3,3,0,1,1,3,4,8635
4,4,0,2,1,5,6,8635
5,5,0,2,1,7,8,8635
6,6,0,0,1,7,8,8635
0,0,1,0,1,0,1,8636
1,1,1,0,2,0,2,8636
2,2,1,0,3,0,3,8636
3,3,1,0,4,0,4,8636
4,4,0,0,4,0,4,8636
0,0,1,0,1,0,1,8637
1,1,1,0,2,0,2,8637
2,2,0,0,2,0,2,8637
0,0,1,0,1,0,1,8638
1,1,1,0,2,0,2,8638
2,2,1,0,3,0,3,8638
3,3,1,0,4,0,4,8638
4,4,0,1,4,1,5,8638
5,5,1,0,5,1,6,8638
6,6,1,0,6,1,7,8638
7,7,2,0,8,1,9,8638
8,8,2,0,10,1,11,8638
9,9,0,0,10,1,11,8638
0,0,1,0,1,0,1,8639
1,1,1,0,2,0,2,8639
2,2,0,0,2,0,2,8639
0,0,1,0,1,0,1,8640
1,1,1,0,2,0,2,8640
2,2,0,0,2,0,2,8640
0,0,1,0,1,0,1,8641
1,1,1,0,2,0,2,8641
2,2,0,0,2,0,2,8641
0,0,1,0,1,0,1,8642
1,1,0,1,1,1,2,8642
2,2,0,1,1,2,3,8642
3,3,0,3,1,5,6,8642
4,4,0,3,1,8,9,8642
5,5,0,3,1,11,12,8642
6,6,0,3,1,14,15,8642
7,7,0,4,1,18,19,8642
8,8,0,5,1,23,24,8642
9,9,0,1,1,24,25,8642
10,10,0,1,1,25,26,8642
11,11,0,2,1,27,28,8642
12,12,0,1,1,28,29,8642
13,13,1,1,2,29,31,8642
14,14,2,3,4,32,36,8642
15,15,2,3,6,35,41,8642
16,16,1,2,7,37,44,8642
17,17,1,3,8,40,48,8642
18,18,0,1,8,41,49,8642
19,19,0,1,8,42,50,8642
20,20,0,0,8,42,50,8642
0,0,1,0,1,0,1,8643
1,1,1,0,2,0,2,8643
2,2,0,1,2,1,3,8643
3,3,0,1,2,2,4,8643
4,4,0,1,2,3,5,8643
5,5,0,1,2,4,6,8643
6,6,0,1,2,5,7,8643
7,7,0,2,2,7,9,8643
8,8,0,2,2,9,11,8643
9,9,2,1,4,10,14,8643
10,10,1,0,5,10,15,8643
11,11,0,0,5,10,15,8643
0,0,1,0,1,0,1,8644
1,1,0,0,1,0,1,8644
0,0,1,0,1,0,1,8645
1,1,1,0,2,0,2,8645
2,2,0,1,2,1,3,8645
3,3,0,0,2,1,3,8645
0,0,1,0,1,0,1,8646
1,1,1,0,2,0,2,8646
2,2,1,0,3,0,3,8646
3,3,0,0,3,0,3,8646
0,0,1,0,1,0,1,8647
1,1,0,0,1,0,1,8647
0,0,1,0,1,0,1,8648
1,1,2,0,3,0,3,8648
2,2,2,0,5,0,5,8648
3,3,2,0,7,0,7,8648
4,4,2,0,9,0,9,8648
5,5,3,2,12,2,14,8648
6,6,3,0,15,2,17,8648
7,7,4,0,19,2,21,8648
8,8,4,0,23,2,25,8648
9,9,2,0,25,2,27,8648
10,10,3,0,28,2,30,8648
11,11,1,0,29,2,31,8648
12,12,0,0,29,2,31,8648
0,0,1,0,1,0,1,8649
1,1,4,0,5,0,5,8649
2,2,3,0,8,0,8,8649
3,3,3,0,11,0,11,8649
4,4,3,2,14,2,16,8649
5,5,1,3,15,5,20,8649
6,6,3,1,18,6,24,8649
7,7,0,0,18,6,24,8649
0,0,1,0,1,0,1,8650
1,1,1,0,2,0,2,8650
2,2,2,0,4,0,4,8650
3,3,1,0,5,0,5,8650
4,4,1,0,6,0,6,8650
5,5,1,0,7,0,7,8650
6,6,0,0,7,0,7,8650
0,0,1,0,1,0,1,8651
1,1,1,0,2,0,2,8651
2,2,0,0,2,0,2,8651
0,0,1,0,1,0,1,8652
1,1,1,0,2,0,2,8652
2,2,0,1,2,1,3,8652
3,3,1,0,3,1,4,8652
4,4,0,0,3,1,4,8652
0,0,1,0,1,0,1,8653
1,1,2,0,3,0,3,8653
2,2,3,0,6,0,6,8653
3,3,2,1,8,1,9,8653
4,4,1,0,9,1,10,8653
5,5,2,0,11,1,12,8653
6,6,2,1,13,2,15,8653
7,7,2,0,15,2,17,8653
8,8,2,1,17,3,20,8653
9,9,2,0,19,3,22,8653
10,10,4,0,23,3,26,8653
11,11,3,0,26,3,29,8653
12,12,2,0,28,3,31,8653
13,13,1,0,29,3,32,8653
14,14,2,0,31,3,34,8653
15,15,1,0,32,3,35,8653
16,16,2,1,34,4,38,8653
17,17,4,1,38,5,43,8653
18,18,4,2,42,7,49,8653
19,19,1,0,43,7,50,8653
20,20,0,0,43,7,50,8653
0,0,1,0,1,0,1,8654
1,1,0,0,1,0,1,8654
0,0,1,0,1,0,1,8655
1,1,0,1,1,1,2,8655
2,2,0,1,1,2,3,8655
3,3,1,1,2,3,5,8655
4,4,0,3,2,6,8,8655
5,5,0,5,2,11,13,8655
6,6,1,4,3,15,18,8655
7,7,2,5,5,20,25,8655
8,8,3,3,8,23,31,8655
9,9,0,4,8,27,35,8655
10,10,3,3,11,30,41,8655
11,11,2,1,13,31,44,8655
12,12,2,2,15,33,48,8655
13,13,4,0,19,33,52,8655
14,14,6,0,25,33,58,8655
15,15,4,1,29,34,63,8655
16,16,3,2,32,36,68,8655
17,17,5,1,37,37,74,8655
18,18,2,1,39,38,77,8655
19,19,1,0,40,38,78,8655
20,20,0,1,40,39,79,8655
21,21,0,1,40,40,80,8655
22,22,0,2,40,42,82,8655
23,23,2,0,42,42,84,8655
24,24,1,0,43,42,85,8655
25,25,3,0,46,42,88,8655
26,26,3,1,49,43,92,8655
27,27,1,0,50,43,93,8655
28,28,1,0,51,43,94,8655
29,29,1,0,52,43,95,8655
30,30,4,0,56,43,99,8655
31,31,1,1,57,44,101,8655
32,32,0,3,57,47,104,8655
33,33,0,1,57,48,105,8655
34,34,0,2,57,50,107,8655
35,35,0,2,57,52,109,8655
36,36,0,1,57,53,110,8655
37,37,0,0,57,53,110,8655
0,0,1,0,1,0,1,8656
1,1,3,0,4,0,4,8656
2,2,1,2,5,2,7,8656
3,3,3,2,8,4,12,8656
4,4,2,4,10,8,18,8656
5,5,0,2,10,10,20,8656
6,6,1,0,11,10,21,8656
7,7,0,0,11,10,21,8656
0,0,1,0,1,0,1,8657
1,1,2,0,3,0,3,8657
2,2,0,1,3,1,4,8657
3,3,1,1,4,2,6,8657
4,4,2,1,6,3,9,8657
5,5,1,1,7,4,11,8657
6,6,1,0,8,4,12,8657
7,7,1,0,9,4,13,8657
8,8,0,0,9,4,13,8657
0,0,1,0,1,0,1,8658
1,1,1,0,2,0,2,8658
2,2,2,0,4,0,4,8658
3,3,0,0,4,0,4,8658
0,0,1,0,1,0,1,8659
1,1,1,0,2,0,2,8659
2,2,0,0,2,0,2,8659
0,0,1,0,1,0,1,8660
1,1,1,1,2,1,3,8660
2,2,2,0,4,1,5,8660
3,3,2,0,6,1,7,8660
4,4,0,0,6,1,7,8660
0,0,1,0,1,0,1,8661
1,1,0,0,1,0,1,8661
0,0,1,0,1,0,1,8662
1,1,0,0,1,0,1,8662
0,0,1,0,1,0,1,8663
1,1,1,0,2,0,2,8663
2,2,0,0,2,0,2,8663
0,0,1,0,1,0,1,8664
1,1,1,0,2,0,2,8664
2,2,1,1,3,1,4,8664
3,3,2,0,5,1,6,8664
4,4,1,0,6,1,7,8664
5,5,1,1,7,2,9,8664
6,6,0,0,7,2,9,8664
0,0,1,0,1,0,1,8665
1,1,0,1,1,1,2,8665
2,2,0,2,1,3,4,8665
3,3,0,2,1,5,6,8665
4,4,0,2,1,7,8,8665
5,5,0,1,1,8,9,8665
6,6,0,1,1,9,10,8665
7,7,0,1,1,10,11,8665
8,8,0,0,1,10,11,8665
0,0,1,0,1,0,1,8666
1,1,3,0,4,0,4,8666
2,2,2,1,6,1,7,8666
3,3,2,0,8,1,9,8666
4,4,2,0,10,1,11,8666
5,5,1,0,11,1,12,8666
6,6,2,0,13,1,14,8666
7,7,1,1,14,2,16,8666
8,8,0,0,14,2,16,8666
0,0,1,0,1,0,1,8667
1,1,1,0,2,0,2,8667
2,2,0,0,2,0,2,8667
0,0,1,0,1,0,1,8668
1,1,3,0,4,0,4,8668
2,2,1,1,5,1,6,8668
3,3,0,2,5,3,8,8668
4,4,1,1,6,4,10,8668
5,5,2,3,8,7,15,8668
6,6,3,0,11,7,18,8668
7,7,3,0,14,7,21,8668
8,8,1,0,15,7,22,8668
9,9,2,0,17,7,24,8668
10,10,0,0,17,7,24,8668
0,0,1,0,1,0,1,8669
1,1,1,0,2,0,2,8669
2,2,1,0,3,0,3,8669
3,3,0,0,3,0,3,8669
0,0,1,0,1,0,1,8670
1,1,2,0,3,0,3,8670
2,2,4,0,7,0,7,8670
3,3,0,1,7,1,8,8670
4,4,0,2,7,3,10,8670
5,5,1,1,8,4,12,8670
6,6,0,0,8,4,12,8670
0,0,1,0,1,0,1,8671
1,1,1,0,2,0,2,8671
2,2,2,0,4,0,4,8671
3,3,2,0,6,0,6,8671
4,4,2,0,8,0,8,8671
5,5,3,0,11,0,11,8671
6,6,3,0,14,0,14,8671
7,7,3,0,17,0,17,8671
8,8,1,0,18,0,18,8671
9,9,0,0,18,0,18,8671
0,0,1,0,1,0,1,8672
1,1,0,1,1,1,2,8672
2,2,0,1,1,2,3,8672
3,3,0,2,1,4,5,8672
4,4,0,1,1,5,6,8672
5,5,0,0,1,5,6,8672
0,0,1,0,1,0,1,8673
1,1,0,0,1,0,1,8673
0,0,1,0,1,0,1,8674
1,1,0,0,1,0,1,8674
0,0,1,0,1,0,1,8675
1,1,0,0,1,0,1,8675
0,0,1,0,1,0,1,8676
1,1,1,0,2,0,2,8676
2,2,0,0,2,0,2,8676
0,0,1,0,1,0,1,8677
1,1,0,1,1,1,2,8677
2,2,0,0,1,1,2,8677
0,0,1,0,1,0,1,8678
1,1,0,0,1,0,1,8678
0,0,1,0,1,0,1,8679
1,1,0,0,1,0,1,8679
0,0,1,0,1,0,1,8680
1,1,1,0,2,0,2,8680
2,2,2,0,4,0,4,8680
3,3,3,1,7,1,8,8680
4,4,1,1,8,2,10,8680
5,5,1,1,9,3,12,8680
6,6,0,0,9,3,12,8680
0,0,1,0,1,0,1,8681
1,1,0,0,1,0,1,8681
0,0,1,0,1,0,1,8682
1,1,1,0,2,0,2,8682
2,2,0,0,2,0,2,8682
0,0,1,0,1,0,1,8683
1,1,2,1,3,1,4,8683
2,2,0,0,3,1,4,8683
0,0,1,0,1,0,1,8684
1,1,1,1,2,1,3,8684
2,2,1,0,3,1,4,8684
3,3,1,0,4,1,5,8684
4,4,0,0,4,1,5,8684
0,0,1,0,1,0,1,8685
1,1,0,0,1,0,1,8685
0,0,1,0,1,0,1,8686
1,1,0,1,1,1,2,8686
2,2,0,1,1,2,3,8686
3,3,0,1,1,3,4,8686
4,4,0,2,1,5,6,8686
5,5,0,2,1,7,8,8686
6,6,0,0,1,7,8,8686
0,0,1,0,1,0,1,8687
1,1,0,0,1,0,1,8687
0,0,1,0,1,0,1,8688
1,1,3,0,4,0,4,8688
2,2,3,0,7,0,7,8688
3,3,0,0,7,0,7,8688
0,0,1,0,1,0,1,8689
1,1,1,0,2,0,2,8689
2,2,0,0,2,0,2,8689
0,0,1,0,1,0,1,8690
1,1,1,1,2,1,3,8690
2,2,4,2,6,3,9,8690
3,3,2,2,8,5,13,8690
4,4,2,1,10,6,16,8690
5,5,3,1,13,7,20,8690
6,6,4,0,17,7,24,8690
7,7,3,2,20,9,29,8690
8,8,2,0,22,9,31,8690
9,9,0,1,22,10,32,8690
10,10,0,1,22,11,33,8690
11,11,0,1,22,12,34,8690
12,12,0,0,22,12,34,8690
0,0,1,0,1,0,1,8691
1,1,2,0,3,0,3,8691
2,2,1,0,4,0,4,8691
3,3,0,0,4,0,4,8691
0,0,1,0,1,0,1,8692
1,1,0,1,1,1,2,8692
2,2,0,1,1,2,3,8692
3,3,0,0,1,2,3,8692
0,0,1,0,1,0,1,8693
1,1,0,1,1,1,2,8693
2,2,0,0,1,1,2,8693
0,0,1,0,1,0,1,8694
1,1,0,1,1,1,2,8694
2,2,0,0,1,1,2,8694
0,0,1,0,1,0,1,8695
1,1,0,0,1,0,1,8695
0,0,1,0,1,0,1,8696
1,1,0,0,1,0,1,8696
0,0,1,0,1,0,1,8697
1,1,1,0,2,0,2,8697
2,2,0,0,2,0,2,8697
0,0,1,0,1,0,1,8698
1,1,1,1,2,1,3,8698
2,2,0,0,2,1,3,8698
0,0,1,0,1,0,1,8699
1,1,1,0,2,0,2,8699
2,2,1,1,3,1,4,8699
3,3,0,0,3,1,4,8699
0,0,1,0,1,0,1,8700
1,1,1,1,2,1,3,8700
2,2,0,1,2,2,4,8700
3,3,0,1,2,3,5,8700
4,4,0,2,2,5,7,8700
5,5,0,1,2,6,8,8700
6,6,1,1,3,7,10,8700
7,7,2,2,5,9,14,8700
8,8,3,1,8,10,18,8700
9,9,0,0,8,10,18,8700
0,0,1,0,1,0,1,8701
1,1,3,0,4,0,4,8701
2,2,2,0,6,0,6,8701
3,3,2,1,8,1,9,8701
4,4,2,1,10,2,12,8701
5,5,3,3,13,5,18,8701
6,6,0,1,13,6,19,8701
7,7,0,2,13,8,21,8701
8,8,2,2,15,10,25,8701
9,9,2,2,17,12,29,8701
10,10,3,2,20,14,34,8701
11,11,5,3,25,17,42,8701
12,12,2,3,27,20,47,8701
13,13,5,1,32,21,53,8701
14,14,1,0,33,21,54,8701
15,15,0,1,33,22,55,8701
16,16,0,1,33,23,56,8701
17,17,0,2,33,25,58,8701
18,18,0,1,33,26,59,8701
19,19,0,0,33,26,59,8701
0,0,1,0,1,0,1,8702
1,1,0,0,1,0,1,8702
0,0,1,0,1,0,1,8703
1,1,0,0,1,0,1,8703
0,0,1,0,1,0,1,8704
1,1,0,0,1,0,1,8704
0,0,1,0,1,0,1,8705
1,1,1,0,2,0,2,8705
2,2,1,1,3,1,4,8705
3,3,1,1,4,2,6,8705
4,4,0,3,4,5,9,8705
5,5,1,2,5,7,12,8705
6,6,2,1,7,8,15,8705
7,7,0,1,7,9,16,8705
8,8,0,2,7,11,18,8705
9,9,0,2,7,13,20,8705
10,10,1,0,8,13,21,8705
11,11,0,1,8,14,22,8705
12,12,0,1,8,15,23,8705
13,13,0,1,8,16,24,8705
14,14,0,1,8,17,25,8705
15,15,0,2,8,19,27,8705
16,16,0,1,8,20,28,8705
17,17,0,0,8,20,28,8705
0,0,1,0,1,0,1,8706
1,1,0,0,1,0,1,8706
0,0,1,0,1,0,1,8707
1,1,0,0,1,0,1,8707
0,0,1,0,1,0,1,8708
1,1,3,0,4,0,4,8708
2,2,3,0,7,0,7,8708
3,3,3,1,10,1,11,8708
4,4,1,0,11,1,12,8708
5,5,3,0,14,1,15,8708
6,6,1,4,15,5,20,8708
7,7,0,2,15,7,22,8708
8,8,0,0,15,7,22,8708
0,0,1,0,1,0,1,8709
1,1,1,0,2,0,2,8709
2,2,0,1,2,1,3,8709
3,3,0,2,2,3,5,8709
4,4,0,1,2,4,6,8709
5,5,0,0,2,4,6,8709
0,0,1,0,1,0,1,8710
1,1,0,0,1,0,1,8710
0,0,1,0,1,0,1,8711
1,1,2,0,3,0,3,8711
2,2,2,1,5,1,6,8711
3,3,1,1,6,2,8,8711
4,4,0,0,6,2,8,8711
0,0,1,0,1,0,1,8712
1,1,0,0,1,0,1,8712
0,0,1,0,1,0,1,8713
1,1,0,0,1,0,1,8713
0,0,1,0,1,0,1,8714
1,1,1,0,2,0,2,8714
2,2,2,0,4,0,4,8714
3,3,0,0,4,0,4,8714
0,0,1,0,1,0,1,8715
1,1,2,0,3,0,3,8715
2,2,2,1,5,1,6,8715
3,3,1,0,6,1,7,8715
4,4,0,1,6,2,8,8715
5,5,0,0,6,2,8,8715
0,0,1,0,1,0,1,8716
1,1,0,0,1,0,1,8716
0,0,1,0,1,0,1,8717
1,1,1,0,2,0,2,8717
2,2,0,0,2,0,2,8717
0,0,1,0,1,0,1,8718
1,1,2,1,3,1,4,8718
2,2,2,0,5,1,6,8718
3,3,1,0,6,1,7,8718
4,4,0,1,6,2,8,8718
5,5,0,0,6,2,8,8718
0,0,1,0,1,0,1,8719
1,1,1,0,2,0,2,8719
2,2,1,0,3,0,3,8719
3,3,1,0,4,0,4,8719
4,4,0,0,4,0,4,8719
0,0,1,0,1,0,1,8720
1,1,0,0,1,0,1,8720
0,0,1,0,1,0,1,8721
1,1,0,0,1,0,1,8721
0,0,1,0,1,0,1,8722
1,1,1,0,2,0,2,8722
2,2,1,0,3,0,3,8722
3,3,0,0,3,0,3,8722
0,0,1,0,1,0,1,8723
1,1,1,0,2,0,2,8723
2,2,0,1,2,1,3,8723
3,3,0,1,2,2,4,8723
4,4,1,1,3,3,6,8723
5,5,3,3,6,6,12,8723
6,6,1,3,7,9,16,8723
7,7,1,1,8,10,18,8723
8,8,0,0,8,10,18,8723
0,0,1,0,1,0,1,8724
1,1,2,0,3,0,3,8724
2,2,2,1,5,1,6,8724
3,3,1,2,6,3,9,8724
4,4,0,5,6,8,14,8724
5,5,0,2,6,10,16,8724
6,6,0,1,6,11,17,8724
7,7,0,0,6,11,17,8724
0,0,1,0,1,0,1,8725
1,1,0,0,1,0,1,8725
0,0,1,0,1,0,1,8726
1,1,1,0,2,0,2,8726
2,2,1,0,3,0,3,8726
3,3,1,1,4,1,5,8726
4,4,2,1,6,2,8,8726
5,5,2,0,8,2,10,8726
6,6,2,0,10,2,12,8726
7,7,1,0,11,2,13,8726
8,8,0,0,11,2,13,8726
0,0,1,0,1,0,1,8727
1,1,1,0,2,0,2,8727
2,2,0,1,2,1,3,8727
3,3,0,3,2,4,6,8727
4,4,0,4,2,8,10,8727
5,5,4,3,6,11,17,8727
6,6,6,2,12,13,25,8727
7,7,4,2,16,15,31,8727
8,8,4,2,20,17,37,8727
9,9,5,2,25,19,44,8727
10,10,7,2,32,21,53,8727
11,11,7,0,39,21,60,8727
12,12,5,3,44,24,68,8727
13,13,4,2,48,26,74,8727
14,14,7,3,55,29,84,8727
15,15,4,3,59,32,91,8727
16,16,5,3,64,35,99,8727
17,17,4,5,68,40,108,8727
18,18,6,3,74,43,117,8727
19,19,4,4,78,47,125,8727
20,20,3,5,81,52,133,8727
21,21,0,4,81,56,137,8727
22,22,0,1,81,57,138,8727
23,23,0,0,81,57,138,8727
0,0,1,0,1,0,1,8728
1,1,0,1,1,1,2,8728
2,2,0,0,1,1,2,8728
0,0,1,0,1,0,1,8729
1,1,3,0,4,0,4,8729
2,2,2,0,6,0,6,8729
3,3,3,0,9,0,9,8729
4,4,2,2,11,2,13,8729
5,5,1,3,12,5,17,8729
6,6,0,4,12,9,21,8729
7,7,0,3,12,12,24,8729
8,8,0,2,12,14,26,8729
9,9,1,0,13,14,27,8729
10,10,2,0,15,14,29,8729
11,11,2,0,17,14,31,8729
12,12,1,1,18,15,33,8729
13,13,2,1,20,16,36,8729
14,14,0,1,20,17,37,8729
15,15,0,0,20,17,37,8729
0,0,1,0,1,0,1,8730
1,1,0,0,1,0,1,8730
0,0,1,0,1,0,1,8731
1,1,0,0,1,0,1,8731
0,0,1,0,1,0,1,8732
1,1,1,0,2,0,2,8732
2,2,3,0,5,0,5,8732
3,3,0,1,5,1,6,8732
4,4,0,1,5,2,7,8732
5,5,0,2,5,4,9,8732
6,6,1,1,6,5,11,8732
7,7,0,1,6,6,12,8732
8,8,0,0,6,6,12,8732
0,0,1,0,1,0,1,8733
1,1,2,0,3,0,3,8733
2,2,2,2,5,2,7,8733
3,3,4,2,9,4,13,8733
4,4,0,2,9,6,15,8733
5,5,0,0,9,6,15,8733
0,0,1,0,1,0,1,8734
1,1,0,0,1,0,1,8734
0,0,1,0,1,0,1,8735
1,1,1,0,2,0,2,8735
2,2,1,1,3,1,4,8735
3,3,0,1,3,2,5,8735
4,4,0,0,3,2,5,8735
0,0,1,0,1,0,1,8736
1,1,0,0,1,0,1,8736
0,0,1,0,1,0,1,8737
1,1,0,0,1,0,1,8737
0,0,1,0,1,0,1,8738
1,1,1,0,2,0,2,8738
2,2,2,1,4,1,5,8738
3,3,5,0,9,1,10,8738
4,4,3,1,12,2,14,8738
5,5,1,3,13,5,18,8738
6,6,1,3,14,8,22,8738
7,7,1,1,15,9,24,8738
8,8,1,0,16,9,25,8738
9,9,0,0,16,9,25,8738
0,0,1,0,1,0,1,8739
1,1,0,0,1,0,1,8739
0,0,1,0,1,0,1,8740
1,1,0,0,1,0,1,8740
0,0,1,0,1,0,1,8741
1,1,0,0,1,0,1,8741
0,0,1,0,1,0,1,8742
1,1,0,0,1,0,1,8742
0,0,1,0,1,0,1,8743
1,1,2,0,3,0,3,8743
2,2,1,1,4,1,5,8743
3,3,2,0,6,1,7,8743
4,4,3,0,9,1,10,8743
5,5,2,1,11,2,13,8743
6,6,0,3,11,5,16,8743
7,7,0,2,11,7,18,8743
8,8,0,3,11,10,21,8743
9,9,1,1,12,11,23,8743
10,10,1,2,13,13,26,8743
11,11,1,1,14,14,28,8743
12,12,1,0,15,14,29,8743
13,13,0,0,15,14,29,8743
0,0,1,0,1,0,1,8744
1,1,0,1,1,1,2,8744
2,2,0,1,1,2,3,8744
3,3,0,0,1,2,3,8744
0,0,1,0,1,0,1,8745
1,1,1,0,2,0,2,8745
2,2,0,2,2,2,4,8745
3,3,0,2,2,4,6,8745
4,4,1,2,3,6,9,8745
5,5,2,1,5,7,12,8745
6,6,0,4,5,11,16,8745
7,7,0,3,5,14,19,8745
8,8,0,5,5,19,24,8745
9,9,0,2,5,21,26,8745
10,10,0,2,5,23,28,8745
11,11,0,2,5,25,30,8745
12,12,0,0,5,25,30,8745
0,0,1,0,1,0,1,8746
1,1,1,1,2,1,3,8746
2,2,2,0,4,1,5,8746
3,3,1,0,5,1,6,8746
4,4,0,0,5,1,6,8746
0,0,1,0,1,0,1,8747
1,1,0,0,1,0,1,8747
0,0,1,0,1,0,1,8748
1,1,0,0,1,0,1,8748
0,0,1,0,1,0,1,8749
1,1,1,0,2,0,2,8749
2,2,0,0,2,0,2,8749
0,0,1,0,1,0,1,8750
1,1,0,1,1,1,2,8750
2,2,0,0,1,1,2,8750
0,0,1,0,1,0,1,8751
1,1,0,0,1,0,1,8751
0,0,1,0,1,0,1,8752
1,1,0,0,1,0,1,8752
0,0,1,0,1,0,1,8753
1,1,2,0,3,0,3,8753
2,2,3,1,6,1,7,8753
3,3,2,1,8,2,10,8753
4,4,0,1,8,3,11,8753
5,5,0,0,8,3,11,8753
0,0,1,0,1,0,1,8754
1,1,0,0,1,0,1,8754
0,0,1,0,1,0,1,8755
1,1,0,0,1,0,1,8755
0,0,1,0,1,0,1,8756
1,1,1,0,2,0,2,8756
2,2,1,0,3,0,3,8756
3,3,1,1,4,1,5,8756
4,4,1,0,5,1,6,8756
5,5,0,0,5,1,6,8756
0,0,1,0,1,0,1,8757
1,1,1,0,2,0,2,8757
2,2,0,1,2,1,3,8757
3,3,0,1,2,2,4,8757
4,4,0,1,2,3,5,8757
5,5,0,0,2,3,5,8757
0,0,1,0,1,0,1,8758
1,1,0,1,1,1,2,8758
2,2,0,0,1,1,2,8758
0,0,1,0,1,0,1,8759
1,1,0,0,1,0,1,8759
0,0,1,0,1,0,1,8760
1,1,0,0,1,0,1,8760
0,0,1,0,1,0,1,8761
1,1,1,0,2,0,2,8761
2,2,0,0,2,0,2,8761
0,0,1,0,1,0,1,8762
1,1,0,0,1,0,1,8762
0,0,1,0,1,0,1,8763
1,1,1,0,2,0,2,8763
2,2,0,0,2,0,2,8763
0,0,1,0,1,0,1,8764
1,1,1,0,2,0,2,8764
2,2,0,0,2,0,2,8764
0,0,1,0,1,0,1,8765
1,1,0,0,1,0,1,8765
0,0,1,0,1,0,1,8766
1,1,1,0,2,0,2,8766
2,2,0,0,2,0,2,8766
0,0,1,0,1,0,1,8767
1,1,2,0,3,0,3,8767
2,2,1,0,4,0,4,8767
3,3,0,1,4,1,5,8767
4,4,0,2,4,3,7,8767
5,5,0,2,4,5,9,8767
6,6,0,0,4,5,9,8767
0,0,1,0,1,0,1,8768
1,1,0,0,1,0,1,8768
0,0,1,0,1,0,1,8769
1,1,0,0,1,0,1,8769
0,0,1,0,1,0,1,8770
1,1,1,0,2,0,2,8770
2,2,0,0,2,0,2,8770
0,0,1,0,1,0,1,8771
1,1,1,0,2,0,2,8771
2,2,0,0,2,0,2,8771
0,0,1,0,1,0,1,8772
1,1,0,0,1,0,1,8772
0,0,1,0,1,0,1,8773
1,1,0,0,1,0,1,8773
0,0,1,0,1,0,1,8774
1,1,0,0,1,0,1,8774
0,0,1,0,1,0,1,8775
1,1,0,0,1,0,1,8775
0,0,1,0,1,0,1,8776
1,1,1,1,2,1,3,8776
2,2,3,0,5,1,6,8776
3,3,1,1,6,2,8,8776
4,4,1,2,7,4,11,8776
5,5,1,4,8,8,16,8776
6,6,1,2,9,10,19,8776
7,7,1,0,10,10,20,8776
8,8,2,0,12,10,22,8776
9,9,2,0,14,10,24,8776
10,10,0,0,14,10,24,8776
0,0,1,0,1,0,1,8777
1,1,1,0,2,0,2,8777
2,2,1,0,3,0,3,8777
3,3,0,1,3,1,4,8777
4,4,0,0,3,1,4,8777
0,0,1,0,1,0,1,8778
1,1,3,0,4,0,4,8778
2,2,2,2,6,2,8,8778
3,3,2,0,8,2,10,8778
4,4,0,0,8,2,10,8778
0,0,1,0,1,0,1,8779
1,1,1,1,2,1,3,8779
2,2,0,1,2,2,4,8779
3,3,0,1,2,3,5,8779
4,4,0,1,2,4,6,8779
5,5,0,0,2,4,6,8779
0,0,1,0,1,0,1,8780
1,1,1,0,2,0,2,8780
2,2,1,1,3,1,4,8780
3,3,0,3,3,4,7,8780
4,4,0,3,3,7,10,8780
5,5,0,2,3,9,12,8780
6,6,1,0,4,9,13,8780
7,7,1,1,5,10,15,8780
8,8,0,0,5,10,15,8780
0,0,1,0,1,0,1,8781
1,1,0,0,1,0,1,8781
0,0,1,0,1,0,1,8782
1,1,0,0,1,0,1,8782
0,0,1,0,1,0,1,8783
1,1,0,0,1,0,1,8783
0,0,1,0,1,0,1,8784
1,1,1,0,2,0,2,8784
2,2,1,0,3,0,3,8784
3,3,0,0,3,0,3,8784
0,0,1,0,1,0,1,8785
1,1,0,0,1,0,1,8785
0,0,1,0,1,0,1,8786
1,1,0,0,1,0,1,8786
0,0,1,0,1,0,1,8787
1,1,0,0,1,0,1,8787
0,0,1,0,1,0,1,8788
1,1,1,1,2,1,3,8788
2,2,0,1,2,2,4,8788
3,3,0,0,2,2,4,8788
0,0,1,0,1,0,1,8789
1,1,0,0,1,0,1,8789
0,0,1,0,1,0,1,8790
1,1,0,0,1,0,1,8790
0,0,1,0,1,0,1,8791
1,1,0,1,1,1,2,8791
2,2,0,1,1,2,3,8791
3,3,0,0,1,2,3,8791
0,0,1,0,1,0,1,8792
1,1,0,0,1,0,1,8792
0,0,1,0,1,0,1,8793
1,1,1,1,2,1,3,8793
2,2,1,1,3,2,5,8793
3,3,1,1,4,3,7,8793
4,4,1,0,5,3,8,8793
5,5,0,0,5,3,8,8793
0,0,1,0,1,0,1,8794
1,1,2,1,3,1,4,8794
2,2,0,1,3,2,5,8794
3,3,0,0,3,2,5,8794
0,0,1,0,1,0,1,8795
1,1,0,0,1,0,1,8795
0,0,1,0,1,0,1,8796
1,1,1,0,2,0,2,8796
2,2,2,1,4,1,5,8796
3,3,2,0,6,1,7,8796
4,4,2,0,8,1,9,8796
5,5,1,0,9,1,10,8796
6,6,1,0,10,1,11,8796
7,7,1,0,11,1,12,8796
8,8,1,0,12,1,13,8796
9,9,0,2,12,3,15,8796
10,10,1,0,13,3,16,8796
11,11,1,0,14,3,17,8796
12,12,1,0,15,3,18,8796
13,13,2,0,17,3,20,8796
14,14,1,0,18,3,21,8796
15,15,0,0,18,3,21,8796
0,0,1,0,1,0,1,8797
1,1,2,0,3,0,3,8797
2,2,1,1,4,1,5,8797
3,3,1,0,5,1,6,8797
4,4,0,0,5,1,6,8797
0,0,1,0,1,0,1,8798
1,1,0,0,1,0,1,8798
0,0,1,0,1,0,1,8799
1,1,0,0,1,0,1,8799
0,0,1,0,1,0,1,8800
1,1,1,0,2,0,2,8800
2,2,2,0,4,0,4,8800
3,3,0,1,4,1,5,8800
4,4,0,0,4,1,5,8800
0,0,1,0,1,0,1,8801
1,1,0,0,1,0,1,8801
0,0,1,0,1,0,1,8802
1,1,0,0,1,0,1,8802
0,0,1,0,1,0,1,8803
1,1,0,0,1,0,1,8803
0,0,1,0,1,0,1,8804
1,1,0,0,1,0,1,8804
0,0,1,0,1,0,1,8805
1,1,2,0,3,0,3,8805
2,2,3,0,6,0,6,8805
3,3,2,0,8,0,8,8805
4,4,1,0,9,0,9,8805
5,5,0,0,9,0,9,8805
0,0,1,0,1,0,1,8806
1,1,0,0,1,0,1,8806
0,0,1,0,1,0,1,8807
1,1,0,0,1,0,1,8807
0,0,1,0,1,0,1,8808
1,1,1,0,2,0,2,8808
2,2,1,1,3,1,4,8808
3,3,1,0,4,1,5,8808
4,4,0,0,4,1,5,8808
0,0,1,0,1,0,1,8809
1,1,0,0,1,0,1,8809
0,0,1,0,1,0,1,8810
1,1,1,0,2,0,2,8810
2,2,0,0,2,0,2,8810
0,0,1,0,1,0,1,8811
1,1,0,0,1,0,1,8811
0,0,1,0,1,0,1,8812
1,1,0,0,1,0,1,8812
0,0,1,0,1,0,1,8813
1,1,1,0,2,0,2,8813
2,2,1,0,3,0,3,8813
3,3,0,1,3,1,4,8813
4,4,0,1,3,2,5,8813
5,5,1,0,4,2,6,8813
6,6,0,0,4,2,6,8813
0,0,1,0,1,0,1,8814
1,1,2,0,3,0,3,8814
2,2,2,0,5,0,5,8814
3,3,2,0,7,0,7,8814
4,4,0,0,7,0,7,8814
0,0,1,0,1,0,1,8815
1,1,0,0,1,0,1,8815
0,0,1,0,1,0,1,8816
1,1,0,0,1,0,1,8816
0,0,1,0,1,0,1,8817
1,1,1,0,2,0,2,8817
2,2,0,0,2,0,2,8817
0,0,1,0,1,0,1,8818
1,1,1,1,2,1,3,8818
2,2,0,0,2,1,3,8818
0,0,1,0,1,0,1,8819
1,1,1,0,2,0,2,8819
2,2,1,0,3,0,3,8819
3,3,0,0,3,0,3,8819
0,0,1,0,1,0,1,8820
1,1,1,0,2,0,2,8820
2,2,0,0,2,0,2,8820
0,0,1,0,1,0,1,8821
1,1,0,0,1,0,1,8821
0,0,1,0,1,0,1,8822
1,1,0,0,1,0,1,8822
0,0,1,0,1,0,1,8823
1,1,1,0,2,0,2,8823
2,2,0,0,2,0,2,8823
0,0,1,0,1,0,1,8824
1,1,2,0,3,0,3,8824
2,2,2,0,5,0,5,8824
3,3,2,0,7,0,7,8824
4,4,4,0,11,0,11,8824
5,5,2,1,13,1,14,8824
6,6,2,1,15,2,17,8824
7,7,0,2,15,4,19,8824
8,8,3,0,18,4,22,8824
9,9,3,1,21,5,26,8824
10,10,2,1,23,6,29,8824
11,11,0,0,23,6,29,8824
0,0,1,0,1,0,1,8825
1,1,0,0,1,0,1,8825
0,0,1,0,1,0,1,8826
1,1,1,0,2,0,2,8826
2,2,1,0,3,0,3,8826
3,3,0,0,3,0,3,8826
0,0,1,0,1,0,1,8827
1,1,0,0,1,0,1,8827
0,0,1,0,1,0,1,8828
1,1,2,0,3,0,3,8828
2,2,3,0,6,0,6,8828
3,3,1,0,7,0,7,8828
4,4,2,0,9,0,9,8828
5,5,1,0,10,0,10,8828
6,6,0,0,10,0,10,8828
0,0,1,0,1,0,1,8829
1,1,3,0,4,0,4,8829
2,2,4,0,8,0,8,8829
3,3,3,0,11,0,11,8829
4,4,5,1,16,1,17,8829
5,5,6,4,22,5,27,8829
6,6,4,5,26,10,36,8829
7,7,6,3,32,13,45,8829
8,8,12,4,44,17,61,8829
9,9,13,4,57,21,78,8829
10,10,9,4,66,25,91,8829
11,11,2,5,68,30,98,8829
12,12,0,4,68,34,102,8829
13,13,0,2,68,36,104,8829
14,14,0,4,68,40,108,8829
15,15,0,5,68,45,113,8829
16,16,2,4,70,49,119,8829
17,17,5,2,75,51,126,8829
18,18,2,1,77,52,129,8829
19,19,2,4,79,56,135,8829
20,20,5,0,84,56,140,8829
21,21,3,1,87,57,144,8829
22,22,4,0,91,57,148,8829
23,23,2,0,93,57,150,8829
24,24,1,1,94,58,152,8829
25,25,0,0,94,58,152,8829
0,0,1,0,1,0,1,8830
1,1,3,1,4,1,5,8830
2,2,4,0,8,1,9,8830
3,3,6,0,14,1,15,8830
4,4,7,3,21,4,25,8830
5,5,4,3,25,7,32,8830
6,6,5,4,30,11,41,8830
7,7,8,6,38,17,55,8830
8,8,6,3,44,20,64,8830
9,9,10,6,54,26,80,8830
10,10,11,5,65,31,96,8830
11,11,9,5,74,36,110,8830
12,12,11,6,85,42,127,8830
13,13,8,6,93,48,141,8830
14,14,7,4,100,52,152,8830
15,15,3,10,103,62,165,8830
16,16,0,9,103,71,174,8830
17,17,3,3,106,74,180,8830
18,18,2,3,108,77,185,8830
19,19,0,2,108,79,187,8830
20,20,0,3,108,82,190,8830
21,21,1,4,109,86,195,8830
22,22,0,1,109,87,196,8830
23,23,0,0,109,87,196,8830
0,0,1,0,1,0,1,8831
1,1,4,1,5,1,6,8831
2,2,3,2,8,3,11,8831
3,3,1,6,9,9,18,8831
4,4,4,2,13,11,24,8831
5,5,2,1,15,12,27,8831
6,6,1,2,16,14,30,8831
7,7,1,2,17,16,33,8831
8,8,0,1,17,17,34,8831
9,9,0,0,17,17,34,8831
0,0,1,0,1,0,1,8832
1,1,0,0,1,0,1,8832
0,0,1,0,1,0,1,8833
1,1,3,0,4,0,4,8833
2,2,4,1,8,1,9,8833
3,3,2,0,10,1,11,8833
4,4,2,1,12,2,14,8833
5,5,0,0,12,2,14,8833
0,0,1,0,1,0,1,8834
1,1,0,0,1,0,1,8834
0,0,1,0,1,0,1,8835
1,1,1,0,2,0,2,8835
2,2,0,0,2,0,2,8835
0,0,1,0,1,0,1,8836
1,1,3,0,4,0,4,8836
2,2,3,0,7,0,7,8836
3,3,3,0,10,0,10,8836
4,4,3,1,13,1,14,8836
5,5,5,0,18,1,19,8836
6,6,4,1,22,2,24,8836
7,7,3,0,25,2,27,8836
8,8,2,0,27,2,29,8836
9,9,0,0,27,2,29,8836
0,0,1,0,1,0,1,8837
1,1,0,0,1,0,1,8837
0,0,1,0,1,0,1,8838
1,1,1,1,2,1,3,8838
2,2,1,1,3,2,5,8838
3,3,2,1,5,3,8,8838
4,4,1,2,6,5,11,8838
5,5,0,2,6,7,13,8838
6,6,0,0,6,7,13,8838
0,0,1,0,1,0,1,8839
1,1,2,0,3,0,3,8839
2,2,1,0,4,0,4,8839
3,3,0,0,4,0,4,8839
0,0,1,0,1,0,1,8840
1,1,0,1,1,1,2,8840
2,2,1,0,2,1,3,8840
3,3,1,1,3,2,5,8840
4,4,1,0,4,2,6,8840
5,5,0,0,4,2,6,8840
0,0,1,0,1,0,1,8841
1,1,1,0,2,0,2,8841
2,2,3,0,5,0,5,8841
3,3,5,0,10,0,10,8841
4,4,5,0,15,0,15,8841
5,5,2,1,17,1,18,8841
6,6,2,1,19,2,21,8841
7,7,1,1,20,3,23,8841
8,8,0,1,20,4,24,8841
9,9,0,1,20,5,25,8841
10,10,2,0,22,5,27,8841
11,11,2,0,24,5,29,8841
12,12,1,0,25,5,30,8841
13,13,1,1,26,6,32,8841
14,14,0,0,26,6,32,8841
0,0,1,0,1,0,1,8842
1,1,1,1,2,1,3,8842
2,2,0,1,2,2,4,8842
3,3,0,0,2,2,4,8842
0,0,1,0,1,0,1,8843
1,1,1,0,2,0,2,8843
2,2,0,0,2,0,2,8843
0,0,1,0,1,0,1,8844
1,1,0,0,1,0,1,8844
0,0,1,0,1,0,1,8845
1,1,2,0,3,0,3,8845
2,2,0,1,3,1,4,8845
3,3,0,1,3,2,5,8845
4,4,0,2,3,4,7,8845
5,5,0,1,3,5,8,8845
6,6,0,0,3,5,8,8845
0,0,1,0,1,0,1,8846
1,1,1,0,2,0,2,8846
2,2,0,1,2,1,3,8846
3,3,0,0,2,1,3,8846
0,0,1,0,1,0,1,8847
1,1,0,0,1,0,1,8847
0,0,1,0,1,0,1,8848
1,1,1,1,2,1,3,8848
2,2,0,1,2,2,4,8848
3,3,0,1,2,3,5,8848
4,4,0,0,2,3,5,8848
0,0,1,0,1,0,1,8849
1,1,2,0,3,0,3,8849
2,2,0,0,3,0,3,8849
0,0,1,0,1,0,1,8850
1,1,0,0,1,0,1,8850
0,0,1,0,1,0,1,8851
1,1,3,0,4,0,4,8851
2,2,1,1,5,1,6,8851
3,3,1,0,6,1,7,8851
4,4,1,0,7,1,8,8851
5,5,1,0,8,1,9,8851
6,6,1,0,9,1,10,8851
7,7,0,0,9,1,10,8851
0,0,1,0,1,0,1,8852
1,1,1,0,2,0,2,8852
2,2,1,0,3,0,3,8852
3,3,0,0,3,0,3,8852
0,0,1,0,1,0,1,8853
1,1,1,0,2,0,2,8853
2,2,1,1,3,1,4,8853
3,3,0,0,3,1,4,8853
0,0,1,0,1,0,1,8854
1,1,0,0,1,0,1,8854
0,0,1,0,1,0,1,8855
1,1,0,1,1,1,2,8855
2,2,0,1,1,2,3,8855
3,3,1,2,2,4,6,8855
4,4,3,0,5,4,9,8855
5,5,2,0,7,4,11,8855
6,6,0,0,7,4,11,8855
0,0,1,0,1,0,1,8856
1,1,1,0,2,0,2,8856
2,2,1,0,3,0,3,8856
3,3,1,0,4,0,4,8856
4,4,1,0,5,0,5,8856
5,5,0,1,5,1,6,8856
6,6,0,1,5,2,7,8856
7,7,0,2,5,4,9,8856
8,8,1,2,6,6,12,8856
9,9,4,3,10,9,19,8856
10,10,3,0,13,9,22,8856
11,11,0,0,13,9,22,8856
0,0,1,0,1,0,1,8857
1,1,0,0,1,0,1,8857
0,0,1,0,1,0,1,8858
1,1,1,1,2,1,3,8858
2,2,0,0,2,1,3,8858
0,0,1,0,1,0,1,8859
1,1,0,0,1,0,1,8859
0,0,1,0,1,0,1,8860
1,1,1,0,2,0,2,8860
2,2,2,0,4,0,4,8860
3,3,0,0,4,0,4,8860
0,0,1,0,1,0,1,8861
1,1,0,0,1,0,1,8861
0,0,1,0,1,0,1,8862
1,1,0,0,1,0,1,8862
0,0,1,0,1,0,1,8863
1,1,1,1,2,1,3,8863
2,2,1,1,3,2,5,8863
3,3,1,0,4,2,6,8863
4,4,1,1,5,3,8,8863
5,5,0,1,5,4,9,8863
6,6,0,0,5,4,9,8863
0,0,1,0,1,0,1,8864
1,1,2,0,3,0,3,8864
2,2,2,0,5,0,5,8864
3,3,1,0,6,0,6,8864
4,4,1,0,7,0,7,8864
5,5,0,0,7,0,7,8864
0,0,1,0,1,0,1,8865
1,1,0,0,1,0,1,8865
0,0,1,0,1,0,1,8866
1,1,0,0,1,0,1,8866
0,0,1,0,1,0,1,8867
1,1,0,0,1,0,1,8867
0,0,1,0,1,0,1,8868
1,1,1,0,2,0,2,8868
2,2,3,1,5,1,6,8868
3,3,7,2,12,3,15,8868
4,4,9,0,21,3,24,8868
5,5,7,0,28,3,31,8868
6,6,4,3,32,6,38,8868
7,7,2,0,34,6,40,8868
8,8,2,0,36,6,42,8868
9,9,2,1,38,7,45,8868
10,10,0,2,38,9,47,8868
11,11,1,1,39,10,49,8868
12,12,2,1,41,11,52,8868
13,13,1,2,42,13,55,8868
14,14,1,2,43,15,58,8868
15,15,0,1,43,16,59,8868
16,16,0,0,43,16,59,8868
0,0,1,0,1,0,1,8869
1,1,0,0,1,0,1,8869
0,0,1,0,1,0,1,8870
1,1,2,0,3,0,3,8870
2,2,0,0,3,0,3,8870
0,0,1,0,1,0,1,8871
1,1,0,0,1,0,1,8871
0,0,1,0,1,0,1,8872
1,1,0,0,1,0,1,8872
0,0,1,0,1,0,1,8873
1,1,0,0,1,0,1,8873
0,0,1,0,1,0,1,8874
1,1,2,0,3,0,3,8874
2,2,3,1,6,1,7,8874
3,3,6,0,12,1,13,8874
4,4,4,0,16,1,17,8874
5,5,4,2,20,3,23,8874
6,6,5,2,25,5,30,8874
7,7,3,2,28,7,35,8874
8,8,3,4,31,11,42,8874
9,9,6,4,37,15,52,8874
10,10,12,7,49,22,71,8874
11,11,13,2,62,24,86,8874
12,12,11,3,73,27,100,8874
13,13,9,10,82,37,119,8874
14,14,8,8,90,45,135,8874
15,15,4,6,94,51,145,8874
16,16,3,2,97,53,150,8874
17,17,3,3,100,56,156,8874
18,18,6,4,106,60,166,8874
19,19,5,1,111,61,172,8874
20,20,3,1,114,62,176,8874
21,21,4,1,118,63,181,8874
22,22,2,0,120,63,183,8874
23,23,1,0,121,63,184,8874
24,24,0,0,121,63,184,8874
0,0,1,0,1,0,1,8875
1,1,0,0,1,0,1,8875
0,0,1,0,1,0,1,8876
1,1,0,0,1,0,1,8876
0,0,1,0,1,0,1,8877
1,1,1,0,2,0,2,8877
2,2,1,0,3,0,3,8877
3,3,0,0,3,0,3,8877
0,0,1,0,1,0,1,8878
1,1,0,1,1,1,2,8878
2,2,0,2,1,3,4,8878
3,3,0,0,1,3,4,8878
0,0,1,0,1,0,1,8879
1,1,0,0,1,0,1,8879
0,0,1,0,1,0,1,8880
1,1,0,1,1,1,2,8880
2,2,0,0,1,1,2,8880
0,0,1,0,1,0,1,8881
1,1,2,0,3,0,3,8881
2,2,0,0,3,0,3,8881
0,0,1,0,1,0,1,8882
1,1,2,0,3,0,3,8882
2,2,1,1,4,1,5,8882
3,3,1,1,5,2,7,8882
4,4,0,0,5,2,7,8882
0,0,1,0,1,0,1,8883
1,1,0,2,1,2,3,8883
2,2,0,1,1,3,4,8883
3,3,0,1,1,4,5,8883
4,4,0,0,1,4,5,8883
0,0,1,0,1,0,1,8884
1,1,0,0,1,0,1,8884
0,0,1,0,1,0,1,8885
1,1,1,0,2,0,2,8885
2,2,0,0,2,0,2,8885
0,0,1,0,1,0,1,8886
1,1,0,1,1,1,2,8886
2,2,0,1,1,2,3,8886
3,3,0,2,1,4,5,8886
4,4,0,1,1,5,6,8886
5,5,0,0,1,5,6,8886
0,0,1,0,1,0,1,8887
1,1,0,0,1,0,1,8887
0,0,1,0,1,0,1,8888
1,1,1,0,2,0,2,8888
2,2,0,0,2,0,2,8888
0,0,1,0,1,0,1,8889
1,1,1,1,2,1,3,8889
2,2,1,1,3,2,5,8889
3,3,0,0,3,2,5,8889
0,0,1,0,1,0,1,8890
1,1,2,0,3,0,3,8890
2,2,1,0,4,0,4,8890
3,3,0,0,4,0,4,8890
0,0,1,0,1,0,1,8891
1,1,0,0,1,0,1,8891
0,0,1,0,1,0,1,8892
1,1,2,0,3,0,3,8892
2,2,1,0,4,0,4,8892
3,3,0,0,4,0,4,8892
0,0,1,0,1,0,1,8893
1,1,2,0,3,0,3,8893
2,2,1,3,4,3,7,8893
3,3,3,2,7,5,12,8893
4,4,6,4,13,9,22,8893
5,5,5,5,18,14,32,8893
6,6,7,3,25,17,42,8893
7,7,8,1,33,18,51,8893
8,8,6,1,39,19,58,8893
9,9,3,1,42,20,62,8893
10,10,3,3,45,23,68,8893
11,11,0,1,45,24,69,8893
12,12,0,0,45,24,69,8893
0,0,1,0,1,0,1,8894
1,1,1,0,2,0,2,8894
2,2,0,0,2,0,2,8894
0,0,1,0,1,0,1,8895
1,1,0,0,1,0,1,8895
0,0,1,0,1,0,1,8896
1,1,1,0,2,0,2,8896
2,2,3,0,5,0,5,8896
3,3,3,0,8,0,8,8896
4,4,4,1,12,1,13,8896
5,5,3,2,15,3,18,8896
6,6,4,2,19,5,24,8896
7,7,5,3,24,8,32,8896
8,8,5,0,29,8,37,8896
9,9,4,1,33,9,42,8896
10,10,5,3,38,12,50,8896
11,11,2,1,40,13,53,8896
12,12,1,1,41,14,55,8896
13,13,2,0,43,14,57,8896
14,14,0,1,43,15,58,8896
15,15,0,0,43,15,58,8896
0,0,1,0,1,0,1,8897
1,1,0,0,1,0,1,8897
0,0,1,0,1,0,1,8898
1,1,1,0,2,0,2,8898
2,2,0,0,2,0,2,8898
0,0,1,0,1,0,1,8899
1,1,1,0,2,0,2,8899
2,2,1,0,3,0,3,8899
3,3,0,0,3,0,3,8899
0,0,1,0,1,0,1,8900
1,1,0,1,1,1,2,8900
2,2,0,2,1,3,4,8900
3,3,1,1,2,4,6,8900
4,4,1,0,3,4,7,8900
5,5,1,0,4,4,8,8900
6,6,2,0,6,4,10,8900
7,7,0,0,6,4,10,8900
0,0,1,0,1,0,1,8901
1,1,0,0,1,0,1,8901
0,0,1,0,1,0,1,8902
1,1,1,0,2,0,2,8902
2,2,0,1,2,1,3,8902
3,3,0,0,2,1,3,8902
0,0,1,0,1,0,1,8903
1,1,0,1,1,1,2,8903
2,2,0,1,1,2,3,8903
3,3,0,1,1,3,4,8903
4,4,0,1,1,4,5,8903
5,5,0,0,1,4,5,8903
0,0,1,0,1,0,1,8904
1,1,0,0,1,0,1,8904
0,0,1,0,1,0,1,8905
1,1,1,0,2,0,2,8905
2,2,0,0,2,0,2,8905
0,0,1,0,1,0,1,8906
1,1,0,0,1,0,1,8906
0,0,1,0,1,0,1,8907
1,1,3,0,4,0,4,8907
2,2,3,0,7,0,7,8907
3,3,4,1,11,1,12,8907
4,4,1,1,12,2,14,8907
5,5,1,2,13,4,17,8907
6,6,0,1,13,5,18,8907
7,7,1,1,14,6,20,8907
8,8,0,3,14,9,23,8907
9,9,0,3,14,12,26,8907
10,10,0,2,14,14,28,8907
11,11,0,0,14,14,28,8907
0,0,1,0,1,0,1,8908
1,1,1,0,2,0,2,8908
2,2,1,0,3,0,3,8908
3,3,1,1,4,1,5,8908
4,4,1,0,5,1,6,8908
5,5,1,1,6,2,8,8908
6,6,5,1,11,3,14,8908
7,7,1,1,12,4,16,8908
8,8,3,0,15,4,19,8908
9,9,3,0,18,4,22,8908
10,10,0,0,18,4,22,8908
0,0,1,0,1,0,1,8909
1,1,0,0,1,0,1,8909
0,0,1,0,1,0,1,8910
1,1,0,0,1,0,1,8910
0,0,1,0,1,0,1,8911
1,1,2,1,3,1,4,8911
2,2,0,1,3,2,5,8911
3,3,0,0,3,2,5,8911
0,0,1,0,1,0,1,8912
1,1,1,0,2,0,2,8912
2,2,0,0,2,0,2,8912
0,0,1,0,1,0,1,8913
1,1,0,0,1,0,1,8913
0,0,1,0,1,0,1,8914
1,1,0,0,1,0,1,8914
0,0,1,0,1,0,1,8915
1,1,2,0,3,0,3,8915
2,2,1,0,4,0,4,8915
3,3,0,0,4,0,4,8915
0,0,1,0,1,0,1,8916
1,1,1,0,2,0,2,8916
2,2,1,0,3,0,3,8916
3,3,0,0,3,0,3,8916
0,0,1,0,1,0,1,8917
1,1,1,0,2,0,2,8917
2,2,0,0,2,0,2,8917
0,0,1,0,1,0,1,8918
1,1,0,0,1,0,1,8918
0,0,1,0,1,0,1,8919
1,1,0,0,1,0,1,8919
0,0,1,0,1,0,1,8920
1,1,0,0,1,0,1,8920
0,0,1,0,1,0,1,8921
1,1,1,0,2,0,2,8921
2,2,0,0,2,0,2,8921
0,0,1,0,1,0,1,8922
1,1,0,0,1,0,1,8922
0,0,1,0,1,0,1,8923
1,1,2,0,3,0,3,8923
2,2,0,0,3,0,3,8923
0,0,1,0,1,0,1,8924
1,1,1,0,2,0,2,8924
2,2,0,0,2,0,2,8924
0,0,1,0,1,0,1,8925
1,1,2,0,3,0,3,8925
2,2,0,0,3,0,3,8925
0,0,1,0,1,0,1,8926
1,1,0,0,1,0,1,8926
0,0,1,0,1,0,1,8927
1,1,1,1,2,1,3,8927
2,2,1,0,3,1,4,8927
3,3,1,0,4,1,5,8927
4,4,1,0,5,1,6,8927
5,5,1,0,6,1,7,8927
6,6,0,0,6,1,7,8927
0,0,1,0,1,0,1,8928
1,1,0,0,1,0,1,8928
0,0,1,0,1,0,1,8929
1,1,0,1,1,1,2,8929
2,2,0,0,1,1,2,8929
0,0,1,0,1,0,1,8930
1,1,0,0,1,0,1,8930
0,0,1,0,1,0,1,8931
1,1,0,0,1,0,1,8931
0,0,1,0,1,0,1,8932
1,1,0,1,1,1,2,8932
2,2,0,3,1,4,5,8932
3,3,1,4,2,8,10,8932
4,4,0,4,2,12,14,8932
5,5,0,1,2,13,15,8932
6,6,0,1,2,14,16,8932
7,7,0,1,2,15,17,8932
8,8,0,1,2,16,18,8932
9,9,1,2,3,18,21,8932
10,10,1,3,4,21,25,8932
11,11,0,4,4,25,29,8932
12,12,1,0,5,25,30,8932
13,13,1,0,6,25,31,8932
14,14,0,0,6,25,31,8932
0,0,1,0,1,0,1,8933
1,1,3,0,4,0,4,8933
2,2,2,0,6,0,6,8933
3,3,0,1,6,1,7,8933
4,4,0,1,6,2,8,8933
5,5,0,2,6,4,10,8933
6,6,0,0,6,4,10,8933
0,0,1,0,1,0,1,8934
1,1,0,0,1,0,1,8934
0,0,1,0,1,0,1,8935
1,1,2,0,3,0,3,8935
2,2,3,1,6,1,7,8935
3,3,2,0,8,1,9,8935
4,4,1,1,9,2,11,8935
5,5,1,2,10,4,14,8935
6,6,0,4,10,8,18,8935
7,7,1,3,11,11,22,8935
8,8,2,3,13,14,27,8935
9,9,1,3,14,17,31,8935
10,10,1,0,15,17,32,8935
11,11,1,0,16,17,33,8935
12,12,0,0,16,17,33,8935
0,0,1,0,1,0,1,8936
1,1,2,0,3,0,3,8936
2,2,2,0,5,0,5,8936
3,3,1,0,6,0,6,8936
4,4,0,0,6,0,6,8936
0,0,1,0,1,0,1,8937
1,1,1,0,2,0,2,8937
2,2,1,0,3,0,3,8937
3,3,0,0,3,0,3,8937
0,0,1,0,1,0,1,8938
1,1,1,0,2,0,2,8938
2,2,0,0,2,0,2,8938
0,0,1,0,1,0,1,8939
1,1,1,0,2,0,2,8939
2,2,2,0,4,0,4,8939
3,3,0,0,4,0,4,8939
0,0,1,0,1,0,1,8940
1,1,0,0,1,0,1,8940
0,0,1,0,1,0,1,8941
1,1,1,0,2,0,2,8941
2,2,1,0,3,0,3,8941
3,3,0,0,3,0,3,8941
0,0,1,0,1,0,1,8942
1,1,0,0,1,0,1,8942
0,0,1,0,1,0,1,8943
1,1,0,0,1,0,1,8943
0,0,1,0,1,0,1,8944
1,1,2,0,3,0,3,8944
2,2,1,0,4,0,4,8944
3,3,1,0,5,0,5,8944
4,4,1,2,6,2,8,8944
5,5,2,4,8,6,14,8944
6,6,3,3,11,9,20,8944
7,7,2,1,13,10,23,8944
8,8,1,1,14,11,25,8944
9,9,2,2,16,13,29,8944
10,10,1,3,17,16,33,8944
11,11,1,1,18,17,35,8944
12,12,1,1,19,18,37,8944
13,13,3,0,22,18,40,8944
14,14,0,0,22,18,40,8944
0,0,1,0,1,0,1,8945
1,1,0,0,1,0,1,8945
0,0,1,0,1,0,1,8946
1,1,0,0,1,0,1,8946
0,0,1,0,1,0,1,8947
1,1,0,1,1,1,2,8947
2,2,0,1,1,2,3,8947
3,3,0,0,1,2,3,8947
0,0,1,0,1,0,1,8948
1,1,1,0,2,0,2,8948
2,2,0,0,2,0,2,8948
0,0,1,0,1,0,1,8949
1,1,2,0,3,0,3,8949
2,2,3,0,6,0,6,8949
3,3,3,1,9,1,10,8949
4,4,2,1,11,2,13,8949
5,5,1,0,12,2,14,8949
6,6,1,0,13,2,15,8949
7,7,1,0,14,2,16,8949
8,8,0,1,14,3,17,8949
9,9,1,1,15,4,19,8949
10,10,0,2,15,6,21,8949
11,11,2,3,17,9,26,8949
12,12,1,3,18,12,30,8949
13,13,0,3,18,15,33,8949
14,14,2,3,20,18,38,8949
15,15,4,2,24,20,44,8949
16,16,3,3,27,23,50,8949
17,17,5,0,32,23,55,8949
18,18,3,1,35,24,59,8949
19,19,2,1,37,25,62,8949
20,20,0,1,37,26,63,8949
21,21,0,1,37,27,64,8949
22,22,0,1,37,28,65,8949
23,23,0,1,37,29,66,8949
24,24,0,0,37,29,66,8949
0,0,1,0,1,0,1,8950
1,1,0,0,1,0,1,8950
0,0,1,0,1,0,1,8951
1,1,1,0,2,0,2,8951
2,2,0,0,2,0,2,8951
0,0,1,0,1,0,1,8952
1,1,0,0,1,0,1,8952
0,0,1,0,1,0,1,8953
1,1,0,0,1,0,1,8953
0,0,1,0,1,0,1,8954
1,1,1,0,2,0,2,8954
2,2,1,0,3,0,3,8954
3,3,1,0,4,0,4,8954
4,4,1,0,5,0,5,8954
5,5,1,1,6,1,7,8954
6,6,0,2,6,3,9,8954
7,7,0,1,6,4,10,8954
8,8,1,0,7,4,11,8954
9,9,0,0,7,4,11,8954
0,0,1,0,1,0,1,8955
1,1,1,0,2,0,2,8955
2,2,0,0,2,0,2,8955
0,0,1,0,1,0,1,8956
1,1,0,0,1,0,1,8956
0,0,1,0,1,0,1,8957
1,1,1,0,2,0,2,8957
2,2,0,0,2,0,2,8957
0,0,1,0,1,0,1,8958
1,1,1,0,2,0,2,8958
2,2,1,0,3,0,3,8958
3,3,1,1,4,1,5,8958
4,4,2,0,6,1,7,8958
5,5,4,0,10,1,11,8958
6,6,4,1,14,2,16,8958
7,7,2,1,16,3,19,8958
8,8,1,0,17,3,20,8958
9,9,3,0,20,3,23,8958
10,10,5,0,25,3,28,8958
11,11,4,0,29,3,32,8958
12,12,5,0,34,3,37,8958
13,13,1,0,35,3,38,8958
14,14,1,0,36,3,39,8958
15,15,1,0,37,3,40,8958
16,16,1,0,38,3,41,8958
17,17,2,0,40,3,43,8958
18,18,2,1,42,4,46,8958
19,19,1,0,43,4,47,8958
20,20,1,0,44,4,48,8958
21,21,1,1,45,5,50,8958
22,22,1,3,46,8,54,8958
23,23,0,4,46,12,58,8958
24,24,0,4,46,16,62,8958
25,25,1,3,47,19,66,8958
26,26,0,2,47,21,68,8958
27,27,1,2,48,23,71,8958
28,28,1,2,49,25,74,8958
29,29,3,1,52,26,78,8958
30,30,1,1,53,27,80,8958
31,31,1,2,54,29,83,8958
32,32,1,5,55,34,89,8958
33,33,1,3,56,37,93,8958
34,34,0,4,56,41,97,8958
35,35,0,4,56,45,101,8958
36,36,1,2,57,47,104,8958
37,37,0,0,57,47,104,8958
0,0,1,0,1,0,1,8959
1,1,1,0,2,0,2,8959
2,2,0,0,2,0,2,8959
0,0,1,0,1,0,1,8960
1,1,0,0,1,0,1,8960
0,0,1,0,1,0,1,8961
1,1,2,0,3,0,3,8961
2,2,1,0,4,0,4,8961
3,3,0,0,4,0,4,8961
0,0,1,0,1,0,1,8962
1,1,0,0,1,0,1,8962
0,0,1,0,1,0,1,8963
1,1,2,0,3,0,3,8963
2,2,4,0,7,0,7,8963
3,3,5,1,12,1,13,8963
4,4,3,2,15,3,18,8963
5,5,1,3,16,6,22,8963
6,6,0,1,16,7,23,8963
7,7,0,2,16,9,25,8963
8,8,0,3,16,12,28,8963
9,9,0,4,16,16,32,8963
10,10,0,4,16,20,36,8963
11,11,0,3,16,23,39,8963
12,12,1,1,17,24,41,8963
13,13,0,2,17,26,43,8963
14,14,0,2,17,28,45,8963
15,15,0,2,17,30,47,8963
16,16,1,2,18,32,50,8963
17,17,0,1,18,33,51,8963
18,18,0,1,18,34,52,8963
19,19,0,1,18,35,53,8963
20,20,0,1,18,36,54,8963
21,21,0,0,18,36,54,8963
0,0,1,0,1,0,1,8964
1,1,1,0,2,0,2,8964
2,2,0,0,2,0,2,8964
0,0,1,0,1,0,1,8965
1,1,1,0,2,0,2,8965
2,2,0,0,2,0,2,8965
0,0,1,0,1,0,1,8966
1,1,3,0,4,0,4,8966
2,2,4,0,8,0,8,8966
3,3,2,1,10,1,11,8966
4,4,1,0,11,1,12,8966
5,5,0,0,11,1,12,8966
0,0,1,0,1,0,1,8967
1,1,6,1,7,1,8,8967
2,2,2,3,9,4,13,8967
3,3,1,3,10,7,17,8967
4,4,0,0,10,7,17,8967
0,0,1,0,1,0,1,8968
1,1,1,0,2,0,2,8968
2,2,1,0,3,0,3,8968
3,3,2,1,5,1,6,8968
4,4,2,1,7,2,9,8968
5,5,1,2,8,4,12,8968
6,6,2,3,10,7,17,8968
7,7,2,1,12,8,20,8968
8,8,0,1,12,9,21,8968
9,9,0,0,12,9,21,8968
0,0,1,0,1,0,1,8969
1,1,1,1,2,1,3,8969
2,2,1,1,3,2,5,8969
3,3,1,2,4,4,8,8969
4,4,0,1,4,5,9,8969
5,5,0,0,4,5,9,8969
0,0,1,0,1,0,1,8970
1,1,0,0,1,0,1,8970
0,0,1,0,1,0,1,8971
1,1,1,1,2,1,3,8971
2,2,0,3,2,4,6,8971
3,3,0,2,2,6,8,8971
4,4,0,0,2,6,8,8971
0,0,1,0,1,0,1,8972
1,1,0,0,1,0,1,8972
0,0,1,0,1,0,1,8973
1,1,0,0,1,0,1,8973
0,0,1,0,1,0,1,8974
1,1,0,0,1,0,1,8974
0,0,1,0,1,0,1,8975
1,1,1,0,2,0,2,8975
2,2,1,0,3,0,3,8975
3,3,1,0,4,0,4,8975
4,4,0,0,4,0,4,8975
0,0,1,0,1,0,1,8976
1,1,0,0,1,0,1,8976
0,0,1,0,1,0,1,8977
1,1,0,0,1,0,1,8977
0,0,1,0,1,0,1,8978
1,1,0,0,1,0,1,8978
0,0,1,0,1,0,1,8979
1,1,0,0,1,0,1,8979
0,0,1,0,1,0,1,8980
1,1,0,0,1,0,1,8980
0,0,1,0,1,0,1,8981
1,1,0,0,1,0,1,8981
0,0,1,0,1,0,1,8982
1,1,2,0,3,0,3,8982
2,2,1,0,4,0,4,8982
3,3,2,0,6,0,6,8982
4,4,1,0,7,0,7,8982
5,5,1,0,8,0,8,8982
6,6,0,0,8,0,8,8982
0,0,1,0,1,0,1,8983
1,1,1,1,2,1,3,8983
2,2,0,0,2,1,3,8983
0,0,1,0,1,0,1,8984
1,1,0,0,1,0,1,8984
0,0,1,0,1,0,1,8985
1,1,0,0,1,0,1,8985
0,0,1,0,1,0,1,8986
1,1,0,0,1,0,1,8986
0,0,1,0,1,0,1,8987
1,1,0,0,1,0,1,8987
0,0,1,0,1,0,1,8988
1,1,2,0,3,0,3,8988
2,2,2,2,5,2,7,8988
3,3,4,2,9,4,13,8988
4,4,3,1,12,5,17,8988
5,5,2,2,14,7,21,8988
6,6,1,1,15,8,23,8988
7,7,2,0,17,8,25,8988
8,8,1,0,18,8,26,8988
9,9,0,0,18,8,26,8988
0,0,1,0,1,0,1,8989
1,1,0,0,1,0,1,8989
0,0,1,0,1,0,1,8990
1,1,1,0,2,0,2,8990
2,2,0,0,2,0,2,8990
0,0,1,0,1,0,1,8991
1,1,0,0,1,0,1,8991
0,0,1,0,1,0,1,8992
1,1,1,0,2,0,2,8992
2,2,0,0,2,0,2,8992
0,0,1,0,1,0,1,8993
1,1,0,2,1,2,3,8993
2,2,0,1,1,3,4,8993
3,3,0,0,1,3,4,8993
0,0,1,0,1,0,1,8994
1,1,0,0,1,0,1,8994
0,0,1,0,1,0,1,8995
1,1,0,0,1,0,1,8995
0,0,1,0,1,0,1,8996
1,1,1,0,2,0,2,8996
2,2,1,1,3,1,4,8996
3,3,0,0,3,1,4,8996
0,0,1,0,1,0,1,8997
1,1,0,1,1,1,2,8997
2,2,0,0,1,1,2,8997
0,0,1,0,1,0,1,8998
1,1,4,0,5,0,5,8998
2,2,7,0,12,0,12,8998
3,3,4,0,16,0,16,8998
4,4,2,0,18,0,18,8998
5,5,0,1,18,1,19,8998
6,6,0,0,18,1,19,8998
0,0,1,0,1,0,1,8999
1,1,0,0,1,0,1,8999
0,0,1,0,1,0,1,9000
1,1,1,0,2,0,2,9000
2,2,1,0,3,0,3,9000
3,3,0,0,3,0,3,9000
0,0,1,0,1,0,1,9001
1,1,1,1,2,1,3,9001
2,2,2,1,4,2,6,9001
3,3,2,2,6,4,10,9001
4,4,2,0,8,4,12,9001
5,5,1,0,9,4,13,9001
6,6,1,0,10,4,14,9001
7,7,1,0,11,4,15,9001
8,8,1,0,12,4,16,9001
9,9,0,0,12,4,16,9001
0,0,1,0,1,0,1,9002
1,1,0,0,1,0,1,9002
0,0,1,0,1,0,1,9003
1,1,1,0,2,0,2,9003
2,2,0,0,2,0,2,9003
0,0,1,0,1,0,1,9004
1,1,0,0,1,0,1,9004
0,0,1,0,1,0,1,9005
1,1,0,0,1,0,1,9005
0,0,1,0,1,0,1,9006
1,1,1,0,2,0,2,9006
2,2,2,0,4,0,4,9006
3,3,2,1,6,1,7,9006
4,4,0,1,6,2,8,9006
5,5,0,1,6,3,9,9006
6,6,0,0,6,3,9,9006
0,0,1,0,1,0,1,9007
1,1,0,0,1,0,1,9007
0,0,1,0,1,0,1,9008
1,1,3,0,4,0,4,9008
2,2,2,0,6,0,6,9008
3,3,2,1,8,1,9,9008
4,4,0,1,8,2,10,9008
5,5,0,1,8,3,11,9008
6,6,0,0,8,3,11,9008
0,0,1,0,1,0,1,9009
1,1,0,0,1,0,1,9009
0,0,1,0,1,0,1,9010
1,1,0,0,1,0,1,9010
0,0,1,0,1,0,1,9011
1,1,0,0,1,0,1,9011
0,0,1,0,1,0,1,9012
1,1,0,0,1,0,1,9012
0,0,1,0,1,0,1,9013
1,1,1,1,2,1,3,9013
2,2,0,0,2,1,3,9013
0,0,1,0,1,0,1,9014
1,1,2,0,3,0,3,9014
2,2,2,0,5,0,5,9014
3,3,1,0,6,0,6,9014
4,4,0,0,6,0,6,9014
0,0,1,0,1,0,1,9015
1,1,4,0,5,0,5,9015
2,2,3,1,8,1,9,9015
3,3,2,0,10,1,11,9015
4,4,3,0,13,1,14,9015
5,5,4,0,17,1,18,9015
6,6,1,0,18,1,19,9015
7,7,0,0,18,1,19,9015
0,0,1,0,1,0,1,9016
1,1,1,0,2,0,2,9016
2,2,0,0,2,0,2,9016
0,0,1,0,1,0,1,9017
1,1,0,0,1,0,1,9017
0,0,1,0,1,0,1,9018
1,1,0,0,1,0,1,9018
0,0,1,0,1,0,1,9019
1,1,1,1,2,1,3,9019
2,2,1,0,3,1,4,9019
3,3,2,0,5,1,6,9019
4,4,2,0,7,1,8,9019
5,5,5,1,12,2,14,9019
6,6,6,1,18,3,21,9019
7,7,7,2,25,5,30,9019
8,8,5,0,30,5,35,9019
9,9,2,1,32,6,38,9019
10,10,2,2,34,8,42,9019
11,11,4,2,38,10,48,9019
12,12,6,0,44,10,54,9019
13,13,8,0,52,10,62,9019
14,14,3,1,55,11,66,9019
15,15,5,2,60,13,73,9019
16,16,4,1,64,14,78,9019
17,17,1,3,65,17,82,9019
18,18,0,2,65,19,84,9019
19,19,0,1,65,20,85,9019
20,20,0,0,65,20,85,9019
0,0,1,0,1,0,1,9020
1,1,0,1,1,1,2,9020
2,2,0,0,1,1,2,9020
0,0,1,0,1,0,1,9021
1,1,0,1,1,1,2,9021
2,2,0,1,1,2,3,9021
3,3,0,2,1,4,5,9021
4,4,0,0,1,4,5,9021
0,0,1,0,1,0,1,9022
1,1,1,0,2,0,2,9022
2,2,0,1,2,1,3,9022
3,3,1,0,3,1,4,9022
4,4,1,0,4,1,5,9022
5,5,0,0,4,1,5,9022
0,0,1,0,1,0,1,9023
1,1,2,0,3,0,3,9023
2,2,1,1,4,1,5,9023
3,3,0,3,4,4,8,9023
4,4,0,3,4,7,11,9023
5,5,1,3,5,10,15,9023
6,6,1,5,6,15,21,9023
7,7,2,1,8,16,24,9023
8,8,0,1,8,17,25,9023
9,9,0,1,8,18,26,9023
10,10,0,1,8,19,27,9023
11,11,0,0,8,19,27,9023
0,0,1,0,1,0,1,9024
1,1,1,1,2,1,3,9024
2,2,0,0,2,1,3,9024
0,0,1,0,1,0,1,9025
1,1,1,0,2,0,2,9025
2,2,0,0,2,0,2,9025
0,0,1,0,1,0,1,9026
1,1,4,0,5,0,5,9026
2,2,3,1,8,1,9,9026
3,3,1,0,9,1,10,9026
4,4,0,0,9,1,10,9026
0,0,1,0,1,0,1,9027
1,1,0,0,1,0,1,9027
0,0,1,0,1,0,1,9028
1,1,1,0,2,0,2,9028
2,2,0,0,2,0,2,9028
0,0,1,0,1,0,1,9029
1,1,1,0,2,0,2,9029
2,2,1,0,3,0,3,9029
3,3,2,0,5,0,5,9029
4,4,3,0,8,0,8,9029
5,5,0,0,8,0,8,9029
0,0,1,0,1,0,1,9030
1,1,1,0,2,0,2,9030
2,2,0,0,2,0,2,9030
0,0,1,0,1,0,1,9031
1,1,0,0,1,0,1,9031
0,0,1,0,1,0,1,9032
1,1,1,0,2,0,2,9032
2,2,0,0,2,0,2,9032
0,0,1,0,1,0,1,9033
1,1,0,0,1,0,1,9033
0,0,1,0,1,0,1,9034
1,1,2,0,3,0,3,9034
2,2,2,0,5,0,5,9034
3,3,0,0,5,0,5,9034
0,0,1,0,1,0,1,9035
1,1,0,0,1,0,1,9035
0,0,1,0,1,0,1,9036
1,1,0,0,1,0,1,9036
0,0,1,0,1,0,1,9037
1,1,1,0,2,0,2,9037
2,2,1,1,3,1,4,9037
3,3,0,2,3,3,6,9037
4,4,1,3,4,6,10,9037
5,5,0,1,4,7,11,9037
6,6,0,1,4,8,12,9037
7,7,0,1,4,9,13,9037
8,8,0,0,4,9,13,9037
0,0,1,0,1,0,1,9038
1,1,0,1,1,1,2,9038
2,2,0,1,1,2,3,9038
3,3,0,0,1,2,3,9038
0,0,1,0,1,0,1,9039
1,1,1,0,2,0,2,9039
2,2,2,0,4,0,4,9039
3,3,2,0,6,0,6,9039
4,4,2,1,8,1,9,9039
5,5,4,1,12,2,14,9039
6,6,5,0,17,2,19,9039
7,7,6,0,23,2,25,9039
8,8,4,3,27,5,32,9039
9,9,4,3,31,8,39,9039
10,10,5,7,36,15,51,9039
11,11,4,4,40,19,59,9039
12,12,7,5,47,24,71,9039
13,13,2,4,49,28,77,9039
14,14,0,4,49,32,81,9039
15,15,0,2,49,34,83,9039
16,16,1,0,50,34,84,9039
17,17,1,0,51,34,85,9039
18,18,2,1,53,35,88,9039
19,19,2,0,55,35,90,9039
20,20,3,1,58,36,94,9039
21,21,1,1,59,37,96,9039
22,22,2,1,61,38,99,9039
23,23,0,1,61,39,100,9039
24,24,1,0,62,39,101,9039
25,25,1,0,63,39,102,9039
26,26,1,2,64,41,105,9039
27,27,1,3,65,44,109,9039
28,28,0,8,65,52,117,9039
29,29,1,2,66,54,120,9039
30,30,1,1,67,55,122,9039
31,31,1,1,68,56,124,9039
32,32,1,0,69,56,125,9039
33,33,1,0,70,56,126,9039
34,34,1,0,71,56,127,9039
35,35,2,0,73,56,129,9039
36,36,1,0,74,56,130,9039
37,37,0,0,74,56,130,9039
0,0,1,0,1,0,1,9040
1,1,0,0,1,0,1,9040
0,0,1,0,1,0,1,9041
1,1,1,0,2,0,2,9041
2,2,0,0,2,0,2,9041
0,0,1,0,1,0,1,9042
1,1,0,0,1,0,1,9042
0,0,1,0,1,0,1,9043
1,1,1,0,2,0,2,9043
2,2,0,1,2,1,3,9043
3,3,0,0,2,1,3,9043
0,0,1,0,1,0,1,9044
1,1,0,1,1,1,2,9044
2,2,0,1,1,2,3,9044
3,3,0,2,1,4,5,9044
4,4,0,4,1,8,9,9044
5,5,0,0,1,8,9,9044
0,0,1,0,1,0,1,9045
1,1,0,0,1,0,1,9045
0,0,1,0,1,0,1,9046
1,1,0,0,1,0,1,9046
0,0,1,0,1,0,1,9047
1,1,2,0,3,0,3,9047
2,2,2,0,5,0,5,9047
3,3,0,0,5,0,5,9047
0,0,1,0,1,0,1,9048
1,1,0,0,1,0,1,9048
0,0,1,0,1,0,1,9049
1,1,2,0,3,0,3,9049
2,2,3,0,6,0,6,9049
3,3,2,0,8,0,8,9049
4,4,0,0,8,0,8,9049
0,0,1,0,1,0,1,9050
1,1,0,0,1,0,1,9050
0,0,1,0,1,0,1,9051
1,1,0,0,1,0,1,9051
0,0,1,0,1,0,1,9052
1,1,0,0,1,0,1,9052
0,0,1,0,1,0,1,9053
1,1,0,0,1,0,1,9053
0,0,1,0,1,0,1,9054
1,1,1,0,2,0,2,9054
2,2,1,0,3,0,3,9054
3,3,1,0,4,0,4,9054
4,4,0,0,4,0,4,9054
0,0,1,0,1,0,1,9055
1,1,2,0,3,0,3,9055
2,2,2,0,5,0,5,9055
3,3,4,0,9,0,9,9055
4,4,2,2,11,2,13,9055
5,5,4,3,15,5,20,9055
6,6,0,3,15,8,23,9055
7,7,1,1,16,9,25,9055
8,8,0,2,16,11,27,9055
9,9,0,0,16,11,27,9055
0,0,1,0,1,0,1,9056
1,1,1,0,2,0,2,9056
2,2,0,0,2,0,2,9056
0,0,1,0,1,0,1,9057
1,1,2,0,3,0,3,9057
2,2,0,1,3,1,4,9057
3,3,0,0,3,1,4,9057
0,0,1,0,1,0,1,9058
1,1,0,0,1,0,1,9058
0,0,1,0,1,0,1,9059
1,1,0,0,1,0,1,9059
0,0,1,0,1,0,1,9060
1,1,2,0,3,0,3,9060
2,2,1,0,4,0,4,9060
3,3,1,1,5,1,6,9060
4,4,0,1,5,2,7,9060
5,5,0,2,5,4,9,9060
6,6,1,1,6,5,11,9060
7,7,1,0,7,5,12,9060
8,8,1,0,8,5,13,9060
9,9,1,0,9,5,14,9060
10,10,0,0,9,5,14,9060
0,0,1,0,1,0,1,9061
1,1,1,0,2,0,2,9061
2,2,0,0,2,0,2,9061
0,0,1,0,1,0,1,9062
1,1,1,0,2,0,2,9062
2,2,0,1,2,1,3,9062
3,3,0,1,2,2,4,9062
4,4,1,1,3,3,6,9062
5,5,1,0,4,3,7,9062
6,6,1,0,5,3,8,9062
7,7,0,0,5,3,8,9062
0,0,1,0,1,0,1,9063
1,1,1,0,2,0,2,9063
2,2,0,0,2,0,2,9063
0,0,1,0,1,0,1,9064
1,1,2,1,3,1,4,9064
2,2,5,0,8,1,9,9064
3,3,3,0,11,1,12,9064
4,4,4,0,15,1,16,9064
5,5,1,0,16,1,17,9064
6,6,1,0,17,1,18,9064
7,7,0,0,17,1,18,9064
0,0,1,0,1,0,1,9065
1,1,1,0,2,0,2,9065
2,2,0,0,2,0,2,9065
0,0,1,0,1,0,1,9066
1,1,0,0,1,0,1,9066
0,0,1,0,1,0,1,9067
1,1,0,0,1,0,1,9067
0,0,1,0,1,0,1,9068
1,1,0,0,1,0,1,9068
0,0,1,0,1,0,1,9069
1,1,1,0,2,0,2,9069
2,2,0,0,2,0,2,9069
0,0,1,0,1,0,1,9070
1,1,5,0,6,0,6,9070
2,2,4,1,10,1,11,9070
3,3,4,3,14,4,18,9070
4,4,6,1,20,5,25,9070
5,5,4,3,24,8,32,9070
6,6,2,0,26,8,34,9070
7,7,1,1,27,9,36,9070
8,8,0,0,27,9,36,9070
0,0,1,0,1,0,1,9071
1,1,2,0,3,0,3,9071
2,2,3,1,6,1,7,9071
3,3,3,0,9,1,10,9071
4,4,0,1,9,2,11,9071
5,5,0,0,9,2,11,9071
0,0,1,0,1,0,1,9072
1,1,0,0,1,0,1,9072
0,0,1,0,1,0,1,9073
1,1,0,1,1,1,2,9073
2,2,0,1,1,2,3,9073
3,3,0,0,1,2,3,9073
0,0,1,0,1,0,1,9074
1,1,0,0,1,0,1,9074
0,0,1,0,1,0,1,9075
1,1,2,0,3,0,3,9075
2,2,0,0,3,0,3,9075
0,0,1,0,1,0,1,9076
1,1,0,0,1,0,1,9076
0,0,1,0,1,0,1,9077
1,1,0,0,1,0,1,9077
0,0,1,0,1,0,1,9078
1,1,0,0,1,0,1,9078
0,0,1,0,1,0,1,9079
1,1,3,0,4,0,4,9079
2,2,0,0,4,0,4,9079
0,0,1,0,1,0,1,9080
1,1,2,0,3,0,3,9080
2,2,0,0,3,0,3,9080
0,0,1,0,1,0,1,9081
1,1,2,0,3,0,3,9081
2,2,4,0,7,0,7,9081
3,3,2,1,9,1,10,9081
4,4,0,2,9,3,12,9081
5,5,0,2,9,5,14,9081
6,6,2,1,11,6,17,9081
7,7,3,0,14,6,20,9081
8,8,1,0,15,6,21,9081
9,9,3,0,18,6,24,9081
10,10,2,0,20,6,26,9081
11,11,1,0,21,6,27,9081
12,12,0,0,21,6,27,9081
0,0,1,0,1,0,1,9082
1,1,0,1,1,1,2,9082
2,2,0,2,1,3,4,9082
3,3,0,3,1,6,7,9082
4,4,2,2,3,8,11,9082
5,5,3,1,6,9,15,9082
6,6,1,1,7,10,17,9082
7,7,1,0,8,10,18,9082
8,8,0,0,8,10,18,9082
0,0,1,0,1,0,1,9083
1,1,1,0,2,0,2,9083
2,2,2,0,4,0,4,9083
3,3,1,0,5,0,5,9083
4,4,3,1,8,1,9,9083
5,5,5,1,13,2,15,9083
6,6,3,1,16,3,19,9083
7,7,2,0,18,3,21,9083
8,8,0,0,18,3,21,9083
0,0,1,0,1,0,1,9084
1,1,0,0,1,0,1,9084
0,0,1,0,1,0,1,9085
1,1,0,0,1,0,1,9085
0,0,1,0,1,0,1,9086
1,1,1,0,2,0,2,9086
2,2,1,0,3,0,3,9086
3,3,2,0,5,0,5,9086
4,4,0,0,5,0,5,9086
0,0,1,0,1,0,1,9087
1,1,0,0,1,0,1,9087
0,0,1,0,1,0,1,9088
1,1,0,1,1,1,2,9088
2,2,0,0,1,1,2,9088
0,0,1,0,1,0,1,9089
1,1,0,0,1,0,1,9089
0,0,1,0,1,0,1,9090
1,1,0,0,1,0,1,9090
0,0,1,0,1,0,1,9091
1,1,4,0,5,0,5,9091
2,2,3,1,8,1,9,9091
3,3,3,2,11,3,14,9091
4,4,1,2,12,5,17,9091
5,5,0,2,12,7,19,9091
6,6,0,3,12,10,22,9091
7,7,0,3,12,13,25,9091
8,8,1,2,13,15,28,9091
9,9,1,4,14,19,33,9091
10,10,0,2,14,21,35,9091
11,11,0,1,14,22,36,9091
12,12,1,0,15,22,37,9091
13,13,0,0,15,22,37,9091
0,0,1,0,1,0,1,9092
1,1,2,0,3,0,3,9092
2,2,2,1,5,1,6,9092
3,3,0,2,5,3,8,9092
4,4,0,1,5,4,9,9092
5,5,0,2,5,6,11,9092
6,6,0,2,5,8,13,9092
7,7,2,1,7,9,16,9092
8,8,2,0,9,9,18,9092
9,9,3,2,12,11,23,9092
10,10,2,4,14,15,29,9092
11,11,3,6,17,21,38,9092
12,12,8,4,25,25,50,9092
13,13,6,5,31,30,61,9092
14,14,8,3,39,33,72,9092
15,15,9,4,48,37,85,9092
16,16,5,5,53,42,95,9092
17,17,4,5,57,47,104,9092
18,18,1,6,58,53,111,9092
19,19,1,2,59,55,114,9092
20,20,1,1,60,56,116,9092
21,21,1,1,61,57,118,9092
22,22,3,0,64,57,121,9092
23,23,2,2,66,59,125,9092
24,24,2,3,68,62,130,9092
25,25,4,2,72,64,136,9092
26,26,4,2,76,66,142,9092
27,27,4,2,80,68,148,9092
28,28,3,0,83,68,151,9092
29,29,1,0,84,68,152,9092
30,30,0,0,84,68,152,9092
0,0,1,0,1,0,1,9093
1,1,3,0,4,0,4,9093
2,2,3,0,7,0,7,9093
3,3,0,1,7,1,8,9093
4,4,1,0,8,1,9,9093
5,5,1,0,9,1,10,9093
6,6,0,0,9,1,10,9093
0,0,1,0,1,0,1,9094
1,1,2,0,3,0,3,9094
2,2,3,0,6,0,6,9094
3,3,2,0,8,0,8,9094
4,4,4,0,12,0,12,9094
5,5,4,0,16,0,16,9094
6,6,4,0,20,0,20,9094
7,7,5,0,25,0,25,9094
8,8,5,0,30,0,30,9094
9,9,4,0,34,0,34,9094
10,10,4,1,38,1,39,9094
11,11,1,1,39,2,41,9094
12,12,0,1,39,3,42,9094
13,13,1,0,40,3,43,9094
14,14,0,0,40,3,43,9094
0,0,1,0,1,0,1,9095
1,1,1,0,2,0,2,9095
2,2,1,0,3,0,3,9095
3,3,0,0,3,0,3,9095
0,0,1,0,1,0,1,9096
1,1,2,0,3,0,3,9096
2,2,1,1,4,1,5,9096
3,3,1,1,5,2,7,9096
4,4,0,1,5,3,8,9096
5,5,0,0,5,3,8,9096
0,0,1,0,1,0,1,9097
1,1,1,0,2,0,2,9097
2,2,1,0,3,0,3,9097
3,3,1,1,4,1,5,9097
4,4,1,1,5,2,7,9097
5,5,1,1,6,3,9,9097
6,6,1,0,7,3,10,9097
7,7,0,0,7,3,10,9097
0,0,1,0,1,0,1,9098
1,1,2,1,3,1,4,9098
2,2,0,1,3,2,5,9098
3,3,1,0,4,2,6,9098
4,4,0,0,4,2,6,9098
0,0,1,0,1,0,1,9099
1,1,0,0,1,0,1,9099
0,0,1,0,1,0,1,9100
1,1,1,0,2,0,2,9100
2,2,0,0,2,0,2,9100
0,0,1,0,1,0,1,9101
1,1,0,0,1,0,1,9101
0,0,1,0,1,0,1,9102
1,1,2,0,3,0,3,9102
2,2,2,0,5,0,5,9102
3,3,2,0,7,0,7,9102
4,4,0,1,7,1,8,9102
5,5,1,0,8,1,9,9102
6,6,0,0,8,1,9,9102
0,0,1,0,1,0,1,9103
1,1,2,0,3,0,3,9103
2,2,0,1,3,1,4,9103
3,3,0,0,3,1,4,9103
0,0,1,0,1,0,1,9104
1,1,1,0,2,0,2,9104
2,2,2,1,4,1,5,9104
3,3,2,1,6,2,8,9104
4,4,1,1,7,3,10,9104
5,5,0,0,7,3,10,9104
0,0,1,0,1,0,1,9105
1,1,0,0,1,0,1,9105
0,0,1,0,1,0,1,9106
1,1,1,0,2,0,2,9106
2,2,1,1,3,1,4,9106
3,3,2,1,5,2,7,9106
4,4,2,1,7,3,10,9106
5,5,0,1,7,4,11,9106
6,6,0,0,7,4,11,9106
0,0,1,0,1,0,1,9107
1,1,0,0,1,0,1,9107
0,0,1,0,1,0,1,9108
1,1,0,0,1,0,1,9108
0,0,1,0,1,0,1,9109
1,1,2,0,3,0,3,9109
2,2,1,0,4,0,4,9109
3,3,0,0,4,0,4,9109
0,0,1,0,1,0,1,9110
1,1,1,0,2,0,2,9110
2,2,0,0,2,0,2,9110
0,0,1,0,1,0,1,9111
1,1,0,0,1,0,1,9111
0,0,1,0,1,0,1,9112
1,1,1,0,2,0,2,9112
2,2,0,0,2,0,2,9112
0,0,1,0,1,0,1,9113
1,1,2,0,3,0,3,9113
2,2,1,0,4,0,4,9113
3,3,1,0,5,0,5,9113
4,4,1,0,6,0,6,9113
5,5,3,0,9,0,9,9113
6,6,0,0,9,0,9,9113
0,0,1,0,1,0,1,9114
1,1,2,0,3,0,3,9114
2,2,2,3,5,3,8,9114
3,3,0,1,5,4,9,9114
4,4,0,0,5,4,9,9114
0,0,1,0,1,0,1,9115
1,1,0,0,1,0,1,9115
0,0,1,0,1,0,1,9116
1,1,0,1,1,1,2,9116
2,2,0,0,1,1,2,9116
0,0,1,0,1,0,1,9117
1,1,2,0,3,0,3,9117
2,2,0,0,3,0,3,9117
0,0,1,0,1,0,1,9118
1,1,0,0,1,0,1,9118
0,0,1,0,1,0,1,9119
1,1,1,0,2,0,2,9119
2,2,1,0,3,0,3,9119
3,3,0,0,3,0,3,9119
0,0,1,0,1,0,1,9120
1,1,0,1,1,1,2,9120
2,2,0,1,1,2,3,9120
3,3,0,0,1,2,3,9120
0,0,1,0,1,0,1,9121
1,1,2,0,3,0,3,9121
2,2,1,0,4,0,4,9121
3,3,1,0,5,0,5,9121
4,4,0,0,5,0,5,9121
0,0,1,0,1,0,1,9122
1,1,1,0,2,0,2,9122
2,2,1,0,3,0,3,9122
3,3,2,0,5,0,5,9122
4,4,2,0,7,0,7,9122
5,5,1,0,8,0,8,9122
6,6,1,0,9,0,9,9122
7,7,0,0,9,0,9,9122
0,0,1,0,1,0,1,9123
1,1,0,0,1,0,1,9123
0,0,1,0,1,0,1,9124
1,1,1,0,2,0,2,9124
2,2,0,0,2,0,2,9124
0,0,1,0,1,0,1,9125
1,1,0,1,1,1,2,9125
2,2,0,1,1,2,3,9125
3,3,0,0,1,2,3,9125
0,0,1,0,1,0,1,9126
1,1,0,0,1,0,1,9126
0,0,1,0,1,0,1,9127
1,1,0,1,1,1,2,9127
2,2,0,2,1,3,4,9127
3,3,0,0,1,3,4,9127
0,0,1,0,1,0,1,9128
1,1,1,0,2,0,2,9128
2,2,0,0,2,0,2,9128
0,0,1,0,1,0,1,9129
1,1,1,0,2,0,2,9129
2,2,0,0,2,0,2,9129
0,0,1,0,1,0,1,9130
1,1,1,1,2,1,3,9130
2,2,1,2,3,3,6,9130
3,3,0,1,3,4,7,9130
4,4,0,1,3,5,8,9130
5,5,0,0,3,5,8,9130
0,0,1,0,1,0,1,9131
1,1,0,0,1,0,1,9131
0,0,1,0,1,0,1,9132
1,1,1,1,2,1,3,9132
2,2,1,2,3,3,6,9132
3,3,1,2,4,5,9,9132
4,4,1,1,5,6,11,9132
5,5,1,1,6,7,13,9132
6,6,0,0,6,7,13,9132
0,0,1,0,1,0,1,9133
1,1,1,0,2,0,2,9133
2,2,0,0,2,0,2,9133
0,0,1,0,1,0,1,9134
1,1,1,1,2,1,3,9134
2,2,1,2,3,3,6,9134
3,3,1,2,4,5,9,9134
4,4,1,4,5,9,14,9134
5,5,1,1,6,10,16,9134
6,6,0,0,6,10,16,9134
0,0,1,0,1,0,1,9135
1,1,0,1,1,1,2,9135
2,2,0,1,1,2,3,9135
3,3,0,0,1,2,3,9135
0,0,1,0,1,0,1,9136
1,1,1,1,2,1,3,9136
2,2,4,1,6,2,8,9136
3,3,2,3,8,5,13,9136
4,4,2,3,10,8,18,9136
5,5,2,2,12,10,22,9136
6,6,3,1,15,11,26,9136
7,7,2,0,17,11,28,9136
8,8,1,0,18,11,29,9136
9,9,2,0,20,11,31,9136
10,10,1,3,21,14,35,9136
11,11,4,3,25,17,42,9136
12,12,3,3,28,20,48,9136
13,13,1,1,29,21,50,9136
14,14,0,0,29,21,50,9136
0,0,1,0,1,0,1,9137
1,1,0,0,1,0,1,9137
0,0,1,0,1,0,1,9138
1,1,0,1,1,1,2,9138
2,2,1,1,2,2,4,9138
3,3,0,0,2,2,4,9138
0,0,1,0,1,0,1,9139
1,1,1,0,2,0,2,9139
2,2,2,0,4,0,4,9139
3,3,2,0,6,0,6,9139
4,4,2,0,8,0,8,9139
5,5,2,0,10,0,10,9139
6,6,2,1,12,1,13,9139
7,7,0,3,12,4,16,9139
8,8,1,6,13,10,23,9139
9,9,5,5,18,15,33,9139
10,10,1,4,19,19,38,9139
11,11,4,5,23,24,47,9139
12,12,8,8,31,32,63,9139
13,13,10,10,41,42,83,9139
14,14,17,10,58,52,110,9139
15,15,10,8,68,60,128,9139
16,16,8,8,76,68,144,9139
17,17,3,3,79,71,150,9139
18,18,0,1,79,72,151,9139
19,19,0,1,79,73,152,9139
20,20,0,0,79,73,152,9139
0,0,1,0,1,0,1,9140
1,1,1,0,2,0,2,9140
2,2,0,0,2,0,2,9140
0,0,1,0,1,0,1,9141
1,1,0,0,1,0,1,9141
0,0,1,0,1,0,1,9142
1,1,1,0,2,0,2,9142
2,2,2,0,4,0,4,9142
3,3,0,0,4,0,4,9142
0,0,1,0,1,0,1,9143
1,1,1,0,2,0,2,9143
2,2,1,0,3,0,3,9143
3,3,1,0,4,0,4,9143
4,4,0,0,4,0,4,9143
0,0,1,0,1,0,1,9144
1,1,0,0,1,0,1,9144
0,0,1,0,1,0,1,9145
1,1,1,0,2,0,2,9145
2,2,0,0,2,0,2,9145
0,0,1,0,1,0,1,9146
1,1,0,0,1,0,1,9146
0,0,1,0,1,0,1,9147
1,1,0,1,1,1,2,9147
2,2,0,0,1,1,2,9147
0,0,1,0,1,0,1,9148
1,1,2,0,3,0,3,9148
2,2,1,0,4,0,4,9148
3,3,1,0,5,0,5,9148
4,4,0,0,5,0,5,9148
0,0,1,0,1,0,1,9149
1,1,0,0,1,0,1,9149
0,0,1,0,1,0,1,9150
1,1,1,0,2,0,2,9150
2,2,1,1,3,1,4,9150
3,3,1,1,4,2,6,9150
4,4,0,0,4,2,6,9150
0,0,1,0,1,0,1,9151
1,1,0,0,1,0,1,9151
0,0,1,0,1,0,1,9152
1,1,1,0,2,0,2,9152
2,2,1,0,3,0,3,9152
3,3,1,0,4,0,4,9152
4,4,0,1,4,1,5,9152
5,5,0,0,4,1,5,9152
0,0,1,0,1,0,1,9153
1,1,3,0,4,0,4,9153
2,2,3,0,7,0,7,9153
3,3,2,1,9,1,10,9153
4,4,5,2,14,3,17,9153
5,5,5,2,19,5,24,9153
6,6,2,0,21,5,26,9153
7,7,0,1,21,6,27,9153
8,8,0,1,21,7,28,9153
9,9,1,0,22,7,29,9153
10,10,1,1,23,8,31,9153
11,11,0,3,23,11,34,9153
12,12,2,8,25,19,44,9153
13,13,2,4,27,23,50,9153
14,14,4,5,31,28,59,9153
15,15,2,2,33,30,63,9153
16,16,5,2,38,32,70,9153
17,17,5,2,43,34,77,9153
18,18,3,3,46,37,83,9153
19,19,4,5,50,42,92,9153
20,20,3,7,53,49,102,9153
21,21,4,2,57,51,108,9153
22,22,0,2,57,53,110,9153
23,23,1,3,58,56,114,9153
24,24,2,1,60,57,117,9153
25,25,0,2,60,59,119,9153
26,26,0,1,60,60,120,9153
27,27,0,1,60,61,121,9153
28,28,0,3,60,64,124,9153
29,29,1,1,61,65,126,9153
30,30,2,1,63,66,129,9153
31,31,1,0,64,66,130,9153
32,32,1,0,65,66,131,9153
33,33,0,1,65,67,132,9153
34,34,0,0,65,67,132,9153
0,0,1,0,1,0,1,9154
1,1,1,0,2,0,2,9154
2,2,2,0,4,0,4,9154
3,3,4,0,8,0,8,9154
4,4,1,0,9,0,9,9154
5,5,1,1,10,1,11,9154
6,6,1,1,11,2,13,9154
7,7,5,0,16,2,18,9154
8,8,3,0,19,2,21,9154
9,9,1,0,20,2,22,9154
10,10,2,0,22,2,24,9154
11,11,2,1,24,3,27,9154
12,12,1,3,25,6,31,9154
13,13,0,3,25,9,34,9154
14,14,0,1,25,10,35,9154
15,15,0,1,25,11,36,9154
16,16,0,0,25,11,36,9154
0,0,1,0,1,0,1,9155
1,1,2,0,3,0,3,9155
2,2,1,0,4,0,4,9155
3,3,2,0,6,0,6,9155
4,4,3,0,9,0,9,9155
5,5,5,0,14,0,14,9155
6,6,2,2,16,2,18,9155
7,7,2,0,18,2,20,9155
8,8,2,1,20,3,23,9155
9,9,0,4,20,7,27,9155
10,10,0,2,20,9,29,9155
11,11,1,4,21,13,34,9155
12,12,2,1,23,14,37,9155
13,13,3,2,26,16,42,9155
14,14,0,1,26,17,43,9155
15,15,0,0,26,17,43,9155
0,0,1,0,1,0,1,9156
1,1,0,0,1,0,1,9156
0,0,1,0,1,0,1,9157
1,1,0,0,1,0,1,9157
0,0,1,0,1,0,1,9158
1,1,1,0,2,0,2,9158
2,2,1,0,3,0,3,9158
3,3,0,1,3,1,4,9158
4,4,0,0,3,1,4,9158
0,0,1,0,1,0,1,9159
1,1,0,0,1,0,1,9159
0,0,1,0,1,0,1,9160
1,1,1,0,2,0,2,9160
2,2,1,0,3,0,3,9160
3,3,0,0,3,0,3,9160
0,0,1,0,1,0,1,9161
1,1,1,0,2,0,2,9161
2,2,3,0,5,0,5,9161
3,3,5,1,10,1,11,9161
4,4,4,2,14,3,17,9161
5,5,4,2,18,5,23,9161
6,6,6,2,24,7,31,9161
7,7,4,3,28,10,38,9161
8,8,6,4,34,14,48,9161
9,9,1,3,35,17,52,9161
10,10,2,4,37,21,58,9161
11,11,3,4,40,25,65,9161
12,12,1,3,41,28,69,9161
13,13,3,4,44,32,76,9161
14,14,1,2,45,34,79,9161
15,15,1,0,46,34,80,9161
16,16,0,0,46,34,80,9161
0,0,1,0,1,0,1,9162
1,1,0,0,1,0,1,9162
0,0,1,0,1,0,1,9163
1,1,0,0,1,0,1,9163
0,0,1,0,1,0,1,9164
1,1,1,0,2,0,2,9164
2,2,0,0,2,0,2,9164
0,0,1,0,1,0,1,9165
1,1,0,0,1,0,1,9165
0,0,1,0,1,0,1,9166
1,1,1,2,2,2,4,9166
2,2,0,3,2,5,7,9166
3,3,0,2,2,7,9,9166
4,4,0,1,2,8,10,9166
5,5,0,0,2,8,10,9166
0,0,1,0,1,0,1,9167
1,1,1,0,2,0,2,9167
2,2,1,0,3,0,3,9167
3,3,1,0,4,0,4,9167
4,4,0,0,4,0,4,9167
0,0,1,0,1,0,1,9168
1,1,0,0,1,0,1,9168
0,0,1,0,1,0,1,9169
1,1,0,1,1,1,2,9169
2,2,0,2,1,3,4,9169
3,3,1,3,2,6,8,9169
4,4,0,1,2,7,9,9169
5,5,0,0,2,7,9,9169
0,0,1,0,1,0,1,9170
1,1,0,0,1,0,1,9170
0,0,1,0,1,0,1,9171
1,1,1,0,2,0,2,9171
2,2,2,0,4,0,4,9171
3,3,1,1,5,1,6,9171
4,4,1,5,6,6,12,9171
5,5,3,6,9,12,21,9171
6,6,3,2,12,14,26,9171
7,7,0,3,12,17,29,9171
8,8,1,1,13,18,31,9171
9,9,0,1,13,19,32,9171
10,10,0,0,13,19,32,9171
0,0,1,0,1,0,1,9172
1,1,1,0,2,0,2,9172
2,2,0,1,2,1,3,9172
3,3,1,0,3,1,4,9172
4,4,0,1,3,2,5,9172
5,5,0,1,3,3,6,9172
6,6,1,0,4,3,7,9172
7,7,1,0,5,3,8,9172
8,8,0,1,5,4,9,9172
9,9,0,1,5,5,10,9172
10,10,0,2,5,7,12,9172
11,11,0,1,5,8,13,9172
12,12,0,1,5,9,14,9172
13,13,0,0,5,9,14,9172
0,0,1,0,1,0,1,9173
1,1,1,0,2,0,2,9173
2,2,0,0,2,0,2,9173
0,0,1,0,1,0,1,9174
1,1,0,0,1,0,1,9174
0,0,1,0,1,0,1,9175
1,1,1,0,2,0,2,9175
2,2,0,0,2,0,2,9175
0,0,1,0,1,0,1,9176
1,1,2,0,3,0,3,9176
2,2,1,2,4,2,6,9176
3,3,0,2,4,4,8,9176
4,4,0,3,4,7,11,9176
5,5,0,2,4,9,13,9176
6,6,0,3,4,12,16,9176
7,7,0,0,4,12,16,9176
0,0,1,0,1,0,1,9177
1,1,2,0,3,0,3,9177
2,2,2,0,5,0,5,9177
3,3,2,0,7,0,7,9177
4,4,1,2,8,2,10,9177
5,5,1,1,9,3,12,9177
6,6,0,0,9,3,12,9177
0,0,1,0,1,0,1,9178
1,1,0,0,1,0,1,9178
0,0,1,0,1,0,1,9179
1,1,2,0,3,0,3,9179
2,2,2,1,5,1,6,9179
3,3,1,2,6,3,9,9179
4,4,1,3,7,6,13,9179
5,5,1,5,8,11,19,9179
6,6,3,3,11,14,25,9179
7,7,2,5,13,19,32,9179
8,8,2,4,15,23,38,9179
9,9,4,6,19,29,48,9179
10,10,2,3,21,32,53,9179
11,11,1,2,22,34,56,9179
12,12,2,2,24,36,60,9179
13,13,1,2,25,38,63,9179
14,14,1,1,26,39,65,9179
15,15,1,1,27,40,67,9179
16,16,5,0,32,40,72,9179
17,17,6,2,38,42,80,9179
18,18,3,4,41,46,87,9179
19,19,2,1,43,47,90,9179
20,20,1,1,44,48,92,9179
21,21,2,1,46,49,95,9179
22,22,2,1,48,50,98,9179
23,23,3,3,51,53,104,9179
24,24,3,1,54,54,108,9179
25,25,2,1,56,55,111,9179
26,26,2,0,58,55,113,9179
27,27,0,1,58,56,114,9179
28,28,0,1,58,57,115,9179
29,29,0,2,58,59,117,9179
30,30,0,4,58,63,121,9179
31,31,1,3,59,66,125,9179
32,32,1,3,60,69,129,9179
33,33,5,5,65,74,139,9179
34,34,6,4,71,78,149,9179
35,35,4,2,75,80,155,9179
36,36,4,5,79,85,164,9179
37,37,6,4,85,89,174,9179
38,38,2,4,87,93,180,9179
39,39,4,2,91,95,186,9179
40,40,4,0,95,95,190,9179
41,41,2,2,97,97,194,9179
42,42,3,0,100,97,197,9179
43,43,2,1,102,98,200,9179
44,44,2,0,104,98,202,9179
45,45,1,0,105,98,203,9179
46,46,0,0,105,98,203,9179
0,0,1,0,1,0,1,9180
1,1,1,0,2,0,2,9180
2,2,1,0,3,0,3,9180
3,3,2,0,5,0,5,9180
4,4,2,0,7,0,7,9180
5,5,4,1,11,1,12,9180
6,6,3,3,14,4,18,9180
7,7,1,2,15,6,21,9180
8,8,1,3,16,9,25,9180
9,9,2,2,18,11,29,9180
10,10,2,3,20,14,34,9180
11,11,0,2,20,16,36,9180
12,12,0,0,20,16,36,9180
0,0,1,0,1,0,1,9181
1,1,0,0,1,0,1,9181
0,0,1,0,1,0,1,9182
1,1,2,0,3,0,3,9182
2,2,1,0,4,0,4,9182
3,3,1,1,5,1,6,9182
4,4,1,0,6,1,7,9182
5,5,0,0,6,1,7,9182
0,0,1,0,1,0,1,9183
1,1,0,0,1,0,1,9183
0,0,1,0,1,0,1,9184
1,1,0,1,1,1,2,9184
2,2,0,1,1,2,3,9184
3,3,1,0,2,2,4,9184
4,4,2,0,4,2,6,9184
5,5,1,0,5,2,7,9184
6,6,0,0,5,2,7,9184
0,0,1,0,1,0,1,9185
1,1,0,0,1,0,1,9185
0,0,1,0,1,0,1,9186
1,1,0,0,1,0,1,9186
0,0,1,0,1,0,1,9187
1,1,0,0,1,0,1,9187
0,0,1,0,1,0,1,9188
1,1,1,0,2,0,2,9188
2,2,1,0,3,0,3,9188
3,3,0,0,3,0,3,9188
0,0,1,0,1,0,1,9189
1,1,1,0,2,0,2,9189
2,2,1,0,3,0,3,9189
3,3,1,0,4,0,4,9189
4,4,0,1,4,1,5,9189
5,5,0,0,4,1,5,9189
0,0,1,0,1,0,1,9190
1,1,1,0,2,0,2,9190
2,2,1,0,3,0,3,9190
3,3,0,0,3,0,3,9190
0,0,1,0,1,0,1,9191
1,1,2,0,3,0,3,9191
2,2,1,1,4,1,5,9191
3,3,3,0,7,1,8,9191
4,4,3,1,10,2,12,9191
5,5,1,2,11,4,15,9191
6,6,1,4,12,8,20,9191
7,7,1,5,13,13,26,9191
8,8,1,4,14,17,31,9191
9,9,0,7,14,24,38,9191
10,10,1,2,15,26,41,9191
11,11,0,0,15,26,41,9191
0,0,1,0,1,0,1,9192
1,1,0,0,1,0,1,9192
0,0,1,0,1,0,1,9193
1,1,0,0,1,0,1,9193
0,0,1,0,1,0,1,9194
1,1,0,1,1,1,2,9194
2,2,0,1,1,2,3,9194
3,3,1,0,2,2,4,9194
4,4,0,1,2,3,5,9194
5,5,0,0,2,3,5,9194
0,0,1,0,1,0,1,9195
1,1,3,0,4,0,4,9195
2,2,2,0,6,0,6,9195
3,3,2,0,8,0,8,9195
4,4,1,0,9,0,9,9195
5,5,0,0,9,0,9,9195
0,0,1,0,1,0,1,9196
1,1,1,0,2,0,2,9196
2,2,0,0,2,0,2,9196
0,0,1,0,1,0,1,9197
1,1,1,0,2,0,2,9197
2,2,0,0,2,0,2,9197
0,0,1,0,1,0,1,9198
1,1,0,0,1,0,1,9198
0,0,1,0,1,0,1,9199
1,1,0,0,1,0,1,9199
0,0,1,0,1,0,1,9200
1,1,0,0,1,0,1,9200
0,0,1,0,1,0,1,9201
1,1,1,0,2,0,2,9201
2,2,0,0,2,0,2,9201
0,0,1,0,1,0,1,9202
1,1,1,0,2,0,2,9202
2,2,0,1,2,1,3,9202
3,3,0,0,2,1,3,9202
0,0,1,0,1,0,1,9203
1,1,0,0,1,0,1,9203
0,0,1,0,1,0,1,9204
1,1,1,0,2,0,2,9204
2,2,0,0,2,0,2,9204
0,0,1,0,1,0,1,9205
1,1,1,0,2,0,2,9205
2,2,0,0,2,0,2,9205
0,0,1,0,1,0,1,9206
1,1,0,0,1,0,1,9206
0,0,1,0,1,0,1,9207
1,1,2,0,3,0,3,9207
2,2,2,0,5,0,5,9207
3,3,2,1,7,1,8,9207
4,4,1,0,8,1,9,9207
5,5,2,0,10,1,11,9207
6,6,1,2,11,3,14,9207
7,7,0,1,11,4,15,9207
8,8,0,1,11,5,16,9207
9,9,0,0,11,5,16,9207
0,0,1,0,1,0,1,9208
1,1,0,0,1,0,1,9208
0,0,1,0,1,0,1,9209
1,1,0,0,1,0,1,9209
0,0,1,0,1,0,1,9210
1,1,1,0,2,0,2,9210
2,2,1,0,3,0,3,9210
3,3,2,0,5,0,5,9210
4,4,2,0,7,0,7,9210
5,5,2,2,9,2,11,9210
6,6,0,1,9,3,12,9210
7,7,0,0,9,3,12,9210
0,0,1,0,1,0,1,9211
1,1,1,0,2,0,2,9211
2,2,0,0,2,0,2,9211
0,0,1,0,1,0,1,9212
1,1,1,0,2,0,2,9212
2,2,2,0,4,0,4,9212
3,3,1,0,5,0,5,9212
4,4,0,2,5,2,7,9212
5,5,1,2,6,4,10,9212
6,6,2,4,8,8,16,9212
7,7,1,0,9,8,17,9212
8,8,1,0,10,8,18,9212
9,9,1,0,11,8,19,9212
10,10,0,0,11,8,19,9212
0,0,1,0,1,0,1,9213
1,1,0,0,1,0,1,9213
0,0,1,0,1,0,1,9214
1,1,0,0,1,0,1,9214
0,0,1,0,1,0,1,9215
1,1,1,0,2,0,2,9215
2,2,0,1,2,1,3,9215
3,3,0,1,2,2,4,9215
4,4,0,0,2,2,4,9215
0,0,1,0,1,0,1,9216
1,1,1,0,2,0,2,9216
2,2,0,0,2,0,2,9216
0,0,1,0,1,0,1,9217
1,1,1,0,2,0,2,9217
2,2,1,0,3,0,3,9217
3,3,1,0,4,0,4,9217
4,4,3,0,7,0,7,9217
5,5,5,0,12,0,12,9217
6,6,4,1,16,1,17,9217
7,7,3,1,19,2,21,9217
8,8,0,1,19,3,22,9217
9,9,0,0,19,3,22,9217
0,0,1,0,1,0,1,9218
1,1,0,0,1,0,1,9218
0,0,1,0,1,0,1,9219
1,1,1,0,2,0,2,9219
2,2,0,0,2,0,2,9219
0,0,1,0,1,0,1,9220
1,1,0,0,1,0,1,9220
0,0,1,0,1,0,1,9221
1,1,0,0,1,0,1,9221
0,0,1,0,1,0,1,9222
1,1,0,0,1,0,1,9222
0,0,1,0,1,0,1,9223
1,1,0,0,1,0,1,9223
0,0,1,0,1,0,1,9224
1,1,2,1,3,1,4,9224
2,2,3,1,6,2,8,9224
3,3,3,2,9,4,13,9224
4,4,2,0,11,4,15,9224
5,5,1,0,12,4,16,9224
6,6,0,0,12,4,16,9224
0,0,1,0,1,0,1,9225
1,1,0,0,1,0,1,9225
0,0,1,0,1,0,1,9226
1,1,1,0,2,0,2,9226
2,2,1,0,3,0,3,9226
3,3,1,0,4,0,4,9226
4,4,0,0,4,0,4,9226
0,0,1,0,1,0,1,9227
1,1,1,0,2,0,2,9227
2,2,1,1,3,1,4,9227
3,3,0,0,3,1,4,9227
0,0,1,0,1,0,1,9228
1,1,0,0,1,0,1,9228
0,0,1,0,1,0,1,9229
1,1,0,0,1,0,1,9229
0,0,1,0,1,0,1,9230
1,1,1,0,2,0,2,9230
2,2,1,0,3,0,3,9230
3,3,0,1,3,1,4,9230
4,4,0,3,3,4,7,9230
5,5,0,2,3,6,9,9230
6,6,0,2,3,8,11,9230
7,7,0,2,3,10,13,9230
8,8,0,3,3,13,16,9230
9,9,1,3,4,16,20,9230
10,10,1,3,5,19,24,9230
11,11,2,2,7,21,28,9230
12,12,2,1,9,22,31,9230
13,13,0,1,9,23,32,9230
14,14,1,0,10,23,33,9230
15,15,3,0,13,23,36,9230
16,16,1,0,14,23,37,9230
17,17,2,0,16,23,39,9230
18,18,0,0,16,23,39,9230
0,0,1,0,1,0,1,9231
1,1,1,0,2,0,2,9231
2,2,1,0,3,0,3,9231
3,3,1,0,4,0,4,9231
4,4,0,0,4,0,4,9231
0,0,1,0,1,0,1,9232
1,1,0,1,1,1,2,9232
2,2,1,0,2,1,3,9232
3,3,2,0,4,1,5,9232
4,4,1,1,5,2,7,9232
5,5,1,2,6,4,10,9232
6,6,0,0,6,4,10,9232
0,0,1,0,1,0,1,9233
1,1,0,0,1,0,1,9233
0,0,1,0,1,0,1,9234
1,1,0,0,1,0,1,9234
0,0,1,0,1,0,1,9235
1,1,0,0,1,0,1,9235
0,0,1,0,1,0,1,9236
1,1,1,0,2,0,2,9236
2,2,1,1,3,1,4,9236
3,3,2,0,5,1,6,9236
4,4,1,0,6,1,7,9236
5,5,2,0,8,1,9,9236
6,6,2,0,10,1,11,9236
7,7,1,0,11,1,12,9236
8,8,0,0,11,1,12,9236
0,0,1,0,1,0,1,9237
1,1,1,0,2,0,2,9237
2,2,0,1,2,1,3,9237
3,3,0,1,2,2,4,9237
4,4,0,1,2,3,5,9237
5,5,0,0,2,3,5,9237
0,0,1,0,1,0,1,9238
1,1,1,0,2,0,2,9238
2,2,1,1,3,1,4,9238
3,3,0,3,3,4,7,9238
4,4,1,0,4,4,8,9238
5,5,1,1,5,5,10,9238
6,6,0,0,5,5,10,9238
0,0,1,0,1,0,1,9239
1,1,2,0,3,0,3,9239
2,2,2,0,5,0,5,9239
3,3,4,1,9,1,10,9239
4,4,3,2,12,3,15,9239
5,5,2,0,14,3,17,9239
6,6,3,0,17,3,20,9239
7,7,2,3,19,6,25,9239
8,8,3,4,22,10,32,9239
9,9,4,5,26,15,41,9239
10,10,5,6,31,21,52,9239
11,11,5,7,36,28,64,9239
12,12,3,8,39,36,75,9239
13,13,4,5,43,41,84,9239
14,14,3,3,46,44,90,9239
15,15,3,3,49,47,96,9239
16,16,4,1,53,48,101,9239
17,17,2,1,55,49,104,9239
18,18,1,0,56,49,105,9239
19,19,0,0,56,49,105,9239
0,0,1,0,1,0,1,9240
1,1,2,0,3,0,3,9240
2,2,2,0,5,0,5,9240
3,3,1,0,6,0,6,9240
4,4,0,0,6,0,6,9240
0,0,1,0,1,0,1,9241
1,1,1,0,2,0,2,9241
2,2,0,0,2,0,2,9241
0,0,1,0,1,0,1,9242
1,1,0,0,1,0,1,9242
0,0,1,0,1,0,1,9243
1,1,0,0,1,0,1,9243
0,0,1,0,1,0,1,9244
1,1,1,0,2,0,2,9244
2,2,0,0,2,0,2,9244
0,0,1,0,1,0,1,9245
1,1,1,0,2,0,2,9245
2,2,1,0,3,0,3,9245
3,3,3,0,6,0,6,9245
4,4,2,1,8,1,9,9245
5,5,2,2,10,3,13,9245
6,6,3,0,13,3,16,9245
7,7,2,2,15,5,20,9245
8,8,2,6,17,11,28,9245
9,9,0,7,17,18,35,9245
10,10,1,2,18,20,38,9245
11,11,1,0,19,20,39,9245
12,12,1,0,20,20,40,9245
13,13,0,0,20,20,40,9245
0,0,1,0,1,0,1,9246
1,1,1,0,2,0,2,9246
2,2,1,0,3,0,3,9246
3,3,1,0,4,0,4,9246
4,4,1,1,5,1,6,9246
5,5,0,2,5,3,8,9246
6,6,1,0,6,3,9,9246
7,7,1,0,7,3,10,9246
8,8,0,0,7,3,10,9246
0,0,1,0,1,0,1,9247
1,1,0,0,1,0,1,9247
0,0,1,0,1,0,1,9248
1,1,1,1,2,1,3,9248
2,2,1,0,3,1,4,9248
3,3,1,0,4,1,5,9248
4,4,1,1,5,2,7,9248
5,5,0,3,5,5,10,9248
6,6,1,1,6,6,12,9248
7,7,1,1,7,7,14,9248
8,8,1,2,8,9,17,9248
9,9,1,3,9,12,21,9248
10,10,1,3,10,15,25,9248
11,11,0,2,10,17,27,9248
12,12,0,0,10,17,27,9248
0,0,1,0,1,0,1,9249
1,1,0,1,1,1,2,9249
2,2,0,0,1,1,2,9249
0,0,1,0,1,0,1,9250
1,1,0,0,1,0,1,9250
0,0,1,0,1,0,1,9251
1,1,1,0,2,0,2,9251
2,2,0,2,2,2,4,9251
3,3,0,0,2,2,4,9251
0,0,1,0,1,0,1,9252
1,1,2,1,3,1,4,9252
2,2,2,4,5,5,10,9252
3,3,4,2,9,7,16,9252
4,4,2,2,11,9,20,9252
5,5,0,0,11,9,20,9252
0,0,1,0,1,0,1,9253
1,1,2,0,3,0,3,9253
2,2,2,1,5,1,6,9253
3,3,2,1,7,2,9,9253
4,4,1,0,8,2,10,9253
5,5,0,0,8,2,10,9253
0,0,1,0,1,0,1,9254
1,1,3,0,4,0,4,9254
2,2,5,0,9,0,9,9254
3,3,3,1,12,1,13,9254
4,4,1,2,13,3,16,9254
5,5,0,1,13,4,17,9254
6,6,0,0,13,4,17,9254
0,0,1,0,1,0,1,9255
1,1,1,0,2,0,2,9255
2,2,1,0,3,0,3,9255
3,3,0,0,3,0,3,9255
0,0,1,0,1,0,1,9256
1,1,0,1,1,1,2,9256
2,2,0,1,1,2,3,9256
3,3,0,0,1,2,3,9256
0,0,1,0,1,0,1,9257
1,1,0,0,1,0,1,9257
0,0,1,0,1,0,1,9258
1,1,1,0,2,0,2,9258
2,2,1,0,3,0,3,9258
3,3,1,0,4,0,4,9258
4,4,1,0,5,0,5,9258
5,5,0,0,5,0,5,9258
0,0,1,0,1,0,1,9259
1,1,1,0,2,0,2,9259
2,2,1,0,3,0,3,9259
3,3,0,0,3,0,3,9259
0,0,1,0,1,0,1,9260
1,1,1,0,2,0,2,9260
2,2,1,0,3,0,3,9260
3,3,0,0,3,0,3,9260
0,0,1,0,1,0,1,9261
1,1,1,0,2,0,2,9261
2,2,0,0,2,0,2,9261
0,0,1,0,1,0,1,9262
1,1,0,0,1,0,1,9262
0,0,1,0,1,0,1,9263
1,1,0,1,1,1,2,9263
2,2,0,0,1,1,2,9263
0,0,1,0,1,0,1,9264
1,1,1,0,2,0,2,9264
2,2,1,0,3,0,3,9264
3,3,0,0,3,0,3,9264
0,0,1,0,1,0,1,9265
1,1,0,0,1,0,1,9265
0,0,1,0,1,0,1,9266
1,1,2,0,3,0,3,9266
2,2,1,0,4,0,4,9266
3,3,0,2,4,2,6,9266
4,4,0,0,4,2,6,9266
0,0,1,0,1,0,1,9267
1,1,0,0,1,0,1,9267
0,0,1,0,1,0,1,9268
1,1,2,0,3,0,3,9268
2,2,3,0,6,0,6,9268
3,3,1,0,7,0,7,9268
4,4,1,0,8,0,8,9268
5,5,2,1,10,1,11,9268
6,6,1,0,11,1,12,9268
7,7,1,0,12,1,13,9268
8,8,2,0,14,1,15,9268
9,9,0,0,14,1,15,9268
0,0,1,0,1,0,1,9269
1,1,1,0,2,0,2,9269
2,2,0,0,2,0,2,9269
0,0,1,0,1,0,1,9270
1,1,0,0,1,0,1,9270
0,0,1,0,1,0,1,9271
1,1,1,0,2,0,2,9271
2,2,2,1,4,1,5,9271
3,3,0,1,4,2,6,9271
4,4,1,0,5,2,7,9271
5,5,1,0,6,2,8,9271
6,6,1,0,7,2,9,9271
7,7,0,0,7,2,9,9271
0,0,1,0,1,0,1,9272
1,1,1,1,2,1,3,9272
2,2,0,3,2,4,6,9272
3,3,1,4,3,8,11,9272
4,4,2,2,5,10,15,9272
5,5,2,3,7,13,20,9272
6,6,1,3,8,16,24,9272
7,7,4,3,12,19,31,9272
8,8,4,7,16,26,42,9272
9,9,3,4,19,30,49,9272
10,10,5,6,24,36,60,9272
11,11,2,3,26,39,65,9272
12,12,3,3,29,42,71,9272
13,13,4,4,33,46,79,9272
14,14,4,8,37,54,91,9272
15,15,4,8,41,62,103,9272
16,16,3,8,44,70,114,9272
17,17,3,2,47,72,119,9272
18,18,4,0,51,72,123,9272
19,19,5,0,56,72,128,9272
20,20,3,0,59,72,131,9272
21,21,1,1,60,73,133,9272
22,22,2,2,62,75,137,9272
23,23,0,1,62,76,138,9272
24,24,0,1,62,77,139,9272
25,25,0,2,62,79,141,9272
26,26,0,1,62,80,142,9272
27,27,0,0,62,80,142,9272
0,0,1,0,1,0,1,9273
1,1,1,0,2,0,2,9273
2,2,1,0,3,0,3,9273
3,3,0,0,3,0,3,9273
0,0,1,0,1,0,1,9274
1,1,1,0,2,0,2,9274
2,2,2,0,4,0,4,9274
3,3,0,2,4,2,6,9274
4,4,1,0,5,2,7,9274
5,5,3,0,8,2,10,9274
6,6,4,0,12,2,14,9274
7,7,3,2,15,4,19,9274
8,8,7,2,22,6,28,9274
9,9,3,4,25,10,35,9274
10,10,0,1,25,11,36,9274
11,11,0,1,25,12,37,9274
12,12,0,0,25,12,37,9274
0,0,1,0,1,0,1,9275
1,1,0,0,1,0,1,9275
0,0,1,0,1,0,1,9276
1,1,3,0,4,0,4,9276
2,2,2,1,6,1,7,9276
3,3,4,1,10,2,12,9276
4,4,3,1,13,3,16,9276
5,5,3,1,16,4,20,9276
6,6,4,2,20,6,26,9276
7,7,3,0,23,6,29,9276
8,8,3,1,26,7,33,9276
9,9,3,0,29,7,36,9276
10,10,4,2,33,9,42,9276
11,11,1,0,34,9,43,9276
12,12,1,0,35,9,44,9276
13,13,0,1,35,10,45,9276
14,14,0,0,35,10,45,9276
0,0,1,0,1,0,1,9277
1,1,0,0,1,0,1,9277
0,0,1,0,1,0,1,9278
1,1,1,0,2,0,2,9278
2,2,0,0,2,0,2,9278
0,0,1,0,1,0,1,9279
1,1,1,0,2,0,2,9279
2,2,0,0,2,0,2,9279
0,0,1,0,1,0,1,9280
1,1,0,0,1,0,1,9280
0,0,1,0,1,0,1,9281
1,1,1,0,2,0,2,9281
2,2,0,0,2,0,2,9281
0,0,1,0,1,0,1,9282
1,1,0,0,1,0,1,9282
0,0,1,0,1,0,1,9283
1,1,0,0,1,0,1,9283
0,0,1,0,1,0,1,9284
1,1,0,0,1,0,1,9284
0,0,1,0,1,0,1,9285
1,1,2,0,3,0,3,9285
2,2,0,0,3,0,3,9285
0,0,1,0,1,0,1,9286
1,1,0,0,1,0,1,9286
0,0,1,0,1,0,1,9287
1,1,1,0,2,0,2,9287
2,2,0,0,2,0,2,9287
0,0,1,0,1,0,1,9288
1,1,1,0,2,0,2,9288
2,2,0,0,2,0,2,9288
0,0,1,0,1,0,1,9289
1,1,0,0,1,0,1,9289
0,0,1,0,1,0,1,9290
1,1,0,0,1,0,1,9290
0,0,1,0,1,0,1,9291
1,1,0,1,1,1,2,9291
2,2,0,0,1,1,2,9291
0,0,1,0,1,0,1,9292
1,1,0,0,1,0,1,9292
0,0,1,0,1,0,1,9293
1,1,2,0,3,0,3,9293
2,2,2,0,5,0,5,9293
3,3,0,0,5,0,5,9293
0,0,1,0,1,0,1,9294
1,1,1,0,2,0,2,9294
2,2,0,0,2,0,2,9294
0,0,1,0,1,0,1,9295
1,1,0,0,1,0,1,9295
0,0,1,0,1,0,1,9296
1,1,0,1,1,1,2,9296
2,2,1,1,2,2,4,9296
3,3,0,1,2,3,5,9296
4,4,0,0,2,3,5,9296
0,0,1,0,1,0,1,9297
1,1,1,1,2,1,3,9297
2,2,1,1,3,2,5,9297
3,3,3,3,6,5,11,9297
4,4,4,4,10,9,19,9297
5,5,3,6,13,15,28,9297
6,6,4,0,17,15,32,9297
7,7,3,1,20,16,36,9297
8,8,2,2,22,18,40,9297
9,9,3,3,25,21,46,9297
10,10,2,2,27,23,50,9297
11,11,5,2,32,25,57,9297
12,12,1,0,33,25,58,9297
13,13,1,0,34,25,59,9297
14,14,3,0,37,25,62,9297
15,15,2,1,39,26,65,9297
16,16,2,0,41,26,67,9297
17,17,3,1,44,27,71,9297
18,18,3,0,47,27,74,9297
19,19,3,3,50,30,80,9297
20,20,2,4,52,34,86,9297
21,21,3,6,55,40,95,9297
22,22,9,4,64,44,108,9297
23,23,5,7,69,51,120,9297
24,24,5,2,74,53,127,9297
25,25,3,1,77,54,131,9297
26,26,3,0,80,54,134,9297
27,27,1,1,81,55,136,9297
28,28,0,1,81,56,137,9297
29,29,0,0,81,56,137,9297
0,0,1,0,1,0,1,9298
1,1,1,0,2,0,2,9298
2,2,1,0,3,0,3,9298
3,3,2,0,5,0,5,9298
4,4,1,1,6,1,7,9298
5,5,0,0,6,1,7,9298
0,0,1,0,1,0,1,9299
1,1,0,0,1,0,1,9299
0,0,1,0,1,0,1,9300
1,1,2,1,3,1,4,9300
2,2,2,0,5,1,6,9300
3,3,3,1,8,2,10,9300
4,4,3,1,11,3,14,9300
5,5,3,1,14,4,18,9300
6,6,2,0,16,4,20,9300
7,7,2,0,18,4,22,9300
8,8,2,1,20,5,25,9300
9,9,2,1,22,6,28,9300
10,10,2,0,24,6,30,9300
11,11,3,1,27,7,34,9300
12,12,4,2,31,9,40,9300
13,13,5,1,36,10,46,9300
14,14,3,2,39,12,51,9300
15,15,3,2,42,14,56,9300
16,16,3,0,45,14,59,9300
17,17,1,0,46,14,60,9300
18,18,0,0,46,14,60,9300
0,0,1,0,1,0,1,9301
1,1,0,1,1,1,2,9301
2,2,1,0,2,1,3,9301
3,3,0,0,2,1,3,9301
0,0,1,0,1,0,1,9302
1,1,0,1,1,1,2,9302
2,2,0,1,1,2,3,9302
3,3,0,0,1,2,3,9302
0,0,1,0,1,0,1,9303
1,1,2,0,3,0,3,9303
2,2,1,1,4,1,5,9303
3,3,2,0,6,1,7,9303
4,4,2,1,8,2,10,9303
5,5,1,1,9,3,12,9303
6,6,4,3,13,6,19,9303
7,7,4,1,17,7,24,9303
8,8,4,0,21,7,28,9303
9,9,4,0,25,7,32,9303
10,10,1,0,26,7,33,9303
11,11,1,0,27,7,34,9303
12,12,0,0,27,7,34,9303
0,0,1,0,1,0,1,9304
1,1,0,0,1,0,1,9304
0,0,1,0,1,0,1,9305
1,1,0,0,1,0,1,9305
0,0,1,0,1,0,1,9306
1,1,2,0,3,0,3,9306
2,2,2,1,5,1,6,9306
3,3,2,2,7,3,10,9306
4,4,2,1,9,4,13,9306
5,5,0,1,9,5,14,9306
6,6,0,1,9,6,15,9306
7,7,0,1,9,7,16,9306
8,8,0,0,9,7,16,9306
0,0,1,0,1,0,1,9307
1,1,1,0,2,0,2,9307
2,2,0,0,2,0,2,9307
0,0,1,0,1,0,1,9308
1,1,0,0,1,0,1,9308
0,0,1,0,1,0,1,9309
1,1,1,0,2,0,2,9309
2,2,0,0,2,0,2,9309
0,0,1,0,1,0,1,9310
1,1,1,1,2,1,3,9310
2,2,0,0,2,1,3,9310
0,0,1,0,1,0,1,9311
1,1,0,0,1,0,1,9311
0,0,1,0,1,0,1,9312
1,1,2,1,3,1,4,9312
2,2,2,0,5,1,6,9312
3,3,2,2,7,3,10,9312
4,4,2,2,9,5,14,9312
5,5,2,2,11,7,18,9312
6,6,2,2,13,9,22,9312
7,7,3,1,16,10,26,9312
8,8,1,0,17,10,27,9312
9,9,0,0,17,10,27,9312
0,0,1,0,1,0,1,9313
1,1,1,0,2,0,2,9313
2,2,0,0,2,0,2,9313
0,0,1,0,1,0,1,9314
1,1,1,0,2,0,2,9314
2,2,0,0,2,0,2,9314
0,0,1,0,1,0,1,9315
1,1,0,1,1,1,2,9315
2,2,0,0,1,1,2,9315
0,0,1,0,1,0,1,9316
1,1,2,0,3,0,3,9316
2,2,4,3,7,3,10,9316
3,3,4,2,11,5,16,9316
4,4,2,2,13,7,20,9316
5,5,2,1,15,8,23,9316
6,6,2,1,17,9,26,9316
7,7,1,3,18,12,30,9316
8,8,0,3,18,15,33,9316
9,9,1,5,19,20,39,9316
10,10,0,3,19,23,42,9316
11,11,0,3,19,26,45,9316
12,12,0,4,19,30,49,9316
13,13,0,3,19,33,52,9316
14,14,0,2,19,35,54,9316
15,15,0,1,19,36,55,9316
16,16,0,0,19,36,55,9316
0,0,1,0,1,0,1,9317
1,1,0,0,1,0,1,9317
0,0,1,0,1,0,1,9318
1,1,0,0,1,0,1,9318
0,0,1,0,1,0,1,9319
1,1,2,0,3,0,3,9319
2,2,1,0,4,0,4,9319
3,3,0,0,4,0,4,9319
0,0,1,0,1,0,1,9320
1,1,1,0,2,0,2,9320
2,2,0,0,2,0,2,9320
0,0,1,0,1,0,1,9321
1,1,1,1,2,1,3,9321
2,2,0,0,2,1,3,9321
0,0,1,0,1,0,1,9322
1,1,1,0,2,0,2,9322
2,2,1,0,3,0,3,9322
3,3,0,0,3,0,3,9322
0,0,1,0,1,0,1,9323
1,1,0,0,1,0,1,9323
0,0,1,0,1,0,1,9324
1,1,2,0,3,0,3,9324
2,2,1,1,4,1,5,9324
3,3,0,1,4,2,6,9324
4,4,0,1,4,3,7,9324
5,5,0,0,4,3,7,9324
0,0,1,0,1,0,1,9325
1,1,0,0,1,0,1,9325
0,0,1,0,1,0,1,9326
1,1,0,1,1,1,2,9326
2,2,0,3,1,4,5,9326
3,3,0,2,1,6,7,9326
4,4,1,1,2,7,9,9326
5,5,1,0,3,7,10,9326
6,6,0,0,3,7,10,9326
0,0,1,0,1,0,1,9327
1,1,0,1,1,1,2,9327
2,2,0,0,1,1,2,9327
0,0,1,0,1,0,1,9328
1,1,1,0,2,0,2,9328
2,2,1,1,3,1,4,9328
3,3,3,0,6,1,7,9328
4,4,2,2,8,3,11,9328
5,5,2,3,10,6,16,9328
6,6,4,5,14,11,25,9328
7,7,5,2,19,13,32,9328
8,8,2,0,21,13,34,9328
9,9,3,0,24,13,37,9328
10,10,1,1,25,14,39,9328
11,11,4,0,29,14,43,9328
12,12,2,0,31,14,45,9328
13,13,0,1,31,15,46,9328
14,14,0,3,31,18,49,9328
15,15,0,1,31,19,50,9328
16,16,0,2,31,21,52,9328
17,17,0,2,31,23,54,9328
18,18,1,2,32,25,57,9328
19,19,1,2,33,27,60,9328
20,20,1,2,34,29,63,9328
21,21,1,2,35,31,66,9328
22,22,0,1,35,32,67,9328
23,23,0,0,35,32,67,9328
0,0,1,0,1,0,1,9329
1,1,2,1,3,1,4,9329
2,2,2,0,5,1,6,9329
3,3,2,0,7,1,8,9329
4,4,5,0,12,1,13,9329
5,5,7,1,19,2,21,9329
6,6,6,0,25,2,27,9329
7,7,3,0,28,2,30,9329
8,8,2,2,30,4,34,9329
9,9,2,0,32,4,36,9329
10,10,4,0,36,4,40,9329
11,11,5,1,41,5,46,9329
12,12,0,1,41,6,47,9329
13,13,0,3,41,9,50,9329
14,14,0,6,41,15,56,9329
15,15,0,4,41,19,60,9329
16,16,2,2,43,21,64,9329
17,17,2,2,45,23,68,9329
18,18,1,2,46,25,71,9329
19,19,2,2,48,27,75,9329
20,20,3,1,51,28,79,9329
21,21,3,0,54,28,82,9329
22,22,4,0,58,28,86,9329
23,23,2,2,60,30,90,9329
24,24,2,3,62,33,95,9329
25,25,2,4,64,37,101,9329
26,26,3,2,67,39,106,9329
27,27,3,1,70,40,110,9329
28,28,2,1,72,41,113,9329
29,29,3,1,75,42,117,9329
30,30,5,0,80,42,122,9329
31,31,1,1,81,43,124,9329
32,32,2,1,83,44,127,9329
33,33,1,2,84,46,130,9329
34,34,5,2,89,48,137,9329
35,35,4,1,93,49,142,9329
36,36,4,0,97,49,146,9329
37,37,3,1,100,50,150,9329
38,38,0,0,100,50,150,9329
0,0,1,0,1,0,1,9330
1,1,0,0,1,0,1,9330
0,0,1,0,1,0,1,9331
1,1,2,0,3,0,3,9331
2,2,1,1,4,1,5,9331
3,3,1,0,5,1,6,9331
4,4,0,0,5,1,6,9331
0,0,1,0,1,0,1,9332
1,1,2,0,3,0,3,9332
2,2,0,1,3,1,4,9332
3,3,0,1,3,2,5,9332
4,4,0,0,3,2,5,9332
0,0,1,0,1,0,1,9333
1,1,1,0,2,0,2,9333
2,2,0,0,2,0,2,9333
0,0,1,0,1,0,1,9334
1,1,1,0,2,0,2,9334
2,2,0,0,2,0,2,9334
0,0,1,0,1,0,1,9335
1,1,0,0,1,0,1,9335
0,0,1,0,1,0,1,9336
1,1,0,0,1,0,1,9336
0,0,1,0,1,0,1,9337
1,1,0,0,1,0,1,9337
0,0,1,0,1,0,1,9338
1,1,1,0,2,0,2,9338
2,2,1,0,3,0,3,9338
3,3,0,0,3,0,3,9338
0,0,1,0,1,0,1,9339
1,1,1,0,2,0,2,9339
2,2,0,0,2,0,2,9339
0,0,1,0,1,0,1,9340
1,1,2,1,3,1,4,9340
2,2,1,0,4,1,5,9340
3,3,0,0,4,1,5,9340
0,0,1,0,1,0,1,9341
1,1,1,0,2,0,2,9341
2,2,0,0,2,0,2,9341
0,0,1,0,1,0,1,9342
1,1,1,0,2,0,2,9342
2,2,0,0,2,0,2,9342
0,0,1,0,1,0,1,9343
1,1,0,0,1,0,1,9343
0,0,1,0,1,0,1,9344
1,1,0,0,1,0,1,9344
0,0,1,0,1,0,1,9345
1,1,0,0,1,0,1,9345
0,0,1,0,1,0,1,9346
1,1,0,0,1,0,1,9346
0,0,1,0,1,0,1,9347
1,1,1,0,2,0,2,9347
2,2,1,1,3,1,4,9347
3,3,1,2,4,3,7,9347
4,4,1,2,5,5,10,9347
5,5,2,3,7,8,15,9347
6,6,0,1,7,9,16,9347
7,7,0,2,7,11,18,9347
8,8,0,1,7,12,19,9347
9,9,0,0,7,12,19,9347
0,0,1,0,1,0,1,9348
1,1,1,0,2,0,2,9348
2,2,1,0,3,0,3,9348
3,3,4,0,7,0,7,9348
4,4,2,1,9,1,10,9348
5,5,1,1,10,2,12,9348
6,6,2,1,12,3,15,9348
7,7,1,0,13,3,16,9348
8,8,2,0,15,3,18,9348
9,9,2,0,17,3,20,9348
10,10,2,0,19,3,22,9348
11,11,0,0,19,3,22,9348
0,0,1,0,1,0,1,9349
1,1,1,0,2,0,2,9349
2,2,2,0,4,0,4,9349
3,3,0,0,4,0,4,9349
0,0,1,0,1,0,1,9350
1,1,0,1,1,1,2,9350
2,2,0,1,1,2,3,9350
3,3,0,1,1,3,4,9350
4,4,0,0,1,3,4,9350
0,0,1,0,1,0,1,9351
1,1,1,2,2,2,4,9351
2,2,1,1,3,3,6,9351
3,3,1,2,4,5,9,9351
4,4,0,3,4,8,12,9351
5,5,1,2,5,10,15,9351
6,6,1,2,6,12,18,9351
7,7,2,2,8,14,22,9351
8,8,5,0,13,14,27,9351
9,9,2,0,15,14,29,9351
10,10,2,0,17,14,31,9351
11,11,0,1,17,15,32,9351
12,12,0,0,17,15,32,9351
0,0,1,0,1,0,1,9352
1,1,1,0,2,0,2,9352
2,2,0,0,2,0,2,9352
0,0,1,0,1,0,1,9353
1,1,0,0,1,0,1,9353
0,0,1,0,1,0,1,9354
1,1,1,0,2,0,2,9354
2,2,0,0,2,0,2,9354
0,0,1,0,1,0,1,9355
1,1,0,3,1,3,4,9355
2,2,0,1,1,4,5,9355
3,3,0,0,1,4,5,9355
0,0,1,0,1,0,1,9356
1,1,0,0,1,0,1,9356
0,0,1,0,1,0,1,9357
1,1,2,0,3,0,3,9357
2,2,0,0,3,0,3,9357
0,0,1,0,1,0,1,9358
1,1,0,0,1,0,1,9358
0,0,1,0,1,0,1,9359
1,1,1,0,2,0,2,9359
2,2,1,0,3,0,3,9359
3,3,0,0,3,0,3,9359
0,0,1,0,1,0,1,9360
1,1,0,0,1,0,1,9360
0,0,1,0,1,0,1,9361
1,1,0,0,1,0,1,9361
0,0,1,0,1,0,1,9362
1,1,0,0,1,0,1,9362
0,0,1,0,1,0,1,9363
1,1,0,1,1,1,2,9363
2,2,0,0,1,1,2,9363
0,0,1,0,1,0,1,9364
1,1,0,0,1,0,1,9364
0,0,1,0,1,0,1,9365
1,1,0,0,1,0,1,9365
0,0,1,0,1,0,1,9366
1,1,0,1,1,1,2,9366
2,2,0,1,1,2,3,9366
3,3,0,1,1,3,4,9366
4,4,0,1,1,4,5,9366
5,5,0,0,1,4,5,9366
0,0,1,0,1,0,1,9367
1,1,1,0,2,0,2,9367
2,2,1,0,3,0,3,9367
3,3,1,0,4,0,4,9367
4,4,0,0,4,0,4,9367
0,0,1,0,1,0,1,9368
1,1,0,0,1,0,1,9368
0,0,1,0,1,0,1,9369
1,1,0,0,1,0,1,9369
0,0,1,0,1,0,1,9370
1,1,0,0,1,0,1,9370
0,0,1,0,1,0,1,9371
1,1,0,0,1,0,1,9371
0,0,1,0,1,0,1,9372
1,1,2,0,3,0,3,9372
2,2,1,0,4,0,4,9372
3,3,1,0,5,0,5,9372
4,4,0,0,5,0,5,9372
0,0,1,0,1,0,1,9373
1,1,1,0,2,0,2,9373
2,2,0,0,2,0,2,9373
0,0,1,0,1,0,1,9374
1,1,0,0,1,0,1,9374
0,0,1,0,1,0,1,9375
1,1,2,0,3,0,3,9375
2,2,0,0,3,0,3,9375
0,0,1,0,1,0,1,9376
1,1,1,0,2,0,2,9376
2,2,3,0,5,0,5,9376
3,3,3,1,8,1,9,9376
4,4,5,2,13,3,16,9376
5,5,2,3,15,6,21,9376
6,6,3,4,18,10,28,9376
7,7,3,0,21,10,31,9376
8,8,1,1,22,11,33,9376
9,9,4,1,26,12,38,9376
10,10,3,4,29,16,45,9376
11,11,5,5,34,21,55,9376
12,12,5,5,39,26,65,9376
13,13,6,9,45,35,80,9376
14,14,6,7,51,42,93,9376
15,15,7,8,58,50,108,9376
16,16,4,7,62,57,119,9376
17,17,6,4,68,61,129,9376
18,18,4,1,72,62,134,9376
19,19,2,0,74,62,136,9376
20,20,1,0,75,62,137,9376
21,21,0,0,75,62,137,9376
0,0,1,0,1,0,1,9377
1,1,0,0,1,0,1,9377
0,0,1,0,1,0,1,9378
1,1,1,0,2,0,2,9378
2,2,1,0,3,0,3,9378
3,3,3,0,6,0,6,9378
4,4,2,1,8,1,9,9378
5,5,2,0,10,1,11,9378
6,6,2,0,12,1,13,9378
7,7,1,0,13,1,14,9378
8,8,1,1,14,2,16,9378
9,9,0,0,14,2,16,9378
0,0,1,0,1,0,1,9379
1,1,0,0,1,0,1,9379
0,0,1,0,1,0,1,9380
1,1,0,0,1,0,1,9380
0,0,1,0,1,0,1,9381
1,1,2,0,3,0,3,9381
2,2,2,1,5,1,6,9381
3,3,2,0,7,1,8,9381
4,4,3,1,10,2,12,9381
5,5,0,2,10,4,14,9381
6,6,1,1,11,5,16,9381
7,7,0,1,11,6,17,9381
8,8,0,1,11,7,18,9381
9,9,0,1,11,8,19,9381
10,10,0,1,11,9,20,9381
11,11,0,1,11,10,21,9381
12,12,0,1,11,11,22,9381
13,13,0,0,11,11,22,9381
0,0,1,0,1,0,1,9382
1,1,0,0,1,0,1,9382
0,0,1,0,1,0,1,9383
1,1,3,3,4,3,7,9383
2,2,1,2,5,5,10,9383
3,3,4,1,9,6,15,9383
4,4,4,3,13,9,22,9383
5,5,1,3,14,12,26,9383
6,6,1,5,15,17,32,9383
7,7,2,3,17,20,37,9383
8,8,3,3,20,23,43,9383
9,9,1,2,21,25,46,9383
10,10,1,1,22,26,48,9383
11,11,1,2,23,28,51,9383
12,12,0,5,23,33,56,9383
13,13,2,6,25,39,64,9383
14,14,2,4,27,43,70,9383
15,15,1,3,28,46,74,9383
16,16,3,2,31,48,79,9383
17,17,2,2,33,50,83,9383
18,18,2,0,35,50,85,9383
19,19,3,0,38,50,88,9383
20,20,3,0,41,50,91,9383
21,21,2,1,43,51,94,9383
22,22,3,0,46,51,97,9383
23,23,3,0,49,51,100,9383
24,24,1,0,50,51,101,9383
25,25,0,0,50,51,101,9383
0,0,1,0,1,0,1,9384
1,1,1,0,2,0,2,9384
2,2,0,0,2,0,2,9384
0,0,1,0,1,0,1,9385
1,1,0,0,1,0,1,9385
0,0,1,0,1,0,1,9386
1,1,1,0,2,0,2,9386
2,2,1,0,3,0,3,9386
3,3,1,0,4,0,4,9386
4,4,1,1,5,1,6,9386
5,5,2,1,7,2,9,9386
6,6,0,3,7,5,12,9386
7,7,0,2,7,7,14,9386
8,8,0,1,7,8,15,9386
9,9,0,1,7,9,16,9386
10,10,0,0,7,9,16,9386
0,0,1,0,1,0,1,9387
1,1,1,0,2,0,2,9387
2,2,1,0,3,0,3,9387
3,3,0,0,3,0,3,9387
0,0,1,0,1,0,1,9388
1,1,0,0,1,0,1,9388
0,0,1,0,1,0,1,9389
1,1,0,0,1,0,1,9389
0,0,1,0,1,0,1,9390
1,1,1,0,2,0,2,9390
2,2,0,0,2,0,2,9390
0,0,1,0,1,0,1,9391
1,1,0,0,1,0,1,9391
0,0,1,0,1,0,1,9392
1,1,3,0,4,0,4,9392
2,2,0,0,4,0,4,9392
0,0,1,0,1,0,1,9393
1,1,0,0,1,0,1,9393
0,0,1,0,1,0,1,9394
1,1,0,0,1,0,1,9394
0,0,1,0,1,0,1,9395
1,1,0,0,1,0,1,9395
0,0,1,0,1,0,1,9396
1,1,0,0,1,0,1,9396
0,0,1,0,1,0,1,9397
1,1,0,0,1,0,1,9397
0,0,1,0,1,0,1,9398
1,1,2,0,3,0,3,9398
2,2,1,0,4,0,4,9398
3,3,0,0,4,0,4,9398
0,0,1,0,1,0,1,9399
1,1,2,0,3,0,3,9399
2,2,0,0,3,0,3,9399
0,0,1,0,1,0,1,9400
1,1,1,0,2,0,2,9400
2,2,1,0,3,0,3,9400
3,3,1,0,4,0,4,9400
4,4,0,0,4,0,4,9400
0,0,1,0,1,0,1,9401
1,1,0,0,1,0,1,9401
0,0,1,0,1,0,1,9402
1,1,2,0,3,0,3,9402
2,2,3,0,6,0,6,9402
3,3,1,2,7,2,9,9402
4,4,0,1,7,3,10,9402
5,5,0,0,7,3,10,9402
0,0,1,0,1,0,1,9403
1,1,0,0,1,0,1,9403
0,0,1,0,1,0,1,9404
1,1,0,0,1,0,1,9404
0,0,1,0,1,0,1,9405
1,1,0,0,1,0,1,9405
0,0,1,0,1,0,1,9406
1,1,0,0,1,0,1,9406
0,0,1,0,1,0,1,9407
1,1,0,0,1,0,1,9407
0,0,1,0,1,0,1,9408
1,1,0,0,1,0,1,9408
0,0,1,0,1,0,1,9409
1,1,0,0,1,0,1,9409
0,0,1,0,1,0,1,9410
1,1,0,0,1,0,1,9410
0,0,1,0,1,0,1,9411
1,1,1,0,2,0,2,9411
2,2,1,0,3,0,3,9411
3,3,0,0,3,0,3,9411
0,0,1,0,1,0,1,9412
1,1,0,1,1,1,2,9412
2,2,0,1,1,2,3,9412
3,3,0,1,1,3,4,9412
4,4,0,2,1,5,6,9412
5,5,0,2,1,7,8,9412
6,6,1,1,2,8,10,9412
7,7,2,0,4,8,12,9412
8,8,2,1,6,9,15,9412
9,9,0,0,6,9,15,9412
0,0,1,0,1,0,1,9413
1,1,0,0,1,0,1,9413
0,0,1,0,1,0,1,9414
1,1,0,0,1,0,1,9414
0,0,1,0,1,0,1,9415
1,1,2,0,3,0,3,9415
2,2,1,0,4,0,4,9415
3,3,1,0,5,0,5,9415
4,4,1,0,6,0,6,9415
5,5,0,0,6,0,6,9415
0,0,1,0,1,0,1,9416
1,1,1,0,2,0,2,9416
2,2,1,0,3,0,3,9416
3,3,1,0,4,0,4,9416
4,4,2,0,6,0,6,9416
5,5,1,0,7,0,7,9416
6,6,2,1,9,1,10,9416
7,7,2,1,11,2,13,9416
8,8,2,2,13,4,17,9416
9,9,2,1,15,5,20,9416
10,10,2,0,17,5,22,9416
11,11,1,1,18,6,24,9416
12,12,2,1,20,7,27,9416
13,13,0,1,20,8,28,9416
14,14,0,0,20,8,28,9416
0,0,1,0,1,0,1,9417
1,1,1,0,2,0,2,9417
2,2,1,1,3,1,4,9417
3,3,2,1,5,2,7,9417
4,4,4,0,9,2,11,9417
5,5,2,0,11,2,13,9417
6,6,1,1,12,3,15,9417
7,7,1,1,13,4,17,9417
8,8,1,3,14,7,21,9417
9,9,0,4,14,11,25,9417
10,10,1,1,15,12,27,9417
11,11,1,1,16,13,29,9417
12,12,2,2,18,15,33,9417
13,13,0,1,18,16,34,9417
14,14,0,3,18,19,37,9417
15,15,0,2,18,21,39,9417
16,16,0,2,18,23,41,9417
17,17,1,1,19,24,43,9417
18,18,1,4,20,28,48,9417
19,19,0,3,20,31,51,9417
20,20,0,1,20,32,52,9417
21,21,0,3,20,35,55,9417
22,22,0,5,20,40,60,9417
23,23,2,3,22,43,65,9417
24,24,2,4,24,47,71,9417
25,25,3,3,27,50,77,9417
26,26,5,0,32,50,82,9417
27,27,4,3,36,53,89,9417
28,28,5,4,41,57,98,9417
29,29,10,5,51,62,113,9417
30,30,11,6,62,68,130,9417
31,31,9,6,71,74,145,9417
32,32,8,2,79,76,155,9417
33,33,8,2,87,78,165,9417
34,34,8,8,95,86,181,9417
35,35,8,3,103,89,192,9417
36,36,5,5,108,94,202,9417
37,37,6,6,114,100,214,9417
38,38,5,7,119,107,226,9417
39,39,3,4,122,111,233,9417
40,40,3,3,125,114,239,9417
41,41,4,0,129,114,243,9417
42,42,2,2,131,116,247,9417
43,43,1,1,132,117,249,9417
44,44,2,1,134,118,252,9417
45,45,0,4,134,122,256,9417
46,46,0,2,134,124,258,9417
47,47,0,4,134,128,262,9417
48,48,2,2,136,130,266,9417
49,49,4,1,140,131,271,9417
50,50,7,2,147,133,280,9417
51,51,6,2,153,135,288,9417
52,52,6,1,159,136,295,9417
53,53,5,3,164,139,303,9417
54,54,2,2,166,141,307,9417
55,55,0,2,166,143,309,9417
56,56,0,4,166,147,313,9417
57,57,1,3,167,150,317,9417
58,58,1,3,168,153,321,9417
59,59,1,2,169,155,324,9417
60,60,1,2,170,157,327,9417
61,61,1,1,171,158,329,9417
62,62,0,1,171,159,330,9417
63,63,0,1,171,160,331,9417
64,64,0,1,171,161,332,9417
65,65,0,0,171,161,332,9417
0,0,1,0,1,0,1,9418
1,1,0,0,1,0,1,9418
0,0,1,0,1,0,1,9419
1,1,0,0,1,0,1,9419
0,0,1,0,1,0,1,9420
1,1,0,0,1,0,1,9420
0,0,1,0,1,0,1,9421
1,1,3,0,4,0,4,9421
2,2,2,0,6,0,6,9421
3,3,1,2,7,2,9,9421
4,4,2,3,9,5,14,9421
5,5,3,2,12,7,19,9421
6,6,0,2,12,9,21,9421
7,7,0,2,12,11,23,9421
8,8,0,1,12,12,24,9421
9,9,0,0,12,12,24,9421
0,0,1,0,1,0,1,9422
1,1,1,0,2,0,2,9422
2,2,2,1,4,1,5,9422
3,3,4,0,8,1,9,9422
4,4,2,0,10,1,11,9422
5,5,0,0,10,1,11,9422
0,0,1,0,1,0,1,9423
1,1,1,0,2,0,2,9423
2,2,1,1,3,1,4,9423
3,3,1,0,4,1,5,9423
4,4,0,0,4,1,5,9423
0,0,1,0,1,0,1,9424
1,1,1,0,2,0,2,9424
2,2,0,0,2,0,2,9424
0,0,1,0,1,0,1,9425
1,1,1,2,2,2,4,9425
2,2,0,1,2,3,5,9425
3,3,0,0,2,3,5,9425
0,0,1,0,1,0,1,9426
1,1,1,1,2,1,3,9426
2,2,0,2,2,3,5,9426
3,3,0,0,2,3,5,9426
0,0,1,0,1,0,1,9427
1,1,2,0,3,0,3,9427
2,2,1,0,4,0,4,9427
3,3,0,1,4,1,5,9427
4,4,0,0,4,1,5,9427
0,0,1,0,1,0,1,9428
1,1,1,0,2,0,2,9428
2,2,0,0,2,0,2,9428
0,0,1,0,1,0,1,9429
1,1,1,0,2,0,2,9429
2,2,0,0,2,0,2,9429
0,0,1,0,1,0,1,9430
1,1,2,0,3,0,3,9430
2,2,0,2,3,2,5,9430
3,3,0,0,3,2,5,9430
0,0,1,0,1,0,1,9431
1,1,0,0,1,0,1,9431
0,0,1,0,1,0,1,9432
1,1,2,1,3,1,4,9432
2,2,4,1,7,2,9,9432
3,3,3,4,10,6,16,9432
4,4,5,1,15,7,22,9432
5,5,4,1,19,8,27,9432
6,6,4,2,23,10,33,9432
7,7,0,2,23,12,35,9432
8,8,1,0,24,12,36,9432
9,9,2,0,26,12,38,9432
10,10,4,0,30,12,42,9432
11,11,2,1,32,13,45,9432
12,12,2,2,34,15,49,9432
13,13,2,1,36,16,52,9432
14,14,3,0,39,16,55,9432
15,15,2,0,41,16,57,9432
16,16,3,1,44,17,61,9432
17,17,2,1,46,18,64,9432
18,18,0,0,46,18,64,9432
0,0,1,0,1,0,1,9433
1,1,0,1,1,1,2,9433
2,2,0,2,1,3,4,9433
3,3,1,1,2,4,6,9433
4,4,0,1,2,5,7,9433
5,5,0,0,2,5,7,9433
0,0,1,0,1,0,1,9434
1,1,0,1,1,1,2,9434
2,2,0,1,1,2,3,9434
3,3,0,0,1,2,3,9434
0,0,1,0,1,0,1,9435
1,1,1,0,2,0,2,9435
2,2,0,1,2,1,3,9435
3,3,0,0,2,1,3,9435
0,0,1,0,1,0,1,9436
1,1,3,0,4,0,4,9436
2,2,0,1,4,1,5,9436
3,3,0,1,4,2,6,9436
4,4,0,0,4,2,6,9436
0,0,1,0,1,0,1,9437
1,1,1,0,2,0,2,9437
2,2,0,2,2,2,4,9437
3,3,0,1,2,3,5,9437
4,4,0,0,2,3,5,9437
0,0,1,0,1,0,1,9438
1,1,2,0,3,0,3,9438
2,2,0,1,3,1,4,9438
3,3,0,1,3,2,5,9438
4,4,0,0,3,2,5,9438
0,0,1,0,1,0,1,9439
1,1,1,1,2,1,3,9439
2,2,0,0,2,1,3,9439
0,0,1,0,1,0,1,9440
1,1,0,0,1,0,1,9440
0,0,1,0,1,0,1,9441
1,1,0,0,1,0,1,9441
0,0,1,0,1,0,1,9442
1,1,0,1,1,1,2,9442
2,2,0,1,1,2,3,9442
3,3,0,2,1,4,5,9442
4,4,1,2,2,6,8,9442
5,5,1,1,3,7,10,9442
6,6,4,0,7,7,14,9442
7,7,4,1,11,8,19,9442
8,8,2,2,13,10,23,9442
9,9,3,5,16,15,31,9442
10,10,1,0,17,15,32,9442
11,11,1,0,18,15,33,9442
12,12,0,1,18,16,34,9442
13,13,3,2,21,18,39,9442
14,14,3,2,24,20,44,9442
15,15,4,3,28,23,51,9442
16,16,5,5,33,28,61,9442
17,17,8,3,41,31,72,9442
18,18,9,4,50,35,85,9442
19,19,4,7,54,42,96,9442
20,20,4,5,58,47,105,9442
21,21,5,6,63,53,116,9442
22,22,8,4,71,57,128,9442
23,23,4,2,75,59,134,9442
24,24,5,2,80,61,141,9442
25,25,6,3,86,64,150,9442
26,26,4,6,90,70,160,9442
27,27,3,8,93,78,171,9442
28,28,0,7,93,85,178,9442
29,29,0,2,93,87,180,9442
30,30,0,1,93,88,181,9442
31,31,0,1,93,89,182,9442
32,32,1,1,94,90,184,9442
33,33,2,0,96,90,186,9442
34,34,1,0,97,90,187,9442
35,35,0,0,97,90,187,9442
0,0,1,0,1,0,1,9443
1,1,0,0,1,0,1,9443
0,0,1,0,1,0,1,9444
1,1,0,0,1,0,1,9444
0,0,1,0,1,0,1,9445
1,1,0,0,1,0,1,9445
0,0,1,0,1,0,1,9446
1,1,1,0,2,0,2,9446
2,2,1,1,3,1,4,9446
3,3,2,0,5,1,6,9446
4,4,1,0,6,1,7,9446
5,5,0,0,6,1,7,9446
0,0,1,0,1,0,1,9447
1,1,4,0,5,0,5,9447
2,2,4,0,9,0,9,9447
3,3,2,0,11,0,11,9447
4,4,3,1,14,1,15,9447
5,5,1,0,15,1,16,9447
6,6,0,0,15,1,16,9447
0,0,1,0,1,0,1,9448
1,1,1,0,2,0,2,9448
2,2,0,0,2,0,2,9448
0,0,1,0,1,0,1,9449
1,1,1,0,2,0,2,9449
2,2,1,0,3,0,3,9449
3,3,1,0,4,0,4,9449
4,4,2,0,6,0,6,9449
5,5,1,0,7,0,7,9449
6,6,2,0,9,0,9,9449
7,7,2,0,11,0,11,9449
8,8,2,0,13,0,13,9449
9,9,0,2,13,2,15,9449
10,10,1,1,14,3,17,9449
11,11,0,1,14,4,18,9449
12,12,0,2,14,6,20,9449
13,13,0,1,14,7,21,9449
14,14,0,0,14,7,21,9449
0,0,1,0,1,0,1,9450
1,1,3,0,4,0,4,9450
2,2,3,0,7,0,7,9450
3,3,0,0,7,0,7,9450
0,0,1,0,1,0,1,9451
1,1,2,0,3,0,3,9451
2,2,2,0,5,0,5,9451
3,3,2,0,7,0,7,9451
4,4,0,0,7,0,7,9451
0,0,1,0,1,0,1,9452
1,1,0,0,1,0,1,9452
0,0,1,0,1,0,1,9453
1,1,1,0,2,0,2,9453
2,2,1,0,3,0,3,9453
3,3,0,1,3,1,4,9453
4,4,0,1,3,2,5,9453
5,5,0,0,3,2,5,9453
0,0,1,0,1,0,1,9454
1,1,1,0,2,0,2,9454
2,2,1,0,3,0,3,9454
3,3,0,0,3,0,3,9454
0,0,1,0,1,0,1,9455
1,1,0,0,1,0,1,9455
0,0,1,0,1,0,1,9456
1,1,0,0,1,0,1,9456
0,0,1,0,1,0,1,9457
1,1,0,0,1,0,1,9457
0,0,1,0,1,0,1,9458
1,1,0,0,1,0,1,9458
0,0,1,0,1,0,1,9459
1,1,2,0,3,0,3,9459
2,2,2,0,5,0,5,9459
3,3,1,0,6,0,6,9459
4,4,1,2,7,2,9,9459
5,5,0,2,7,4,11,9459
6,6,0,2,7,6,13,9459
7,7,1,2,8,8,16,9459
8,8,1,2,9,10,19,9459
9,9,3,0,12,10,22,9459
10,10,0,1,12,11,23,9459
11,11,0,1,12,12,24,9459
12,12,0,1,12,13,25,9459
13,13,0,2,12,15,27,9459
14,14,0,1,12,16,28,9459
15,15,0,2,12,18,30,9459
16,16,2,1,14,19,33,9459
17,17,4,0,18,19,37,9459
18,18,2,0,20,19,39,9459
19,19,1,0,21,19,40,9459
20,20,0,0,21,19,40,9459
0,0,1,0,1,0,1,9460
1,1,1,0,2,0,2,9460
2,2,1,0,3,0,3,9460
3,3,0,0,3,0,3,9460
0,0,1,0,1,0,1,9461
1,1,0,0,1,0,1,9461
0,0,1,0,1,0,1,9462
1,1,0,0,1,0,1,9462
0,0,1,0,1,0,1,9463
1,1,2,0,3,0,3,9463
2,2,1,0,4,0,4,9463
3,3,1,0,5,0,5,9463
4,4,0,0,5,0,5,9463
0,0,1,0,1,0,1,9464
1,1,0,0,1,0,1,9464
0,0,1,0,1,0,1,9465
1,1,0,0,1,0,1,9465
0,0,1,0,1,0,1,9466
1,1,2,0,3,0,3,9466
2,2,1,0,4,0,4,9466
3,3,0,0,4,0,4,9466
0,0,1,0,1,0,1,9467
1,1,2,1,3,1,4,9467
2,2,2,1,5,2,7,9467
3,3,0,0,5,2,7,9467
0,0,1,0,1,0,1,9468
1,1,0,0,1,0,1,9468
0,0,1,0,1,0,1,9469
1,1,0,1,1,1,2,9469
2,2,0,1,1,2,3,9469
3,3,0,0,1,2,3,9469
0,0,1,0,1,0,1,9470
1,1,1,0,2,0,2,9470
2,2,1,1,3,1,4,9470
3,3,2,1,5,2,7,9470
4,4,0,2,5,4,9,9470
5,5,0,2,5,6,11,9470
6,6,1,3,6,9,15,9470
7,7,2,3,8,12,20,9470
8,8,3,1,11,13,24,9470
9,9,2,2,13,15,28,9470
10,10,2,0,15,15,30,9470
11,11,1,0,16,15,31,9470
12,12,1,0,17,15,32,9470
13,13,2,0,19,15,34,9470
14,14,3,0,22,15,37,9470
15,15,4,0,26,15,41,9470
16,16,2,0,28,15,43,9470
17,17,1,1,29,16,45,9470
18,18,0,0,29,16,45,9470
0,0,1,0,1,0,1,9471
1,1,0,0,1,0,1,9471
0,0,1,0,1,0,1,9472
1,1,0,0,1,0,1,9472
0,0,1,0,1,0,1,9473
1,1,0,0,1,0,1,9473
0,0,1,0,1,0,1,9474
1,1,0,0,1,0,1,9474
0,0,1,0,1,0,1,9475
1,1,1,1,2,1,3,9475
2,2,0,0,2,1,3,9475
0,0,1,0,1,0,1,9476
1,1,1,0,2,0,2,9476
2,2,1,0,3,0,3,9476
3,3,2,1,5,1,6,9476
4,4,3,4,8,5,13,9476
5,5,3,5,11,10,21,9476
6,6,1,6,12,16,28,9476
7,7,1,2,13,18,31,9476
8,8,0,2,13,20,33,9476
9,9,1,1,14,21,35,9476
10,10,2,0,16,21,37,9476
11,11,1,1,17,22,39,9476
12,12,1,1,18,23,41,9476
13,13,0,0,18,23,41,9476
0,0,1,0,1,0,1,9477
1,1,1,0,2,0,2,9477
2,2,0,1,2,1,3,9477
3,3,0,3,2,4,6,9477
4,4,1,1,3,5,8,9477
5,5,2,1,5,6,11,9477
6,6,2,0,7,6,13,9477
7,7,1,1,8,7,15,9477
8,8,1,1,9,8,17,9477
9,9,0,0,9,8,17,9477
0,0,1,0,1,0,1,9478
1,1,1,0,2,0,2,9478
2,2,0,1,2,1,3,9478
3,3,0,0,2,1,3,9478
0,0,1,0,1,0,1,9479
1,1,0,0,1,0,1,9479
0,0,1,0,1,0,1,9480
1,1,2,0,3,0,3,9480
2,2,1,1,4,1,5,9480
3,3,1,3,5,4,9,9480
4,4,2,3,7,7,14,9480
5,5,1,2,8,9,17,9480
6,6,0,5,8,14,22,9480
7,7,1,4,9,18,27,9480
8,8,0,5,9,23,32,9480
9,9,0,5,9,28,37,9480
10,10,2,3,11,31,42,9480
11,11,2,2,13,33,46,9480
12,12,3,2,16,35,51,9480
13,13,1,4,17,39,56,9480
14,14,2,0,19,39,58,9480
15,15,1,1,20,40,60,9480
16,16,1,0,21,40,61,9480
17,17,0,0,21,40,61,9480
0,0,1,0,1,0,1,9481
1,1,3,0,4,0,4,9481
2,2,4,1,8,1,9,9481
3,3,4,2,12,3,15,9481
4,4,4,2,16,5,21,9481
5,5,0,2,16,7,23,9481
6,6,0,0,16,7,23,9481
0,0,1,0,1,0,1,9482
1,1,0,1,1,1,2,9482
2,2,0,0,1,1,2,9482
0,0,1,0,1,0,1,9483
1,1,0,0,1,0,1,9483
0,0,1,0,1,0,1,9484
1,1,1,0,2,0,2,9484
2,2,0,0,2,0,2,9484
0,0,1,0,1,0,1,9485
1,1,0,0,1,0,1,9485
0,0,1,0,1,0,1,9486
1,1,0,0,1,0,1,9486
0,0,1,0,1,0,1,9487
1,1,1,1,2,1,3,9487
2,2,1,1,3,2,5,9487
3,3,0,1,3,3,6,9487
4,4,0,1,3,4,7,9487
5,5,0,2,3,6,9,9487
6,6,0,1,3,7,10,9487
7,7,0,1,3,8,11,9487
8,8,2,1,5,9,14,9487
9,9,2,1,7,10,17,9487
10,10,3,1,10,11,21,9487
11,11,2,1,12,12,24,9487
12,12,1,0,13,12,25,9487
13,13,1,0,14,12,26,9487
14,14,1,0,15,12,27,9487
15,15,0,0,15,12,27,9487
0,0,1,0,1,0,1,9488
1,1,1,0,2,0,2,9488
2,2,1,0,3,0,3,9488
3,3,1,1,4,1,5,9488
4,4,0,2,4,3,7,9488
5,5,0,1,4,4,8,9488
6,6,0,1,4,5,9,9488
7,7,0,1,4,6,10,9488
8,8,0,1,4,7,11,9488
9,9,0,2,4,9,13,9488
10,10,0,1,4,10,14,9488
11,11,1,1,5,11,16,9488
12,12,1,1,6,12,18,9488
13,13,2,1,8,13,21,9488
14,14,1,2,9,15,24,9488
15,15,0,3,9,18,27,9488
16,16,0,0,9,18,27,9488
0,0,1,0,1,0,1,9489
1,1,3,0,4,0,4,9489
2,2,1,1,5,1,6,9489
3,3,1,4,6,5,11,9489
4,4,1,6,7,11,18,9489
5,5,0,2,7,13,20,9489
6,6,0,1,7,14,21,9489
7,7,0,1,7,15,22,9489
8,8,0,3,7,18,25,9489
9,9,0,1,7,19,26,9489
10,10,0,0,7,19,26,9489
0,0,1,0,1,0,1,9490
1,1,0,0,1,0,1,9490
0,0,1,0,1,0,1,9491
1,1,0,0,1,0,1,9491
0,0,1,0,1,0,1,9492
1,1,0,0,1,0,1,9492
0,0,1,0,1,0,1,9493
1,1,0,0,1,0,1,9493
0,0,1,0,1,0,1,9494
1,1,0,1,1,1,2,9494
2,2,0,1,1,2,3,9494
3,3,0,0,1,2,3,9494
0,0,1,0,1,0,1,9495
1,1,0,0,1,0,1,9495
0,0,1,0,1,0,1,9496
1,1,2,0,3,0,3,9496
2,2,1,0,4,0,4,9496
3,3,0,0,4,0,4,9496
0,0,1,0,1,0,1,9497
1,1,1,1,2,1,3,9497
2,2,1,0,3,1,4,9497
3,3,1,0,4,1,5,9497
4,4,0,0,4,1,5,9497
0,0,1,0,1,0,1,9498
1,1,0,0,1,0,1,9498
0,0,1,0,1,0,1,9499
1,1,0,0,1,0,1,9499
0,0,1,0,1,0,1,9500
1,1,0,0,1,0,1,9500
0,0,1,0,1,0,1,9501
1,1,0,0,1,0,1,9501
0,0,1,0,1,0,1,9502
1,1,1,0,2,0,2,9502
2,2,3,0,5,0,5,9502
3,3,4,2,9,2,11,9502
4,4,4,4,13,6,19,9502
5,5,2,4,15,10,25,9502
6,6,2,3,17,13,30,9502
7,7,3,5,20,18,38,9502
8,8,1,4,21,22,43,9502
9,9,2,7,23,29,52,9502
10,10,3,6,26,35,61,9502
11,11,1,4,27,39,66,9502
12,12,3,4,30,43,73,9502
13,13,4,6,34,49,83,9502
14,14,2,5,36,54,90,9502
15,15,5,3,41,57,98,9502
16,16,7,4,48,61,109,9502
17,17,5,5,53,66,119,9502
18,18,5,6,58,72,130,9502
19,19,6,5,64,77,141,9502
20,20,4,4,68,81,149,9502
21,21,6,2,74,83,157,9502
22,22,5,4,79,87,166,9502
23,23,2,2,81,89,170,9502
24,24,1,3,82,92,174,9502
25,25,1,2,83,94,177,9502
26,26,2,1,85,95,180,9502
27,27,1,0,86,95,181,9502
28,28,0,0,86,95,181,9502
0,0,1,0,1,0,1,9503
1,1,0,0,1,0,1,9503
0,0,1,0,1,0,1,9504
1,1,0,0,1,0,1,9504
0,0,1,0,1,0,1,9505
1,1,2,1,3,1,4,9505
2,2,0,0,3,1,4,9505
0,0,1,0,1,0,1,9506
1,1,1,0,2,0,2,9506
2,2,0,0,2,0,2,9506
0,0,1,0,1,0,1,9507
1,1,1,0,2,0,2,9507
2,2,0,0,2,0,2,9507
0,0,1,0,1,0,1,9508
1,1,3,0,4,0,4,9508
2,2,2,0,6,0,6,9508
3,3,0,0,6,0,6,9508
0,0,1,0,1,0,1,9509
1,1,0,0,1,0,1,9509
0,0,1,0,1,0,1,9510
1,1,1,0,2,0,2,9510
2,2,0,1,2,1,3,9510
3,3,0,2,2,3,5,9510
4,4,3,1,5,4,9,9510
5,5,1,2,6,6,12,9510
6,6,2,1,8,7,15,9510
7,7,2,0,10,7,17,9510
8,8,2,0,12,7,19,9510
9,9,2,1,14,8,22,9510
10,10,1,1,15,9,24,9510
11,11,0,2,15,11,26,9510
12,12,1,4,16,15,31,9510
13,13,1,3,17,18,35,9510
14,14,0,2,17,20,37,9510
15,15,0,1,17,21,38,9510
16,16,1,1,18,22,40,9510
17,17,1,0,19,22,41,9510
18,18,1,0,20,22,42,9510
19,19,0,0,20,22,42,9510
0,0,1,0,1,0,1,9511
1,1,1,0,2,0,2,9511
2,2,2,1,4,1,5,9511
3,3,1,0,5,1,6,9511
4,4,1,0,6,1,7,9511
5,5,0,0,6,1,7,9511
0,0,1,0,1,0,1,9512
1,1,3,0,4,0,4,9512
2,2,3,0,7,0,7,9512
3,3,1,2,8,2,10,9512
4,4,0,1,8,3,11,9512
5,5,1,2,9,5,14,9512
6,6,1,1,10,6,16,9512
7,7,1,0,11,6,17,9512
8,8,0,0,11,6,17,9512
0,0,1,0,1,0,1,9513
1,1,0,0,1,0,1,9513
0,0,1,0,1,0,1,9514
1,1,0,0,1,0,1,9514
0,0,1,0,1,0,1,9515
1,1,0,1,1,1,2,9515
2,2,0,1,1,2,3,9515
3,3,0,1,1,3,4,9515
4,4,0,0,1,3,4,9515
0,0,1,0,1,0,1,9516
1,1,1,1,2,1,3,9516
2,2,0,0,2,1,3,9516
0,0,1,0,1,0,1,9517
1,1,0,0,1,0,1,9517
0,0,1,0,1,0,1,9518
1,1,0,0,1,0,1,9518
0,0,1,0,1,0,1,9519
1,1,1,1,2,1,3,9519
2,2,0,1,2,2,4,9519
3,3,0,1,2,3,5,9519
4,4,1,1,3,4,7,9519
5,5,0,0,3,4,7,9519
0,0,1,0,1,0,1,9520
1,1,0,0,1,0,1,9520
0,0,1,0,1,0,1,9521
1,1,2,0,3,0,3,9521
2,2,1,1,4,1,5,9521
3,3,0,5,4,6,10,9521
4,4,0,9,4,15,19,9521
5,5,2,10,6,25,31,9521
6,6,6,8,12,33,45,9521
7,7,5,6,17,39,56,9521
8,8,7,7,24,46,70,9521
9,9,6,6,30,52,82,9521
10,10,2,5,32,57,89,9521
11,11,3,4,35,61,96,9521
12,12,2,1,37,62,99,9521
13,13,2,2,39,64,103,9521
14,14,0,2,39,66,105,9521
15,15,0,1,39,67,106,9521
16,16,0,0,39,67,106,9521
0,0,1,0,1,0,1,9522
1,1,0,0,1,0,1,9522
0,0,1,0,1,0,1,9523
1,1,1,0,2,0,2,9523
2,2,0,0,2,0,2,9523
0,0,1,0,1,0,1,9524
1,1,2,0,3,0,3,9524
2,2,2,0,5,0,5,9524
3,3,3,0,8,0,8,9524
4,4,4,0,12,0,12,9524
5,5,1,0,13,0,13,9524
6,6,1,0,14,0,14,9524
7,7,0,0,14,0,14,9524
0,0,1,0,1,0,1,9525
1,1,0,0,1,0,1,9525
0,0,1,0,1,0,1,9526
1,1,0,0,1,0,1,9526
0,0,1,0,1,0,1,9527
1,1,0,0,1,0,1,9527
0,0,1,0,1,0,1,9528
1,1,0,0,1,0,1,9528
0,0,1,0,1,0,1,9529
1,1,2,2,3,2,5,9529
2,2,1,3,4,5,9,9529
3,3,1,3,5,8,13,9529
4,4,2,2,7,10,17,9529
5,5,1,2,8,12,20,9529
6,6,4,1,12,13,25,9529
7,7,4,2,16,15,31,9529
8,8,2,0,18,15,33,9529
9,9,1,0,19,15,34,9529
10,10,1,0,20,15,35,9529
11,11,2,0,22,15,37,9529
12,12,1,0,23,15,38,9529
13,13,1,0,24,15,39,9529
14,14,0,0,24,15,39,9529
0,0,1,0,1,0,1,9530
1,1,1,0,2,0,2,9530
2,2,2,0,4,0,4,9530
3,3,1,0,5,0,5,9530
4,4,3,0,8,0,8,9530
5,5,4,0,12,0,12,9530
6,6,2,1,14,1,15,9530
7,7,0,2,14,3,17,9530
8,8,0,2,14,5,19,9530
9,9,0,1,14,6,20,9530
10,10,0,1,14,7,21,9530
11,11,0,0,14,7,21,9530
0,0,1,0,1,0,1,9531
1,1,0,0,1,0,1,9531
0,0,1,0,1,0,1,9532
1,1,0,0,1,0,1,9532
0,0,1,0,1,0,1,9533
1,1,0,0,1,0,1,9533
0,0,1,0,1,0,1,9534
1,1,0,0,1,0,1,9534
0,0,1,0,1,0,1,9535
1,1,0,0,1,0,1,9535
0,0,1,0,1,0,1,9536
1,1,1,0,2,0,2,9536
2,2,1,0,3,0,3,9536
3,3,3,1,6,1,7,9536
4,4,3,1,9,2,11,9536
5,5,3,1,12,3,15,9536
6,6,0,4,12,7,19,9536
7,7,1,4,13,11,24,9536
8,8,1,5,14,16,30,9536
9,9,2,3,16,19,35,9536
10,10,3,2,19,21,40,9536
11,11,2,4,21,25,46,9536
12,12,3,2,24,27,51,9536
13,13,5,4,29,31,60,9536
14,14,7,8,36,39,75,9536
15,15,6,7,42,46,88,9536
16,16,7,4,49,50,99,9536
17,17,1,4,50,54,104,9536
18,18,1,1,51,55,106,9536
19,19,4,1,55,56,111,9536
20,20,4,2,59,58,117,9536
21,21,3,2,62,60,122,9536
22,22,4,3,66,63,129,9536
23,23,2,2,68,65,133,9536
24,24,3,2,71,67,138,9536
25,25,7,3,78,70,148,9536
26,26,14,1,92,71,163,9536
27,27,12,4,104,75,179,9536
28,28,16,4,120,79,199,9536
29,29,15,3,135,82,217,9536
30,30,16,0,151,82,233,9536
31,31,11,3,162,85,247,9536
32,32,11,5,173,90,263,9536
33,33,6,8,179,98,277,9536
34,34,8,6,187,104,291,9536
35,35,4,9,191,113,304,9536
36,36,2,10,193,123,316,9536
37,37,3,11,196,134,330,9536
38,38,5,10,201,144,345,9536
39,39,5,11,206,155,361,9536
40,40,3,8,209,163,372,9536
41,41,7,5,216,168,384,9536
42,42,7,2,223,170,393,9536
43,43,4,3,227,173,400,9536
44,44,1,3,228,176,404,9536
45,45,0,6,228,182,410,9536
46,46,0,6,228,188,416,9536
47,47,1,8,229,196,425,9536
48,48,2,7,231,203,434,9536
49,49,1,6,232,209,441,9536
50,50,2,1,234,210,444,9536
51,51,3,2,237,212,449,9536
52,52,5,6,242,218,460,9536
53,53,4,8,246,226,472,9536
54,54,3,2,249,228,477,9536
55,55,1,4,250,232,482,9536
56,56,1,3,251,235,486,9536
57,57,0,2,251,237,488,9536
58,58,0,0,251,237,488,9536
0,0,1,0,1,0,1,9537
1,1,0,0,1,0,1,9537
0,0,1,0,1,0,1,9538
1,1,0,0,1,0,1,9538
0,0,1,0,1,0,1,9539
1,1,1,0,2,0,2,9539
2,2,1,0,3,0,3,9539
3,3,1,0,4,0,4,9539
4,4,0,0,4,0,4,9539
0,0,1,0,1,0,1,9540
1,1,0,1,1,1,2,9540
2,2,0,0,1,1,2,9540
0,0,1,0,1,0,1,9541
1,1,0,0,1,0,1,9541
0,0,1,0,1,0,1,9542
1,1,1,1,2,1,3,9542
2,2,0,1,2,2,4,9542
3,3,0,0,2,2,4,9542
0,0,1,0,1,0,1,9543
1,1,0,0,1,0,1,9543
0,0,1,0,1,0,1,9544
1,1,0,0,1,0,1,9544
0,0,1,0,1,0,1,9545
1,1,0,1,1,1,2,9545
2,2,0,1,1,2,3,9545
3,3,0,0,1,2,3,9545
0,0,1,0,1,0,1,9546
1,1,1,0,2,0,2,9546
2,2,1,0,3,0,3,9546
3,3,0,0,3,0,3,9546
0,0,1,0,1,0,1,9547
1,1,1,0,2,0,2,9547
2,2,0,0,2,0,2,9547
0,0,1,0,1,0,1,9548
1,1,1,0,2,0,2,9548
2,2,1,0,3,0,3,9548
3,3,0,0,3,0,3,9548
0,0,1,0,1,0,1,9549
1,1,1,1,2,1,3,9549
2,2,0,0,2,1,3,9549
0,0,1,0,1,0,1,9550
1,1,0,0,1,0,1,9550
0,0,1,0,1,0,1,9551
1,1,1,1,2,1,3,9551
2,2,2,0,4,1,5,9551
3,3,1,0,5,1,6,9551
4,4,0,0,5,1,6,9551
0,0,1,0,1,0,1,9552
1,1,0,1,1,1,2,9552
2,2,2,1,3,2,5,9552
3,3,4,4,7,6,13,9552
4,4,1,2,8,8,16,9552
5,5,2,2,10,10,20,9552
6,6,0,1,10,11,21,9552
7,7,0,0,10,11,21,9552
0,0,1,0,1,0,1,9553
1,1,1,0,2,0,2,9553
2,2,0,0,2,0,2,9553
0,0,1,0,1,0,1,9554
1,1,0,0,1,0,1,9554
0,0,1,0,1,0,1,9555
1,1,1,0,2,0,2,9555
2,2,1,0,3,0,3,9555
3,3,0,0,3,0,3,9555
0,0,1,0,1,0,1,9556
1,1,2,0,3,0,3,9556
2,2,2,1,5,1,6,9556
3,3,0,1,5,2,7,9556
4,4,0,2,5,4,9,9556
5,5,0,0,5,4,9,9556
0,0,1,0,1,0,1,9557
1,1,2,0,3,0,3,9557
2,2,3,0,6,0,6,9557
3,3,3,0,9,0,9,9557
4,4,3,2,12,2,14,9557
5,5,3,1,15,3,18,9557
6,6,3,2,18,5,23,9557
7,7,0,2,18,7,25,9557
8,8,0,2,18,9,27,9557
9,9,0,1,18,10,28,9557
10,10,1,0,19,10,29,9557
11,11,0,0,19,10,29,9557
0,0,1,0,1,0,1,9558
1,1,1,1,2,1,3,9558
2,2,0,0,2,1,3,9558
0,0,1,0,1,0,1,9559
1,1,1,0,2,0,2,9559
2,2,1,0,3,0,3,9559
3,3,0,0,3,0,3,9559
0,0,1,0,1,0,1,9560
1,1,0,1,1,1,2,9560
2,2,0,0,1,1,2,9560
0,0,1,0,1,0,1,9561
1,1,0,0,1,0,1,9561
0,0,1,0,1,0,1,9562
1,1,1,0,2,0,2,9562
2,2,0,0,2,0,2,9562
0,0,1,0,1,0,1,9563
1,1,2,0,3,0,3,9563
2,2,2,0,5,0,5,9563
3,3,2,0,7,0,7,9563
4,4,1,0,8,0,8,9563
5,5,1,0,9,0,9,9563
6,6,4,0,13,0,13,9563
7,7,3,1,16,1,17,9563
8,8,2,1,18,2,20,9563
9,9,1,1,19,3,22,9563
10,10,0,0,19,3,22,9563
0,0,1,0,1,0,1,9564
1,1,0,0,1,0,1,9564
0,0,1,0,1,0,1,9565
1,1,1,0,2,0,2,9565
2,2,1,0,3,0,3,9565
3,3,0,0,3,0,3,9565
0,0,1,0,1,0,1,9566
1,1,0,0,1,0,1,9566
0,0,1,0,1,0,1,9567
1,1,1,1,2,1,3,9567
2,2,0,2,2,3,5,9567
3,3,0,3,2,6,8,9567
4,4,1,4,3,10,13,9567
5,5,2,2,5,12,17,9567
6,6,2,3,7,15,22,9567
7,7,1,2,8,17,25,9567
8,8,0,4,8,21,29,9567
9,9,0,2,8,23,31,9567
10,10,2,0,10,23,33,9567
11,11,2,1,12,24,36,9567
12,12,1,0,13,24,37,9567
13,13,0,0,13,24,37,9567
0,0,1,0,1,0,1,9568
1,1,1,0,2,0,2,9568
2,2,0,0,2,0,2,9568
0,0,1,0,1,0,1,9569
1,1,0,0,1,0,1,9569
0,0,1,0,1,0,1,9570
1,1,1,1,2,1,3,9570
2,2,1,0,3,1,4,9570
3,3,1,0,4,1,5,9570
4,4,0,0,4,1,5,9570
0,0,1,0,1,0,1,9571
1,1,0,0,1,0,1,9571
0,0,1,0,1,0,1,9572
1,1,1,0,2,0,2,9572
2,2,0,0,2,0,2,9572
0,0,1,0,1,0,1,9573
1,1,4,0,5,0,5,9573
2,2,6,0,11,0,11,9573
3,3,3,3,14,3,17,9573
4,4,0,2,14,5,19,9573
5,5,0,3,14,8,22,9573
6,6,0,2,14,10,24,9573
7,7,0,0,14,10,24,9573
0,0,1,0,1,0,1,9574
1,1,1,0,2,0,2,9574
2,2,0,0,2,0,2,9574
0,0,1,0,1,0,1,9575
1,1,2,2,3,2,5,9575
2,2,0,2,3,4,7,9575
3,3,0,1,3,5,8,9575
4,4,0,0,3,5,8,9575
0,0,1,0,1,0,1,9576
1,1,0,0,1,0,1,9576
0,0,1,0,1,0,1,9577
1,1,3,0,4,0,4,9577
2,2,1,2,5,2,7,9577
3,3,2,0,7,2,9,9577
4,4,2,0,9,2,11,9577
5,5,1,1,10,3,13,9577
6,6,2,0,12,3,15,9577
7,7,0,1,12,4,16,9577
8,8,1,0,13,4,17,9577
9,9,2,0,15,4,19,9577
10,10,6,1,21,5,26,9577
11,11,4,4,25,9,34,9577
12,12,4,4,29,13,42,9577
13,13,1,1,30,14,44,9577
14,14,2,1,32,15,47,9577
15,15,0,0,32,15,47,9577
0,0,1,0,1,0,1,9578
1,1,1,0,2,0,2,9578
2,2,1,0,3,0,3,9578
3,3,0,0,3,0,3,9578
0,0,1,0,1,0,1,9579
1,1,1,1,2,1,3,9579
2,2,0,0,2,1,3,9579
0,0,1,0,1,0,1,9580
1,1,0,1,1,1,2,9580
2,2,0,0,1,1,2,9580
0,0,1,0,1,0,1,9581
1,1,0,0,1,0,1,9581
0,0,1,0,1,0,1,9582
1,1,0,0,1,0,1,9582
0,0,1,0,1,0,1,9583
1,1,0,0,1,0,1,9583
0,0,1,0,1,0,1,9584
1,1,0,1,1,1,2,9584
2,2,0,1,1,2,3,9584
3,3,1,1,2,3,5,9584
4,4,0,1,2,4,6,9584
5,5,0,1,2,5,7,9584
6,6,1,2,3,7,10,9584
7,7,1,0,4,7,11,9584
8,8,1,0,5,7,12,9584
9,9,0,0,5,7,12,9584
0,0,1,0,1,0,1,9585
1,1,0,0,1,0,1,9585
0,0,1,0,1,0,1,9586
1,1,0,0,1,0,1,9586
0,0,1,0,1,0,1,9587
1,1,0,0,1,0,1,9587
0,0,1,0,1,0,1,9588
1,1,3,0,4,0,4,9588
2,2,2,1,6,1,7,9588
3,3,2,1,8,2,10,9588
4,4,1,1,9,3,12,9588
5,5,0,0,9,3,12,9588
0,0,1,0,1,0,1,9589
1,1,1,0,2,0,2,9589
2,2,0,0,2,0,2,9589
0,0,1,0,1,0,1,9590
1,1,1,0,2,0,2,9590
2,2,1,0,3,0,3,9590
3,3,1,0,4,0,4,9590
4,4,1,0,5,0,5,9590
5,5,1,0,6,0,6,9590
6,6,1,0,7,0,7,9590
7,7,1,0,8,0,8,9590
8,8,2,0,10,0,10,9590
9,9,1,0,11,0,11,9590
10,10,1,1,12,1,13,9590
11,11,2,1,14,2,16,9590
12,12,0,2,14,4,18,9590
13,13,0,2,14,6,20,9590
14,14,0,2,14,8,22,9590
15,15,0,1,14,9,23,9590
16,16,0,1,14,10,24,9590
17,17,0,1,14,11,25,9590
18,18,0,2,14,13,27,9590
19,19,0,0,14,13,27,9590
0,0,1,0,1,0,1,9591
1,1,0,0,1,0,1,9591
0,0,1,0,1,0,1,9592
1,1,0,0,1,0,1,9592
0,0,1,0,1,0,1,9593
1,1,0,0,1,0,1,9593
0,0,1,0,1,0,1,9594
1,1,2,0,3,0,3,9594
2,2,1,0,4,0,4,9594
3,3,1,0,5,0,5,9594
4,4,1,0,6,0,6,9594
5,5,0,0,6,0,6,9594
0,0,1,0,1,0,1,9595
1,1,1,0,2,0,2,9595
2,2,1,0,3,0,3,9595
3,3,0,0,3,0,3,9595
0,0,1,0,1,0,1,9596
1,1,1,0,2,0,2,9596
2,2,0,0,2,0,2,9596
0,0,1,0,1,0,1,9597
1,1,0,0,1,0,1,9597
0,0,1,0,1,0,1,9598
1,1,1,0,2,0,2,9598
2,2,0,0,2,0,2,9598
0,0,1,0,1,0,1,9599
1,1,0,0,1,0,1,9599
0,0,1,0,1,0,1,9600
1,1,1,0,2,0,2,9600
2,2,1,0,3,0,3,9600
3,3,0,0,3,0,3,9600
0,0,1,0,1,0,1,9601
1,1,1,0,2,0,2,9601
2,2,2,2,4,2,6,9601
3,3,2,0,6,2,8,9601
4,4,0,0,6,2,8,9601
0,0,1,0,1,0,1,9602
1,1,2,1,3,1,4,9602
2,2,0,2,3,3,6,9602
3,3,1,1,4,4,8,9602
4,4,2,4,6,8,14,9602
5,5,2,5,8,13,21,9602
6,6,1,4,9,17,26,9602
7,7,2,5,11,22,33,9602
8,8,5,3,16,25,41,9602
9,9,8,3,24,28,52,9602
10,10,8,6,32,34,66,9602
11,11,5,5,37,39,76,9602
12,12,6,10,43,49,92,9602
13,13,8,10,51,59,110,9602
14,14,6,15,57,74,131,9602
15,15,5,13,62,87,149,9602
16,16,6,8,68,95,163,9602
17,17,6,9,74,104,178,9602
18,18,6,5,80,109,189,9602
19,19,6,3,86,112,198,9602
20,20,4,1,90,113,203,9602
21,21,1,2,91,115,206,9602
22,22,1,4,92,119,211,9602
23,23,0,3,92,122,214,9602
24,24,1,2,93,124,217,9602
25,25,1,1,94,125,219,9602
26,26,0,0,94,125,219,9602
0,0,1,0,1,0,1,9603
1,1,1,0,2,0,2,9603
2,2,1,0,3,0,3,9603
3,3,1,0,4,0,4,9603
4,4,2,0,6,0,6,9603
5,5,2,0,8,0,8,9603
6,6,3,0,11,0,11,9603
7,7,3,0,14,0,14,9603
8,8,4,0,18,0,18,9603
9,9,2,1,20,1,21,9603
10,10,5,1,25,2,27,9603
11,11,3,2,28,4,32,9603
12,12,1,2,29,6,35,9603
13,13,0,1,29,7,36,9603
14,14,0,0,29,7,36,9603
0,0,1,0,1,0,1,9604
1,1,1,0,2,0,2,9604
2,2,0,0,2,0,2,9604
0,0,1,0,1,0,1,9605
1,1,0,0,1,0,1,9605
0,0,1,0,1,0,1,9606
1,1,1,0,2,0,2,9606
2,2,1,0,3,0,3,9606
3,3,0,1,3,1,4,9606
4,4,0,0,3,1,4,9606
0,0,1,0,1,0,1,9607
1,1,2,0,3,0,3,9607
2,2,0,0,3,0,3,9607
0,0,1,0,1,0,1,9608
1,1,0,0,1,0,1,9608
0,0,1,0,1,0,1,9609
1,1,0,0,1,0,1,9609
0,0,1,0,1,0,1,9610
1,1,2,0,3,0,3,9610
2,2,1,0,4,0,4,9610
3,3,0,1,4,1,5,9610
4,4,0,0,4,1,5,9610
0,0,1,0,1,0,1,9611
1,1,1,0,2,0,2,9611
2,2,3,0,5,0,5,9611
3,3,0,0,5,0,5,9611
0,0,1,0,1,0,1,9612
1,1,1,0,2,0,2,9612
2,2,1,0,3,0,3,9612
3,3,4,0,7,0,7,9612
4,4,0,0,7,0,7,9612
0,0,1,0,1,0,1,9613
1,1,0,1,1,1,2,9613
2,2,0,0,1,1,2,9613
0,0,1,0,1,0,1,9614
1,1,1,0,2,0,2,9614
2,2,0,0,2,0,2,9614
0,0,1,0,1,0,1,9615
1,1,1,1,2,1,3,9615
2,2,2,0,4,1,5,9615
3,3,1,1,5,2,7,9615
4,4,0,1,5,3,8,9615
5,5,0,2,5,5,10,9615
6,6,0,0,5,5,10,9615
0,0,1,0,1,0,1,9616
1,1,1,0,2,0,2,9616
2,2,0,0,2,0,2,9616
0,0,1,0,1,0,1,9617
1,1,1,0,2,0,2,9617
2,2,1,0,3,0,3,9617
3,3,1,0,4,0,4,9617
4,4,1,1,5,1,6,9617
5,5,1,1,6,2,8,9617
6,6,1,1,7,3,10,9617
7,7,0,0,7,3,10,9617
0,0,1,0,1,0,1,9618
1,1,0,0,1,0,1,9618
0,0,1,0,1,0,1,9619
1,1,0,1,1,1,2,9619
2,2,0,1,1,2,3,9619
3,3,0,0,1,2,3,9619
0,0,1,0,1,0,1,9620
1,1,0,0,1,0,1,9620
0,0,1,0,1,0,1,9621
1,1,0,0,1,0,1,9621
0,0,1,0,1,0,1,9622
1,1,0,0,1,0,1,9622
0,0,1,0,1,0,1,9623
1,1,1,0,2,0,2,9623
2,2,0,0,2,0,2,9623
0,0,1,0,1,0,1,9624
1,1,1,0,2,0,2,9624
2,2,0,1,2,1,3,9624
3,3,0,0,2,1,3,9624
0,0,1,0,1,0,1,9625
1,1,0,0,1,0,1,9625
0,0,1,0,1,0,1,9626
1,1,0,0,1,0,1,9626
0,0,1,0,1,0,1,9627
1,1,0,0,1,0,1,9627
0,0,1,0,1,0,1,9628
1,1,1,0,2,0,2,9628
2,2,2,2,4,2,6,9628
3,3,3,1,7,3,10,9628
4,4,2,2,9,5,14,9628
5,5,2,3,11,8,19,9628
6,6,1,3,12,11,23,9628
7,7,1,2,13,13,26,9628
8,8,1,1,14,14,28,9628
9,9,0,0,14,14,28,9628
0,0,1,0,1,0,1,9629
1,1,4,0,5,0,5,9629
2,2,1,1,6,1,7,9629
3,3,0,3,6,4,10,9629
4,4,0,0,6,4,10,9629
0,0,1,0,1,0,1,9630
1,1,0,0,1,0,1,9630
0,0,1,0,1,0,1,9631
1,1,0,0,1,0,1,9631
0,0,1,0,1,0,1,9632
1,1,0,0,1,0,1,9632
0,0,1,0,1,0,1,9633
1,1,0,0,1,0,1,9633
0,0,1,0,1,0,1,9634
1,1,1,0,2,0,2,9634
2,2,0,0,2,0,2,9634
0,0,1,0,1,0,1,9635
1,1,0,1,1,1,2,9635
2,2,0,0,1,1,2,9635
0,0,1,0,1,0,1,9636
1,1,0,0,1,0,1,9636
0,0,1,0,1,0,1,9637
1,1,1,0,2,0,2,9637
2,2,0,0,2,0,2,9637
0,0,1,0,1,0,1,9638
1,1,1,0,2,0,2,9638
2,2,0,1,2,1,3,9638
3,3,0,2,2,3,5,9638
4,4,0,1,2,4,6,9638
5,5,1,2,3,6,9,9638
6,6,3,4,6,10,16,9638
7,7,2,1,8,11,19,9638
8,8,2,3,10,14,24,9638
9,9,1,3,11,17,28,9638
10,10,2,6,13,23,36,9638
11,11,2,4,15,27,42,9638
12,12,4,2,19,29,48,9638
13,13,2,2,21,31,52,9638
14,14,5,0,26,31,57,9638
15,15,4,0,30,31,61,9638
16,16,2,1,32,32,64,9638
17,17,1,0,33,32,65,9638
18,18,0,0,33,32,65,9638
0,0,1,0,1,0,1,9639
1,1,1,0,2,0,2,9639
2,2,3,0,5,0,5,9639
3,3,1,1,6,1,7,9639
4,4,2,2,8,3,11,9639
5,5,4,4,12,7,19,9639
6,6,3,3,15,10,25,9639
7,7,4,5,19,15,34,9639
8,8,2,5,21,20,41,9639
9,9,2,3,23,23,46,9639
10,10,2,1,25,24,49,9639
11,11,3,0,28,24,52,9639
12,12,3,0,31,24,55,9639
13,13,4,0,35,24,59,9639
14,14,2,0,37,24,61,9639
15,15,1,0,38,24,62,9639
16,16,4,0,42,24,66,9639
17,17,5,1,47,25,72,9639
18,18,3,3,50,28,78,9639
19,19,1,3,51,31,82,9639
20,20,0,2,51,33,84,9639
21,21,0,0,51,33,84,9639
0,0,1,0,1,0,1,9640
1,1,0,1,1,1,2,9640
2,2,0,1,1,2,3,9640
3,3,0,2,1,4,5,9640
4,4,0,2,1,6,7,9640
5,5,1,4,2,10,12,9640
6,6,1,3,3,13,16,9640
7,7,1,1,4,14,18,9640
8,8,0,1,4,15,19,9640
9,9,0,2,4,17,21,9640
10,10,0,2,4,19,23,9640
11,11,2,3,6,22,28,9640
12,12,6,0,12,22,34,9640
13,13,5,1,17,23,40,9640
14,14,0,1,17,24,41,9640
15,15,0,2,17,26,43,9640
16,16,1,4,18,30,48,9640
17,17,2,4,20,34,54,9640
18,18,5,1,25,35,60,9640
19,19,4,1,29,36,65,9640
20,20,3,1,32,37,69,9640
21,21,4,1,36,38,74,9640
22,22,2,0,38,38,76,9640
23,23,0,1,38,39,77,9640
24,24,0,1,38,40,78,9640
25,25,0,1,38,41,79,9640
26,26,0,2,38,43,81,9640
27,27,1,0,39,43,82,9640
28,28,0,0,39,43,82,9640
0,0,1,0,1,0,1,9641
1,1,1,0,2,0,2,9641
2,2,0,1,2,1,3,9641
3,3,0,1,2,2,4,9641
4,4,0,0,2,2,4,9641
0,0,1,0,1,0,1,9642
1,1,1,0,2,0,2,9642
2,2,1,0,3,0,3,9642
3,3,0,0,3,0,3,9642
0,0,1,0,1,0,1,9643
1,1,0,0,1,0,1,9643
0,0,1,0,1,0,1,9644
1,1,1,0,2,0,2,9644
2,2,0,1,2,1,3,9644
3,3,0,0,2,1,3,9644
0,0,1,0,1,0,1,9645
1,1,0,1,1,1,2,9645
2,2,0,0,1,1,2,9645
0,0,1,0,1,0,1,9646
1,1,0,0,1,0,1,9646
0,0,1,0,1,0,1,9647
1,1,1,0,2,0,2,9647
2,2,2,0,4,0,4,9647
3,3,1,0,5,0,5,9647
4,4,0,1,5,1,6,9647
5,5,0,0,5,1,6,9647
0,0,1,0,1,0,1,9648
1,1,0,0,1,0,1,9648
0,0,1,0,1,0,1,9649
1,1,1,0,2,0,2,9649
2,2,0,0,2,0,2,9649
0,0,1,0,1,0,1,9650
1,1,1,0,2,0,2,9650
2,2,1,2,3,2,5,9650
3,3,1,0,4,2,6,9650
4,4,1,0,5,2,7,9650
5,5,1,0,6,2,8,9650
6,6,2,0,8,2,10,9650
7,7,1,1,9,3,12,9650
8,8,1,0,10,3,13,9650
9,9,0,0,10,3,13,9650
0,0,1,0,1,0,1,9651
1,1,0,0,1,0,1,9651
0,0,1,0,1,0,1,9652
1,1,1,0,2,0,2,9652
2,2,0,0,2,0,2,9652
0,0,1,0,1,0,1,9653
1,1,1,0,2,0,2,9653
2,2,0,0,2,0,2,9653
0,0,1,0,1,0,1,9654
1,1,0,0,1,0,1,9654
0,0,1,0,1,0,1,9655
1,1,1,0,2,0,2,9655
2,2,2,0,4,0,4,9655
3,3,2,0,6,0,6,9655
4,4,0,0,6,0,6,9655
0,0,1,0,1,0,1,9656
1,1,0,0,1,0,1,9656
0,0,1,0,1,0,1,9657
1,1,0,0,1,0,1,9657
0,0,1,0,1,0,1,9658
1,1,0,0,1,0,1,9658
0,0,1,0,1,0,1,9659
1,1,2,0,3,0,3,9659
2,2,1,0,4,0,4,9659
3,3,0,0,4,0,4,9659
0,0,1,0,1,0,1,9660
1,1,0,1,1,1,2,9660
2,2,0,0,1,1,2,9660
0,0,1,0,1,0,1,9661
1,1,0,0,1,0,1,9661
0,0,1,0,1,0,1,9662
1,1,1,0,2,0,2,9662
2,2,2,1,4,1,5,9662
3,3,2,0,6,1,7,9662
4,4,0,0,6,1,7,9662
0,0,1,0,1,0,1,9663
1,1,0,1,1,1,2,9663
2,2,0,1,1,2,3,9663
3,3,0,0,1,2,3,9663
0,0,1,0,1,0,1,9664
1,1,2,1,3,1,4,9664
2,2,0,2,3,3,6,9664
3,3,0,1,3,4,7,9664
4,4,0,0,3,4,7,9664
0,0,1,0,1,0,1,9665
1,1,1,1,2,1,3,9665
2,2,2,0,4,1,5,9665
3,3,1,0,5,1,6,9665
4,4,0,0,5,1,6,9665
0,0,1,0,1,0,1,9666
1,1,3,1,4,1,5,9666
2,2,3,0,7,1,8,9666
3,3,1,0,8,1,9,9666
4,4,0,0,8,1,9,9666
0,0,1,0,1,0,1,9667
1,1,1,0,2,0,2,9667
2,2,1,0,3,0,3,9667
3,3,0,0,3,0,3,9667
0,0,1,0,1,0,1,9668
1,1,1,0,2,0,2,9668
2,2,0,0,2,0,2,9668
0,0,1,0,1,0,1,9669
1,1,0,0,1,0,1,9669
0,0,1,0,1,0,1,9670
1,1,0,0,1,0,1,9670
0,0,1,0,1,0,1,9671
1,1,0,0,1,0,1,9671
0,0,1,0,1,0,1,9672
1,1,0,1,1,1,2,9672
2,2,0,1,1,2,3,9672
3,3,0,1,1,3,4,9672
4,4,0,0,1,3,4,9672
0,0,1,0,1,0,1,9673
1,1,0,0,1,0,1,9673
0,0,1,0,1,0,1,9674
1,1,1,0,2,0,2,9674
2,2,1,0,3,0,3,9674
3,3,1,0,4,0,4,9674
4,4,1,0,5,0,5,9674
5,5,1,0,6,0,6,9674
6,6,3,0,9,0,9,9674
7,7,2,0,11,0,11,9674
8,8,2,1,13,1,14,9674
9,9,1,2,14,3,17,9674
10,10,1,1,15,4,19,9674
11,11,1,1,16,5,21,9674
12,12,1,3,17,8,25,9674
13,13,1,3,18,11,29,9674
14,14,1,3,19,14,33,9674
15,15,2,2,21,16,37,9674
16,16,5,3,26,19,45,9674
17,17,3,4,29,23,52,9674
18,18,2,4,31,27,58,9674
19,19,1,1,32,28,60,9674
20,20,1,0,33,28,61,9674
21,21,0,0,33,28,61,9674
0,0,1,0,1,0,1,9675
1,1,1,0,2,0,2,9675
2,2,1,0,3,0,3,9675
3,3,1,0,4,0,4,9675
4,4,2,0,6,0,6,9675
5,5,0,1,6,1,7,9675
6,6,0,1,6,2,8,9675
7,7,0,0,6,2,8,9675
0,0,1,0,1,0,1,9676
1,1,0,0,1,0,1,9676
0,0,1,0,1,0,1,9677
1,1,1,0,2,0,2,9677
2,2,2,0,4,0,4,9677
3,3,1,0,5,0,5,9677
4,4,0,1,5,1,6,9677
5,5,0,0,5,1,6,9677
0,0,1,0,1,0,1,9678
1,1,1,0,2,0,2,9678
2,2,0,0,2,0,2,9678
0,0,1,0,1,0,1,9679
1,1,2,0,3,0,3,9679
2,2,3,0,6,0,6,9679
3,3,5,1,11,1,12,9679
4,4,2,1,13,2,15,9679
5,5,1,4,14,6,20,9679
6,6,3,3,17,9,26,9679
7,7,1,1,18,10,28,9679
8,8,0,0,18,10,28,9679
0,0,1,0,1,0,1,9680
1,1,3,0,4,0,4,9680
2,2,1,0,5,0,5,9680
3,3,0,0,5,0,5,9680
0,0,1,0,1,0,1,9681
1,1,1,0,2,0,2,9681
2,2,0,0,2,0,2,9681
0,0,1,0,1,0,1,9682
1,1,1,0,2,0,2,9682
2,2,0,0,2,0,2,9682
0,0,1,0,1,0,1,9683
1,1,0,1,1,1,2,9683
2,2,0,0,1,1,2,9683
0,0,1,0,1,0,1,9684
1,1,0,0,1,0,1,9684
0,0,1,0,1,0,1,9685
1,1,1,0,2,0,2,9685
2,2,1,0,3,0,3,9685
3,3,1,1,4,1,5,9685
4,4,0,0,4,1,5,9685
0,0,1,0,1,0,1,9686
1,1,0,0,1,0,1,9686
0,0,1,0,1,0,1,9687
1,1,0,0,1,0,1,9687
0,0,1,0,1,0,1,9688
1,1,2,0,3,0,3,9688
2,2,0,0,3,0,3,9688
0,0,1,0,1,0,1,9689
1,1,1,1,2,1,3,9689
2,2,1,2,3,3,6,9689
3,3,4,3,7,6,13,9689
4,4,1,2,8,8,16,9689
5,5,2,1,10,9,19,9689
6,6,5,0,15,9,24,9689
7,7,2,0,17,9,26,9689
8,8,1,0,18,9,27,9689
9,9,2,1,20,10,30,9689
10,10,1,2,21,12,33,9689
11,11,1,3,22,15,37,9689
12,12,1,2,23,17,40,9689
13,13,2,0,25,17,42,9689
14,14,2,0,27,17,44,9689
15,15,1,0,28,17,45,9689
16,16,2,0,30,17,47,9689
17,17,2,0,32,17,49,9689
18,18,2,0,34,17,51,9689
19,19,1,1,35,18,53,9689
20,20,1,2,36,20,56,9689
21,21,1,1,37,21,58,9689
22,22,1,0,38,21,59,9689
23,23,2,0,40,21,61,9689
24,24,1,0,41,21,62,9689
25,25,2,0,43,21,64,9689
26,26,2,0,45,21,66,9689
27,27,1,0,46,21,67,9689
28,28,1,0,47,21,68,9689
29,29,0,1,47,22,69,9689
30,30,0,2,47,24,71,9689
31,31,0,3,47,27,74,9689
32,32,0,1,47,28,75,9689
33,33,0,1,47,29,76,9689
34,34,1,2,48,31,79,9689
35,35,2,2,50,33,83,9689
36,36,0,1,50,34,84,9689
37,37,0,0,50,34,84,9689
0,0,1,0,1,0,1,9690
1,1,0,0,1,0,1,9690
0,0,1,0,1,0,1,9691
1,1,1,1,2,1,3,9691
2,2,1,0,3,1,4,9691
3,3,3,0,6,1,7,9691
4,4,4,1,10,2,12,9691
5,5,4,0,14,2,16,9691
6,6,1,1,15,3,18,9691
7,7,1,1,16,4,20,9691
8,8,1,0,17,4,21,9691
9,9,0,0,17,4,21,9691
0,0,1,0,1,0,1,9692
1,1,0,0,1,0,1,9692
0,0,1,0,1,0,1,9693
1,1,1,0,2,0,2,9693
2,2,0,1,2,1,3,9693
3,3,1,0,3,1,4,9693
4,4,1,0,4,1,5,9693
5,5,1,1,5,2,7,9693
6,6,1,2,6,4,10,9693
7,7,0,0,6,4,10,9693
0,0,1,0,1,0,1,9694
1,1,0,1,1,1,2,9694
2,2,2,0,3,1,4,9694
3,3,0,0,3,1,4,9694
0,0,1,0,1,0,1,9695
1,1,0,0,1,0,1,9695
0,0,1,0,1,0,1,9696
1,1,0,0,1,0,1,9696
0,0,1,0,1,0,1,9697
1,1,0,0,1,0,1,9697
0,0,1,0,1,0,1,9698
1,1,0,0,1,0,1,9698
0,0,1,0,1,0,1,9699
1,1,0,0,1,0,1,9699
0,0,1,0,1,0,1,9700
1,1,2,0,3,0,3,9700
2,2,0,0,3,0,3,9700
0,0,1,0,1,0,1,9701
1,1,0,0,1,0,1,9701
0,0,1,0,1,0,1,9702
1,1,2,0,3,0,3,9702
2,2,1,0,4,0,4,9702
3,3,1,1,5,1,6,9702
4,4,1,0,6,1,7,9702
5,5,1,0,7,1,8,9702
6,6,0,0,7,1,8,9702
0,0,1,0,1,0,1,9703
1,1,0,1,1,1,2,9703
2,2,0,0,1,1,2,9703
0,0,1,0,1,0,1,9704
1,1,0,0,1,0,1,9704
0,0,1,0,1,0,1,9705
1,1,1,0,2,0,2,9705
2,2,1,0,3,0,3,9705
3,3,1,0,4,0,4,9705
4,4,1,0,5,0,5,9705
5,5,3,0,8,0,8,9705
6,6,1,0,9,0,9,9705
7,7,0,1,9,1,10,9705
8,8,1,0,10,1,11,9705
9,9,0,0,10,1,11,9705
0,0,1,0,1,0,1,9706
1,1,0,0,1,0,1,9706
0,0,1,0,1,0,1,9707
1,1,0,0,1,0,1,9707
0,0,1,0,1,0,1,9708
1,1,4,0,5,0,5,9708
2,2,3,0,8,0,8,9708
3,3,4,1,12,1,13,9708
4,4,3,3,15,4,19,9708
5,5,2,5,17,9,26,9708
6,6,1,5,18,14,32,9708
7,7,1,5,19,19,38,9708
8,8,1,3,20,22,42,9708
9,9,1,2,21,24,45,9708
10,10,1,3,22,27,49,9708
11,11,2,3,24,30,54,9708
12,12,0,1,24,31,55,9708
13,13,0,0,24,31,55,9708
0,0,1,0,1,0,1,9709
1,1,0,0,1,0,1,9709
0,0,1,0,1,0,1,9710
1,1,1,0,2,0,2,9710
2,2,0,0,2,0,2,9710
0,0,1,0,1,0,1,9711
1,1,3,0,4,0,4,9711
2,2,2,0,6,0,6,9711
3,3,0,0,6,0,6,9711
0,0,1,0,1,0,1,9712
1,1,0,0,1,0,1,9712
0,0,1,0,1,0,1,9713
1,1,0,0,1,0,1,9713
0,0,1,0,1,0,1,9714
1,1,2,0,3,0,3,9714
2,2,1,1,4,1,5,9714
3,3,1,0,5,1,6,9714
4,4,0,0,5,1,6,9714
0,0,1,0,1,0,1,9715
1,1,0,0,1,0,1,9715
0,0,1,0,1,0,1,9716
1,1,0,0,1,0,1,9716
0,0,1,0,1,0,1,9717
1,1,2,0,3,0,3,9717
2,2,2,0,5,0,5,9717
3,3,0,0,5,0,5,9717
0,0,1,0,1,0,1,9718
1,1,1,0,2,0,2,9718
2,2,3,0,5,0,5,9718
3,3,1,0,6,0,6,9718
4,4,2,0,8,0,8,9718
5,5,2,0,10,0,10,9718
6,6,0,0,10,0,10,9718
0,0,1,0,1,0,1,9719
1,1,0,0,1,0,1,9719
0,0,1,0,1,0,1,9720
1,1,0,0,1,0,1,9720
0,0,1,0,1,0,1,9721
1,1,1,1,2,1,3,9721
2,2,2,1,4,2,6,9721
3,3,3,0,7,2,9,9721
4,4,2,1,9,3,12,9721
5,5,2,0,11,3,14,9721
6,6,4,0,15,3,18,9721
7,7,0,1,15,4,19,9721
8,8,2,1,17,5,22,9721
9,9,2,0,19,5,24,9721
10,10,2,0,21,5,26,9721
11,11,3,0,24,5,29,9721
12,12,4,0,28,5,33,9721
13,13,4,0,32,5,37,9721
14,14,3,1,35,6,41,9721
15,15,3,0,38,6,44,9721
16,16,5,0,43,6,49,9721
17,17,3,2,46,8,54,9721
18,18,3,2,49,10,59,9721
19,19,2,1,51,11,62,9721
20,20,2,1,53,12,65,9721
21,21,2,0,55,12,67,9721
22,22,1,0,56,12,68,9721
23,23,2,0,58,12,70,9721
24,24,1,0,59,12,71,9721
25,25,2,0,61,12,73,9721
26,26,1,1,62,13,75,9721
27,27,1,0,63,13,76,9721
28,28,0,0,63,13,76,9721
0,0,1,0,1,0,1,9722
1,1,0,0,1,0,1,9722
0,0,1,0,1,0,1,9723
1,1,0,0,1,0,1,9723
0,0,1,0,1,0,1,9724
1,1,1,0,2,0,2,9724
2,2,2,0,4,0,4,9724
3,3,2,0,6,0,6,9724
4,4,1,0,7,0,7,9724
5,5,1,1,8,1,9,9724
6,6,0,1,8,2,10,9724
7,7,0,0,8,2,10,9724
0,0,1,0,1,0,1,9725
1,1,0,0,1,0,1,9725
0,0,1,0,1,0,1,9726
1,1,1,1,2,1,3,9726
2,2,2,0,4,1,5,9726
3,3,0,0,4,1,5,9726
0,0,1,0,1,0,1,9727
1,1,1,0,2,0,2,9727
2,2,1,0,3,0,3,9727
3,3,1,0,4,0,4,9727
4,4,2,0,6,0,6,9727
5,5,1,0,7,0,7,9727
6,6,0,0,7,0,7,9727
0,0,1,0,1,0,1,9728
1,1,2,1,3,1,4,9728
2,2,0,1,3,2,5,9728
3,3,0,0,3,2,5,9728
0,0,1,0,1,0,1,9729
1,1,1,0,2,0,2,9729
2,2,0,0,2,0,2,9729
0,0,1,0,1,0,1,9730
1,1,0,0,1,0,1,9730
0,0,1,0,1,0,1,9731
1,1,0,0,1,0,1,9731
0,0,1,0,1,0,1,9732
1,1,0,0,1,0,1,9732
0,0,1,0,1,0,1,9733
1,1,0,0,1,0,1,9733
0,0,1,0,1,0,1,9734
1,1,0,0,1,0,1,9734
0,0,1,0,1,0,1,9735
1,1,1,0,2,0,2,9735
2,2,1,1,3,1,4,9735
3,3,0,0,3,1,4,9735
0,0,1,0,1,0,1,9736
1,1,0,0,1,0,1,9736
0,0,1,0,1,0,1,9737
1,1,2,0,3,0,3,9737
2,2,3,0,6,0,6,9737
3,3,3,0,9,0,9,9737
4,4,1,0,10,0,10,9737
5,5,1,0,11,0,11,9737
6,6,2,0,13,0,13,9737
7,7,2,1,15,1,16,9737
8,8,2,1,17,2,19,9737
9,9,1,3,18,5,23,9737
10,10,0,3,18,8,26,9737
11,11,0,2,18,10,28,9737
12,12,0,1,18,11,29,9737
13,13,0,0,18,11,29,9737
0,0,1,0,1,0,1,9738
1,1,0,0,1,0,1,9738
0,0,1,0,1,0,1,9739
1,1,1,0,2,0,2,9739
2,2,0,0,2,0,2,9739
0,0,1,0,1,0,1,9740
1,1,1,0,2,0,2,9740
2,2,0,0,2,0,2,9740
0,0,1,0,1,0,1,9741
1,1,4,0,5,0,5,9741
2,2,2,2,7,2,9,9741
3,3,0,2,7,4,11,9741
4,4,0,4,7,8,15,9741
5,5,1,3,8,11,19,9741
6,6,0,2,8,13,21,9741
7,7,1,6,9,19,28,9741
8,8,1,2,10,21,31,9741
9,9,2,2,12,23,35,9741
10,10,1,3,13,26,39,9741
11,11,2,2,15,28,43,9741
12,12,4,2,19,30,49,9741
13,13,1,4,20,34,54,9741
14,14,1,3,21,37,58,9741
15,15,1,1,22,38,60,9741
16,16,2,0,24,38,62,9741
17,17,1,1,25,39,64,9741
18,18,0,0,25,39,64,9741
0,0,1,0,1,0,1,9742
1,1,0,0,1,0,1,9742
0,0,1,0,1,0,1,9743
1,1,0,0,1,0,1,9743
0,0,1,0,1,0,1,9744
1,1,1,0,2,0,2,9744
2,2,1,1,3,1,4,9744
3,3,0,2,3,3,6,9744
4,4,0,0,3,3,6,9744
0,0,1,0,1,0,1,9745
1,1,0,1,1,1,2,9745
2,2,0,1,1,2,3,9745
3,3,0,0,1,2,3,9745
0,0,1,0,1,0,1,9746
1,1,0,0,1,0,1,9746
0,0,1,0,1,0,1,9747
1,1,1,1,2,1,3,9747
2,2,0,2,2,3,5,9747
3,3,0,1,2,4,6,9747
4,4,0,2,2,6,8,9747
5,5,0,3,2,9,11,9747
6,6,0,3,2,12,14,9747
7,7,0,1,2,13,15,9747
8,8,0,1,2,14,16,9747
9,9,0,2,2,16,18,9747
10,10,0,0,2,16,18,9747
0,0,1,0,1,0,1,9748
1,1,0,0,1,0,1,9748
0,0,1,0,1,0,1,9749
1,1,1,0,2,0,2,9749
2,2,0,1,2,1,3,9749
3,3,0,1,2,2,4,9749
4,4,0,1,2,3,5,9749
5,5,0,3,2,6,8,9749
6,6,2,1,4,7,11,9749
7,7,2,0,6,7,13,9749
8,8,0,0,6,7,13,9749
0,0,1,0,1,0,1,9750
1,1,0,0,1,0,1,9750
0,0,1,0,1,0,1,9751
1,1,0,0,1,0,1,9751
0,0,1,0,1,0,1,9752
1,1,0,2,1,2,3,9752
2,2,0,3,1,5,6,9752
3,3,3,0,4,5,9,9752
4,4,7,0,11,5,16,9752
5,5,4,2,15,7,22,9752
6,6,1,3,16,10,26,9752
7,7,0,5,16,15,31,9752
8,8,1,6,17,21,38,9752
9,9,2,7,19,28,47,9752
10,10,3,7,22,35,57,9752
11,11,0,8,22,43,65,9752
12,12,0,7,22,50,72,9752
13,13,4,5,26,55,81,9752
14,14,2,2,28,57,85,9752
15,15,1,3,29,60,89,9752
16,16,3,3,32,63,95,9752
17,17,1,2,33,65,98,9752
18,18,1,2,34,67,101,9752
19,19,3,0,37,67,104,9752
20,20,1,0,38,67,105,9752
21,21,0,0,38,67,105,9752
0,0,1,0,1,0,1,9753
1,1,1,0,2,0,2,9753
2,2,3,0,5,0,5,9753
3,3,6,1,11,1,12,9753
4,4,7,2,18,3,21,9753
5,5,2,2,20,5,25,9753
6,6,1,1,21,6,27,9753
7,7,2,1,23,7,30,9753
8,8,2,1,25,8,33,9753
9,9,1,0,26,8,34,9753
10,10,0,0,26,8,34,9753
0,0,1,0,1,0,1,9754
1,1,1,0,2,0,2,9754
2,2,3,0,5,0,5,9754
3,3,2,1,7,1,8,9754
4,4,2,1,9,2,11,9754
5,5,1,1,10,3,13,9754
6,6,0,0,10,3,13,9754
0,0,1,0,1,0,1,9755
1,1,1,0,2,0,2,9755
2,2,1,0,3,0,3,9755
3,3,0,0,3,0,3,9755
0,0,1,0,1,0,1,9756
1,1,0,0,1,0,1,9756
0,0,1,0,1,0,1,9757
1,1,0,0,1,0,1,9757
0,0,1,0,1,0,1,9758
1,1,0,0,1,0,1,9758
0,0,1,0,1,0,1,9759
1,1,2,1,3,1,4,9759
2,2,1,3,4,4,8,9759
3,3,1,0,5,4,9,9759
4,4,0,0,5,4,9,9759
0,0,1,0,1,0,1,9760
1,1,0,0,1,0,1,9760
0,0,1,0,1,0,1,9761
1,1,0,0,1,0,1,9761
0,0,1,0,1,0,1,9762
1,1,3,0,4,0,4,9762
2,2,5,0,9,0,9,9762
3,3,4,3,13,3,16,9762
4,4,4,8,17,11,28,9762
5,5,8,5,25,16,41,9762
6,6,10,6,35,22,57,9762
7,7,11,4,46,26,72,9762
8,8,8,10,54,36,90,9762
9,9,4,4,58,40,98,9762
10,10,3,5,61,45,106,9762
11,11,2,3,63,48,111,9762
12,12,0,3,63,51,114,9762
13,13,0,2,63,53,116,9762
14,14,0,1,63,54,117,9762
15,15,0,0,63,54,117,9762
0,0,1,0,1,0,1,9763
1,1,3,1,4,1,5,9763
2,2,2,2,6,3,9,9763
3,3,2,1,8,4,12,9763
4,4,1,0,9,4,13,9763
5,5,0,0,9,4,13,9763
0,0,1,0,1,0,1,9764
1,1,0,0,1,0,1,9764
0,0,1,0,1,0,1,9765
1,1,3,0,4,0,4,9765
2,2,1,0,5,0,5,9765
3,3,0,0,5,0,5,9765
0,0,1,0,1,0,1,9766
1,1,1,0,2,0,2,9766
2,2,0,0,2,0,2,9766
0,0,1,0,1,0,1,9767
1,1,0,0,1,0,1,9767
0,0,1,0,1,0,1,9768
1,1,0,0,1,0,1,9768
0,0,1,0,1,0,1,9769
1,1,0,0,1,0,1,9769
0,0,1,0,1,0,1,9770
1,1,1,0,2,0,2,9770
2,2,0,0,2,0,2,9770
0,0,1,0,1,0,1,9771
1,1,0,0,1,0,1,9771
0,0,1,0,1,0,1,9772
1,1,2,0,3,0,3,9772
2,2,1,0,4,0,4,9772
3,3,0,0,4,0,4,9772
0,0,1,0,1,0,1,9773
1,1,1,0,2,0,2,9773
2,2,0,1,2,1,3,9773
3,3,0,0,2,1,3,9773
0,0,1,0,1,0,1,9774
1,1,1,0,2,0,2,9774
2,2,0,0,2,0,2,9774
0,0,1,0,1,0,1,9775
1,1,1,0,2,0,2,9775
2,2,1,0,3,0,3,9775
3,3,0,1,3,1,4,9775
4,4,0,1,3,2,5,9775
5,5,0,2,3,4,7,9775
6,6,2,1,5,5,10,9775
7,7,2,2,7,7,14,9775
8,8,1,3,8,10,18,9775
9,9,1,1,9,11,20,9775
10,10,2,1,11,12,23,9775
11,11,1,2,12,14,26,9775
12,12,0,2,12,16,28,9775
13,13,1,2,13,18,31,9775
14,14,2,3,15,21,36,9775
15,15,1,1,16,22,38,9775
16,16,2,0,18,22,40,9775
17,17,2,1,20,23,43,9775
18,18,0,1,20,24,44,9775
19,19,1,0,21,24,45,9775
20,20,1,1,22,25,47,9775
21,21,0,1,22,26,48,9775
22,22,0,1,22,27,49,9775
23,23,0,3,22,30,52,9775
24,24,0,2,22,32,54,9775
25,25,1,3,23,35,58,9775
26,26,0,4,23,39,62,9775
27,27,1,6,24,45,69,9775
28,28,2,3,26,48,74,9775
29,29,0,3,26,51,77,9775
30,30,2,2,28,53,81,9775
31,31,1,4,29,57,86,9775
32,32,1,4,30,61,91,9775
33,33,0,3,30,64,94,9775
34,34,0,3,30,67,97,9775
35,35,0,6,30,73,103,9775
36,36,0,5,30,78,108,9775
37,37,3,3,33,81,114,9775
38,38,1,3,34,84,118,9775
39,39,2,4,36,88,124,9775
40,40,2,5,38,93,131,9775
41,41,4,4,42,97,139,9775
42,42,6,2,48,99,147,9775
43,43,3,1,51,100,151,9775
44,44,3,2,54,102,156,9775
45,45,3,2,57,104,161,9775
46,46,2,3,59,107,166,9775
47,47,2,3,61,110,171,9775
48,48,1,3,62,113,175,9775
49,49,1,2,63,115,178,9775
50,50,0,0,63,115,178,9775
0,0,1,0,1,0,1,9776
1,1,0,0,1,0,1,9776
0,0,1,0,1,0,1,9777
1,1,1,0,2,0,2,9777
2,2,0,0,2,0,2,9777
0,0,1,0,1,0,1,9778
1,1,1,0,2,0,2,9778
2,2,1,0,3,0,3,9778
3,3,2,1,5,1,6,9778
4,4,4,3,9,4,13,9778
5,5,3,2,12,6,18,9778
6,6,3,1,15,7,22,9778
7,7,2,1,17,8,25,9778
8,8,0,1,17,9,26,9778
9,9,0,1,17,10,27,9778
10,10,0,1,17,11,28,9778
11,11,0,1,17,12,29,9778
12,12,0,2,17,14,31,9778
13,13,0,2,17,16,33,9778
14,14,0,1,17,17,34,9778
15,15,0,3,17,20,37,9778
16,16,2,1,19,21,40,9778
17,17,0,1,19,22,41,9778
18,18,0,0,19,22,41,9778
0,0,1,0,1,0,1,9779
1,1,2,0,3,0,3,9779
2,2,2,1,5,1,6,9779
3,3,2,0,7,1,8,9779
4,4,1,0,8,1,9,9779
5,5,0,0,8,1,9,9779
0,0,1,0,1,0,1,9780
1,1,1,0,2,0,2,9780
2,2,1,0,3,0,3,9780
3,3,1,0,4,0,4,9780
4,4,1,0,5,0,5,9780
5,5,1,0,6,0,6,9780
6,6,0,0,6,0,6,9780
0,0,1,0,1,0,1,9781
1,1,1,0,2,0,2,9781
2,2,0,0,2,0,2,9781
0,0,1,0,1,0,1,9782
1,1,0,1,1,1,2,9782
2,2,0,1,1,2,3,9782
3,3,0,4,1,6,7,9782
4,4,0,4,1,10,11,9782
5,5,0,3,1,13,14,9782
6,6,0,1,1,14,15,9782
7,7,0,1,1,15,16,9782
8,8,0,2,1,17,18,9782
9,9,0,1,1,18,19,9782
10,10,0,0,1,18,19,9782
0,0,1,0,1,0,1,9783
1,1,0,0,1,0,1,9783
0,0,1,0,1,0,1,9784
1,1,2,0,3,0,3,9784
2,2,1,1,4,1,5,9784
3,3,1,0,5,1,6,9784
4,4,2,0,7,1,8,9784
5,5,1,0,8,1,9,9784
6,6,1,0,9,1,10,9784
7,7,1,0,10,1,11,9784
8,8,2,1,12,2,14,9784
9,9,2,1,14,3,17,9784
10,10,2,0,16,3,19,9784
11,11,0,1,16,4,20,9784
12,12,1,1,17,5,22,9784
13,13,1,0,18,5,23,9784
14,14,2,0,20,5,25,9784
15,15,0,0,20,5,25,9784
0,0,1,0,1,0,1,9785
1,1,1,0,2,0,2,9785
2,2,0,0,2,0,2,9785
0,0,1,0,1,0,1,9786
1,1,0,2,1,2,3,9786
2,2,0,2,1,4,5,9786
3,3,0,1,1,5,6,9786
4,4,1,0,2,5,7,9786
5,5,0,0,2,5,7,9786
0,0,1,0,1,0,1,9787
1,1,2,0,3,0,3,9787
2,2,1,0,4,0,4,9787
3,3,0,0,4,0,4,9787
0,0,1,0,1,0,1,9788
1,1,0,0,1,0,1,9788
0,0,1,0,1,0,1,9789
1,1,1,0,2,0,2,9789
2,2,1,1,3,1,4,9789
3,3,0,2,3,3,6,9789
4,4,0,1,3,4,7,9789
5,5,0,0,3,4,7,9789
0,0,1,0,1,0,1,9790
1,1,0,0,1,0,1,9790
0,0,1,0,1,0,1,9791
1,1,1,0,2,0,2,9791
2,2,0,0,2,0,2,9791
0,0,1,0,1,0,1,9792
1,1,3,0,4,0,4,9792
2,2,5,0,9,0,9,9792
3,3,2,0,11,0,11,9792
4,4,2,1,13,1,14,9792
5,5,0,2,13,3,16,9792
6,6,0,1,13,4,17,9792
7,7,0,2,13,6,19,9792
8,8,0,2,13,8,21,9792
9,9,0,1,13,9,22,9792
10,10,0,3,13,12,25,9792
11,11,1,1,14,13,27,9792
12,12,2,1,16,14,30,9792
13,13,1,2,17,16,33,9792
14,14,0,2,17,18,35,9792
15,15,0,0,17,18,35,9792
0,0,1,0,1,0,1,9793
1,1,1,1,2,1,3,9793
2,2,4,1,6,2,8,9793
3,3,2,0,8,2,10,9793
4,4,1,0,9,2,11,9793
5,5,1,1,10,3,13,9793
6,6,1,1,11,4,15,9793
7,7,1,1,12,5,17,9793
8,8,1,0,13,5,18,9793
9,9,2,0,15,5,20,9793
10,10,3,1,18,6,24,9793
11,11,5,2,23,8,31,9793
12,12,8,2,31,10,41,9793
13,13,7,3,38,13,51,9793
14,14,6,3,44,16,60,9793
15,15,4,2,48,18,66,9793
16,16,2,4,50,22,72,9793
17,17,5,1,55,23,78,9793
18,18,3,1,58,24,82,9793
19,19,4,3,62,27,89,9793
20,20,3,2,65,29,94,9793
21,21,3,2,68,31,99,9793
22,22,2,1,70,32,102,9793
23,23,3,1,73,33,106,9793
24,24,3,0,76,33,109,9793
25,25,0,0,76,33,109,9793
0,0,1,0,1,0,1,9794
1,1,0,0,1,0,1,9794
0,0,1,0,1,0,1,9795
1,1,0,0,1,0,1,9795
0,0,1,0,1,0,1,9796
1,1,1,0,2,0,2,9796
2,2,1,0,3,0,3,9796
3,3,0,1,3,1,4,9796
4,4,0,1,3,2,5,9796
5,5,0,0,3,2,5,9796
0,0,1,0,1,0,1,9797
1,1,0,0,1,0,1,9797
0,0,1,0,1,0,1,9798
1,1,1,0,2,0,2,9798
2,2,2,0,4,0,4,9798
3,3,1,0,5,0,5,9798
4,4,2,1,7,1,8,9798
5,5,0,0,7,1,8,9798
0,0,1,0,1,0,1,9799
1,1,2,0,3,0,3,9799
2,2,3,0,6,0,6,9799
3,3,1,1,7,1,8,9799
4,4,1,2,8,3,11,9799
5,5,2,3,10,6,16,9799
6,6,3,0,13,6,19,9799
7,7,5,0,18,6,24,9799
8,8,5,2,23,8,31,9799
9,9,4,3,27,11,38,9799
10,10,3,1,30,12,42,9799
11,11,3,0,33,12,45,9799
12,12,3,0,36,12,48,9799
13,13,3,0,39,12,51,9799
14,14,2,0,41,12,53,9799
15,15,2,1,43,13,56,9799
16,16,1,2,44,15,59,9799
17,17,2,4,46,19,65,9799
18,18,1,6,47,25,72,9799
19,19,2,3,49,28,77,9799
20,20,3,2,52,30,82,9799
21,21,2,2,54,32,86,9799
22,22,2,4,56,36,92,9799
23,23,2,4,58,40,98,9799
24,24,3,3,61,43,104,9799
25,25,5,5,66,48,114,9799
26,26,3,5,69,53,122,9799
27,27,3,8,72,61,133,9799
28,28,3,9,75,70,145,9799
29,29,1,5,76,75,151,9799
30,30,2,0,78,75,153,9799
31,31,1,0,79,75,154,9799
32,32,0,1,79,76,155,9799
33,33,0,0,79,76,155,9799
0,0,1,0,1,0,1,9800
1,1,2,0,3,0,3,9800
2,2,3,0,6,0,6,9800
3,3,3,1,9,1,10,9800
4,4,3,4,12,5,17,9800
5,5,4,2,16,7,23,9800
6,6,3,3,19,10,29,9800
7,7,1,8,20,18,38,9800
8,8,1,4,21,22,43,9800
9,9,3,5,24,27,51,9800
10,10,4,0,28,27,55,9800
11,11,2,1,30,28,58,9800
12,12,3,2,33,30,63,9800
13,13,3,1,36,31,67,9800
14,14,1,0,37,31,68,9800
15,15,0,0,37,31,68,9800
0,0,1,0,1,0,1,9801
1,1,1,0,2,0,2,9801
2,2,1,0,3,0,3,9801
3,3,0,0,3,0,3,9801
0,0,1,0,1,0,1,9802
1,1,0,0,1,0,1,9802
0,0,1,0,1,0,1,9803
1,1,2,1,3,1,4,9803
2,2,2,0,5,1,6,9803
3,3,0,0,5,1,6,9803
0,0,1,0,1,0,1,9804
1,1,0,0,1,0,1,9804
0,0,1,0,1,0,1,9805
1,1,1,0,2,0,2,9805
2,2,1,0,3,0,3,9805
3,3,3,0,6,0,6,9805
4,4,2,1,8,1,9,9805
5,5,1,0,9,1,10,9805
6,6,1,0,10,1,11,9805
7,7,0,1,10,2,12,9805
8,8,0,0,10,2,12,9805
0,0,1,0,1,0,1,9806
1,1,1,1,2,1,3,9806
2,2,0,2,2,3,5,9806
3,3,0,1,2,4,6,9806
4,4,1,0,3,4,7,9806
5,5,0,0,3,4,7,9806
0,0,1,0,1,0,1,9807
1,1,0,0,1,0,1,9807
0,0,1,0,1,0,1,9808
1,1,0,1,1,1,2,9808
2,2,0,3,1,4,5,9808
3,3,0,3,1,7,8,9808
4,4,0,5,1,12,13,9808
5,5,1,4,2,16,18,9808
6,6,2,2,4,18,22,9808
7,7,3,4,7,22,29,9808
8,8,4,1,11,23,34,9808
9,9,1,2,12,25,37,9808
10,10,2,1,14,26,40,9808
11,11,2,0,16,26,42,9808
12,12,4,0,20,26,46,9808
13,13,3,1,23,27,50,9808
14,14,2,4,25,31,56,9808
15,15,3,4,28,35,63,9808
16,16,2,7,30,42,72,9808
17,17,1,5,31,47,78,9808
18,18,0,1,31,48,79,9808
19,19,0,1,31,49,80,9808
20,20,0,1,31,50,81,9808
21,21,0,1,31,51,82,9808
22,22,0,0,31,51,82,9808
0,0,1,0,1,0,1,9809
1,1,0,0,1,0,1,9809
0,0,1,0,1,0,1,9810
1,1,0,1,1,1,2,9810
2,2,0,0,1,1,2,9810
0,0,1,0,1,0,1,9811
1,1,0,0,1,0,1,9811
0,0,1,0,1,0,1,9812
1,1,2,0,3,0,3,9812
2,2,6,1,9,1,10,9812
3,3,4,1,13,2,15,9812
4,4,3,3,16,5,21,9812
5,5,3,3,19,8,27,9812
6,6,0,3,19,11,30,9812
7,7,1,4,20,15,35,9812
8,8,2,1,22,16,38,9812
9,9,2,3,24,19,43,9812
10,10,3,3,27,22,49,9812
11,11,3,2,30,24,54,9812
12,12,3,1,33,25,58,9812
13,13,3,1,36,26,62,9812
14,14,3,0,39,26,65,9812
15,15,1,2,40,28,68,9812
16,16,2,2,42,30,72,9812
17,17,4,2,46,32,78,9812
18,18,6,3,52,35,87,9812
19,19,10,3,62,38,100,9812
20,20,8,5,70,43,113,9812
21,21,6,6,76,49,125,9812
22,22,8,10,84,59,143,9812
23,23,9,6,93,65,158,9812
24,24,7,2,100,67,167,9812
25,25,7,3,107,70,177,9812
26,26,4,4,111,74,185,9812
27,27,4,7,115,81,196,9812
28,28,2,9,117,90,207,9812
29,29,2,7,119,97,216,9812
30,30,5,2,124,99,223,9812
31,31,4,0,128,99,227,9812
32,32,4,1,132,100,232,9812
33,33,7,1,139,101,240,9812
34,34,4,2,143,103,246,9812
35,35,2,1,145,104,249,9812
36,36,0,0,145,104,249,9812
0,0,1,0,1,0,1,9813
1,1,0,0,1,0,1,9813
0,0,1,0,1,0,1,9814
1,1,2,0,3,0,3,9814
2,2,1,0,4,0,4,9814
3,3,0,0,4,0,4,9814
0,0,1,0,1,0,1,9815
1,1,0,0,1,0,1,9815
0,0,1,0,1,0,1,9816
1,1,1,0,2,0,2,9816
2,2,0,0,2,0,2,9816
0,0,1,0,1,0,1,9817
1,1,0,0,1,0,1,9817
0,0,1,0,1,0,1,9818
1,1,1,0,2,0,2,9818
2,2,1,0,3,0,3,9818
3,3,0,0,3,0,3,9818
0,0,1,0,1,0,1,9819
1,1,0,0,1,0,1,9819
0,0,1,0,1,0,1,9820
1,1,0,0,1,0,1,9820
0,0,1,0,1,0,1,9821
1,1,2,0,3,0,3,9821
2,2,1,0,4,0,4,9821
3,3,0,0,4,0,4,9821
0,0,1,0,1,0,1,9822
1,1,1,0,2,0,2,9822
2,2,1,0,3,0,3,9822
3,3,3,0,6,0,6,9822
4,4,3,1,9,1,10,9822
5,5,2,0,11,1,12,9822
6,6,0,0,11,1,12,9822
0,0,1,0,1,0,1,9823
1,1,2,1,3,1,4,9823
2,2,1,2,4,3,7,9823
3,3,0,2,4,5,9,9823
4,4,0,0,4,5,9,9823
0,0,1,0,1,0,1,9824
1,1,0,1,1,1,2,9824
2,2,0,2,1,3,4,9824
3,3,0,1,1,4,5,9824
4,4,1,1,2,5,7,9824
5,5,1,1,3,6,9,9824
6,6,0,3,3,9,12,9824
7,7,0,1,3,10,13,9824
8,8,0,1,3,11,14,9824
9,9,0,0,3,11,14,9824
0,0,1,0,1,0,1,9825
1,1,0,0,1,0,1,9825
0,0,1,0,1,0,1,9826
1,1,0,0,1,0,1,9826
0,0,1,0,1,0,1,9827
1,1,0,0,1,0,1,9827
0,0,1,0,1,0,1,9828
1,1,1,0,2,0,2,9828
2,2,1,1,3,1,4,9828
3,3,1,1,4,2,6,9828
4,4,0,0,4,2,6,9828
0,0,1,0,1,0,1,9829
1,1,1,0,2,0,2,9829
2,2,0,0,2,0,2,9829
0,0,1,0,1,0,1,9830
1,1,3,1,4,1,5,9830
2,2,2,1,6,2,8,9830
3,3,2,0,8,2,10,9830
4,4,0,0,8,2,10,9830
0,0,1,0,1,0,1,9831
1,1,0,0,1,0,1,9831
0,0,1,0,1,0,1,9832
1,1,0,0,1,0,1,9832
0,0,1,0,1,0,1,9833
1,1,1,0,2,0,2,9833
2,2,0,1,2,1,3,9833
3,3,0,0,2,1,3,9833
0,0,1,0,1,0,1,9834
1,1,1,0,2,0,2,9834
2,2,1,0,3,0,3,9834
3,3,0,0,3,0,3,9834
0,0,1,0,1,0,1,9835
1,1,1,0,2,0,2,9835
2,2,0,0,2,0,2,9835
0,0,1,0,1,0,1,9836
1,1,1,0,2,0,2,9836
2,2,1,0,3,0,3,9836
3,3,0,0,3,0,3,9836
0,0,1,0,1,0,1,9837
1,1,3,0,4,0,4,9837
2,2,2,1,6,1,7,9837
3,3,0,0,6,1,7,9837
0,0,1,0,1,0,1,9838
1,1,0,0,1,0,1,9838
0,0,1,0,1,0,1,9839
1,1,0,0,1,0,1,9839
0,0,1,0,1,0,1,9840
1,1,1,1,2,1,3,9840
2,2,0,0,2,1,3,9840
0,0,1,0,1,0,1,9841
1,1,0,0,1,0,1,9841
0,0,1,0,1,0,1,9842
1,1,0,0,1,0,1,9842
0,0,1,0,1,0,1,9843
1,1,0,0,1,0,1,9843
0,0,1,0,1,0,1,9844
1,1,0,1,1,1,2,9844
2,2,0,0,1,1,2,9844
0,0,1,0,1,0,1,9845
1,1,1,0,2,0,2,9845
2,2,2,0,4,0,4,9845
3,3,3,0,7,0,7,9845
4,4,3,1,10,1,11,9845
5,5,1,4,11,5,16,9845
6,6,2,0,13,5,18,9845
7,7,0,0,13,5,18,9845
0,0,1,0,1,0,1,9846
1,1,1,1,2,1,3,9846
2,2,0,1,2,2,4,9846
3,3,0,0,2,2,4,9846
0,0,1,0,1,0,1,9847
1,1,0,0,1,0,1,9847
0,0,1,0,1,0,1,9848
1,1,1,0,2,0,2,9848
2,2,1,0,3,0,3,9848
3,3,1,0,4,0,4,9848
4,4,0,0,4,0,4,9848
0,0,1,0,1,0,1,9849
1,1,1,0,2,0,2,9849
2,2,0,0,2,0,2,9849
0,0,1,0,1,0,1,9850
1,1,0,0,1,0,1,9850
0,0,1,0,1,0,1,9851
1,1,0,0,1,0,1,9851
0,0,1,0,1,0,1,9852
1,1,2,0,3,0,3,9852
2,2,2,0,5,0,5,9852
3,3,3,0,8,0,8,9852
4,4,4,0,12,0,12,9852
5,5,3,0,15,0,15,9852
6,6,7,0,22,0,22,9852
7,7,3,1,25,1,26,9852
8,8,5,1,30,2,32,9852
9,9,5,1,35,3,38,9852
10,10,3,2,38,5,43,9852
11,11,5,1,43,6,49,9852
12,12,4,2,47,8,55,9852
13,13,5,4,52,12,64,9852
14,14,4,4,56,16,72,9852
15,15,4,6,60,22,82,9852
16,16,4,9,64,31,95,9852
17,17,5,3,69,34,103,9852
18,18,4,4,73,38,111,9852
19,19,5,2,78,40,118,9852
20,20,2,0,80,40,120,9852
21,21,1,0,81,40,121,9852
22,22,1,0,82,40,122,9852
23,23,0,0,82,40,122,9852
0,0,1,0,1,0,1,9853
1,1,3,1,4,1,5,9853
2,2,2,0,6,1,7,9853
3,3,0,0,6,1,7,9853
0,0,1,0,1,0,1,9854
1,1,0,0,1,0,1,9854
0,0,1,0,1,0,1,9855
1,1,0,0,1,0,1,9855
0,0,1,0,1,0,1,9856
1,1,1,0,2,0,2,9856
2,2,0,0,2,0,2,9856
0,0,1,0,1,0,1,9857
1,1,0,0,1,0,1,9857
0,0,1,0,1,0,1,9858
1,1,0,0,1,0,1,9858
0,0,1,0,1,0,1,9859
1,1,1,0,2,0,2,9859
2,2,1,1,3,1,4,9859
3,3,0,0,3,1,4,9859
0,0,1,0,1,0,1,9860
1,1,0,0,1,0,1,9860
0,0,1,0,1,0,1,9861
1,1,2,0,3,0,3,9861
2,2,0,0,3,0,3,9861
0,0,1,0,1,0,1,9862
1,1,0,2,1,2,3,9862
2,2,0,1,1,3,4,9862
3,3,0,0,1,3,4,9862
0,0,1,0,1,0,1,9863
1,1,0,0,1,0,1,9863
0,0,1,0,1,0,1,9864
1,1,1,0,2,0,2,9864
2,2,0,1,2,1,3,9864
3,3,0,1,2,2,4,9864
4,4,0,0,2,2,4,9864
0,0,1,0,1,0,1,9865
1,1,0,0,1,0,1,9865
0,0,1,0,1,0,1,9866
1,1,1,0,2,0,2,9866
2,2,1,0,3,0,3,9866
3,3,1,0,4,0,4,9866
4,4,2,0,6,0,6,9866
5,5,2,1,8,1,9,9866
6,6,0,0,8,1,9,9866
0,0,1,0,1,0,1,9867
1,1,1,0,2,0,2,9867
2,2,2,0,4,0,4,9867
3,3,1,1,5,1,6,9867
4,4,2,2,7,3,10,9867
5,5,5,3,12,6,18,9867
6,6,3,5,15,11,26,9867
7,7,4,4,19,15,34,9867
8,8,3,5,22,20,42,9867
9,9,2,5,24,25,49,9867
10,10,5,4,29,29,58,9867
11,11,3,1,32,30,62,9867
12,12,1,1,33,31,64,9867
13,13,3,0,36,31,67,9867
14,14,1,1,37,32,69,9867
15,15,0,0,37,32,69,9867
0,0,1,0,1,0,1,9868
1,1,0,0,1,0,1,9868
0,0,1,0,1,0,1,9869
1,1,0,0,1,0,1,9869
0,0,1,0,1,0,1,9870
1,1,0,0,1,0,1,9870
0,0,1,0,1,0,1,9871
1,1,0,0,1,0,1,9871
0,0,1,0,1,0,1,9872
1,1,1,0,2,0,2,9872
2,2,0,0,2,0,2,9872
0,0,1,0,1,0,1,9873
1,1,1,0,2,0,2,9873
2,2,1,0,3,0,3,9873
3,3,1,0,4,0,4,9873
4,4,1,0,5,0,5,9873
5,5,0,0,5,0,5,9873
0,0,1,0,1,0,1,9874
1,1,1,1,2,1,3,9874
2,2,0,1,2,2,4,9874
3,3,0,0,2,2,4,9874
0,0,1,0,1,0,1,9875
1,1,0,0,1,0,1,9875
0,0,1,0,1,0,1,9876
1,1,1,0,2,0,2,9876
2,2,0,0,2,0,2,9876
0,0,1,0,1,0,1,9877
1,1,1,0,2,0,2,9877
2,2,0,0,2,0,2,9877
0,0,1,0,1,0,1,9878
1,1,0,0,1,0,1,9878
0,0,1,0,1,0,1,9879
1,1,3,0,4,0,4,9879
2,2,1,0,5,0,5,9879
3,3,0,0,5,0,5,9879
0,0,1,0,1,0,1,9880
1,1,0,0,1,0,1,9880
0,0,1,0,1,0,1,9881
1,1,3,0,4,0,4,9881
2,2,4,0,8,0,8,9881
3,3,4,0,12,0,12,9881
4,4,2,0,14,0,14,9881
5,5,1,0,15,0,15,9881
6,6,1,0,16,0,16,9881
7,7,1,0,17,0,17,9881
8,8,0,0,17,0,17,9881
0,0,1,0,1,0,1,9882
1,1,0,1,1,1,2,9882
2,2,0,2,1,3,4,9882
3,3,0,0,1,3,4,9882
0,0,1,0,1,0,1,9883
1,1,1,0,2,0,2,9883
2,2,2,0,4,0,4,9883
3,3,1,0,5,0,5,9883
4,4,0,0,5,0,5,9883
0,0,1,0,1,0,1,9884
1,1,0,0,1,0,1,9884
0,0,1,0,1,0,1,9885
1,1,2,0,3,0,3,9885
2,2,3,0,6,0,6,9885
3,3,4,0,10,0,10,9885
4,4,2,1,12,1,13,9885
5,5,1,0,13,1,14,9885
6,6,0,0,13,1,14,9885
0,0,1,0,1,0,1,9886
1,1,2,0,3,0,3,9886
2,2,2,0,5,0,5,9886
3,3,3,0,8,0,8,9886
4,4,0,0,8,0,8,9886
0,0,1,0,1,0,1,9887
1,1,2,0,3,0,3,9887
2,2,3,0,6,0,6,9887
3,3,1,0,7,0,7,9887
4,4,1,0,8,0,8,9887
5,5,0,0,8,0,8,9887
0,0,1,0,1,0,1,9888
1,1,1,0,2,0,2,9888
2,2,1,0,3,0,3,9888
3,3,1,0,4,0,4,9888
4,4,0,0,4,0,4,9888
0,0,1,0,1,0,1,9889
1,1,0,0,1,0,1,9889
0,0,1,0,1,0,1,9890
1,1,1,0,2,0,2,9890
2,2,2,0,4,0,4,9890
3,3,3,0,7,0,7,9890
4,4,4,0,11,0,11,9890
5,5,8,0,19,0,19,9890
6,6,4,1,23,1,24,9890
7,7,4,2,27,3,30,9890
8,8,2,3,29,6,35,9890
9,9,5,3,34,9,43,9890
10,10,4,3,38,12,50,9890
11,11,3,2,41,14,55,9890
12,12,2,1,43,15,58,9890
13,13,1,1,44,16,60,9890
14,14,1,0,45,16,61,9890
15,15,1,0,46,16,62,9890
16,16,2,0,48,16,64,9890
17,17,0,0,48,16,64,9890
0,0,1,0,1,0,1,9891
1,1,0,0,1,0,1,9891
0,0,1,0,1,0,1,9892
1,1,0,0,1,0,1,9892
0,0,1,0,1,0,1,9893
1,1,0,0,1,0,1,9893
0,0,1,0,1,0,1,9894
1,1,4,0,5,0,5,9894
2,2,4,2,9,2,11,9894
3,3,7,1,16,3,19,9894
4,4,7,2,23,5,28,9894
5,5,6,2,29,7,36,9894
6,6,7,5,36,12,48,9894
7,7,4,3,40,15,55,9894
8,8,1,6,41,21,62,9894
9,9,1,4,42,25,67,9894
10,10,2,3,44,28,72,9894
11,11,2,4,46,32,78,9894
12,12,0,6,46,38,84,9894
13,13,1,2,47,40,87,9894
14,14,0,1,47,41,88,9894
15,15,0,2,47,43,90,9894
16,16,0,1,47,44,91,9894
17,17,1,0,48,44,92,9894
18,18,0,0,48,44,92,9894
0,0,1,0,1,0,1,9895
1,1,1,0,2,0,2,9895
2,2,2,0,4,0,4,9895
3,3,1,1,5,1,6,9895
4,4,2,2,7,3,10,9895
5,5,1,1,8,4,12,9895
6,6,1,1,9,5,14,9895
7,7,1,0,10,5,15,9895
8,8,1,0,11,5,16,9895
9,9,0,0,11,5,16,9895
0,0,1,0,1,0,1,9896
1,1,1,0,2,0,2,9896
2,2,0,0,2,0,2,9896
0,0,1,0,1,0,1,9897
1,1,0,0,1,0,1,9897
0,0,1,0,1,0,1,9898
1,1,0,0,1,0,1,9898
0,0,1,0,1,0,1,9899
1,1,0,0,1,0,1,9899
0,0,1,0,1,0,1,9900
1,1,1,0,2,0,2,9900
2,2,0,1,2,1,3,9900
3,3,0,1,2,2,4,9900
4,4,0,0,2,2,4,9900
0,0,1,0,1,0,1,9901
1,1,0,0,1,0,1,9901
0,0,1,0,1,0,1,9902
1,1,0,0,1,0,1,9902
0,0,1,0,1,0,1,9903
1,1,1,0,2,0,2,9903
2,2,2,0,4,0,4,9903
3,3,1,0,5,0,5,9903
4,4,1,0,6,0,6,9903
5,5,0,0,6,0,6,9903
0,0,1,0,1,0,1,9904
1,1,0,0,1,0,1,9904
0,0,1,0,1,0,1,9905
1,1,1,0,2,0,2,9905
2,2,0,1,2,1,3,9905
3,3,0,2,2,3,5,9905
4,4,0,2,2,5,7,9905
5,5,0,0,2,5,7,9905
0,0,1,0,1,0,1,9906
1,1,1,1,2,1,3,9906
2,2,0,0,2,1,3,9906
0,0,1,0,1,0,1,9907
1,1,0,0,1,0,1,9907
0,0,1,0,1,0,1,9908
1,1,0,0,1,0,1,9908
0,0,1,0,1,0,1,9909
1,1,0,0,1,0,1,9909
0,0,1,0,1,0,1,9910
1,1,0,0,1,0,1,9910
0,0,1,0,1,0,1,9911
1,1,1,0,2,0,2,9911
2,2,2,1,4,1,5,9911
3,3,0,2,4,3,7,9911
4,4,0,1,4,4,8,9911
5,5,0,0,4,4,8,9911
0,0,1,0,1,0,1,9912
1,1,1,0,2,0,2,9912
2,2,0,1,2,1,3,9912
3,3,0,0,2,1,3,9912
0,0,1,0,1,0,1,9913
1,1,1,1,2,1,3,9913
2,2,0,1,2,2,4,9913
3,3,0,1,2,3,5,9913
4,4,0,0,2,3,5,9913
0,0,1,0,1,0,1,9914
1,1,0,1,1,1,2,9914
2,2,0,0,1,1,2,9914
0,0,1,0,1,0,1,9915
1,1,1,0,2,0,2,9915
2,2,2,0,4,0,4,9915
3,3,1,1,5,1,6,9915
4,4,1,2,6,3,9,9915
5,5,1,2,7,5,12,9915
6,6,1,4,8,9,17,9915
7,7,0,2,8,11,19,9915
8,8,1,1,9,12,21,9915
9,9,0,1,9,13,22,9915
10,10,0,1,9,14,23,9915
11,11,1,1,10,15,25,9915
12,12,2,0,12,15,27,9915
13,13,1,0,13,15,28,9915
14,14,0,0,13,15,28,9915
0,0,1,0,1,0,1,9916
1,1,2,0,3,0,3,9916
2,2,1,0,4,0,4,9916
3,3,0,0,4,0,4,9916
0,0,1,0,1,0,1,9917
1,1,1,0,2,0,2,9917
2,2,1,0,3,0,3,9917
3,3,0,0,3,0,3,9917
0,0,1,0,1,0,1,9918
1,1,0,1,1,1,2,9918
2,2,0,0,1,1,2,9918
0,0,1,0,1,0,1,9919
1,1,3,0,4,0,4,9919
2,2,1,0,5,0,5,9919
3,3,2,0,7,0,7,9919
4,4,2,0,9,0,9,9919
5,5,1,1,10,1,11,9919
6,6,0,1,10,2,12,9919
7,7,0,2,10,4,14,9919
8,8,0,0,10,4,14,9919
0,0,1,0,1,0,1,9920
1,1,2,0,3,0,3,9920
2,2,3,0,6,0,6,9920
3,3,2,0,8,0,8,9920
4,4,2,0,10,0,10,9920
5,5,0,0,10,0,10,9920
0,0,1,0,1,0,1,9921
1,1,1,1,2,1,3,9921
2,2,0,1,2,2,4,9921
3,3,1,0,3,2,5,9921
4,4,1,0,4,2,6,9921
5,5,2,0,6,2,8,9921
6,6,2,1,8,3,11,9921
7,7,1,1,9,4,13,9921
8,8,0,1,9,5,14,9921
9,9,0,1,9,6,15,9921
10,10,0,3,9,9,18,9921
11,11,0,2,9,11,20,9921
12,12,1,1,10,12,22,9921
13,13,2,1,12,13,25,9921
14,14,1,1,13,14,27,9921
15,15,0,2,13,16,29,9921
16,16,0,0,13,16,29,9921
0,0,1,0,1,0,1,9922
1,1,0,0,1,0,1,9922
0,0,1,0,1,0,1,9923
1,1,0,0,1,0,1,9923
0,0,1,0,1,0,1,9924
1,1,0,0,1,0,1,9924
0,0,1,0,1,0,1,9925
1,1,1,0,2,0,2,9925
2,2,0,0,2,0,2,9925
0,0,1,0,1,0,1,9926
1,1,1,0,2,0,2,9926
2,2,1,0,3,0,3,9926
3,3,1,0,4,0,4,9926
4,4,2,0,6,0,6,9926
5,5,0,0,6,0,6,9926
0,0,1,0,1,0,1,9927
1,1,2,0,3,0,3,9927
2,2,1,1,4,1,5,9927
3,3,0,4,4,5,9,9927
4,4,0,4,4,9,13,9927
5,5,4,2,8,11,19,9927
6,6,4,1,12,12,24,9927
7,7,3,3,15,15,30,9927
8,8,1,2,16,17,33,9927
9,9,2,1,18,18,36,9927
10,10,4,1,22,19,41,9927
11,11,5,2,27,21,48,9927
12,12,4,3,31,24,55,9927
13,13,4,3,35,27,62,9927
14,14,1,2,36,29,65,9927
15,15,1,2,37,31,68,9927
16,16,1,4,38,35,73,9927
17,17,2,1,40,36,76,9927
18,18,0,0,40,36,76,9927
0,0,1,0,1,0,1,9928
1,1,0,1,1,1,2,9928
2,2,0,3,1,4,5,9928
3,3,0,2,1,6,7,9928
4,4,0,3,1,9,10,9928
5,5,0,0,1,9,10,9928
0,0,1,0,1,0,1,9929
1,1,0,1,1,1,2,9929
2,2,0,0,1,1,2,9929
0,0,1,0,1,0,1,9930
1,1,0,0,1,0,1,9930
0,0,1,0,1,0,1,9931
1,1,1,0,2,0,2,9931
2,2,0,0,2,0,2,9931
0,0,1,0,1,0,1,9932
1,1,0,0,1,0,1,9932
0,0,1,0,1,0,1,9933
1,1,2,1,3,1,4,9933
2,2,0,1,3,2,5,9933
3,3,0,1,3,3,6,9933
4,4,0,0,3,3,6,9933
0,0,1,0,1,0,1,9934
1,1,1,0,2,0,2,9934
2,2,1,0,3,0,3,9934
3,3,0,0,3,0,3,9934
0,0,1,0,1,0,1,9935
1,1,1,0,2,0,2,9935
2,2,0,0,2,0,2,9935
0,0,1,0,1,0,1,9936
1,1,0,1,1,1,2,9936
2,2,0,1,1,2,3,9936
3,3,0,0,1,2,3,9936
0,0,1,0,1,0,1,9937
1,1,1,0,2,0,2,9937
2,2,1,0,3,0,3,9937
3,3,0,0,3,0,3,9937
0,0,1,0,1,0,1,9938
1,1,0,0,1,0,1,9938
0,0,1,0,1,0,1,9939
1,1,1,0,2,0,2,9939
2,2,0,0,2,0,2,9939
0,0,1,0,1,0,1,9940
1,1,1,0,2,0,2,9940
2,2,0,0,2,0,2,9940
0,0,1,0,1,0,1,9941
1,1,1,0,2,0,2,9941
2,2,1,0,3,0,3,9941
3,3,1,0,4,0,4,9941
4,4,3,0,7,0,7,9941
5,5,1,1,8,1,9,9941
6,6,1,2,9,3,12,9941
7,7,2,5,11,8,19,9941
8,8,2,5,13,13,26,9941
9,9,1,6,14,19,33,9941
10,10,1,3,15,22,37,9941
11,11,1,6,16,28,44,9941
12,12,4,9,20,37,57,9941
13,13,4,6,24,43,67,9941
14,14,2,9,26,52,78,9941
15,15,4,3,30,55,85,9941
16,16,4,2,34,57,91,9941
17,17,9,2,43,59,102,9941
18,18,4,6,47,65,112,9941
19,19,5,8,52,73,125,9941
20,20,5,7,57,80,137,9941
21,21,3,4,60,84,144,9941
22,22,0,4,60,88,148,9941
23,23,1,3,61,91,152,9941
24,24,1,1,62,92,154,9941
25,25,0,1,62,93,155,9941
26,26,0,1,62,94,156,9941
27,27,0,0,62,94,156,9941
0,0,1,0,1,0,1,9942
1,1,0,0,1,0,1,9942
0,0,1,0,1,0,1,9943
1,1,1,0,2,0,2,9943
2,2,2,0,4,0,4,9943
3,3,2,0,6,0,6,9943
4,4,2,1,8,1,9,9943
5,5,1,2,9,3,12,9943
6,6,1,2,10,5,15,9943
7,7,1,2,11,7,18,9943
8,8,0,4,11,11,22,9943
9,9,1,3,12,14,26,9943
10,10,2,1,14,15,29,9943
11,11,2,1,16,16,32,9943
12,12,3,0,19,16,35,9943
13,13,3,2,22,18,40,9943
14,14,1,0,23,18,41,9943
15,15,3,1,26,19,45,9943
16,16,3,2,29,21,50,9943
17,17,1,0,30,21,51,9943
18,18,1,0,31,21,52,9943
19,19,0,0,31,21,52,9943
0,0,1,0,1,0,1,9944
1,1,1,0,2,0,2,9944
2,2,1,0,3,0,3,9944
3,3,0,0,3,0,3,9944
0,0,1,0,1,0,1,9945
1,1,0,0,1,0,1,9945
0,0,1,0,1,0,1,9946
1,1,1,0,2,0,2,9946
2,2,1,0,3,0,3,9946
3,3,2,0,5,0,5,9946
4,4,1,0,6,0,6,9946
5,5,0,0,6,0,6,9946
0,0,1,0,1,0,1,9947
1,1,2,0,3,0,3,9947
2,2,0,0,3,0,3,9947
0,0,1,0,1,0,1,9948
1,1,1,0,2,0,2,9948
2,2,0,2,2,2,4,9948
3,3,0,2,2,4,6,9948
4,4,0,1,2,5,7,9948
5,5,0,0,2,5,7,9948
0,0,1,0,1,0,1,9949
1,1,0,0,1,0,1,9949
0,0,1,0,1,0,1,9950
1,1,1,0,2,0,2,9950
2,2,0,0,2,0,2,9950
0,0,1,0,1,0,1,9951
1,1,0,0,1,0,1,9951
0,0,1,0,1,0,1,9952
1,1,0,0,1,0,1,9952
0,0,1,0,1,0,1,9953
1,1,0,0,1,0,1,9953
0,0,1,0,1,0,1,9954
1,1,0,0,1,0,1,9954
0,0,1,0,1,0,1,9955
1,1,1,0,2,0,2,9955
2,2,0,0,2,0,2,9955
0,0,1,0,1,0,1,9956
1,1,1,0,2,0,2,9956
2,2,2,0,4,0,4,9956
3,3,0,0,4,0,4,9956
0,0,1,0,1,0,1,9957
1,1,1,0,2,0,2,9957
2,2,1,0,3,0,3,9957
3,3,1,0,4,0,4,9957
4,4,1,1,5,1,6,9957
5,5,0,1,5,2,7,9957
6,6,0,2,5,4,9,9957
7,7,0,0,5,4,9,9957
0,0,1,0,1,0,1,9958
1,1,1,0,2,0,2,9958
2,2,1,0,3,0,3,9958
3,3,2,0,5,0,5,9958
4,4,0,0,5,0,5,9958
0,0,1,0,1,0,1,9959
1,1,1,0,2,0,2,9959
2,2,1,0,3,0,3,9959
3,3,1,0,4,0,4,9959
4,4,0,0,4,0,4,9959
0,0,1,0,1,0,1,9960
1,1,2,0,3,0,3,9960
2,2,1,0,4,0,4,9960
3,3,0,0,4,0,4,9960
0,0,1,0,1,0,1,9961
1,1,1,0,2,0,2,9961
2,2,0,0,2,0,2,9961
0,0,1,0,1,0,1,9962
1,1,2,0,3,0,3,9962
2,2,1,0,4,0,4,9962
3,3,0,1,4,1,5,9962
4,4,0,2,4,3,7,9962
5,5,2,1,6,4,10,9962
6,6,3,1,9,5,14,9962
7,7,1,1,10,6,16,9962
8,8,0,3,10,9,19,9962
9,9,1,2,11,11,22,9962
10,10,0,0,11,11,22,9962
0,0,1,0,1,0,1,9963
1,1,0,0,1,0,1,9963
0,0,1,0,1,0,1,9964
1,1,1,0,2,0,2,9964
2,2,0,0,2,0,2,9964
0,0,1,0,1,0,1,9965
1,1,0,0,1,0,1,9965
0,0,1,0,1,0,1,9966
1,1,0,0,1,0,1,9966
0,0,1,0,1,0,1,9967
1,1,2,1,3,1,4,9967
2,2,1,1,4,2,6,9967
3,3,1,1,5,3,8,9967
4,4,1,1,6,4,10,9967
5,5,0,1,6,5,11,9967
6,6,0,2,6,7,13,9967
7,7,0,3,6,10,16,9967
8,8,1,1,7,11,18,9967
9,9,0,2,7,13,20,9967
10,10,0,0,7,13,20,9967
0,0,1,0,1,0,1,9968
1,1,1,0,2,0,2,9968
2,2,1,0,3,0,3,9968
3,3,2,0,5,0,5,9968
4,4,2,0,7,0,7,9968
5,5,2,0,9,0,9,9968
6,6,1,0,10,0,10,9968
7,7,1,0,11,0,11,9968
8,8,1,0,12,0,12,9968
9,9,0,0,12,0,12,9968
0,0,1,0,1,0,1,9969
1,1,1,0,2,0,2,9969
2,2,2,0,4,0,4,9969
3,3,1,1,5,1,6,9969
4,4,0,0,5,1,6,9969
0,0,1,0,1,0,1,9970
1,1,2,1,3,1,4,9970
2,2,3,2,6,3,9,9970
3,3,0,4,6,7,13,9970
4,4,3,1,9,8,17,9970
5,5,2,0,11,8,19,9970
6,6,3,0,14,8,22,9970
7,7,4,1,18,9,27,9970
8,8,4,1,22,10,32,9970
9,9,4,2,26,12,38,9970
10,10,2,1,28,13,41,9970
11,11,1,1,29,14,43,9970
12,12,1,1,30,15,45,9970
13,13,1,2,31,17,48,9970
14,14,0,2,31,19,50,9970
15,15,0,0,31,19,50,9970
0,0,1,0,1,0,1,9971
1,1,0,0,1,0,1,9971
0,0,1,0,1,0,1,9972
1,1,2,0,3,0,3,9972
2,2,0,1,3,1,4,9972
3,3,0,0,3,1,4,9972
0,0,1,0,1,0,1,9973
1,1,1,1,2,1,3,9973
2,2,0,1,2,2,4,9973
3,3,0,0,2,2,4,9973
0,0,1,0,1,0,1,9974
1,1,0,0,1,0,1,9974
0,0,1,0,1,0,1,9975
1,1,3,0,4,0,4,9975
2,2,4,1,8,1,9,9975
3,3,3,0,11,1,12,9975
4,4,3,1,14,2,16,9975
5,5,3,2,17,4,21,9975
6,6,1,5,18,9,27,9975
7,7,3,4,21,13,34,9975
8,8,2,2,23,15,38,9975
9,9,1,1,24,16,40,9975
10,10,2,0,26,16,42,9975
11,11,0,0,26,16,42,9975
0,0,1,0,1,0,1,9976
1,1,0,1,1,1,2,9976
2,2,0,1,1,2,3,9976
3,3,0,1,1,3,4,9976
4,4,0,2,1,5,6,9976
5,5,0,1,1,6,7,9976
6,6,0,1,1,7,8,9976
7,7,0,2,1,9,10,9976
8,8,0,2,1,11,12,9976
9,9,0,1,1,12,13,9976
10,10,0,2,1,14,15,9976
11,11,0,0,1,14,15,9976
0,0,1,0,1,0,1,9977
1,1,1,0,2,0,2,9977
2,2,0,0,2,0,2,9977
0,0,1,0,1,0,1,9978
1,1,0,0,1,0,1,9978
0,0,1,0,1,0,1,9979
1,1,1,1,2,1,3,9979
2,2,1,0,3,1,4,9979
3,3,0,0,3,1,4,9979
0,0,1,0,1,0,1,9980
1,1,2,0,3,0,3,9980
2,2,1,0,4,0,4,9980
3,3,0,1,4,1,5,9980
4,4,0,1,4,2,6,9980
5,5,0,0,4,2,6,9980
0,0,1,0,1,0,1,9981
1,1,1,0,2,0,2,9981
2,2,2,0,4,0,4,9981
3,3,3,0,7,0,7,9981
4,4,2,1,9,1,10,9981
5,5,2,6,11,7,18,9981
6,6,2,4,13,11,24,9981
7,7,4,1,17,12,29,9981
8,8,5,2,22,14,36,9981
9,9,3,1,25,15,40,9981
10,10,4,4,29,19,48,9981
11,11,2,5,31,24,55,9981
12,12,2,4,33,28,61,9981
13,13,3,5,36,33,69,9981
14,14,3,4,39,37,76,9981
15,15,1,2,40,39,79,9981
16,16,0,2,40,41,81,9981
17,17,1,1,41,42,83,9981
18,18,0,0,41,42,83,9981
0,0,1,0,1,0,1,9982
1,1,2,0,3,0,3,9982
2,2,0,1,3,1,4,9982
3,3,1,0,4,1,5,9982
4,4,2,0,6,1,7,9982
5,5,0,0,6,1,7,9982
0,0,1,0,1,0,1,9983
1,1,0,1,1,1,2,9983
2,2,1,0,2,1,3,9983
3,3,1,0,3,1,4,9983
4,4,1,0,4,1,5,9983
5,5,1,0,5,1,6,9983
6,6,1,0,6,1,7,9983
7,7,0,1,6,2,8,9983
8,8,0,0,6,2,8,9983
0,0,1,0,1,0,1,9984
1,1,0,0,1,0,1,9984
0,0,1,0,1,0,1,9985
1,1,2,0,3,0,3,9985
2,2,1,0,4,0,4,9985
3,3,0,0,4,0,4,9985
0,0,1,0,1,0,1,9986
1,1,1,0,2,0,2,9986
2,2,3,0,5,0,5,9986
3,3,3,0,8,0,8,9986
4,4,0,1,8,1,9,9986
5,5,0,2,8,3,11,9986
6,6,1,1,9,4,13,9986
7,7,2,1,11,5,16,9986
8,8,3,0,14,5,19,9986
9,9,1,2,15,7,22,9986
10,10,4,0,19,7,26,9986
11,11,4,0,23,7,30,9986
12,12,4,1,27,8,35,9986
13,13,5,3,32,11,43,9986
14,14,3,1,35,12,47,9986
15,15,0,1,35,13,48,9986
16,16,0,0,35,13,48,9986
0,0,1,0,1,0,1,9987
1,1,1,1,2,1,3,9987
2,2,1,1,3,2,5,9987
3,3,2,0,5,2,7,9987
4,4,2,1,7,3,10,9987
5,5,1,3,8,6,14,9987
6,6,1,2,9,8,17,9987
7,7,1,2,10,10,20,9987
8,8,0,1,10,11,21,9987
9,9,0,1,10,12,22,9987
10,10,0,2,10,14,24,9987
11,11,0,0,10,14,24,9987
0,0,1,0,1,0,1,9988
1,1,3,0,4,0,4,9988
2,2,3,0,7,0,7,9988
3,3,3,1,10,1,11,9988
4,4,4,1,14,2,16,9988
5,5,3,5,17,7,24,9988
6,6,0,3,17,10,27,9988
7,7,0,0,17,10,27,9988
0,0,1,0,1,0,1,9989
1,1,0,0,1,0,1,9989
0,0,1,0,1,0,1,9990
1,1,3,0,4,0,4,9990
2,2,3,0,7,0,7,9990
3,3,1,0,8,0,8,9990
4,4,0,0,8,0,8,9990
0,0,1,0,1,0,1,9991
1,1,2,1,3,1,4,9991
2,2,3,1,6,2,8,9991
3,3,1,1,7,3,10,9991
4,4,1,3,8,6,14,9991
5,5,0,2,8,8,16,9991
6,6,0,0,8,8,16,9991
0,0,1,0,1,0,1,9992
1,1,0,0,1,0,1,9992
0,0,1,0,1,0,1,9993
1,1,0,0,1,0,1,9993
0,0,1,0,1,0,1,9994
1,1,1,0,2,0,2,9994
2,2,1,0,3,0,3,9994
3,3,3,0,6,0,6,9994
4,4,1,1,7,1,8,9994
5,5,2,1,9,2,11,9994
6,6,1,2,10,4,14,9994
7,7,1,4,11,8,19,9994
8,8,0,1,11,9,20,9994
9,9,0,0,11,9,20,9994
0,0,1,0,1,0,1,9995
1,1,0,0,1,0,1,9995
0,0,1,0,1,0,1,9996
1,1,1,0,2,0,2,9996
2,2,2,0,4,0,4,9996
3,3,0,0,4,0,4,9996
0,0,1,0,1,0,1,9997
1,1,0,0,1,0,1,9997
0,0,1,0,1,0,1,9998
1,1,1,0,2,0,2,9998
2,2,0,0,2,0,2,9998
0,0,1,0,1,0,1,9999
1,1,0,0,1,0,1,9999
